processing mutantSample-PB7 2020-06-09 19:02:24 
Converted TACACCTGCA to GGCCCCTACAbecause it is a known primer mishybridization result 
Combined ACATTCGGTT GAAACACCGGTCGATTCATATCGAAACCTTCCCGTGTGGTTAGAGCTAGA 4 into ACATTCGGTT GAAACACCGGTCGATTCATATCGAAACCTTCCCGTGGGGTTAGAGCTAGA 5	for max_spacer_dist
Combined AGACCCTCGC CAAAACACCGGTGCATTCGAAAGTCCGGTCGTAGTGTGGACGTGGGGTTA 4 into AGACCCTCGC GAAACACCGGTGCATTCGAAAGTCCGGTCGTAGTGTGGACGTGGGGTTAG 1835	for one base displacement
Combined ATGCTTAGCT CAAAACACCGGTTTACGTTGCATCGGTGTGGGGTTAGAGCTAGAAATAGC 3 into ATGCTTAGCT GAAACACCGGTTTACGTTGCATCGGTGTGGGGTTAGAGCTAGAAATAGCA 957	for one base displacement
Combined CATCGTCGTC CAAAACACCGGTGTACGTATGGACTGAACCAGGGTGTGCAAGTGGGGTTA 5 into CATCGTCGTC GAAACACCGGTGTACGTATGGACTGAACCAGGGTGTGCAAGTGGGGTTAG 1621	for one base displacement
Combined CCTTTACCGC CAAAACACCGGTCGGGGCCACTCAGTGGTGGGGTTAGAGCTAGAAATAGC 3 into CCTTTACCGC GAAACACCGGTCGGGGCCACTCAGTGGTGGGGTTAGAGCTAGAAATAGCA 1492	for one base displacement
Combined CGAATCCTTT CAAAACACCGGTCTCGAGTGAGGTGTTCAGGGTGGGGTTAGAGCTAGAAA 7 into CGAATCCTTT GAAACACCGGTCTCGAGTGAGGTGTTCAGGGTGGGGTTAGAGCTAGAAAT 1234	for one base displacement
Combined CGTGTTGTCT GAAACACCGGTGACATTGGGTACGGGGTTAGAGCTAGAAATAGCAAGTTA 4 into CGTGTTGTCT GAAACACCGGTGACATTGGGTATGGGGTTAGAGCTAGAAATAGCAAGTTA 5	for max_spacer_dist
Combined CGTGTTGTCT GAAACACCGGTGACATGGGTTAGAGCTAGAAATAGCAAGTTAACCTAAGG 5 into CGTGTTGTCT GAAACACCGGTGACAGGGGTTAGAGCTAGAAATAGCAAGTTAACCTAAGG 8	for max_spacer_dist
Combined CGTGTTGTCT CAAAACACCGGTGACATTGGGTACAGGGTGGGGTTAGAGCTAGAAATAGC 3 into CGTGTTGTCT GAAACACCGGTGACATTGGGTACAGGGTGGGGTTAGAGCTAGAAATAGCA 368	for one base displacement
Combined GAAGACCCGC GAAACACGGGTTAGAGCTAGAAATAGCAAGTTAACCTAAGGCTAGTCCGT 4 into GAAGACCCGC GAAACACCGGTTAGAGCTAGAAATAGCAAGTTAACCTAAGGCTAGTCCGT 20	for max_spacer_dist
Combined GAAGACCCGC GAAACACCGGTCGGCGGCAGTGGGGTTAGAGCTAGAAATAGCAAGTTAAC 4 into GAAGACCCGC GAAACACCGGTCGGCGGCAATGGGGTTAGAGCTAGAAATAGCAAGTTAAC 8	for max_spacer_dist
Combined GAAGACCCGC GAAACACCGGTCGGCGGTTAGAGCTAGAAATAGCAAGTTAACCTAAGGCT 13 into GAAGACCCGC GAAACACCGGTCGGGGGTTAGAGCTAGAAATAGCAAGTTAACCTAAGGCT 16	for max_spacer_dist
Combined GAAGACCCGC GAAACACCGGTCGGCGGCAATCGGGGTTAGAGCTAGAAATAGCAAGTTAA 20 into GAAGACCCGC GAAACACCGGTCGGCGGCAATCGTGGTTAGAGCTAGAAATAGCAAGTTAA 21	for max_spacer_dist
Combined GACACAGACA GAAACACCGGTAGCAAGTGCGAGCAAGTTGTGGGGTTAGAGCTAGAAATA 9 into GACACAGACA GAAACACCGGTAGCAAGTGCGAGCAAGTTTTGGGGTTAGAGCTAGAAATA 11	for max_spacer_dist
Combined GACACAGACA GAAACACCGGTAGCAAGTGCGGTTAGAGCTAGAAATAGCAAGTTAACCTA 37 into GACACAGACA GAAACACCGGTAGCAAGTGGGGTTAGAGCTAGAAATAGCAAGTTAACCTA 73	for max_spacer_dist
Combined GGCACCCTCC GAACACCGGTGTGGCTGAGAGTCCGGCAATGGTGTGGCTGTGGGGTTAGA 3 into GGCACCCTCC GAAACACCGGTGTGGCTGAGAGTCCGGCAATGGTGTGGCTGTGGGGTTAG 1069	for one base displacement
Combined TAACTTATAC GAAACACCGGTAACTATATTCATGCGATATAGCCGTATGGGGTTAGAGCT 3 into TAACTTATAC GAAACACCGGTAACTATATTCATGCGATATCGCCGTATGGGGTTAGAGCT 5	for max_spacer_dist
Combined TCTATCGAGG GAAACACCGGTTATATTTGTAAGTGTTAGAGCTAGAAATAGCAAGTTAAC 5 into TCTATCGAGG GAAACACCGGTTATATTTGTAAGGGTTAGAGCTAGAAATAGCAAGTTAAC 10	for max_spacer_dist
Combined TTAGCTATGT GAAATACCGGTTACATTGAGTGGGGTTAGAGCTAGAAATAGCAAGTTAAC 3 into TTAGCTATGT GAAACACCGGTTACATTGAGTGGGGTTAGAGCTAGAAATAGCAAGTTAAC 9	for max_spacer_dist
Combined TTAGCTATGT CAAAACACCGGTTACATTGAGGGGTTAGAGCTAGAAATAGCAAGTTAACC 3 into TTAGCTATGT GAAACACCGGTTACATTGAGGGGTTAGAGCTAGAAATAGCAAGTTAACCT 302	for one base displacement
Combined TTAGCTATGT GTGAGGGTTAGAGCTAGAAATAGCAAGTTAACCTAAGGCTAGTCCGTTAT 4 into TTAGCTATGT AGAGGGTTAGAGCTAGAAATAGCAAGTTAACCTAAGGCTAGTCCGTTATC 5	for one base displacement
Combined TTAGCTATGT ATTGAGGGTTAGAGCTAGAAATAGCAAGTTAACCTAAGGCTAGTCCGTTA 5 into TTAGCTATGT AGAGGGTTAGAGCTAGAAATAGCAAGTTAACCTAAGGCTAGTCCGTTATC 9	for one base displacement
processing PB7-founder 2020-06-09 19:02:25 
Converted TACACCTGCA to GGCCCCTACAbecause it is a known primer mishybridization result 
Combined ACTCCATGTT CAAAACACCGGTATGAGAATCGGTAGTCATGGTGGGGTTAGAGCTAGAAA 3 into ACTCCATGTT GAAACACCGGTATGAGAATCGGTAGTCATGGTGGGGTTAGAGCTAGAAAT 505	for one base displacement
Combined CATCGTCGTC CAAAACACCGGTGTACGTATGGACTGAACCAGGGTGTGCAAGTGGGGTTA 3 into CATCGTCGTC GAAACACCGGTGTACGTATGGACTGAACCAGGGTGTGCAAGTGGGGTTAG 461	for one base displacement
Combined CATTGGAGGT CAAAACACCGGTGACAGAAGCTGCGTGGTGGGGTTAGAGCTAGAAATAGC 4 into CATTGGAGGT GAAACACCGGTGACAGAAGCTGCGTGGTGGGGTTAGAGCTAGAAATAGCA 766	for one base displacement
Combined CCCAAAACAC CAAAACACCGGTTTACTGGATTAGTTCGTGGGGTTAGAGCTAGAAATAGC 4 into CCCAAAACAC GAAACACCGGTTTACTGGATTAGTTCGTGGGGTTAGAGCTAGAAATAGCA 1479	for one base displacement
Combined CGTGTTGTCT GACGAAACACCGGTGACATTGGGTACAGGGTGGGGTTAGAGCTAGAAATA 4 into CGTGTTGTCT GAAACACCGGTGACATTGGGTACAGGGTGGGGTTAGAGCTAGAAATAGCA 543	for one base displacement
Combined CTGCTATCGA CAAAACACCGGTTGTGTCACCTTCACAGTGGGGTTAGAGCTAGAAATAGC 3 into CTGCTATCGA GAAACACCGGTTGTGTCACCTTCACAGTGGGGTTAGAGCTAGAAATAGCA 618	for one base displacement
Combined GACCTCCAAT CAAAACACCGGTGTACACAGAGTCGACTACCCAGTATGTTCGTGGGGTTA 7 into GACCTCCAAT GAAACACCGGTGTACACAGAGTCGACTACCCAGTATGTTCGTGGGGTTAG 583	for one base displacement
Combined GCCCCATTCC CAAAACACCGGTCAGGTCACGTCGTCTGTGGGGTTAGAGCTAGAAATAGC 4 into GCCCCATTCC GAAACACCGGTCAGGTCACGTCGTCTGTGGGGTTAGAGCTAGAAATAGCA 504	for one base displacement
Combined GTACACAATT CAAAACACCGGTTAAAGTAAATTGCGAGTGGGGTTAGAGCTAGAAATAGC 3 into GTACACAATT GAAACACCGGTTAAAGTAAATTGCGAGTGGGGTTAGAGCTAGAAATAGCA 310	for one base displacement
Combined GTGGAGCCTC CAAAACACCGGTTCCCGTCCAGTAATCGTGGGGTTAGAGCTAGAAATAGC 4 into GTGGAGCCTC GAAACACCGGTTCCCGTCCAGTAATCGTGGGGTTAGAGCTAGAAATAGCA 925	for one base displacement
Combined TAACTTATAC CAAAACACCGGTAACTATATTCATGCGATATCGCCGTATCAGTGGGGTTA 6 into TAACTTATAC GAAACACCGGTAACTATATTCATGCGATATCGCCGTATCAGTGGGGTTAG 885	for one base displacement
Combined TAGCCATGCA CAAAACACCGGTCGTTGTAGCAACCTATCGGGTGGGGTTAGAGCTAGAAA 3 into TAGCCATGCA GAAACACCGGTCGTTGTAGCAACCTATCGGGTGGGGTTAGAGCTAGAAAT 825	for one base displacement
Combined TTAGCTATGT CAAAACACCGGTTACATTGAGAACTTCGTGGGGTTAGAGCTAGAAATAGC 3 into TTAGCTATGT GAAACACCGGTTACATTGAGAACTTCGTGGGGTTAGAGCTAGAAATAGCA 572	for one base displacement
Combined TTGAGCATAA CAAAACACCGGTTAAGCCGAGGAGTTAGTGGGGTTAGAGCTAGAAATAGC 4 into TTGAGCATAA GAAACACCGGTTAAGCCGAGGAGTTAGTGGGGTTAGAGCTAGAAATAGCA 530	for one base displacement
Combined TTTGGCACAC CAAAACACCGGTAGCAGCGGCAGGCGTGATGGTGGGGTTAGAGCTAGAAA 3 into TTTGGCACAC GAAACACCGGTAGCAGCGGCAGGCGTGATGGTGGGGTTAGAGCTAGAAAT 719	for one base displacement
