ACAAATCCTG	GAAACACCGGTAGGAGAGTGGTCACCGTATTCATTATAGGTGGGGTTAGA	1	bc
ACAATCTCAA	GAAACACCGGTGCTCTCGGATCATCAGTGGGGTTAGAGCTAGAAATAGCA	1	bc
AGTAGCTATG	GAAACACCGGTTACATTGAGAACTTCGTGGGGGTAGAGCTAGAAATAGCA	1	bc
AACGCTCGAG	GAAACACCGGTGCTCTCGGTTCATCAGTGGGGTAAGAGTAGGAATTACAA	1	bc
CACCCAGCCC	GAAACACCGGTCTGAACTACCTAGTTGTGGGGTTAGAGCTAGAAATAGCA	1	bc
TGACTCCTGT	GAAACACCGGTCTCGAGTGAGGTGTTCAGGGTGGGGTTAGAGCTAGAAAT	1	bc
CATCTCGCTT	GAAACACCGGTGGAAGGTTGTATGTTGCTAGTGGGGTTAGAGCTAGAAAT	1	bc
CTCTCTCGCG	GAAACACCGGTACCTTCGTCGCCGCAGGGGGGGTATAGCTATAGATATAG	1	bc
ATCTCTCAAT	GAAACACCGGTGCTCTCGGGTCATCAGTGGGGTGAGAGCTAGAAATAGCA	1	bc
GAATGACGCG	GAAACACCGGTAGCAAACGTTTGGACGTGGGGTTAGAGCTAGAAATAGCA	1	bc
CGAGCCACGC	GAAACACCGGTGCATTCGAAAGTCCGGTCGTAGTGTGGACGTGGGGTTAG	1	bc
AGCCAGCAGC	GAAACACCGGTTAGCAGCCAATTGCGTGGCTCCTAGAGGTGTGGGGTTAG	1	bc
AGGATACGCC	GAAACACCGGTAGCCCGTGATTCTGCAGGGGCGTATCCTGAATTCGGGCC	1	bc
CGCACGATGA	GAAACACCGGTCGATGTAGAACCCTCTCGGGAGGGGTTACAGGTAGATAT	1	bc
AGGGCGCTTC	GAAACACCGGTGTCTCGTTGGTAGGATCTGGTGGGGTTCGGGCTAGAAAT	1	bc
TGCACTACGA	GAAACACCGGTGCCAATGTGGTTGCGTCATGTGGGGTTAGAGCTAGAAAT	1	bc
TTTCTGCTTC	GAAACACCGGTCAGTAGGAGACTCGTGCTAGATATGCCTGGTCCGTTAGC	1	bc
AGGGACCTGG	GAAACACCGGTGCATTCGAAAGTCCGGTCGTAGTGTGGACGTGGGGTTAG	1	bc
CTTTTGAGTC	GAAACACCGGTGTAATCCAGAGCTATTAACATCATGGGTTGTGGGGCTAG	1	bc
CCATTCAACC	GAAACACCGGTCGTCTGCACTACGCAGTGGGGTTAGAGCTAGAAATAGCA	1	bc
ACTCCATGTT	GAAACACCGGTATGAGAATCGGTAGTCATGGTGGGGTTAGAGCTAGAAAT	1	bc
CGTTGTCTCC	GAAACACCGGTGACATTGGGTACAGGGTGGGGTTAGAGCTAGAAATAGCA	1	bc
AAACGCCTTA	GAAACACCGGTGCCCTTACTCTCACCTGATTACTTAATCCGTGGGGTTAG	1	bc
CCCAAGCCCC	GAAACACCGGTGTCCGCGGTTAGTTCCATTGGGGGGATAGAGCTAGAAAT	1	bc
ATTGAGCATC	GAAACACCGGTTAAGGGGACCGCAGGTACATGTCTGGGTAGTAAGTTTAG	1	bc
AGCACACCCA	GAAACACCGGTCCTGTCGCCACGGGTGTGGGGTTAGAGCTAGAAATAGCA	1	bc
TCCCCTCCAT	GAAACACCGGTGGAAGGTTGTATGTTGCTAGTGGGGTTAGAGCTAGAAAT	1	bc
CTAATCACGT	GAAACACCGGTCGTCTGCACTACGCAGTGGGGGTAGAGCTAGAAATAGCA	1	bc
ATGATTGGCC	GAAACACCGGTTTACGTTGCATATAGCAAGGTATAGTACTAGTAATCGCA	1	bc
TCATTTGTCG	GAAACACCGGTGTAATCCAAAGCTATTAACATCATGAGTTGTGGGGTTAG	1	bc
GAGATACCCA	GAAACACCGGTCCGAAATGTCGCCACGTGGGGGTAGAGCTAGAAATAGCC	1	bc
CACAGACCCT	GAAACACCGGTCGTCTGCACTACGCAGTGGGGCTAGAGCTAGAAGTATCA	1	bc
GTACCAGTAA	GAAACACCGGTTCATGAAAAACATACTTAGACGACGGTCCGTGGGGTTAG	1	bc
GATACAGATC	GAAACACCGGTAGCAAGTGCGAGACGTGTTGTGGGGTTAGAGCTAGAAAT	1	bc
ACCCTTCACT	GAAACACCGGTGGAAGGTTGTATGTTGCTAGTGGGGTTAGAGCTAGAAAT	1	bc
CGAAGCGATT	GAAACACCGGTCTCGAGAGGGGAGTTCAGGGTGGGGTTAGAGCTAGAAAT	1	bc
AGCTCTAAGC	GAACCACCGGTGCCAATGTGGTTGCGTCATGTGGGGTTAGAGCTAGAAAT	1	bc
