CGTTTCTCAT	GAAACACCGGTGACATTGGGTGTCCACTGTAGGACTTGGAATATGACAAG	16	bc
CTCCCCTGCA	GAAACACCGGTGTGGCTGAGAGTCCGGCAATGGTGTGGCTGTGGGGTTAG	16	bc
AGGCAACCTC	GAAACACCGGTGTGGCTGAGAGTCCGGCAATGGTGTGGCTGTGGGGTTAG	7	bc
ACATTTACCG	GAAACACCGGTCGGGGCCACTCAGTGGTGGGGTTAGAGCTAGAAATAGCA	6	bc
AAATCGTCGT	GAAACACCGGTGTACGTATGGACTGAACCAGGGTGTGCAAGTGGGGTTAG	6	bc
AACTTTACCG	GAAACACCGGTCGGGGCCACTCAGTGGTGGGGTTAGAGCTAGAAATAGCA	5	bc
AGTGGAGACT	GAAACACCGGTTCCCGTCCAGTGGGGTTAGAGCTAGAAATAGCAAGTTAA	5	bc
ACCTTTACAG	GAAACACCGGTCGGGGCCACTCAGTGGTGGGGTTAGAGCTAGAAATAGCA	4	bc
ACATCGTAGT	GAAACACCGGTGTACGTATGGACTGAACCAGGGTGTGCAAGTGGGGTTAG	4	bc
AACATTAGGT	GAAACACCGGTCGATTCATATCGAAACCTTCCCGTGACAGTGGGGTTAGA	4	bc
AAACGCACTA	GAAACACCGGTGCCCTTACTCTCACCTGATTACTTAATCCGTGGGGTTAG	4	bc
AAGAACCTCG	GAAACACCGGTGCATTCGAAAGTCCGGTCGTAGTGTGGACGTGGGGTTAG	4	bc
ACCTTTAACG	GAAACACCGGTCGGGGCCACTCAGTGGTGGGGTTAGAGCTAGAAATAGCA	4	bc
AAGTCTGACT	GAAACACCGGTCCGTAGGAGACCCGTGTGGCATGTACCTGTGGGGTTAGA	4	bc
AAGAATCCTT	GAAACACCGGTCTCGAGTGAGGTGTTCAGGGTGGGGTTAGAGCTAGAAAT	4	bc
AAGACACTCG	GAAACACCGGTGCATTCGAAAGTCCGGTCGTAGTGTGGACGTGGGGTTAG	4	bc
AGGCACCCTA	GAAACACCGGTGTGGCTGAGAGTCCGGCAATGGTGTGGCTGTGGGGTTAG	4	bc
ACCTTTATCG	GAAACACCGGTCGGGGCCACTCAGTGGTGGGGTTAGAGCTAGAAATAGCA	4	bc
ACCTTAACCG	GAAACACCGGTCGGGGCCACTCAGTGGTGGGGTTAGAGCTAGAAATAGCA	3	bc
AGAAGACACG	GAAACACCGGTCGGCGGCAATCGTGGGTGGGGTTAGAGCTAGAAATAGCA	3	bc
TACTTTACCG	GAAACACCGGTCGGGGCCACTCAGTGGTGGGGTTAGAGCTAGAAATAGCA	3	bc
AAACGACCTA	GAAACACCGGTGCCCTTACTCTCACCTGATTACTTAATCCGTGGGGTTAG	3	bc
ACACAACGCA	GAAACACCGGTTTGAACTAGAAATAGCAAGTTAACCTAAGGCTAGTCCGT	3	bc
ACATTGTCGT	GAAACACCGGTGTACGTATGGACTGAACCAGGGTGTGCAAGTGGGGTTAG	3	bc
AACATACGGT	GAAACACCGGTCGATTCATATCGAAACCTTCCCGTGACAGTGGGGTTAGA	3	bc
ACATCGGCGT	GAAACACCGGTGTACGTATGGACTGAACCAGGGTGTGCAAGTGGGGTTAG	3	bc
AGTGGAGTCT	GAAACACCGGTTCCCGTCCAGTGGGGTTAGAGCTAGAAATAGCAAGTTAA	3	bc
AGTGGAGCAT	GAAACACCGGTTCCCGTCCAGTGGGGTTAGAGCTAGAAATAGCAAGTTAA	3	bc
AGGCACACTC	GAAACACCGGTGTGGCTGAGAGTCCGGCAATGGTGTGGCTGTGGGGTTAG	3	bc
AAACGCCGTA	GAAACACCGGTGCCCTTACTCTCACCTGATTACTTAATCCGTGGGGTTAG	3	bc
GGCGACCGCA	GAAACACCGGTCCCGGTAGAACCAAAGGCTGTGGGGTTAGAGCTAGAAAT	3	bc
AGTGGCGCCT	GAAACACCGGTTCCCGTCCAGTGGGGTTAGAGCTAGAAATAGCAAGTTAA	3	bc
AATGCGTAGC	GAAACACCGGTTTACGTTGCATCGGTGTGGGGTTAGAGCTAGAAATAGCA	3	bc
ACCTTTAGCG	GAAACACCGGTCGGGGCCACTCAGTGGTGGGGTTAGAGCTAGAAATAGCA	3	bc
AAACGCCATA	GAAACACCGGTGCCCTTACTCTCACCTGATTACTTAATCCGTGGGGTTAG	2	bc
TATGATTAGC	GAAACACCGGTTTACGTTGCATCGGTGTGGGGTTAGAGCTAGAAATAGCA	2	bc
GCACAACTCA	GAAACACCGGTTTGAACTACCGGGGTTAGAGCTAGAAATAGCAAGTTAAC	2	bc
AGGGGAGCCT	GAAACACCGGTTCCCGTCCAGTGGGGTTAGAGCTAGAAATAGCAAGTTAA	2	bc
ACGAATACTT	GAAACACCGGTCTCGAGTGAGGTGTTCAGGGTGGGGTTAGAGCTAGAAAT	2	bc
ATGGAGCATA	GAAACACCGGTTAAGCCGAGGGTTAGAGCTAGAAATAGCAAGTTAACCTA	2	bc
ATTGAGAATA	GAAACACCGGTTAAGCCGAGTGGGGTTAGAGCTAGAAATAGCAAGTTAAC	2	bc
AAGTCTGCAT	GAAACACCGGTCCGTAGGAGACCCGTGTGGCATGTACCTGTGGGGTTAGA	2	bc
TACATTCGGG	GAAACACCGGTCGATTCATATCGAAACCTTCCCGTGACAGTGGGGTTAGA	2	bc
ACGATTCCTT	GAAACACCGGTCTCGAGTGAGGTGTTCAGGGTGGGGTTAGAGCTAGAAAT	2	bc
GAAGGCCCTA	GAAACACCGGTGCCCTTACTCTCACCTGATTACTTAATCCGTGGGGTTAG	2	bc
ATGACCCACC	GAAACACCGGTATATAAAAATACGAGTACAGTGGGGTTAGAGCTAGAAAT	2	bc
AAGGCACGAC	GAAACACCGGTGCCCTTACTCTCACCTGATTACTTAATCCGTGGGGTTAG	2	bc
AGAACCGAGC	GAAACACCGGTGCATTCGAAAGTCCGGTCGTAGTGTGGACGTGGGGTTAG	2	bc
GCACAACGCT	GAAACACCGGTTTGAACTACCGGGGTTAGAGCTAGAAATAGCAAGTTAAC	2	bc
TAACAACGCC	GAAACACCGGTTTGAACTACCGGGGTTAGAGCTAGAAATAGCAAGTTAAC	2	bc
AGAGGAGCCT	GAAACACCGGTTCCCGTCCAGTGGGGTTAGAGCTAGAAATAGCAAGTTAA	2	bc
ATGAGCTTAC	GAAACACCGGTTAAGCCGAGTGGGGTTAGAGCTAGAAATAGCAAGTTAAC	2	bc
ACGAATCATT	GAAACACCGGTCTCGAGTGAGGTGTTCAGGGTGGGGTTAGAGCTAGAAAT	2	bc
GGCACACGAC	GAAACACCGGTGTGGCTGAGAGTCCGGCAATGGTGTGGCTGTGGGGTTAG	2	bc
AGCACACCCA	GAAACACCGGTCCTGTCGCCACGGGTGTGGGGTTAGGGCTAGAAATAGCA	2	bc
AGGCACCTAC	GAAACACCGGTAAATTTGAGGCTCCGGCATGCAGGAGGCCGTGGGGTTAG	2	bc
AGCGGAGCCT	GAAACACCGGTTCCCGTCCAGTGGGGTTAGAGCTAGAAATAGCAAGTTAA	2	bc
GCATTTACCG	GAAACACCGGTCGGGGCCACTCAGTGGTGGGGTTAGAGCTAGAAATAGCA	2	bc
GGAGCCTAAA	GAAACACCGGTAAATTTGAGGCTCCGGCATGCAGGAGGCCGTGGGGTTAG	2	bc
ACAATCGGGG	GAAACACCGGTCGATTCATATCGAAACCTTCCCGTGACAGTGGGGTTAGA	2	bc
AGGAACCCTC	GAAACACCGGTGTGGCTGAGAGTCCGGCAATGGTGTGGCTGTGGGGTTAG	2	bc
ACGACTCCTT	GAAACACCGGTCTCGAGTGAGGTGTTCAGGGTGGGGTTAGAGCTAGAAAT	2	bc
ATATCCTCTC	GAAACACCGGTGCATTCGAAAGTCCGGTCGTAGTGTGGACGTGGGGTTAG	2	bc
AATGCTTAGA	GAAACACCGGTTTACGTTGCATCGGTGTGGGGTTAGAGCTAGAAATAGCA	2	bc
AAAAGCACTA	GAAACACCGGTGCCCTTACTCTCACCTGATTACTTAATCCGTGGGGTTAG	2	bc
AATGATTAGC	GAAACACCGGTTTACGTTGCATCGGTGTGGGGTTAGAGCTAGAAATAGCA	2	bc
TGTGGAGACT	GAAACACCGGTTCCCGTCCAGTGGGGTTAGAGCTAGAAATAGCAAGTTAA	2	bc
ACACAACGCA	GAAACACCGGTTTGAAATAGCAAGTTAACCTAAGGCTAGTCCGTTATCAA	2	bc
ACGTTTCTCA	GAAACACCGGTGACATTGGGTGTCCACTGTAGGACTTGGAATATGACAAG	2	bc
AGCCCGAATC	GAAACACCGGTTGACACGCTAGGTGTTGAAAAACTTGTTGGTGGGGTTAG	2	bc
AAAGACCTAA	GAAACACCGGTGCCCTTACTCTCACCTGATTACTTAATCCGTGGGGTTAG	2	bc
AAGACCATCG	GAAACACCGGTGCATTCGAAAGTCCGGTCGTAGTGTGGACGTGGGGTTAG	2	bc
AAAGCACTGC	GAAACACCGGTGCCCTTACTCTCACCTGATTACTTAATCCGTGGGGTTAG	2	bc
TCCTATACCG	GAAACACCGGTCGGGGCCACTCAGTGGTGGGGTTAGAGCTAGAAATAGCA	2	bc
AACATTCAGT	GAAACACCGGTCGATTCATATCGAAACCTTCCCGTGACAGTGGGGTTAGA	2	bc
AGACACCCTC	GAAACACCGGTGTGGCTGAGAGTCCGGCAATGGTGTGGCTGTGGGGTTAG	2	bc
AACTATCTAC	GAAACACCGGTGCCCTTACTCTCACCTGATTACTTAATCCGTGGGGTTAG	2	bc
AGGCACGCGC	GAAACACCGGTGCATTCGAAAGTCCGGTCGTAGTGTGGACGTGGGGTTAG	2	bc
AGAAGAACCG	GAAACACCGGTCGGCGGCAATCGTGGGTGGGGTTAGAGCTAGAAATAGCA	2	bc
AAGACTGCCT	GAAACACCGGTCCGTAGGAGACCCGTGTGGCATGTACCTGTGGGGTTAGA	2	bc
GAGAATCCTT	GAAACACCGGTCTCGAGTGAGGTGTTCAGGGTGGGGTTAGAGCTAGAAAT	2	bc
AATAGCCGTC	GAAACACCGGTGTACGTATGGACTGAACCAGGGTGTGCAAGTGGGGTTAG	2	bc
AAACGACATA	GAAACACCGGTGCCCTTACTCTCACCTGATTACTTAATCCGTGGGGTTAG	2	bc
AAACAACGCC	GAAACACCGGTTTGAACTAGAAATAGCAAGTTAACCTAAGGCTAGTCCGT	2	bc
CGTTTATCAT	GAAACACCGGTGACATTGGGTGTCCACTGTAGGACTTGGAATATGACAAG	2	bc
ACACAACGCT	GAAACACCGGTTTGAACTAGAAATAGCAAGTTAACCTAAGGCTAGTCCGT	2	bc
AAGTATGCCT	GAAACACCGGTCCGTAGGAGACCCGTGTGGCATGTACCTGTGGGGTTAGA	2	bc
AAACGGCCTA	GAAACACCGGTGCCCTTACTCTCACCTGATTACTTAATCCGTGGGGTTAG	2	bc
AGTGGAACCT	GAAACACCGGTTCCCGTCCAGTGGGGTTAGAGCTAGAAATAGCAAGTTAA	2	bc
AATGTACTAC	GAAACACCGGTGCCCTTACTCTCACCTGATTACTTAATCCGTGGGGTTAG	2	bc
ACACAACGAC	GAAACACCGGTTTGAACTACCGGGGTTAGAGCTAGAAATAGCAAGTTAAC	2	bc
AATTTAACGC	GAAACACCGGTCGGGGCCACTCAGTGGTGGGGTTAGAGCTAGAAATAGCA	2	bc
GAGTCTGGCT	GAAACACCGGTCCGTAGGAGACCCGTGTGGCATGTACCTGTGGGGTTAGA	2	bc
ATTAGATATG	GAAACACCGGTTACATTGAGGGTTAGAGCTAGAAATAGCAAGTTAACCTA	2	bc
TAGAACCTCG	GAAACACCGGTGCATTCGAAAGTCCGGTCGTAGTGTGGACGTGGGGTTAG	2	bc
AATCGTAGTA	GAAACACCGGTGTACGTATGGACTGAACCAGGGTGTGCAAGTGGGGTTAG	2	bc
ACTACTAGGC	GAAACACCGGTACCTTTGTTGATGCTGGGTGGAAGGAATTTGTGGGGTTA	2	bc
CATTGAGCAT	GAAACACCGGTTAAGCCGAGTGGGGTTAGAGCTAGAAATAGCAAGTTAAC	2	bc
TAGAATCCTT	GAAACACCGGTCTCGAGTGAGGTGTTCAGGGTGGGGTTAGAGCTAGAAAT	2	bc
GCGAATACTT	GAAACACCGGTCTCGAGTGAGGTGTTCAGGGTGGGGTTAGAGCTAGAAAT	2	bc
AGAAGAACCG	GAAACACCGGTCGGCGGCAATCGTTAATCGGTTAATCGTGGGGTTAGAGC	2	bc
AACGCAATAA	GAAACACCGGTGCCCTTACTCTCACCTGATTACTTAATCCGTGGGGTTAG	2	bc
CACTACTCGG	GAAACACCGGTACCTTTGTTGATGCTGGGTGGGGTTAGAGCTAGAAATAG	2	bc
CGTTTCTCAT	GGAACACCGGTGACATTGGGTGTCCACTGTAGGACTTGGAATATGACAAG	2	bc
AAATTAGGTA	GAAACACCGGTCGATTCATATCGAAACCTTCCCGTGACAGTGGGGTTAGA	2	bc
AGGCACCGTC	GAAACACCGGTGTGGCTGAGAGTCCGGCAATGGTGTGGCTGTGGGGTTAG	2	bc
ACTGAGCATA	GAAACACCGGTTAAGCCGAGGGTTAGAGCTAGAAATAGCAAGTTAACCTA	2	bc
GGAAACCTCA	GAAACACCGGTGTGGCTGAGAGTCCGGCAATGGTGTGGCTGTGGGGTTAG	2	bc
TATGCGTAGC	GAAACACCGGTTTACGTTGCATCGGTGTGGGGTTAGAGCTAGAAATAGCA	2	bc
GACAGCCTTC	GAAACACCGGCGTGGCTGAGAGTCCGGCAATGGTGTGGCTGTGGGGTTAG	1	bc
AGAAGACCAG	GAAACACCGGTCGGCGGCAATCGTGGGTGGGGTTAGAGCTAGAAATAGCA	1	bc
AACATTCGGA	GAAACACCGGTCGATTCATATCGAAACCTTCCCGTGACAGTGGGGTTAGA	1	bc
AGTCCCTACC	GAAACACCGGTAAATTTGAGGCTCCGGCATGCAGGAGGCCGGGGGGATAG	1	bc
TGATCGCTCC	GAAACACCGGTGTGTCTGAGAGTCCGGCAATGGTGTGGCTGTGGGGTTAG	1	bc
AGAGATGTAC	GAAACACCGGTGACATTGGGTACAGGGGTGGGGTTAGAGCTAGAAATAGC	1	bc
GCTAATCGGC	GAAACACCGGTACCTTTGTTGATGCTGGGTGGGGTTAGAGCTAGAAATAG	1	bc
ATAACAAAGC	GAAACACCGTGGGGTTAGAGCTAGAAATAGCAAGTTAACCTAAGGCTAGT	1	bc
GTGAACATAC	GAAACACCGGTTAAGCCGAGGAGTTAGAGCTAGAAATAGCAAGTTAACCT	1	bc
TCGAATCGTC	GAAACACCGGTCTCGAGTGAGGTGTTCAGGGTGGGGTTAGAGCTAGAAAT	1	bc
ACTAGGCGCT	GAGACACCGGTTAGCAGGAAACTCGTGTGGCATGTGCGGGTTGGGGTTGG	1	bc
GCATCGACGT	GAAACACCGGTGTACGTATGGACTGAACCAGGGTGTGCAATAGTGGGGTT	1	bc
ACCTTGATCG	GAAACACCGGTCGGGGCCACTCAGTGGTGGGGTTAGAGCTAGAAATAGCA	1	bc
ATGCATAGGG	GAAACACCGGTTTACGATGCATCGGTTGTGGGGTTAGAGCTGGAAATAGC	1	bc
GCGCTATGCT	GAAACACCGGTTTACGTGGGGTTAGAGCTAGAAATAGCAAGTTAACCTAA	1	bc
AATGCTGAAC	GAAACACCGGTTTACGTTGCATCGGTGTGGGGTTAGAGCTAGAAATAGCA	1	bc
ATATCCGCCC	GAAACACCGGTACCTTTGTTGATGCTGTTGGAAGGTGGGGTTAGAGCTAG	1	bc
AAGTATTGTC	GAAACACCGGTGACATTGGGTTTTAGAAATAGCAAGTTAACCTAAGGCTA	1	bc
AAACTTTACT	GAAACACCGGTCGGGGCCACTCAGTGGTGGGGTTAGAGCTAGAAATAGCA	1	bc
TCGAAACCTT	GAAACACCGGTCTCGAGTGAGGTGTTCAGGTGGGGTTAGAGCTAGAAATA	1	bc
AAAGCCATAA	GAAACACCGGTGCCCTTACTCTCACCTGATTACTTAATCCGTGGGGTTAG	1	bc
CAACCCTGCC	GAAACACCGGTACCTTTGTTGATGTTGGGGGGAAGGATTGAGGGGTTAGA	1	bc
AGAGAAACGC	GAAACACCGGTGCATTCGAAAGTCCGGTCGTAGTGTGGACGTGGGGTTAG	1	bc
GAAACTGTGA	GAAACACCGGTAGCAAGTGCGGGACGTGTTAGAGCTAGAAATAGCACCGG	1	bc
CGTTGTCATC	GAAACACCGGTCGGGGCCACTCAGTGGTGGGGTTAGAGCTAGAAATAGCA	1	bc
GAGGCGACTC	GAAACACCGGTTCCCGTCCAGTGGGGTTAAAGCTGGAAATAGCAAGTAAA	1	bc
ATAATGCGAG	GAAACACCGATCGACGGCAATCGTGGGTGGGGTTAGAGCTAGAAATAGCA	1	bc
CAGCAAGCGA	GAAACACCGGTTTGAACTAGTAATAGCAAGTTAACCTACGGCTAGTCCGA	1	bc
CTGTTCTGTC	GAAACACCGGTTGATTCATATCGAAACCTTCCCGTGACAGAGGAGTTAGA	1	bc
AAGTTAGCCT	GAAACACCGGTCCGTAGGAGACCCGTGTGGCATGTACCTGTGGGGTTAGA	1	bc
AGTACGACTC	GAAACACCGGTCCGTAGGAGACCCGTGTGGCATGTACCTGTGGGGTTAGA	1	bc
AGGCTGAGTC	GAAACACCGGTCTGTAGGAGACCCGTGTGGCATGTACCTTTGTGGGGGTA	1	bc
ACCATCGTTT	GAAACACCGGTCGATTCATATCTAAACCTTCCCGTGACAGTGGGGATCGA	1	bc
AGGGGTGACT	GAAACACCGGTCCGTAGGAGACCCGTGTGGCATGAACCTTGTGGGGTTAG	1	bc
GCCTTCACCG	GAAACACCGGTCGGGGCCACTCAGTGGTGGGGTTAGAGCTAGAAATAGCA	1	bc
AACCGCCATA	GAAACACCGGTGCCCTTACTCTCACCTGATTACTTAATCCGTGGGGTTAG	1	bc
GGGACATATA	GAAACACCGGTAAATTTGAGGCTCCGGCATGCAGGAGGCCGTGGGGTTAG	1	bc
AAGGCCGTAA	GAAACACCGGTGCCCTTACTCTCACCTGATTACTTAATCCGTGGGGTTAG	1	bc
TCGAAGCATT	GAAACACCGGTCTCGAGTGAGGTGTTCAGGGTGGGGTTAGAGCTAGAAAT	1	bc
AGTCTGTAGC	GAAACACCGGTCCGTAGGAGACCCGTGTGGCATGTACCTGTGGGGTTAGA	1	bc
GTCTATAGAG	GAAACACCGGTTATATTTGTAAGTGTGTGGGGTTAGAGCTAGAAATAGCA	1	bc
ACATCCCGGC	GAAACACCGGTGCATTCGAAAGTCCGGTCGTAGTGTGGACGTGGGGTTAG	1	bc
ACTGTGCCGC	GAAACACCGGTCGGGGCCACTCAGTGGTGGGGTTAGAGCTAGAAATAGCA	1	bc
ACTGTCGGCT	GAAACACCGGTCGATTCATATCGAAACCTTCCCGTGACAGTGGGGTTAGA	1	bc
GCGGACGCTC	GAAACACCGGTTCCCGTCCAGTGGGGTTAGAGCTAGAAATAGCAAGTCAA	1	bc
CACTACACAC	GAAACACCGGTTTGAACTACCGGGGTTAGAGCTAGAAATAGCAAGTTAAC	1	bc
GACGAACAGT	GAAACACCGGTCGGCGGCAATCGTGGGTGGGGTTAGAGCTAGAAATAGCA	1	bc
GTACTCTACA	GAAACACCGGTAAATTTGAGGCTCCGGCATGCAGGAGGCCGTGGGGTTAG	1	bc
ATGGGCATTA	GAAACACCGGTTAAGCCGAGGTTAGAGCTAGAAATAGCAAGTTAACCTAA	1	bc
CGAAACATCT	GAAACACCGGTCTCGAGTGAGGTGTTCAGGGGTGGGGTTAGAGCTAGAAA	1	bc
CCGTAAATGC	GAAACACCGGTCGGGGCCACTCAGTGGGGTTAGAGCTAGAAATAGCAAGT	1	bc
AAAAGATGTC	GAAACACCGGTGTACGTATGGACTGAACCAGGGTGTGCGGGGTTAGAGCT	1	bc
GTGACTAACA	GAAACACCGGTAGCAAGTGCGAGACGTGTTAGAGCTAGAAATAGCACCGG	1	bc
CGTGGTGGTC	GAAACACCGGTGACATTGGGTACAGGGTGGGGTTAGAGCTAGAAATAGCA	1	bc
AACAATCGGT	GAAACACCGGTCGATTCATATCGAAACCTTCCCGTGACAGTGGGGTTAGA	1	bc
GACCCCGAAT	GAAACACCGGTAAATTTGAGGCTCCGGCATGCAGGAGGCCGTGGGGTTAG	1	bc
GCGGACTATA	GAAACACCGGTTCCCGTCCAGTGGGGTTAGAGCTAGAAATAGCAAGTTAA	1	bc
CAGGCACACT	GAAACACCGGTGTGGCTGAGAGTCCGGCAATGGTGTGGCTGTGGGGTTAG	1	bc
TAACGACATA	GAAACACCGGTGCCCTTACTCTCACCTGATTACTTAATCCGTGGGGTTAG	1	bc
CCCAGATACA	GAAACACCGGTTTGAACCGGTGGGGTTAGAACTAGAAATAGCAAGTTAAC	1	bc
GCGGAGCATT	GAAACACCGGTTCCCGTCCAGAGGGGTTAGAGCTAGAAATAGCAAGTTAA	1	bc
ATAAGTGATA	GAAACACCGGTAACTATATTCATGCGATATCGCCGTATCAGTGGGGTTAG	1	bc
CTGGCACCAT	GAAACACCGGTGTGGCTGAGAGTCCGGCAATGGTGTGGCTGTGGGGTTAG	1	bc
CGTAATATAT	GAAACACCGGTGACATTGGGTACAGGGTGGGGTTAGAGCTAGGAATAGCA	1	bc
TATACCTGAC	GAAACACCGGTAAATTTGAGGCTCCGGCATGCAGGAGGCCGTGGGGTTAG	1	bc
AAACCCTTCT	GAAACACCGGTGCATTCGAAAGCCCGGACGTGGCTGGGATGTGGGGTTAG	1	bc
GGCGCGTACC	GAAACACCGGTAAATTTGAGGCTCCGGCATGCAGGAGGCCGTGGGGTTAG	1	bc
CGGTACCTCT	GAAACACCGGTCTCGAGGGAGGCGTTCGGGGTGGGGTTAGAGCTAGAAAT	1	bc
AGCATACACC	GAAACACCGGTAAATTTGAGGCTCCGGCATGCAGGAGGCCGTGGGGTTAG	1	bc
AAATGAACCA	GAAACACCGGTGCCCTTACTCTCACCTGATTACTTAATCCGTGGGGTTAG	1	bc
GTCGAAACTC	GAAACACCGGTTCCCGTCCAGTGGGGTTAGAGCTAGAAATAGCAAGTTAA	1	bc
AGGCTGCTTT	GAAACACCGGTCTCGAGCGAGGTGTTCAGGGTGGGGTTAGAGCTAGAAAT	1	bc
TCTACTCGGT	GAAACACCGGTACCTTTGTTGATGCTGGGTGGAAGGTGCTTTTTTTCCTG	1	bc
AGCCGCCGCC	GAAACACCGGTGTGGCTGAGAGTCCGGCAATGGTGTGGCTGTGGGGTTAG	1	bc
ACCTCGTCGT	GAAACACCGGTGTACGTATGGACTGAACCAGGGTGGGGTTAGAGCTAGAA	1	bc
TCGTCTGCCT	GAAACACCGGTCCGTAGGAGACCCGTAGAGCTAGAAATAGCAAGTTAACC	1	bc
AGCGCTCTCT	GAAACACCGGTGACATTGGGTACAGAGCTAGAAATAGCAAGTTAACCTAA	1	bc
ACAAAACGCA	GAAACACCGGTTTGGACTAGAAATAGCAAGTTAACCTAAGGCTAGTCCGT	1	bc
CGCGGTATTT	GAAACACCGGTGACATTGGGTTAGAGCTAGAAATAGCAAGTTAACCTAAG	1	bc
ATTAGTCGTT	GAAACACCGGTGTACGTATGGACTGAACCAGGGTGTGCAAGTGGGGTTAG	1	bc
ACCATTACCG	GAAACACCGGTCGGGGCCACTCAGTGGTGGGGTTAGAGCTAGAAATAGCA	1	bc
TGGCTGCCTA	GAAACACCGGTCCGTAGGAGACCCGTGTGGCATGTACCTGTGGGGTTAGA	1	bc
AGGAACCCTT	GAAACACCGGTGTGGCTGAGAGTCCGGCAATGGTGTGGCTGTGGGGTTAG	1	bc
AGGAACCATC	GAAACACCGGTGTGGCTGAGAGTCCGGCAATGGTGTGGCTGTGGGGTTAG	1	bc
CACCACGCAG	GAAACACCGGTTTGAACTAGAAATAGCAAGTTAACCTAAGGCTAGTCCGT	1	bc
GTCCTTTACC	GAAACACCGGTCGGGGCCACTCAGTGGTGGGGTTAGAGCTAGAAATAGCA	1	bc
ACCTTCCGCT	GAAACACCGGTCGATTCATATCGAAACCTTCCCGTGACAGTGGGGCTAGA	1	bc
AGAACCGCGA	GAAACACCGGTGCATTCGAAAGTCCGGTCGTAGTGTGGACGTGGGGTTAG	1	bc
GACCGCCCTA	GAAACACCGGTGCCCTTACTCTCACCTGATTACTTAATCCGTGGGGTTAG	1	bc
CTCACCGGTA	GAAACACCGGTGTGGCTGAGAGTCCGGCAATGGTGTGGCTGTGGGGTTAG	1	bc
ATGCGTAGTC	GAAACACCGGTTTACGTTGCATCGGTGTGGGGTTAGAGCTAGAAATAGCA	1	bc
ACATCGTGGG	GAGACACCGGTTATATTTGTAAGTGTGTGGGGTTAGAGCTAGAAATAGCA	1	bc
AATGAGCATA	GAAACACCGGTTAAGCCGAGGAGTTAGAGCTAGAAATAGCAAGTTAACCT	1	bc
GAATGTGGAA	GAAACACCGGCACCTTTGTTGATTTTTGCTGGGTTAGAGCTAGAAATAGC	1	bc
TCATTTAGAC	GAAACACCGGTAACTATATTCATGCGATATCGCCGTATCAGTGGGGTTAG	1	bc
GGCGCGCAAA	GAAACACCGGTTCCCGTCCAGTGGGGTTAGAGCTAGAAATAGCAAGTTAA	1	bc
AGAACAGCGC	GAAACACCGGTGCATTCGAAAGTCCGGTCGTAGTGTGGACGTGGGGTTAG	1	bc
GAAACCGACT	GAAACACCGGTAGCAAGTGCGAGACGTGTGTTAGAGACGTGTGTTAGAAC	1	bc
GGTATCCTTC	GAAACACCGGTCTCGAGTGAGGTGTTCAGGGTGGGGTTAGAGCTAGAAAT	1	bc
ACTATCGATC	GAAACACCGGTTATAATTGGAAGTGTGTGGGATTAGAGCGAGAAATAGAA	1	bc
ACACCCTGTC	GAAACACCGGTGCATTCGAAAGTCCGGTCGTAGTGTGGACGTGGGGTTAG	1	bc
TCGTTTCTCA	GAAACACCGGTGACATTGGGTGTTCACTGTAGGACTTGGAATATGACAAG	1	bc
TGCAGACCCG	GAAACACCGGTCGGCGGCTAGAAATAGCAAGTTAACCTAAGGCTAGTCCG	1	bc
CAAACAGACC	GAAACACCGGTAGCAAGTGCGAGACGTGTTTGTGGGGTTAGAGCTAGAAA	1	bc
CAGACACCCT	GAAACACCGGTGTGGCTGAGAGTCCGGCAATGGTGTGGCTGTGGGGTTAG	1	bc
CGTCTACTCC	GAAACACCGGTGTGGCTGAGAGTCCGGCAATGGTGTGGCTGTGGGGTTAG	1	bc
TGGCCCTGCA	GAAACACCGGTAAATTTGAGGCTCCGGCATGCAGGAGGCCGTGGGGTTAG	1	bc
AGTTAGCTAT	GAAACACCGGTTACATTGAGGGTTAGAGCTAGAAATAGCAAGTTAACCTA	1	bc
TAGGGCATCA	GAAACACCGGTTAAGCCGAGGGCTAGAGCTAGAAATAGCAAGTTAACCTA	1	bc
GAAAGTCGTA	GAAACACCGGTGTACGTATGGACTGAACCAGGGTGTGCAAGTGGGGTTAG	1	bc
CATATACACA	GAAACACCGGTAGCAAGTTAACCTAAGGCTAGTCCGTTATCAACTTGAAT	1	bc
CGGCACTCGC	GAAACACCGGTGCATTCGAAAGTCCGGTCGTAGTGTGGACGTGGGGTTAG	1	bc
ACCTTTGCCG	GAAACACCGGTCGGGGCCACTCAGTGGTGGGGTTAGAGCTAGGAATAGCA	1	bc
ACTCCTCGGC	GAAACACCGGTACCTTTGTTGATGCTGGGTGGAAGGAATTTGTGGGGTTA	1	bc
TAAGGTACGT	GAAACACCGGTTACATTGAGGGTTAGAGCTAGAAATAGCAAGTTAACCTA	1	bc
ACTGAGCATA	GAAACACCGGTTAAGCCGAGGAGTTAGAGCTAGAAATAGCAAGTTAACCT	1	bc
AGGGCCCTCA	GAAACACCGGTAAATTTGAGGCTCAGGCATGCAGGAGGCCGTGGGGTTAG	1	bc
CTCAAAGGCC	GAAACACCGGTACCTTTGTTGATGCTGGGTGGAAGGAAGGAGTGGGGTTA	1	bc
ACACTCCTCC	GAAACACCGGTTTGAACTACCGGGGTTAGAGCTAGAAATAGCAAGTTAAC	1	bc
TCTATAGATC	GAAACACCGGTTATATTTGTAAGTGTTGTGGGGTTAGAGCTAGAAATAGC	1	bc
AGAAGACTCG	GAAACACCGGTCGGCGGCAACGTGGGGTTAGAGCTAGAAATAGCAAGTTA	1	bc
TGTAGCGTGG	GAAACACCGGTTATATTTGTAGGTGTGTGGGGGTAGAGCTAGAAATAGCA	1	bc
ACGATTCCTT	GAAACACCGGTCTCGAGCGAGGTGTTCAGGGTGGGGTTAGAGCTTGAAAT	1	bc
TGACACCTTT	GAAACACCGGTCTCGAGTGAGGTGTTCAGGGTGGGGTTAGAGCTAGAAAT	1	bc
AGAGTGGCTT	GAAACACCGGTCCGTAGGAGACCCGTGTGGCATGTACCTGTGGGGTTAGA	1	bc
AAAAGACCTA	GAAACACCGGTGCCCTTACTCTCACCTGATTACTTAATCCGTGGGGTTAG	1	bc
TGACACGGAC	GAAACACCGGTAGCAAGTGCGAGACGTGTTTGTGGGGTTAGAGCTAGAAA	1	bc
AGCCTGCTTT	GAAACACCGGTCTCGAGTGAGGTGTTCAGGGTGGGGTTAGAGCTAGAAAT	1	bc
GATAGCCGTC	GAAACACCGGTGTACGTATGGACTGAACCAGGGTGTGCAAGTGGGGTTAG	1	bc
GACTATGACT	GAAACACCGGTAGCAAGTGCGAGACGAATTTGTGGGGGTAGAGCTAGAAA	1	bc
CGAGGTGACT	GAAACACCGGTGACATTGGGGTTAGAGCTAGGAATAGCAAGTTAACCTAA	1	bc
CGCCTCATTT	GAAACACCGGTCTCGAGTGAGGTGTTCAGGGTGGGGTTAGAGCTAGAAAT	1	bc
TAAGATCTGT	GAAACACCGGTTACATTGAGGGTTAGAGCTAGAAATAGCAAGTTAACCTA	1	bc
GTGTATGCTT	GAAACACCGGTTCCCGCCCCGCGGGGGTTCGGCTAGATATAGCAAGTTAA	1	bc
ACGTTGGGTC	GAAACACCGGTCGACTCATATCGAAACCTTCCCGTGACAGTGGGGTTAGA	1	bc
CGGGGTGACT	GAAACACCGGTGGCAATTGGGGTTAGAGCTAGAAATAGCAAGCTAACCTA	1	bc
GCTATTCTCT	GAAACACCGGTGTGGCTGAGAGTCCGGCAATGGTGTGGCTGTGGGGTTAG	1	bc
CCGTGTGGTC	GAAACACCGGTGTACGTATGGACTGAACCAGGGTGTGCAAGTGGGGTTAG	1	bc
TGAACCAGAC	GAAACACCGGTAGCAAGTGCGGTAGCAAAAAGTGGGGTTAGAGCTAGAAA	1	bc
GAGACGCTCG	GAAACACCGGTGCATTCGAAAGTCCGGTCGTAGTGTGGACGTGGGGTTAG	1	bc
AGAGCTGTGT	GAAACACCGGTGACATTGGGAGGGGTTAGAGCTAGGAATAGCAAGTTAAC	1	bc
GAGTAGTCTC	GAAACACCGGTTCCCGTCCAGTGGGGTTAGAGCTAGAAATAGCAAGTTAA	1	bc
ACAGACTCGA	GAAACACCGGTCGGCGGCAATCGTCCCGGTGGGGTTAGAGCTAGAAATAG	1	bc
AAGACTTCCT	GAAACACCGGTCCGTAGGAGACCCGTGTGGCATGTACCTGTGGGGTTAGA	1	bc
GACGACGCTC	GAAACACCGGTGCATTCGAAAGTCCGGTCGTAGTGTGGACGTGGGGTTAG	1	bc
GCAGCTATGC	GAAACACCGGTTACATTGAGGGTTAGAGCTAGAAATAGCAAGTTAACCTA	1	bc
GATGACAGGA	GAAACACCGGTCGGCGGCAATCGTGGGGTGGGGTTAGAGCTAGAAATAGC	1	bc
TCTGAGAATA	GAAACACCGGTTAAGCCGAGGGTTAGAGCTAGAAATAGCAAGTTAACCTA	1	bc
AGACCGACTG	GAAACACCGGTCCGTAGGAGACCCGTGTGGCATGTACCTGTGGGGTTAGA	1	bc
AGAGTAGGAT	GAAACACCGGTGACATTGGGGTTAGAGCTAGAAATAGCAAGTTAACCTAA	1	bc
CGATCCCCTT	GAAACACCGGTCTCGAGTGAGGTGTTCAGGTGGGGTTAGAGCTAGAAAAA	1	bc
CCCCTCGGCA	GAAACACCGGTACCTTTGTTGATGCTGGGTGGCTATAGAGCTAGGGATAG	1	bc
TACAACTCGC	GAAACACCGGTTTGAACTACCGGGGTTAGAGCTAGAAATAGCAAGTTAAC	1	bc
TAGCTTCTTC	GAAACACCGGTAACTATATTCATGCGATATCGCCGTATCAGTGGGGATAG	1	bc
GAGGTGGCAC	GAAACACCGGTTCCCGTCCAGTGGGGTTAGAGCTAGAAATAGCAAGTTAA	1	bc
GGAGTACCGC	GAAACACCGGTCGGCGGCAATCTTTAGAGCTAGAAATAGCAAGTTAACCT	1	bc
GTCGGCCCGC	GAAACACCGGTTCCCGTCCAGGGGGGGTAGAGCTAGAAATAGCAAGTTAA	1	bc
AACATAGATA	GAAACACCGGTAGCAAGTGGGGTTAGAGCTAGAAATAGCAAGTTAACCTA	1	bc
AATGCTGAGT	GAAACACCGGTTTACGTTGCATCGGGGTTAGAGCTAGAAATAGCAAGTCG	1	bc
TCTCGTGGTC	GAAACACCGGTGTACGTATGGACTGAACCGGGGTGTGCAAGTGGGGTTAG	1	bc
GGCCACGCCA	GAAACACCGGTAAATTTGAGGCTCCGGCATGCAGGAGGCCGTGGGGTTAG	1	bc
GTGCACTCGT	GAAACACCGGTTTACGGCACTCGGGGGTGGGGTTAGAGCTAGGAATAGCA	1	bc
GACAAAACGC	GAAACACCGGTCGGCGGCAATCGTGGGTGGGGTTAGAGCTAGAAATAGCA	1	bc
AGACTAGTGC	GAAACACCGGTGCATTCGAAAGTCCGGTCGTAGTGTGGACGTGGGGTTAG	1	bc
TGAGCAGTGT	GAAACACCGGTTACATTGAGATTGGGGTTAGAGCTAGAAATAGCGAGTTA	1	bc
ACAAATCGCC	GAAACACCGGTTTGAAATAGCAAGTTAACCTAAGGCTAGTCCGTTATCAA	1	bc
ACGACAGTTC	GAAACACCGGTAAATTTGAGGCTCCGGCATGCAGGAGGCCGTGGGGTTAG	1	bc
GCCAACGTCC	GAAACACCGGTGCGGCTGAGAGTCCGGCAATGGTGTGGCTGTGGGGTTAG	1	bc
GACGGAGACC	GAAACACCGGTGCCCTTACTCTCACCTGATTACTTAATCCGTGGGGTTAG	1	bc
CACAAGGGCT	GAAACACCGGTTTGAACTAGAAATAGCAAGTTAACCTAAGGCTAGTCCGT	1	bc
AGAAGATCCG	GAAACACCGGTCGGCGGCAATCGTTAGAGCTAGAAATAGCAAGTTAACCT	1	bc
AATGCTTAGA	GAAACACCGGTTTACGTTGCATGGTTAGAGCTAGAAATAGCAAGTTAACC	1	bc
CTACGCGTGC	GAAACACCGGTACCTTTGTTGATGCTGGTGGAAGGTGGGGTTAGAGCTAG	1	bc
AGTCTTAATC	GAAACACCGGTCCGCAGGAGACCCGTGTGACATGTACCAGTGGGGGTAGA	1	bc
CAGCGCGGAC	GAAACACCGGTGCACGTATGGACTTAACCAGGGTGGGCATGTGAGGATCA	1	bc
CGTTTCTCAT	GAAACACCGGTGACATTGGGTGTCCACTGTAGGACCTGGAATATGACAAG	1	bc
CGACGTAGTC	GAAACACCGGTGTACGTATGGACTGAACCAGGGTGTGCAAGTGGGGTTAG	1	bc
ATGCGGAGGT	GAAACACCGGTTTACGTTGCATCGGTGTGGGGTTAGAGCTAGAAATAGCA	1	bc
ACAGAACGCT	GAAACACCGGTTTGAACTAGAAATAGCAAGTTAACCTAAGGCTAGTCCGT	1	bc
ACTTTATAGC	GAAACACCGGTCGGCGGCAATCGTGGGTGGGGTTAGAGCTAGAAATAGCA	1	bc
CACCACGAGC	GAAACACCGGTACCTTTGTTGATGCTGGGTGGGAGGTGCTTTTTTTACAG	1	bc
AAGGAGGACT	GAAACACCGGTCCGTAGGAGACCCGTGTGGCATGTACCTGTGGGGTTAGA	1	bc
AGTCTGGATA	GAAACACCGGTCCGTAGGAGACCCGTGTGGCATGTACCTGTGGGGTTAGA	1	bc
CCAACACTTT	GAAACACCGGTCTCGAGTGAGGTTAGAGCTAGAAATAGCAAGTTAACCTA	1	bc
CGTTACTCAT	GAAACACCGGTGACATTGGGTGTCCACTGTAGGACTTGGAATATGACGAG	1	bc
ATCCTTTACC	GAAACACCGGTCGGGGCCACTCAGTGGTGGGGTTAGAGCTAGAAATAGCA	1	bc
AGCACACCAA	GAAACACCGGTCCTGTCGCCACGGGTGTGGGGTTAGGGCTAGAAATAGCA	1	bc
AGGCGCTGAT	GAAACACCGGTGTTAGAGATAGTAAGAGCAAGTTAACCTAGGGCTAGTAG	1	bc
GAAGTCCGGA	GAAACACCGGTAGGCGGCAATCGTGGGGGGGGTTAGAGCTAGAAATAGCA	1	bc
TTACCTAGGC	GAAACACCGGTGAACGTATGGACTGAACCAGGGTGTGCATGTGGGGATAG	1	bc
GACTTACAAT	GAAACACCGGTCGACGCCACTCAGAGGAGCGGGTAGAGCTAGGAGTAGCG	1	bc
ACATAGTCGT	GAAACACCGGTGTACGTATGGACTGAACCAGGGTGTGCAAAGTGGGGTTA	1	bc
TGACATAGAC	GAAACACCGGTAGCAAGTGGGGTTAGAGCTAGAAATAGCAAGTTAACCTA	1	bc
CCGGTAACGT	GAAACACCGGTTACATTGAGGGGTTAGAGCTAGAAATAGCAAGTTAACCT	1	bc
AAGCCCGCCT	GAAACACCGGTCCGTAGGAGACCCGTGTGGCATGTACCTGTGGGGTTAGA	1	bc
CGACGCCTTC	GAAACACCGGTCTCGGGAGGGACGTTACCAGTGGGCCTAAGGCTAGACCT	1	bc
GAAGAGCTTC	GAAACACCGGTTCCCGTCCAGTGGGGTTAGAGCTAGAAATAGCAAGTTAA	1	bc
AGGCCACTAC	GAAACACCGGTAAATTTGAGGCTCCGGCATGCAGGAGGCCGTGGGGTTAG	1	bc
CGCTTTCGTC	GAAACACCGGCGTACGTATGGACTGAACCAGGGTGTGCAAGTGGGGTTAG	1	bc
GGAGTGTTGT	GGGTTAGAGCTAGAAATAGCAAGTTAACCTAAGGCTAGTCCGTTATCAAC	1	bc
TAGCGCATAG	GAAACACCGGTTAAGCCGAGGGTTAGAGCTAGAAATAGCAAGTTAACCTA	1	bc
CACGAACCAC	GAAACACCGGTGCCCTTACTCTCACCTGATTACTTAATCCGTGGGGTTAG	1	bc
AAGATTGGCA	GAAACACCGGTTTACGTTGCATCGGTGTGGGGTTAGAGCTAGAAATAGCA	1	bc
CGAAACGTGT	GAAACACCGGTGCATTCGAAAGTCCGGTCGTAGTGTGGACGTGGGGTTAG	1	bc
ATGTGACGTC	GAAACACCGGTGTACGCATGGGCTGAACCAGGGTGTGCAAAGTGGGGTTA	1	bc
AAGAAGCTCG	GAAACACCGGTGCATTCGAAGGTCCGGTCGTAGTGTGGACGTGGGGTTAG	1	bc
CTTTTCGTGC	GAAACACCGGTCGGGGCCACTCAGTGGTGGGGTTAGAGCTAGAAATAGCA	1	bc
AAACCACGCT	GAAACACCGGTTTGAACTAGAAATAGCAAGTTAACCTAAGGCTAGTCCGT	1	bc
TTTTTACCGT	GAAACACCGGTCGGGGCCACTCAGTGGTGGGGTTAGAGCTAGAAATAGCA	1	bc
TACAGCAACA	GAAACACCGGTTAAGCCGAGGCTAGAAATAGCAAGTTAACCTAAGGCTAG	1	bc
ACGGGTTGTC	GAAACACCGGTGACATTGGGGTGGGGTTAGAGCTAGAAATAGCAAGTTAA	1	bc
GAGACAAAAA	GAAACACCGGTAGCAAGTGCGAGACGTGTTTGTGGGGTTAGAGCTAGAAA	1	bc
CAAGCAATAC	GAAACACCGGTGCCCTTACTCTCACCTGATTACTTAATCCGTGGGGTTAG	1	bc
AAATACGCAC	GAAACACCGGTTTGAACTACCTAGTGCACACACTAGAGCTAGAAATAGCA	1	bc
AGGCCGTGAC	GAAACACCGGTGCATTCGAAAGTCCGGTCGTAGTGTGGACGTGGGGTTAG	1	bc
AAACGCGCTA	GAAACACCGGTGCCCTTACTCTCACCTGATTACTTAATCCGTGGGGTTAG	1	bc
GATAGCCGTG	GAAACACCGGTGGACTTATGGACTGAACCAGGGTTGGCAATGGGGGTGAG	1	bc
TCGATGCTGA	GAAACACCGGTTAAGCCGGTGGGGTTAGAGCTAGAAATAGCAAGTTAACC	1	bc
GACACCGAAT	GAAACACCGGTAGGACGTGGGGGGTTAGAGCTAGAAATAGCGAGATAACC	1	bc
CGAATGATTC	GAAACACCCGTCTCGAGTGAGGTGTTCAGGGTGGGGTTAGAGCTAGAAAT	1	bc
ATCCTTTACC	GAAACACCGGTCGTCCTTTGGGGTTAGAGCTAGAAATAGCAAGTTAACCT	1	bc
CGTAGTTCGT	GAAACACCGGTGCATTCGAAAGTCCGGTCGTAGTGTGGACGTGGGGTTAG	1	bc
GTAGCCTCAC	GAAACACCGGTCGGCGGCAACGTGGGGGTAGAGGTAGAAATAGCAAGTTA	1	bc
GACACCCGAC	GAAACACCGGTGTGGCTGAGAGTCCGGCAATGGTGTGGCTGTGGGGTTAG	1	bc
TCCTTTAGTG	GAAACACCGGTCGGGGCCACTCAGTGGTGGGGTTAGAGCTAGAAATAGCA	1	bc
TGGTCTGCCT	GAAACACCGGTCCGTAGGAGACCCGTGTGGCATGTACCTGTGGGGTTAGA	1	bc
TCTTCTATGC	GAAACACCGGTTACGTTGAGTGAGAGAGCTAGAAATAGCAAGTTAACCTA	1	bc
AGTCCCCCTT	GAAACACCGGTGTGGCTGAGAGTCCGGCAATGGTGTGGCTGTGGGGTTAG	1	bc
TACAGAATAA	GAAACACCGGTAAAGAGGGCGATACAGGTAAAAACAACAAGTTAACCCGG	1	bc
GACGCGCTCC	GAACCACCGGTACGGCTGAGAGTCCGGCGATAGTGAGGCTGTGAGGTTAG	1	bc
AGGCGGTCTC	GAAACACCGGTCCGTAGGAAACCCGGGTGGCATGGACCAGTGGGGGTAAA	1	bc
GACGTTATGT	GAAACACCGGTTACATTGAGGGGTTAGAGCTAGAAATAGCAAGTTAACCT	1	bc
TATGCTTAGG	GAAACACCGGTTTACGTTGCATCGGTGTGGGGTTAGAGCTAGAAATAGCA	1	bc
ATGGCGAGCT	GAAACACCGGTTTACGTTTTTGTGGGGTTAGAGCTAGAAATAGCAAGTTA	1	bc
AGCGTCGCCA	GAAACACCGGTGACGTTGGGACGAGAGCTAGAAATAGCAAGGTAACATCA	1	bc
ACGTGTAGTC	GAAACACCGGTGACATTGGGTACAGGAGTGGGGTTAGAGCTAGAAATAGC	1	bc
CTGCTTATAC	GAAACACCGGTTTACGTTGCGTCGGTGTGAGGTTAGAGCTAGAAATAGCA	1	bc
AGGATAGGCA	GAAACACCGGTAGCAAGTGCGCGACGTGTTAGAGCTAGAAATAGCACCGG	1	bc
TCGTGGCTAA	GAAACACCGGTTAAGCCGGGGCTAGAAATAGCAGGTTAACCTAAGGCTAG	1	bc
GGGACCTATA	GAACCACCGGTCAATTTGAGGCTCCGGCATGCAGGAGGCCGTTGGGTTAG	1	bc
GCGGAGCAGC	GAAACACCGGTCGGCGGCAATCGTGGGTGGGGTTAGAGCTAGAAATAGCA	1	bc
GGGGAGCCGA	GAAACACCGGTTCCCGTCCAGTGGGGTTAGAGCTAGAAATAGCAAGTAAT	1	bc
AACAAAGACC	GAAACACCGGTTTGAACTACCGGGGTTAGAGCTAGAAATAGCAAGTTAAC	1	bc
GCACAATGCC	GAAACACCGGTTTGAACTACCGGGGTTAGAGCTAGAAATAGCAAGTTAAC	1	bc
TGGGATACTC	GAAACACCGGTTCCCGTCCAGTGGGGTTAGAGCTAGAAATAGCAAGTTAA	1	bc
TGTAGCTCTG	GAAACACCGGTTACATTGAGGGTTAGAGCTAGAAATAGCAAGTTAACCTA	1	bc
TTACCTATAA	GAAGCACCGGTAACTATATTCATGCGATATCGCCGTATCAGTGGGGTTAG	1	bc
AATGATTAGC	GAAACACCGGTTTACGTTGCATCGGGGTTAGAGCTAGAAATAGCAAGTTA	1	bc
AGGATCACTC	GAAACACCGGTCCGTAGGAGACCCGGGTGGAGTGAACCTGTGGTGATAGA	1	bc
GCTAGCTATG	GAAACAACGGTTACATTGGGGTTAGAGCTAGAAATAGCAAGTTAACCTAA	1	bc
GCGGCGCCGC	GAAACACCGGTTCACGTCCAGCGGGGTTAGAGCTAGAAATAGAAAGTTAA	1	bc
TCTATATTGC	GAAACACCGGTTATATTTGTAAGCGTGTGGGTTTAGAGCTAGAAATAGCA	1	bc
CACGTCCGGC	GAAACACCGGTCGTCGGCGTGGGGTTAGAGCTAGAAATAGCAAGTTAACC	1	bc
AGGCATGCAC	GAAACACCGGTGTGGCTGAGAGTCCGGCAATGGTGTGGCTGTGGGGTTAG	1	bc
TAAATTGAAC	GAAACACCGGTAACTATATTCATGCGATATCGCCGTATCAGTGGGGTTAG	1	bc
AGATTATCGC	GAAACACCGGTCGGGGCCACTCAGTGGTGGGGTTAGAGCTAGAAATAGCA	1	bc
GCTAGTCGTA	GAAACACCGGTGTACGTATGGACTGAACCAGGGTGGGGTTAGAGCTAGAA	1	bc
CTACGTGGTC	GAAACACCGGTGTACGTATGGACTGAACCAGGGTGTGCAAGTGGGGTTAG	1	bc
ATTAGCGAGG	GAAACACCGGTTACATTGAGATTGGGGTTAGAGCTAGAAATAGCAAGTTA	1	bc
AGGCAACTAC	GAAACACCGGTAAATTTGAGGCTCCGGCATGCAGGAGGCCGTGGGGTTAG	1	bc
AAGTGTTGTC	GAAACACCGGTGACATTGGGTACAAGTGGGGTTAGAGCTAGAAATAGCAA	1	bc
AATGCTTCGC	GAAACACCGGTTTACGTTGCATCGGTTGTGGGGTTAGGGCTAGAAATAGC	1	bc
CAGGAGGCTA	GAAACACGGGTTAGAGCTAGAAATAGCAAGTTAACCTAAGGCTAGTCCGT	1	bc
CGTATTGCAC	GAAACACCGGTTTCATGGGGTATTAGAGCTAGTAATAGCAAGTTAACCCA	1	bc
ACTACTCGGT	GAAACACCGGTACCTTTGTTGATGCTGGGTGGAAGGAATGTGGGGTTAGA	1	bc
ATCCCCTGCA	GAAACACCGGTGTGGCTGAGAGTCCGGCAATGGTGTGGCTGTGGGGTTAG	1	bc
GATACGCGGC	GAAACACCGGTACCTTTGTTGATGCTGGGTGGGGTTAGAGCTAGAAATAG	1	bc
AAACGCCATA	GAAACACCGGTGCCCATACTCTCACCTGATTACTTAATCCGTGGGGTTAG	1	bc
GACCACGGCC	GAAACACCGGTTTGAACTAGAAATAGCAAGTTAACCTAAGGCTAGTCCGT	1	bc
AAATAACCGC	GAAGCACCGGTCGGGGCCACTCAGTGGTGGGGTTAGAGCTAGAAATAGCA	1	bc
CATTACCCGC	GAAACACCGGTCGGCGGCAATCGTTAGAGCTAGAAATAGCAAGTTAACCT	1	bc
AGCGGAGCCT	GAAACACCGGTTCCCGTCCGGTGGGGTTAGAGCTAGAAATAGCAAGTTAA	1	bc
CCGGAGGACA	GAAACACCGGTTTGAACTAGAAATAGCAAGTTAACCTAAGGCTAGTCCGT	1	bc
GCGAAAACTC	GAAACACCGGTTCCCGTCCAGTGGGGTTAGAGCTAGAAATAGCAAGTTAA	1	bc
GTCACCCGCA	GAAACACCGGTGTGGCTGAGAGTCCGGCAATGGTGTGGCTGTGGGGTTAG	1	bc
ATCAATTAAC	GAAACACCGGTAACTATATTCATGCGATATCGCCGTATCAGTGGGGTTAG	1	bc
AAGCTTGGCG	GAAACACCGGTTTACGTTGCATCGTGGGGTTAGAGCTAGAAATAGCAAGT	1	bc
AAATGCCCTA	GAAACACCGGTGCCCTTACTCTCACCTGATTACTTAATCCGTGGGGTTAG	1	bc
TGGCTCTCTC	GAAACACCGGTGTGGCTGAGAGTCCGGCAATGGTGTGGCTGTGGGGTTAG	1	bc
CGCCCGTAAT	GAAACACCGGTAAGTTTGAGGCTCCGGCATGCAGGAGGCCGTGGGGTTAG	1	bc
TAACAACGCT	GAAACACCGGTTTGAACTACCGGGGTTAGAGCTAGAAATAGCAAGTTAAC	1	bc
GCGTGGTGGA	GAAACACCGGTGACATTGGGTACAGGGGTGGGGTTAGAGCTAGAAATAGC	1	bc
AACTTTCGGT	GAAACACCGGTCGATTCATATCGAAACCTTCCCGTTAGAGCTAGAAATAG	1	bc
CTAAGCGTCG	GAGACACCGGTGTACGTATGGACTGAACCAGGGTGTGCAAGTGGGGTTAG	1	bc
GGAAGACACG	GAAACACGGTTAGAGCTAGAAATAGCAAGTTAACCTAAGGCTAGTCCGTT	1	bc
CCTTCGAGGC	GAAACACCGGTCGGAGCCACTCAGTGGTGGGGTTAGAGCTAGAAATAGCA	1	bc
GAGTCGGCCT	GAAACACCGGTCCGTAGGAGACCCGTGTGGCATGTACCTGTGGGGTTAGA	1	bc
CGGATTATTT	GAAACACCGGTTTACGTTGCATCGGTGTGGGGTTAGAGCTAGAAATAGCA	1	bc
GACCCCCTTC	GAAACACCGGTCTGGCGGGAGGTGTTGAGGGGGGGGGGAGGGCTGGAAAT	1	bc
ATTCTTAGTC	GAAACACCGGTTTACGTTGCATCGGTGTGGGGTTAGAGCTAGAAGTAGCA	1	bc
ACACAAGTCC	GAAACACCGGTTTGAACTACCGGGGTTAGAGCTAGAAATAGCAAGTTAAC	1	bc
AGTGTTGCCA	GAAACACCGGTGACATTGGGTACAGGGTGGGGTTAGAGCTAGAAATAGCA	1	bc
AAGTCCTTAA	GAAACACCGGTGCCCTTACTCGCACCTGATTACTTAATCCGGGGGGATAG	1	bc
CTTGTTGCGT	GAAACACCGGTGACATTGGGTACAGGGGGGTGTTAGAGCTAGAAATAGCA	1	bc
ACGGGTTGTC	GAAACACCGGTGTTAGAGCTAGAAATAGCAAGTTAACCTAAGGCTAGTCC	1	bc
TGACACATGT	GAAACACCGGTCTCGAGGGAAGTGTTCAGGGTGGGGTTAGAGCTATAAAT	1	bc
AAGATCGACG	GAAACACCGGTGCATTCGAAAGTCCGGTCGTAGTGTGGACGTGGGGTTAG	1	bc
TTAGAGCCGC	GAAACACCGGTTACCTTGAGGGGTTAGAGCTAGTAATAGCAAGTTAACCT	1	bc
GGTGACGTCC	GAAACACCGGTGTGGCTGAGAGTCCGGCAATGGTGTGGCTGTGGGGTTAG	1	bc
ACTCTGGAGT	GAAACACCGGTTCTATTTATACGTTAGAGCTAGGAATATCAAGTTAACCT	1	bc
AATAGTCGTA	GAAACACCGGTGTACGTATGGACTGAACCAGGGTGAGCTAGAAATAGCAA	1	bc
CCGTTCGGGT	GAAACACCGGTCGATTCATATCGAAACCTTCCCGTGACAGTGGGGTTAGA	1	bc
ACATCTAGGA	GAAACACCGGTTACATTTAGGGGTAAAATTAGAGATAGAGAGTTAACATT	1	bc
ATACTCCAGC	GAAACACCGGTGCATTCGAGAGTCCGGTCGTAGTGTGGACGTGGGGTTAG	1	bc
CTCCCTTTCA	GAAACACCGGTGTGGCTGAGAGTCCGGCAATGGTGTGGCTGTGGGGTTAG	1	bc
TGAAGAAATG	GAAACACGGTTAGAGCTAGAAATAGCAAGTTAACCTAAGGCTAGTCCGTT	1	bc
TGCCACAGAC	GAAACACCGGTAGCAAGTGCGAGACGTGTTTGTGGGGTTAGAGCTAGAGA	1	bc
CTCGTTACTC	GAAACACCGGTGACCTTCGGGTTAGAGCTGGAATAAGCCAAGAAATCTCA	1	bc
CGGCGCTAAA	GAAACACCGGTAAATTCGACTTCACGGCATGCAGAAAGCCGTGAGGATAG	1	bc
GAAGAATCGA	GAAACACCGGTCGGCGGCAATCGTGGGTGGGGTTAGAGCTAGAAATAGCA	1	bc
AGGCAGCGCC	GAAACACCGGTCCGTAGGAGACCCGTGTGGCATAGCAAGTTAACCTAAGG	1	bc
ATGCCTAGTG	GAAACACCGGTTTACGTTGCATCGGTGTGGGGTTAGAGCTAGAAATAGCA	1	bc
GGCGCTGTCT	GAAACACCGGTAAATTTGAGGCTCCGGCATGCAGGAGGCCGTGGGGTTAG	1	bc
TGAGGAGTCT	GAAACACCGGTTCCCGTCCAGTGGGGTTAGAGCTAGAAATAGCAAGTTAA	1	bc
AGTATGAACC	GAAACACCGGTCCGTAGGAGACCCGTGTGGCATGTACCTGTGGGGTTAGA	1	bc
TACGGATGGT	GAAACACCGGTGCCCTTACTCTCACCTGATTACTTAATACGTGGGGTTAG	1	bc
GAAAGCCCTT	GAAACACCGGTGCCCTTACTCTCACCTGATTACTTAATCCGTGGGGTTAG	1	bc
GATCCTTAAA	GAAACACCGGTAAATTTGAGGCTCCGGCATGCAGGAGGCCGTGGGGTTAG	1	bc
ATAATCGGAA	GAAACACCGGTACCTTTGTTGATGCTGGGTGGGGTTAGAGCTAGAAATAG	1	bc
CAGACACAGA	GAAACACCGGTAGCAAGTTAACCTAAGGCTAGTCCGTTATCAACTTGAAA	1	bc
GTCACAGCCT	GAAACACCGGTAGCAAGTGCGGGGTTAGAGCTAGAAATAGCAAGTTAACC	1	bc
CAGCGACGTA	GAAACACCGGTGTACGTATGGACTGAACCAGGGTGTGCAAGTGGGGTTAG	1	bc
CGTGTGGTAG	GAAACACCGGTGACATTTGGGGTTAGAGCTAGAAATAGCAAGTTAACCTA	1	bc
AGAGACACTC	GAAACACCGGTGCATTCGAAAGTCCGGTCGTAGTGTGGACGTGGGGTTAG	1	bc
GATAACGCCT	GAAACACCGGTTTGAACTAGAAATAGCAAGTTAACCTAAGGCTAGTCCGT	1	bc
GGAAGAGCGG	GAAACACCGGTCGGTGGGGTTAGAGCTAGAAATAGCAAGTTAACCTAAGG	1	bc
TACTTTACCT	GAAACACCGGTCGGGGCCACTCAGTGGTGGGGTTAGAGCTAGAAATAGCA	1	bc
TTGCGAACAA	GAAACACCGGTGACATTGGGTACAAGTGGGGTTAGAGCTAGAAATAGCAA	1	bc
GATTACACGC	GAAACACCGGTCGGCGGCAATCGTGGGTGGGGTTAGAGCTAGAAATAGCA	1	bc
GATGATTGAC	GAAACACCGGTATCAAGTTAACCTAAGTCTAGTCCGTTATCAACTTGAAA	1	bc
GAAGACCGTA	GAAACACCGGTCGGCGGCAATCGTGGGTGGGGTTAGAGCTAGAAATAGCA	1	bc
GGAAAACCCC	GAAACACCGGTGTGGCTGAGAGTCCGGCAATGGTGTGGCTGTGGGGTTAG	1	bc
GGACACAGGC	GAAACACCGGTAGCAAGTTAACCTAAGGCTAGTCCGTTATCAACTTGAAA	1	bc
AAACAACGCC	GAAACACGGGGTTAGAGCTAGAAATAGCAGGTTAACCTAAGGCTAGTCCG	1	bc
TGGCCACTAC	CCGGTAAATTTGAGGCTCCGGCATGCAGGAGGCCGTGGGGTTAGAGCTAG	1	bc
ACATTAGATG	GAAACACCGGTCGATTCATATCGAAACCTTCCCATGACAGTGGGGTTAGA	1	bc
GCGATAATAC	GAAACACCGGTTAAGCCGAGGTGTAGAGCTGGATATAGCAAGTTAACCTA	1	bc
AGACAGAGAC	GAAACACCGGTAGCAAGTGCGAGACGTGTTTTAGAGCTAGAAATAGCAAG	1	bc
CCCTTCGCCC	GAAACACCGGTCGGGGCCACTCAGTGGTGGGGTTAGAGCTAGAAATAGCA	1	bc
AACCGCACGC	GAAACACCGGTGCATTCGAAAGTCCGGTCGTAGTGTGGACGTGAGGTTAG	1	bc
CACAACGGAA	GAAACACCGGTTTGTGGGGTTAGAGCTAGAAATAGCAAGTTAACCTAAGG	1	bc
ACCTTATCTG	GAAACACCGGTCGGGGCCACTCAGTGGTGGGGTTAGAGCTAGAAATAGCA	1	bc
TAAGCTCTAT	CAAACACCGGTTACATTGAGGGTTAGAGCTAGAAATAGCAAGTTAACCTA	1	bc
AAAAGCCCTA	GAAACACCGGTGCCCTTACTCTCACCTGATTACTTAATCCGTGGGGTTAG	1	bc
AGCGTAGTTT	GAAACACCGGTGACGTGTGAAAGTAGAAATAGCGCTAGAAATAAAAGCTT	1	bc
GCCATTACTG	GAAACACCGGTCGGGGCCACTCAGTGGTGGGGTTAGAGCTAGAAATAGCA	1	bc
ACCGTTCGGT	GAAACACCGGTCGATTCATATCGAAACCTTCCCGTGATAGTGGGGTTAGA	1	bc
GGCTATTACT	GAAACACCGGTAAATTTGAGGCTCCGGCATGCAGGAGGCCGTGGGGTTAG	1	bc
AAAACCTGTC	GAAACACCGGTGCCCTTACTCTCACCTGATTACTTAATCCGTGGGGTTAG	1	bc
AGTTTATCGC	GAAACACCGGTCGGGGCCACTCAGTGGTGGGGTTAGAGCTAGAAATAGCA	1	bc
CAGCACCCCC	GAAACACCGGTTTGAACTACCGGGGATAGAGCTAGAACTAGCAAGTTAAC	1	bc
GCAGGCCCTA	GAAACACCGGTGCCCTTACTCTCACCTGATTACTTAATCCGTGGGGTTAG	1	bc
AGGCAGACTC	GAAACACCGGTCCGTAGGAGACCCGTGTGGCATGTACCTGTGGGGTTAGA	1	bc
AGGCTACGTC	GAAACACCGGTGTGGCTGAGAGTCCGGCAATGGTGTGGCTATGGGGTTAG	1	bc
ATGATAGGCC	GAAACACCGGTACCTTTGTTGATGCTGGGTGGATGGAATTTTTGTGAGGT	1	bc
AGGTGAATAA	GAAACACCGGTTAAGCCGAGTGGGGTTAGAGCTAGAAATAGCAAGTTAAC	1	bc
AACACTGTAC	GAAACACCGGTTGCAAGAGCGAGACGTGTTTGTGGGGTTAGAGCTAGAAA	1	bc
CAACTTCGGC	GAAACACCGGTGTACGTATGGACTGAACCAGGGTGTGCAAGTGGGGTTAG	1	bc
GACATTAGGT	GAAACACCGGTCGATTCATATCGAAACCTTCCCGTGACAGTGGGGTTAGA	1	bc
ATTAGCTAGG	GAAACACCGGTTACATTGGGGTTAGAGCTAGAAATAGCAAGTTAACCTAA	1	bc
CATCGTGTTA	GAAACACCGGTGTACGCATGGACTGAACCAGGGTGTGCAAGTGGGGTTAG	1	bc
AGTATGCACC	GAAACACCGGTCCGTAGGAGACCCGTGTGGCATGTACCTGTGGGGTTAGA	1	bc
AATTCTTAGC	GAAACACCGGTTTATGTTGCGTTGTTTGTGGGGTTAGAGCTAGAAATAGC	1	bc
CACTTAGCTC	GAAACACCGGTTTGAACTAGAAATAGCAAGTTAACCTAAGGCTAGTCCGT	1	bc
CCTAAAGCCC	GAAACACCGGTTTGAACTACCGGGGTTAGAGCTAGAAATAGCAAGTTAAC	1	bc
AGACAGAGAC	GAAACACCGGTAGCAAGTGCGAGACGTGTTAGAGCTAGAAATAGCACCGG	1	bc
TATGATTAGA	GAAACACCGGTTTACGTTGCATCGGTGTGGGGTTAGAGCTAGAAATAGCA	1	bc
ATTGGACATA	GAAACACCGGTTAAGCCGAGTGGGGTTAGAGCTAGAAATAGCAAGTTAAC	1	bc
CCATCACAGC	GAAACACCGGTCGGGGCCACTCAGTGGTGGGGTTAGAGCTAGAAATAGCA	1	bc
CTGGCACTAC	GAAACACCGGTGCCCTTACTCTCACCTGATTACTTAATCCGTGGGGTTAG	1	bc
TAACGCGATT	GAAACACCGGTGCCCTTACTCTCACCTGATTACTTAATCCGTGGGGTTAG	1	bc
ATGATCGTCG	GAAACACCGGTGTACGTATGGACTGAACCAGGGTGTGCAAGTGGGGTTAG	1	bc
AGGTAGCCGC	GAAACACCGGTGTACGTATGGACTGAGCCAGGGTGAGCTAGAGATAGCAA	1	bc
GGAACCATTC	GAAACACCGGTGTGGCTGAGAGTCCGGCAATGGTGTGGCTGTGGGGTTAG	1	bc
AATGAGCATA	GAAACACCGGTTAAGCCGTGGGGTTAGAGCTAGAAATAGCAAGTTAACCT	1	bc
AACGCGCACC	GAAACACCGGTGCCCTTACTCTCACCTGATTACTTAATCCGTGGGGTTAG	1	bc
CTAGTCCTGT	GAAACACCGGTTACATTGATGATGGTTAGAGCTAGTAATAGTAAGATTAG	1	bc
GCAGACAAGC	GAAACACCGGTCGGCGGCAATCGTTAGAGCTAGAAATAGCAAGTTAACCT	1	bc
TATGCTGAGC	GAAACACCGGTTACGTTGCATCGGTGTGGGGTTAGAGCTAGAAATAGCAA	1	bc
GTGCTTGGCC	GAAACACCGGTTTACGTTGCATCGGGGTTAGAGCTAGAAATAGCAAGTTA	1	bc
ACCTTTAACG	GAAACACCGGTCGGGGCCACTCAGTGGTGGGGTTAGAACTAGAAATAGCA	1	bc
AGACCAGCGA	GAAACACCGGTAGCTAGTGCGAGACGGGTTTGGGGGGGTAGAGCTAGAAA	1	bc
TCAACTCGGC	GAAACACCGGTGCCCTTACTCTCACCTGATTACTTAATCCGTGGGGTTAG	1	bc
AAACTAGGAT	GAAACACCGGTCGATTCATATCGAAACCTTCCCGTGACAGTGGGGATAGA	1	bc
ATAATGCGTT	GAAACACCGGTCTCGGGTGAGGGGGTCAGGGTGTGGATATAGCTAGAAAT	1	bc
AAGCGTTTTT	GAAACACCGGTAACTATATTCATGCGATATCGCCGTATCAGTGGGGTTAG	1	bc
GTTGAGCAAT	GAAACACCGGTTAAGCCGAGGGTTAGAGCTAGAAATAGCAAGTTAACCTA	1	bc
TCTAATCGGT	GAAACACCGGTACCTTTGTTGATGCTGGGTGTGGGGTTAGAGCTAGAAAT	1	bc
GAAGAAGCGA	GAAACACCGGTCGGCGGCAATCGTGGGTGGGGTTAGAGCTAGAAATAACA	1	bc
AGTCGTCGGC	GAAACACCGGTGTACGTATGGACTGAACCAGGGTGTGCAAAAGTGGGGTT	1	bc
AAGTCTGCTT	GAAACACCGGTGCGCTTACTATCACCTGATTACTTAATCCGTGGGGTTAG	1	bc
AACGAACTCA	GAAACACCGGTGCCCTTACTCTCACCTGATTACTTAATCCGTGGGGTTAG	1	bc
AGTGTGACTT	GAAACACCGGTCCGTAGGAGACCCGTGTGGCATGTACCTTGTGGGGTTAG	1	bc
ACGTTTTCGC	GAAACACCGGTCGGGGCCACTCAGTGGTGGGGTTAGAGCTAGAAATAGCA	1	bc
AATTTAGCCT	GAAACACCGGTTCCCGTCCAGTGGGGTTAGAGCTAGAAATAGCAAGTTAA	1	bc
CAGGGGCGTC	GAAACACCGGTGTACGTATGGACTGAACCAGGGTGTGCAAGTGGGGTTAG	1	bc
ATATACGGTC	GAAACACCGGTCGATTCATATCGAAACCTTCCCTTGACATTGGGGTTAGA	1	bc
GTCAACCTTC	GAAACACCGGTGTGGCTGAGAGTCCGGCAATGGTGTGGCTGTGGGGTTAG	1	bc
GTAGACGCGA	GAAACACCGGTCGGCGGCAATCGTGGGGGGGGTTAGAGCTAGAAATAGCA	1	bc
ATACTCATGA	GAAACACCGGTGCATTCGAAAGTCCGGTCGTAGTGTGGACGTGGGGTTAG	1	bc
GGGAACATCC	GAAACACCGGTGTGGCTGAGAGTCCGGCAATGGTGTGGCTGTGGGGTTAG	1	bc
TGTGGAGCAT	GAAACACCGGTTCCCGTCCAGTGGGGTTAGAGCTAGAAATAGCAAGTTAA	1	bc
GCGGACTCGC	GAAACACCGGTCGGCGGCAATCGTGGGTGGGGTTAGAGCTAGAAATAGCA	1	bc
GTAGCGCGGC	GAAACACCGGTCGGTGGGGTTAGAGCTAGAAATAGCAAGTTAACCTAAGG	1	bc
GCGTTTACCG	GAAACACCGGTCGGGGCCACTCAGTGGTGGGGTTAGAGCTAGAAATAGCA	1	bc
CTACTCAGGA	GAAACACCGGTACCTTTGTTGATGCTGGGTGGAAGGAATTCTGTGGGGTT	1	bc
AAGAGGAACC	GAAACACCGGTCGGCGGCAATCGTGGGTGGGGTTAGAGCTAGAAATAGCA	1	bc
ATAAAATGCA	GAAACACCGGTTTGAACTACCGGGGTTAGAGCTAGAAATAGCAAGTTAAC	1	bc
ATCCTCGGCA	GAAACACCGGTACCTTTGTTGATGCTGGTGTGGGGTTAGAGCTAGAAATA	1	bc
CCGATGGTGC	GAAACACCGGTTATATTTGTAAGTGGGGTTAGAGCTAGAAATAGCAAGAT	1	bc
AGATACTAGG	GAAACACCGGTGCATTCGAAAGTCCGGTCGTAGTGTGGACGTGGGGTTAG	1	bc
CGGATACGTC	GAAACACCGGTAGGGCGTGCTTCGTGGGGGGGGTATCCTGAAAAAGAGCA	1	bc
GCGAATCCAT	GAAACACCGGTCTCGAGTGAGGTGTTCAGGGGTGGGGTTAGAGCTAGAAA	1	bc
TAACACTCGC	GAAACACCGGTGCATTCGAAAGTCCGGTCGTAGTGTGGACGTGGGGTTAG	1	bc
ACACAACGAA	GAAACACCGGTTTGAACTAGAAATAGCAAGTTAACCTAAGGCTAGTCCGT	1	bc
GTCAGAGACC	GAAACACCGGTAGCAAGTGCGAGACGTGTTTGTGGGGTTAGAGCTAGAAA	1	bc
CAGAAGATCC	GAAACACCGGTCGGCGGCAATCGTGGGTGGGGTTAGAGCTAGAAATAGCA	1	bc
AAGCCTGTCT	GAAACACCGGTCCGTAGGAGACCCGTGTGGCATGTACCTGTGGGGTTAGA	1	bc
AGTATTCTTC	GAAACACCGGTCCGTAGGAGACCCGTGTGGCGTGTACCTTGTGGGGTTAG	1	bc
ATACAACGCA	GAAACACCGGTTTGAACTAGAAATAGCAAGTTAACCTAAGGCTAGTCCGT	1	bc
CAACAAGCTC	GAAACACCGGTTTGAACTACCGGGGTTAGAGCTAGAAATAGCAAGTTAAC	1	bc
AAGGCTGTAC	GAAACACCGGTGCATTCGAAAGTCCGGTCGTAGTGTGGACGTGGGGTTAG	1	bc
AATACACGGC	GAAACACCGGTACCTTTGTTGATGCTGGGTGTGGGGTTAGAGCTAGAAAT	1	bc
ATGCGCTAGC	GAAACACCGGTGCATTCGAAAGTCCGGTCGTAGTGTGGACGTGGGGTTAG	1	bc
AACACTGCCC	GAAACACCGGTTTGAACTACCTAGTTCAAACCGGTGGGGTTAGAGCTAGA	1	bc
TTTAGCTACG	GAAACACCGGATTGGGGTTAGAGCTAGAAATAGCAAGTTAACCTAAGGCT	1	bc
AGACGTTGAC	GAAACACCGGTATCAAGTGCGAGACGTGTTTTTTGTGGGGTTAGAGCTAG	1	bc
TTCTTTATTT	GAAACACCGGTTACATTGGGGTTAGAGCTAGAAATAGCAAGCTAACCTAA	1	bc
AATCGGTGCC	GAAACACCGGTGTACGTATGGACTGAACCAGGGTGTGCAAGTGGGGTTAG	1	bc
AATACTGCCT	GAAACACCGGTCCGTAGGAGACCCGTGTGGCATGTACCTGTGGGGTTAGA	1	bc
AACACAGCAA	GAAACACCGGTAGCAAGTGCGAGACGTGTTTTTGTGGGGTTAGAGCTAGA	1	bc
GAGACAGCCC	GAAACACCGGTAGCAAGTGCGAGACGTGTTTTTGTGGGGTTAGAGCTAGA	1	bc
GTGACATCGA	GAAACACCGGTAGCAAGTGCGAGACGTGTTTGTGGGGTTAGAGCTAGAAA	1	bc
TGCACACGCC	GAAACACCGGTGTGGCTGAGAGTCCGGCAATGGTGTGGCTGTGGGGTTAG	1	bc
ACACGCGCTA	GAAACACCGGTGCCCTTACTCTCACCTGATTACTTAATCCGTGGGGTTCG	1	bc
AGATCCACTC	GAAACACCGGTGCATTCGAAAGTCCGGTCGTAGTGTGGACGTGGGGTTAG	1	bc
ATTGATCATA	GAAACACCGGTTAAGCCGAGGGTTAGAGCTAGAAATAGCAAGTTAACCTA	1	bc
CACATGGCCT	GAAACACCGGTTTGAACTACGGGGGTTAGAGCTAGAAATAGCAAGTAAAC	1	bc
GAGGAGCAGC	GAAACACCGGTTCCCGTCCAGTGGGGTTAGAGCTAGAAATAGCAAGTTAA	1	bc
AAGGCTTAGC	GAAACACCGGTTTACGTTGCATGTGGGGTTAGAGCTAGAAATAGCAAGTT	1	bc
GGGTCCTAGT	GAAACACCGGTAGACCCTGTTGCTCCGTGGGGTTAGAGCTAGAAATAGCA	1	bc
AATGGTCGTG	GAAACACCGGTGTACGTATGGACTGAACCAGGGTGTGCAAAGTGGGGTTA	1	bc
GGCTCCATTC	GAAACACCGGTGTGGCTGAGAGTCCGGCAATGGTGTGGCTGTGGGGTTAG	1	bc
AAACTCCCTA	GAAACACCGGTGCCCTTACTCTCACCTGATTACTTAATCCGTGGGGTTAG	1	bc
ACCCAACGCC	GAAACACCGGTTTGAACTAGAAATAGCAAGTTAACCTAAGGCTAGTCCGT	1	bc
ACATCGTAGT	GAAACACCGGTGTACGTATGGACTGAACCAGGGTGTGCAAAGTGGGGTTA	1	bc
AGGGGGAGCC	GAAACACCGGTTCCCGTCCAGTGGGGTTAGAGCTAGAAATAGCAAGTTAA	1	bc
GGCAGAGTCC	GAAACACCGGTGTGGCTGAGAGTCCGGCAATGGTGTGGCTGTGGGGGTAG	1	bc
ATGAGGACAC	GAAACACCGGCTCGGGGTTAGAGCTAGAAATAGCAAGTTAACCTAAGGCT	1	bc
AGGCACACTG	GAAACACCGGTGTGGCTGAGAGTCCGGCAATGGTGTGGCTGTGGGGTTAG	1	bc
ACTCCTCGGC	GAAACACCGGTACCTTTGTTGATGCTGGGTGGGGTTAGAGCTAGAAATAG	1	bc
TATAGCGTGG	GAAACACCGGTTATATTTGTAAGTGTGTAGGGTTAGAGCTAGAAATAGCA	1	bc
ACAGCTATGG	GAAACACCGGTCGATTCATATCGAAACCTTCCCGTGACAGTGGGGTTAGA	1	bc
ATTGGCACTG	GAAACACCGGTTACATTGAGGGTTAGAGCTAGAAATAGCAAGTTAACCTA	1	bc
CGAATCGTGC	GAAACACCGGTGCATTCGAAAGTCCGGTCGTAGTGTGGACGTGGGGTTAG	1	bc
TCATCGTAGT	GAAACACCGGTGTACGTATGGACTGAACCAGGGTGTGCAAGTGGGGTTAG	1	bc
AAGTCATGAT	GAAACACCGGTGCCCTTACTCTCACCTGATTACTTAATCCGTGGGGTTAG	1	bc
AATAGTCGCA	GAAACACCGGTGTACGTATGGACTGAACCAGGGTGTGCAAGTGGGGTTAG	1	bc
ACCTTTACAG	GAAACACCGGTCGGGGCCACTCAGTGGTGGGGTTAGAGCTAGAGATAGCA	1	bc
AAGAGCCGAG	GAAACACCGGTGCATTCGAAAGTCCGGTCGTAGTGTGGACGTGGGGTTAG	1	bc
GGTAGTCGCC	GAAACACCGGTGTGGCTGAGAGTCCGGCAATGGTGTGGCTGTGGGGTTAG	1	bc
GAGCTTGACG	GAAACACCGGTAGCAAGTGCGGTAGCAAGTGGGGTTAGAGCTAGAAATAG	1	bc
TGACAGAGCC	GAAACACCGGTAGCAAGTGGGGTTAGAGCTAGAAATAGCAAGTTAACCTA	1	bc
TAGACCGACT	GAAACACCGGTTATATTTGTTAGCTTGGTTATGGCTATAAATATCGAGAT	1	bc
AATGAGTAGT	GAAACACCGGTTTACGTTGCATCGGTTGTGGGGTTAGAGCTAGAAATAGC	1	bc
TAGCCCGGCA	GAAACACCGGTTATGTTTGAACGTATGGGGGGTGAGTGCTAGAAATAACA	1	bc
TTACTAGGAC	GAAACACCGGTATCTTTGTTGATGCTGGGTGGGGTTAGAGCTAGAAATAG	1	bc
CAACGTAGGT	GAAACACCGGTTACATTGAGGGGTTAGAGCTAGAAATAGCAAGTTAACCT	1	bc
AATGCTTATT	GAAACACCGGTTTACGCTGCATCGGTGTGGGGTTAGAGCTAGAAATAGCA	1	bc
TCTATTGCCG	GAAACACCGGTTGTATTTGTAAGTGTTGTGGGGTTAGAGCTAGAAATAGC	1	bc
TGGATCATAC	GAAACACCGGTTAAGCCGAGTGGGGTTAGAGCTAGAAATAGCAAGTTAAC	1	bc
GGAGATCTGT	GAAACACCGGTCTCATTGAGGGTCAACTTGAGAAATAGCCAGTTAACCTA	1	bc
TTACGCATAC	GAAACACCGGTTAATCCGATAGAAATAGCAAGTTAACCTAAGGCTAGTCC	1	bc
AATACCCGGC	GAAACACCGGTACCTTTGTTGATGCTGGGTGGGGTTAGAGCTAGAAATAG	1	bc
CACACCATCA	GAAACACCGGTTTGAAATAGCAAGTTAACCTAAGGCTAGTCCGTTATCAA	1	bc
GGCCACTCTC	GAAACACCGGTAAATTTGAGGCTCCGGCATGCAGGAGGCCGTGGGGTTAG	1	bc
GAGAATCATT	GAAACACCGGTCTCGAGTGAGGTGTTCAGGGTGGGGTTAGAGCTAGAAAT	1	bc
AGGCTTCCTA	GAAACACCGGTCCGTAGGAGACCCGTGTGGCATGTACCTGTGGGGTTAGA	1	bc
AAATACGCTC	GAAACACCGGTGCATTCGAAAGTCCGGTCGTAGTGTGGACGTGGGGTTAG	1	bc
ACGAACCTCG	GAAACACCGGTGCATTCGAAAGTCCGGTCGTAGTGTGGACGTGGGGTTAG	1	bc
CAAGTTATGC	GAAACACCGGTCGGCGGCAATCGTGGGTGGGGGTAGAGCTAGAAATAGCA	1	bc
AACTTTACCG	GAAACACCGGTCGGGGCCACTCAGTGGTGGGGTTAGAGCTAGAAGTAGCA	1	bc
AGGATCAGCT	GAAACACCGGTTTACGTTGCATCGGTTGTGGGGTTAGAGCTAGAAATAGC	1	bc
AGTAGCGATG	GAAACACCGGTTACATTGAGGGTTAGAGCTAGAAATAGCAAGTTAGCCTA	1	bc
TTAACTGACT	GAAACACCGGCAGCAAGTGCGAGACGTGTTTGTGGGGTTAGAGCTAGAAA	1	bc
CATTTATCGT	GAAACACCGGTCGGGGCCACTCAGTGGTGGGGTTAGAGCTAGAAATAGCA	1	bc
ACGCAGACCC	GAAACACCGGTCCTGTCGCCACGGGTGTGGGGTTAGGGCTAGAAATAGCA	1	bc
AAGACCCTAG	GAAACACCGGCGCATTCGAAAGTCCGGTCGTAGTGTGGACGTGGGGTTAG	1	bc
GGAACCGTCA	GAAACAACGGTGTGGCTGAGAGTCCGGCAATGGTGTGGCTGTGGGGGTAG	1	bc
GTGGAACGTT	GAAACACCGGTTCCCGTCCAGTGGGGTTAGAGCTAGAGATAGCAAGTTAA	1	bc
GCAGACGTTC	GAAACACCGGTCGGCGGCAATCGTGGGTGGGGTTAGAGCTAGAAATAGCA	1	bc
AAAGCACCGA	GAAACACCGGTCGGCGGCAATCGTGGGTGGGGTTAGAGCTAGAAATAGCA	1	bc
AATACACCGC	GAAACACCGGTGCATTCGAAAGTCCGGTCGTAGTGGGGACGTGGGTATAG	1	bc
ATCGCGCTTC	GAAACACCGGTGCCCTTACTCTCACCTGATTACTTAATCCGTGGGGTTAG	1	bc
CAGAGCCGTC	GAAACACCGGTGCACGTATGGACTGAACCAGGGTGTGCAAGTGGGGTTAG	1	bc
CACTCCCGAC	GAAACGCCGGTGCCCTTACTCTCACCTGATTACTTAATCCGTGGGGTTAG	1	bc
ATGATTAGTC	GAAACACCGGTTTACGTTGCATCGGTGTGGGGTTAGAGCTAGAAATAGCA	1	bc
GTACATATAC	GAAACACCGGTAACTATATTCATGCGATATCGCCGTATCAGTGGGGTTAG	1	bc
ATCCAACGCC	GAAACACCGGTTTGAACTACCGGGGTTAGAGCTAGAAATAGCAAGTTAAC	1	bc
CCTTTAGACC	GAAACACCGGTCGGGGCCACTCAGTGGTTGGGTTAGAGCTAGAAATAGCA	1	bc
GGCACCATTT	GAAACACCGGTGTGGCTGAGAGTCCGGCAATGGTGTGGCTGTGGGGTTAG	1	bc
GTAGACCGCC	GAAACACCGGTCGGCGGCAATCGTGGGTGGGGTTAGAGCTAGAAATAGCA	1	bc
TTGATTATCA	GAAACACCGGTTAAGCCGAGTGGGGTTAGAGCTAGAAATAGCAAGTTAAC	1	bc
TTTAGCAGAG	GAAACACCGGTTAAGCCGAGGAGTTAGAGCTAGAAATAGCAAGTTAACCT	1	bc
AACGTGCTTC	GAAACACCGGTGCCCTTACTCTCACCTGATTACTTAATCCGTGGGGTTAG	1	bc
ATTACGTGCT	GAAACACCGGTTGACAGTGCGTCGGTCTTGTGTGTAGATCGAGGGATAAC	1	bc
AGAAGAACCG	GAAACACCGATCGGCGGCAATCGTTAATCGGTTAATCGTGGGGTTAGAGC	1	bc
TTTCGCACCA	GAAACACCGGTTAAGCCGAGGGTTAGAGCTAGAAATAGCAAGTTAACCTA	1	bc
AGAAACGAGC	GAAACACCGGTGCTTTGGAAAGTCCGGTGGTAGTGTGGACGTGGAGTTAG	1	bc
CGTTTCTCAT	GAAACACCGGCGACATTGGGTGTCCACTGTAGGACTTGGAATATGACAAG	1	bc
ATAATCCTGT	GAAACACCGGTCTCGAGTGAGGTGTTCAGGGTGGGGTTAGAGCTAGAAAT	1	bc
GCAGTGGGTT	GAAACACCGGTTCCCTTCCAGTGGGGCTATAGCTAGAAATAGCAAGTCAA	1	bc
AATGCTTATC	GAAACACCGGTTTACGTTGCATCGGTGTGGGGTTAGAGCTAGAAATAGCA	1	bc
GGTGTGAGGC	GAAACACCGGTCGGGGCAAATCCGAAGGGTGGTTAGAGATAGCTATAGCT	1	bc
GAAGAAAAGA	GAAACACCAGTCGGCGGCAATCGTGGGTTAGAGCTAGAAATAGCAAGTTA	1	bc
ACACAACGCT	GAAACACCGGTTTGAACTACCTAGTGCACACACTAGAGCTAGAAATAGCA	1	bc
TGGCCATGCA	GAAACACCGGTAGATTTGAGGCTCCGGCATGCAGGAGGCCGTGGGGTTAG	1	bc
GACGCCTTAT	GAAACACCGGTGCCCTTACTCTCACCTGATTACTTAATACGTGGGGATAG	1	bc
TTGAGAAATA	GAAACACCGGTTAAGCCGAGTGGGGTTAGAGCTAGAAATAGCAAGTTAAC	1	bc
ATATTTATCG	GAAACACCGGTCGGGGCCACTCAGTGGTGGGGTTAGAGCTAGAAATAGCA	1	bc
AACGAACTAA	GAAACACCGGTGCACTTACTCTCACCTGATTACTTAATCCGTGGAGATAG	1	bc
GTACCCGACC	GAAACACCGGTACCTTTGTTGATGCTGGGGGGGGATAGAGCTAGATATAG	1	bc
TTGCCTATCT	GAAACACCGGTTACATTGAGGGGTTATAGCTAGAAGTAGCAGGTTAACAT	1	bc
AACGCTACAC	GAAACACCGGTGCCCTTACTCTCACCTGATTACTTAATCCGTGGGGTTAG	1	bc
ATCTCTCGAG	GAAACACCGGTTATATTTGTAAGTGTGTGGGGTTAGAGCTAGAAATAGCA	1	bc
CGAGTACGTT	GAAACACCGGTCTCGAGTGAGGTGTTCAGGTGAGGTTAGAGCTAGAAATA	1	bc
GATAACACGC	GAAACACCGGTTATATTTGGAAGTGTGTGAGGTTAGAGCTAGAAATAGAA	1	bc
CTGCGAAGCT	GAAACACCGGTTTACGTTGCATCGGTTGTGGGGTTAGAGCTAGAAATAGC	1	bc
ACCTTTCACG	GAAACACCGGTCGGGGCCACTCAGTGGTGGGGTTAGAGCTAGAAATAGCA	1	bc
CATTTGTCTC	GAAACACCGGTTTGAACTACCGGGGTTAGAGCTAGAAATAGCAAGTTAAC	1	bc
CACGCACTCC	GAAACACCGGTGCCCTTACTCTCACCTGATTACTTAATCCGTGGGGTTAG	1	bc
CATATTTGCC	GAAACACCGGTGTACGAATGGACTGAACCAGGTTGTGCATGGGGATTTAG	1	bc
AATCCTTGTC	GAAACACCGGTGTACGTATGGACTGAACCAGGGTGTGCAAGTGGGGTTAG	1	bc
TCACTTCTCC	GAAACACCGGTAACTATATTCATGCGATATCGCCGTATCAGTGGGGTTAG	1	bc
AGAGGAGCCT	GAAACACCGGCTCCCGTCCAGTGGGGTTAGAGCTAGAAATAGCAAGTTAA	1	bc
AAACATTCGG	GAAACACCGGTCGATTCATATCGAAACCTTCCCGTGACAGTGGGGTTAGA	1	bc
GAGGGCTCGC	GAAACACCGGTCGGCGGCAATCGTGGGTGGGGTTAGAGCTAGAAATAGCA	1	bc
GCCACAACAC	GAAACACCGGTTCCCTGCATTAGGTGTTAGAGCTAGAGATAGAAATATCA	1	bc
AAGTATTCCT	GAAACACCGGTCCGTAGGAGACCCGTGTGGCATGTACCTGTGGGGTTAGA	1	bc
GACGGTTCCA	GAAACACCGGTTTCCACGGCGCACATGCGGGTATTAAGGCGTGGGGTTAG	1	bc
TTTGCCGTGG	GAAACACCGGTTATATTTATGGGTTAGAGCGAGAAATAGTAAGTAAACCG	1	bc
ACGATCGCGT	GAAACACCGGTTATATTTGTAAGAGTTGTGGGGTTAGCGCTAGAAATAGC	1	bc
CTCACCAGCA	GAAACACCGGTGTGGCTGAGAGTCCGGCAATGGTGTGGCTGTGGGGTTAG	1	bc
CGTCTCTCGT	GAAACACCGGTGACATTGGGTGTCCACTGTAGGACTTGGAATATGACAAG	1	bc
AACATGCGGT	GAAACACCGGTCGATTCATATCGAAACCTTCCCGTGACAGTGGGGTTAGA	1	bc
ACGTGGTGTC	GAAACACCGGTGACATTGGGTACAGGGTGGGGTTAGAGCTAGAAATAGCA	1	bc
AGGATGCTTC	GAAACACCGGTCCGTAGGAGACCCGTGTGGCATGTACCTGTGGGGTTAGA	1	bc
AGAATACCCG	GAAACACCGGTCGGCGGCAATCGTGGGTGGGGTTAGAGCTAGAAATAGCA	1	bc
CTTTAGCTAT	GAAACACCGGTTACATTGAGGGTTAGAGCTAGAAGTAGCAAGTTAACCTA	1	bc
CAACCAGGCC	GAAAAACCGGTAACGGTGGGTTAGAGCTAGGAATAGCAAGTTAACCTCAG	1	bc
TCTCGGATAA	GAAACACCGGTTAAGCCGAGGAGTTAGAGCTAGAAATAGCAAGTTAACCT	1	bc
GGACCATAAA	GAAACACCGGTAAATTTGAGGCTCCGGCATGCAGGAGGCCGTGGGGTTAG	1	bc
ATAGCGTCGT	GAAACACCGGTTACATTGGGGTTAGAGCTAGAAATAGCAAGTTAACCTAA	1	bc
AGTCTTCCAA	GAAACACCGGTCCGTAGGAGACCCGTGTGGCATGTACCTGTGGGGTTAGA	1	bc
TATTCTGCCT	GAAACACCGGTCCGTAGGAGACCCGTGTGGCTAGAAATAGCAAGTTAACC	1	bc
ATGATCCGTT	GAAACACCGGTTTACGTTCCATCGGTGTGGGGTTAGAGCTAGAAATAGCA	1	bc
CATAACTCGG	GAAACACCGGTACCTTTGTTGATGCTGGGTCGGGGTATAGAGCTAGAAAT	1	bc
ATACGTAGGT	GAAACACCGGTTTACGATGCTTCGGTTGTGGGGTTAGAGCTAGAAATAGC	1	bc
AGTACGCATC	GAAACACCGGTCCGTAGGAGACCCGTGTGGCATGTACCTGTGGGGTTAGA	1	bc
AGGATTATCT	GAAACACCGGTTTACGTTGCATCGGTGAGCTAGAAATAGCAAGTTAACCT	1	bc
ACGTTACCTC	GAAACACCGGTCGGGGCCACTCAGTGGTGGGGTTAGAGCTAGAAATAGCA	1	bc
CAGCGTGGTA	GAAACACCGGTGTACGTATGGACTGAACCAGGGTGTGCAAGTGGGGTTAG	1	bc
TGAATCATAA	GAAACACCGGTCTCGAGGGAGGTTTTCAGGGTGGGGTTAGAGCTTGAAAT	1	bc
GTAGAAGCAC	GAAACACCGGTCGGCGGCAATCGTGCTAGAAATAGCAAGTTAACCTAAGG	1	bc
GCTACTCGGT	GAAACACCGGTACCTTTGTTGATGCTGGGTGGGGTTAGAGCTAGAAATAG	1	bc
AGTCAGGCCC	GAAACACCGGTCCGTACGAGACCCGTGTGGCCTGTACCTCTGTGGGGTTA	1	bc
TACGACTCCC	GAAACACCGGTTTGAAATAGCAAGTTAACCTAAGGCTAGTCCGTTATCAA	1	bc
GATTGAGCAT	GAAACACCGGTTAAGCCGAGGAGTTAGAGCTAGAAATAGCAAGTTAACCT	1	bc
AGAGTTGTGT	GAAACACCGGTGCATTCGAAAGTCCGGTCGTAGTGTGGACGTGGGGTTAG	1	bc
GATAATGCCC	GAAACACCGGTTTGAACTAGAAATAGCAAGTTAACCTAAGGCTAGTCCGT	1	bc
AGGCTGCATA	GAAACACCGGTCCGTAGGAGACCCGTGTGGCATGTACATGAAAAAGTGGC	1	bc
TGAACCTGAA	GAAACACCGGTAAATTTGAGGCTCCGGCATGCAGGAGGCCGTGGGGTTAG	1	bc
AAGATAATTT	GAAACACCGGTCTCGAGTGTAGCAAGTTAACCTAAGGCTAGTCCGTTATC	1	bc
ACATTAGAGC	GAAACACCGGTCGGGGCCACTCAGTGGTGGGGTTAGAGCTAGAAATAGCA	1	bc
GAAAAAGACC	GAAACACCGGTAGCAAGTGGGGTTAGAGCTAGAAATAGCAAGTTAACCTA	1	bc
TTAGCTACTA	GAAACACCGGTTACATTGAGGGGTTAGAGCTAGAAATAGCAAGTTAACCT	1	bc
AATAGCTATG	GAAACACCGGTTACATTGAGGGTTAGAGCTAGAAATAGCAAGTTAACCTA	1	bc
ATCTATCGAT	GAAACACCGGTTATATTTGTAAGTGTTGTGGGGTTAGAGCTAGAAATAGC	1	bc
AATGCTTGGC	GAAACACCGGTTTACGTTGCATCGGTTGTGGGGTTAGAGCTAGAAATAGC	1	bc
AATAACCGGT	GAAACACCGGTACCTTTGTTGATGCTGGGTGTGGGGTTAGAGCTAGAAAT	1	bc
AGGCAGTCCA	GAAACACCGGTAAATTTGAGGCTCCGGCATGCAGGAGGCCGTGGGGTTAG	1	bc
AGTGTAGCCT	GAAACACCGGTTCCCGTCCAGTGGGGTTAGAGCTAGAAATAGCAAGTTAA	1	bc
ACCTTTAGCG	GAAACACCGGTCGGGGCCACTCAGTGGTGGGGTTAGAGCTAGGAATAGCA	1	bc
ATTAGGTATG	GAAACACCGGTTACATATTGAGGGTTAGAGCTAGAAATAGCAAGTTAACC	1	bc
CATAACTGCC	GAAACACCGGTTTGAACTAGAAATAGCAAGTTAACCTAAGGCTAGTCCGT	1	bc
GGAGACCTCC	GAAACACCGGTGTGGCTGAGAGTCCGGCAATGGTGTGGCTGTGGGGTTAG	1	bc
AGTCCGCGTT	GAAACACCGGTCCGTAGGAGACCCGTGTTGCATGTACCTTGTGGGGTTAG	1	bc
GCACAGAGCT	GAAACACCGGTTTGAACTACCGGGGTTAGAGCTAGAAATAGCAAGTTAAC	1	bc
AGAACATAGC	GAAACACCGGTGCATTCGAAAGTCCGGTCGTAGTGTGGACGTGGGGTTAG	1	bc
GACGACGTGC	GAAACACCGGTCGGCGGCAATCGTGGGTGGGGTTAGAGCTAGAAATAGCA	1	bc
ATAGAGCATA	GAAACACCGGTTAAGCCGAGGTTAGAGCTAGAAATAGTAAGTTAACCTAA	1	bc
AACTTTACCG	GAAACACCGGTCGGGGCCACTCAGTGGTGGGGTTAGAGCTAGAAATAGCG	1	bc
ATTCACTCGC	GAAACACCGGTGCATTCGAAAGTCCGGTCGTAGTGTGGACGTGGGGTTAG	1	bc
GGTCTGACCT	GAAACACCGGTCCGTAGGAGACCCGTGTGGCATGTACCTGTGGGGTTAGA	1	bc
AAGAATCCTT	GAAACACCGGTCTCGAGTGAGGTGTTCAGGTGGGGTTAGAGCTAGAAATA	1	bc
CACCCCGCAC	GAAACACCGGTTTGAACTAGAAATAGCAAGTTAACCTAAGGCTAGTCCGT	1	bc
GATGACGAGC	GAAACACCGGTCGGCGGCAATCTTTAGAGCTAGAAATAGCAAGTTAACCT	1	bc
ATGTTACCCT	GAAACACCGGTTTACGTTGCATCGGTTTGTGGGGTTAGAGCTAGAAATAG	1	bc
GCATGGGCGA	GAAACACCGGTGTACGTATGGACTGAACCAGGGTGTGCAAGTGGGGTTAG	1	bc
ATGTGGCCTC	GAAACACCGGTTCCCGTCCAGTGGGGTTAGAGCTAGAAATAGCAAGTTAA	1	bc
TTGTTTCGTC	GAAACACCGGTTTACGTTGCGTCGGTGTGGGGTTAGAGCTAGCAATAGCA	1	bc
AGGGAAACTC	GAAACACCGGTTCCCGTGCAGTGGGGTTAGAGCTAGAAATAGCAAGTTAA	1	bc
GGAGCCGTGC	GAAACACCGGTGTATTCGAAAGTCCGGTCGTAGTGTGGCCGTGGGGTTAG	1	bc
AAAGCCCCCA	GAAACACCGGTGCACTATCTCTCACCTGAGTACTTAATCTGTGGGGATAG	1	bc
TGCCTCCCTG	GAAACACCGGTTCCCGTCCAGTGGGGTTAGAGCTAGAAATAGCAAGTTAA	1	bc
GGACACGCGC	GAAACACCGGTGCATTCGAAAGTCCGGTCGTAGTGTGGACGTGGGGTTAG	1	bc
CAACGGCGAC	GAAACACTAAGGCTAGTCCGTTATCAACTTGAAAAAGTGGCACCGAGTCG	1	bc
GCGCCCTAAA	GAAACACCGGTAAATTTGAGGCTCCGGCATGCAGGAGGCCGTGGGGTTAG	1	bc
AGAAACCATT	GAAACACCGGTCTCGAGTGAGGTGTTCAGGGTGGGGTTAGAGCTAGAAAT	1	bc
ACTACGACCC	GAAACACCGGTTTGAACTACCGGGGTTAGAGCTAGAAATAGCAAGTTAAC	1	bc
ATGGGCACGA	GAAACACCGGTCGGCTCTTGTCAACTTGAAAAAGTGGCACCGAGTCGGTG	1	bc
GAGTCATACA	GAAACACCGGTAAATTTGAGGCTCCGGCATGCAGGAGGCCGTGGGGTTAG	1	bc
TCTATAGGGC	GAAACACCGGTTATATTTGTAAGTGTGTGGGGTTAGAGCTAGAAATAGCA	1	bc
GGCAGACGCC	GAAACACCGGTGTGGCTGAGAGTCCGGCAATGGTGTGGCTGTGGGGTTAG	1	bc
ATAATCGGCA	GACACCGGTACCTTTGTTGATGCTGGGGTGGGGTTAGAGCTAGAAATAGC	1	bc
AGACACTAGA	GAAACACCGGTGCATTCGAAAGTCCGGTCGTAGTGTGGACGTGGGGATAG	1	bc
GGGAGCAGAA	GAAACACCGGTTAAGCTGAGGGGCCTGAGAGCTAGAAATCGCAAGTTAAG	1	bc
ACCTTTTCCG	GAAACACCGGTCGGGGCCACTCAGTGGTGGGGTTAGAGCTAGAAATAGCA	1	bc
GACACCTCAA	GAAACACCGGTAAATTTGAGGCTCCGGCATGCAGGAGGCCGTGGGGTTAG	1	bc
CTGGCGACAC	GAAACACCGGTACACGTTATGGCGTGGTAGAGCTAGAAATAGCAATATAA	1	bc
TCAGCTCCGC	GAAACACCGGTCGGGGCCACTCAGTGGTGGGGTTAGAGCTAGAAATAGCA	1	bc
ATGGGGCGTC	GAAACACCGGTTCCCGTCCAGTGGGGTTAGAGCTAGAAATAGCAAGTTAA	1	bc
AGATTCGCGC	GAAACACCGGTGCATTCGAAAGTCCGGTCGTAGTGTGGACTTGGGGTTAG	1	bc
GGAAAACTCC	GAAACACCGGTGTGGCTGAGAGTCCGGCAATGGTGTGGCTGTGGGGTTAG	1	bc
GATCGTCTCC	CAAAACACCGGTGTGGCTGAGAATCAGGCAATGGTGTGGCTGCGGGGTTA	1	bc
GAGCGTCGCT	GAAACACCGGTCGGCGGGGTTAGAGCTTGGAATAGCAAGTTAACCTAAGG	1	bc
ACTCGACGTC	GAAACACCGGTGTACGTATGGACTGAACCAGGGTGTGCAAGTGGGGTTAG	1	bc
AGGATGTGCT	GAAACACCGGTTTACGTTGCATCGGGGTGGGGTTAGAGCTAGAAATAGCA	1	bc
CCTGTAGTCC	GAAACACCGGTGACATTGGGTACAGGGTGGGGGTAGAGCTAGAAATAGCA	1	bc
TGGCCCAGTC	GAAACACCGGTAAATTTGAGGCTCCGGCATGCAGGAGGCCGTGGGGTTAG	1	bc
ATGGAGAGAC	GAAACACCGGTTTACGTTGCATCGGTGTGGGGTTAGAGCTAGAAATAGCA	1	bc
AAGTTCGGTC	GAAACACCGGTCGATTCATATCGAAACCTTCCCGTGACAGTGGGGTTAGA	1	bc
AATACCCTCG	GAAACACCGGTGCATTCGAAAGTCCGGTCGTAGTGTGGACGTGGGGTTAG	1	bc
GTATGCGTAG	CAAAACACCGGTTTACGTTGCGGTGGGGTTAGAGCTAGAAATAGCAAGTT	1	bc
GAAATCGAGC	GAAACACCGGTCGGAGTCAATCGTGGGTGGGGTTAGAGCTAGAAATAGCA	1	bc
TGACACATAC	GAAACACCGGTAGCAAGTGCGAGACGTTAGAAATAGCAAGTTAACCTAAG	1	bc
CAATTGGGTC	GAAACACCGGTCGATTCATTTCGACACCTTCCCGTGACAGTGGGGGTAGA	1	bc
ACATAGTTGT	GAAACACCGGTGTACGTATGGACTGAACCAGGGTGTGCAAGTGGGGTTAG	1	bc
ATGATAAGCG	GAAACACCGGTTTACGTTGCATCGGTGTGGGGTTAGAGCTAGAAATAGCA	1	bc
TCTCAACGCC	GAAACACCGGTTTGAACTACCGGGGTTAGAGCTAGAAATAGCAAGTTAAC	1	bc
CTTCGATATT	GAAACACCGGTTACATTGAGGGTTAGAGCTAGAAATAGCAAGTTAACCTA	1	bc
AGTGAGCATA	GAAACACCGGCTAAGCCGAGTGGGGTTAGAGCTAGAAATAGCAAGTTAAC	1	bc
CACCGACGCC	GAAACACCGGTGTACGTATGGACTGAACCAGGGAGTGCAAGTGGGGTTAG	1	bc
GGAACCGACA	GAAACACCGGTAGCAAGTGCGAGACGTTAGTTAGAAAGTGGGGTTAGAGC	1	bc
GTTGAACCTG	GAAACACCGGTTCCCGTCCAGCGGGGTTAGGGCTAGAAATAGCAAGATAA	1	bc
TGGTATCTAC	GAAACACCGGTTAAGCCGAGGGTTAGAGCTAGAAATAGCAAGTTAACCTG	1	bc
CATAATGCCA	ATGTGGGGTTAGAGCTAGAAATAGCAAGTTAACCTAAGGCTAGTCCGTTA	1	bc
GAAGACAAGT	GAAACGTGGGGTTAGAGCTAGAAATAGCAAGTTAACCTAAGGCTAGTCCG	1	bc
GTTCCCTGCA	GAAACACCGGTGTGGCTGAGAGTCCGGCAATGGTGTGGCTGTGGGGTTAG	1	bc
AATGCACTAA	GAAACACCGGTGCCCTTACTCTCACCTGATTACTTAATCCGTGGGGTTAG	1	bc
CGCATTGCCT	GAAACACCGGTGAGATTGGAAACTGGGGGGGGGTTAGGGCTGGAAAAGCC	1	bc
AGTTGACCCG	GAAACACCGGCTCGGGGTTAGAGCTAGAAATAGCAAGTTAACCTAAGGCT	1	bc
GCTGTACAGT	GAAACACCGGTCGGGGCCACTCAGTGGTGGGGTTAGAGCTAGAAATAGCA	1	bc
GGCACTCCAC	GAAACACCGGTGTGGCTGAGAGTCCGGCAATGGTGTGGCTGTGGGGTTAG	1	bc
TACATTCGGA	GAAACACCGGTTGATTCATATCGAAACCTTCCCGTGACAGTGGGGTTAGA	1	bc
TGCCCCTTAT	GAAACACCGGTAAATTTGAGGCTCCGGCATGCAGGAGGCCGTGGGGTTAG	1	bc
ATTGGCTATT	GAAACACCGGTTACATTGGGGTTAGAGCTAGAAATAGCAAGTTAACCTAA	1	bc
ACCCCAGATC	GAAACACCGGTTCCCTTCCTCTCACCTGTTTACTTAATCCGTGGGGATAG	1	bc
AGGCGGCCTA	GAAACACCGGTTAAGACGAGGGTTAGGGCTAGAGATAGCAAGTTAACCTA	1	bc
AAGAGCATGA	GAAACACCGGTTAAGCCGAGGAGTTAGAGCTAGAAATAGCAAGTTAACCT	1	bc
GAAGCTTAGC	GAAACACCGGTTTACGTTGCATCGGTGTGGGGTTAGAGCTAGAAATAGCA	1	bc
ACACACCGCG	GAAACACCGGTTTGAACTAGAAATAGCAAGTTAACCTAAGGCTAGTCCGT	1	bc
AGCGAGGTTG	GAGACACCGGTTAAGCCGAGTGGGGTTAGAGCTAGAAATAGCAAGTTAAC	1	bc
TTAGATTTTT	GAAACACCGGTTACATTGAGGGTTAGAGCTAGAAATAGCAAGTTAACCTA	1	bc
GTCCAACCGC	GAAACACCGGTGTGGCTGAGAGTCCGGCGATGGTGTGGCTGTGGGGTTAG	1	bc
ACAAAACGCC	GAAACACCGGTTTGAACTACCTAGAAATAGCAAGTTAACCTAAGGCTAGT	1	bc
ACATACTGAT	GAAACACCGGTCGATTCATATCGAAACCTTCCCGTGACAAGGGGGGTTAG	1	bc
AGACACTGAC	GAAACACCGGTAGCAAGTGCGAGACGTGTTTGTGGGGTTAGAGCTAGAAA	1	bc
GGCAATGTTA	GAAACACCGGTGTGGCTGAGAGTCCGGCAATGGTGTGGCTGTGGGGTTAG	1	bc
TCATACACCG	GAAACACCGGTCGGGGCCACTCCGTGGTGGGGTTAGAGCTAGAAATAGCA	1	bc
AACAAAGTCC	GAAACACCGGTTTGAACTACCGGGGTTAGAGCTAGAAATAGCAAGTTAAC	1	bc
CTACTCGTAA	GAAACACCGGTACCTTTGTTGATGCTGGGTGGAAGGAATGTGGGGTTAGA	1	bc
TCGGATCCTT	GAAACACCGGTCTCGAGTGAGCTAGAAATAGTAAGTTAACCTAAGGCTAG	1	bc
AGCAGAGCTA	GAAACACCGGTCCTGTCGCCACGGGTGTGGGGTTAGGGCTAGAAATAGCA	1	bc
GACACCCGAG	GAAACACCGGTGCATTCGAAAGTCCGGTCGTAGTGTGGACGTGGGGTTAG	1	bc
AGCCTCCGTC	GAAACACCGGTCCGTAGGAGACCCGTGTGGCATGTACCTTGTGGGGTTAG	1	bc
ATACATTCGC	GAAACACCGGTGCATTCGAAAGCCCGGTCGTAGTGTGGACGTGGGGTTAG	1	bc
AAAACCTATA	GAAACACCGGTTTACGTTGCATCGGTTTTTTGGGGTTAGAGCTAGAAATA	1	bc
GCAGTAGCGA	GAAACACCGGTCGTGGGGTTAGAGCTAGAAATAGCAAGTTAACCTAAGGC	1	bc
AGGTGTTGTC	GAAACACCGGTGACAGCGGGGTTAGAGCTAGAAATAGCAAGTTAACCTAA	1	bc
CCTTTCGGGT	GAAACACCGGTCGATTCATATCGAAACCTTCCCGTGACAGTGGGGTTAGA	1	bc
ACATCGTTGT	GAAACACCGGTAGCAAGTGCGAGACGTGTTTGTGGGGTTAGAGCTAGAAA	1	bc
GAATCGTGGT	GAAACACCGGTGTACGTATGGACTGAACCAGGGTGTGCAAGTGGGGTTAG	1	bc
TTTGCTATTG	GAAACACCGGTTACATTGAGGGTTAGAGCTAGAAATAGCAAGTTAACCTA	1	bc
AAACGGAGCG	GAAACACCGGTCGGCGGCAATCGTGGGTGGGGTTAGAGCTAGAAATAGCA	1	bc
GTCTACTCCC	GAAACACCGGTTCACGTCCAGTGCGGTTAGAGCTAGAAATGGCAAGTTAG	1	bc
ACACAATGCA	GAAACACCGGTTTGAACTACCGGGGTTAGAGCTAGAAATAGCAAGTTAAC	1	bc
GCAACTCGGC	GAAACACCGGTACCTTTGTTGATGCTGGGTGGAAGGAATTTTTGTGGGGT	1	bc
ACTAGCTATG	GAAACACCGGTTACATTGGGGTTAGAGCTAGAAATAGCAAGTTAACCTAA	1	bc
CAGAACGACA	GAAACACCGGTTTGAACTAGAAATAGCAAGTTAACCTAAGGCTAGTCCGT	1	bc
GACATCGTCG	GAAACACCGGTGTACGTATGGACTGAACCAGGGTGTGCAAGTGGGGTTAG	1	bc
AGAAGTTCGC	GAAACACCGGTGCATTCGAAAGTCCGGTCGTAGTGTGGACGTGGGGTTAG	1	bc
AGACAACACA	GAAACACCGGTTTGAACTACCGGGGTTAGAGCTAGAAATAGCAAGTTAAC	1	bc
CATCTATCTC	GAAACACCGGTCCGTAGGAAACCCGTGTGGCATGTACCTGTGGGGATAGA	1	bc
AGAGCGTCGT	GAAACACCGGTGTACGTATGGACTGAACCAGGGTGTGCAAGTGGGGTTAG	1	bc
GCGCTCCTAC	GAAACACCGGTAAATTTGAGGCTCCGGCATGCAGGAGGCCGTGGGGTTAG	1	bc
AGCCACTTTT	GAAACACCGGTCTCGAGTGAGGTGTTCAGGGCGGGGTTAGAGCTAGAAAT	1	bc
ACTACTCGTC	GAAACACCGGTACCTTTGTTGATGCTGGGTGGAAGGAATTTTTGTGGGGT	1	bc
CAAAACTTTC	GAAACACCGGTCGGCGGCAATGGTTAATCGGTTAATCGTGGGGTTAGAGC	1	bc
ATGAAATTCT	GAAACACCGGTAACTATATTCATGCGATATCGCCGTATCAGTGGGGTTAG	1	bc
AATGCTTGGC	GAAACACCGGTTTACGTTGCAGCAAGTTAACCTAAGGCTAGTCCGTTATC	1	bc
ATGACAGGTA	GAAACACCGGTTCACGTTGCATCGGTGTGGGGTTAGAGCTAGAAATAGCA	1	bc
ACGCATCCTT	GAAACACCGGTCTCGAGTGAGGTGTTCAGGGTGGGGTTAGAGCTAGAAAT	1	bc
AAGAGCTCAT	GAAACACCGGTTGATGCGATGGGCTAGAGCTACAAATAGCAAGTTAACAT	1	bc
ACCGGCATAC	GAAACACCGGTGCCCTTACTCCCACCTGATTACTTAATCCGTGGGGATAG	1	bc
TTCTATCGCC	GAAACACCGGTCGGGGCCACTCAGTGGTGGGGTTAGAGCTAGAAATAGCA	1	bc
TCTACTCGGT	GAAACACCGGTACCTTTGTTGATGCTGGGTGGGGTTAGAGCTAGAAATAG	1	bc
ATATCGTCGT	GAAACACCGGTGTACGTATGGACTGAACCAGGGTGTGCAAGTGGGGTTAG	1	bc
TAACGCACTA	GAAACACCGGTGCCCTTACTCTCACCTGATTACTTAATCCGTGGGGTTAG	1	bc
AAATAATGAC	GAAACACCGTGGGGTTAGAGCTAGAAATAGCAAGTTAACCTAAGGCTAGT	1	bc
AGAGTTGGCT	GAAACACCGGTGACATTGGGTACAGGGTGGGGTTAGAGCTAGAAATAGCA	1	bc
GGAACCTGTC	GAAACACCGGTCGATCCATATCGCAGCCATTGCGGGGCCTGGGGGGTTAG	1	bc
GGGGAGGCTG	GAAACGCCGGTTCCCGTCCAGTGGGGTTAGAGCTAGAAATAGCAAGTTAA	1	bc
AGACGACCCG	GAGACACGGTTAGAGCTAGAAATAGCAAGTTAACCTAAGGCTAGTCCGTT	1	bc
GATAGTAGTC	GAAACACCGGTTTACGTATGGGCTGAACCAGGGTGTGCAAGTGGGGTTAG	1	bc
AGTAGCTCGC	GACGAAACACCGGTGCATTCGAAAGTCCGGTCGTAGTGTGGACGTGGGGT	1	bc
TTCATTATCT	GAAACACCGGTTACATTGAGGGTTAGAGCTAGAAATAGCAAGTTAACCTA	1	bc
ATGTTTGGCC	GAAACACCGGTTTACGATGCATCGGTGTGGGGTTAGAGCTAGAAATAGCA	1	bc
GAAGCTGTGT	GAAACACCGGTTACATTGAGGGGTTAGAGCTAGAAATAGCAAGTTAACCT	1	bc
GTTAGCTAGG	GAAACACCGGTTACATTGAGGGTTAGAGCTAGAAATAGCAAGTTAACCTA	1	bc
GATTTCGAGG	GAAACACCGGTTATATTTGCAAGAGTGTGGGGTTAGAGCTAGAAATAGCA	1	bc
GTGGGGGGTC	GAAACACCGGTTCCCGTCCAGTGGGGTTAGAGCTAGAAATAGCAAGTTAA	1	bc
AGTGGAGACG	GAAACACCGGTTCCCGTCCAGTGGGGTTAGAGCTAGAAATAGCAAGTTAA	1	bc
AACTTTACAG	GAAACACCGGTCGGGGCCACTCAGTGGTGGGGTTAGAGCTAGAAATAGCA	1	bc
TGTGGAGGAG	GAAACACCGGTTCCCGTCCAGTGGGGTTAGAGCTAGAAATAGCAAGTTAA	1	bc
ATGGATCGTC	GAAACACCGGTTTCCGTCCAGTGGGGTTAGAGCTAGAAATAGCAAGATAA	1	bc
AGGATACTTT	GAAACACCGGTCTCGAGTGAGGTGTTCAGGGTGGGGTTAGAGCTAGAAAT	1	bc
ATGCACAGTT	GAAACACCGGTTTACGTTGCATCGGTGTGGGGCTAGAGCTAGAAATAGCA	1	bc
AAACTTGGGC	GAAACACCGGTACCTTTGTTGATGCTGGGTGGAAGGAATGTGGGGTTAGA	1	bc
AACATCATTT	GAAACACCGGTCTCGAGTGAGGTGTTCAGGGTGGGGTTAGAGCTAGAAGT	1	bc
GGAAGCACCG	GAAACACCGGTCGGCGGCAATCGTGGGTGGGGTTAGAGCTAGAAATAGCA	1	bc
CCGAACGACC	GAGCTAGAAATAGCAAGTTAACCTAAGGCTAATCCGTTATCAACTTGAAA	1	bc
AAACACTCTC	GAAACACCGGTGCATTCGAAAGTCCGGTCGTAGTGTGGACAGGGAGATAG	1	bc
AATGTACCAC	GAAACACCGGTGCCCTTACTCTCACCTGATTACTTAATCCGTGGGGTTAG	1	bc
CGTTACTCAT	GAAACACCGGTGACATTGGGTGTCCACTGTAGGACTTGGAATATGACAAG	1	bc
TACCACGACG	GAAACACCGGTTTGAACTACCTAGTTCAAACCGGTGGGGTTAGAGCTAGA	1	bc
GCCTTGACCG	GAAACACCGGTCGGGGCCACTCAGTGGTGGGGTTAGAGCTATAAATAGCA	1	bc
AAACATATAT	GAAACACCGGTAACTCTTTTCATGCGATATCGCCGTATCAGTGGGGTAAG	1	bc
GCGGTGCCGC	GAAACACCGGTCGCGGCCAATCAGTGGTAGGGTTAGAGCTAGAAAGAGCA	1	bc
TAGCTGGTCT	GAAACACCGGTTTACGGTGCAGCAGTGAGTGGTTAGGGCTGTAGAGCTCG	1	bc
CAGCATCGGC	GAAACACCGGTTTACGTTGCATCGGTGTGGGGTTAGAGCTAGAAATAGCG	1	bc
GAGGCGCTAC	GAAACACCGGTGCCCTTACTCTCACCTGATTACTTAATCCGTGGGGTTAG	1	bc
ACGACTCATT	GAAACACCGGTCTCGAGTGAGGTGTTCAGGGTGGGGTTAGAGCTAGAAAT	1	bc
AAAGCACGAC	GAAACACCGGTGCCCTTACTCTCACCTGATTACTTAATCCGTGGGGTTGG	1	bc
GAACGGCCTA	GAAACACCGGTGCCCTTACTCTCACCAAATAGCAAGTTAACCTAAGGCTA	1	bc
GGGCACCGTC	GAAACACCGGTGTGGCTGAGAGTCCGGCAATGGAGTGGCTGAGGGGGTAG	1	bc
ATGCTGACTC	GAAACACCGGTCCGTAGGAGACCCGTGTGGCATGTACCTGTGGGGTTAGA	1	bc
GCATACACTC	GAAACACCGGTAGGGGTTACAGCTAGAAATAGCAGGTTAGCGTTAGACTA	1	bc
GAAGGCACGT	GAAACACCGGTCGGCGGCAATCGTGGGTGGGGTTAGAGCTAGAAATAGCA	1	bc
TCAAAGATCC	GAAACACCGGTTTGAACTAGAAATAGCAAGTTAACCTAAGGCTAGTCCGT	1	bc
GACACACTAC	GAAACACCGGTGTGGCTGAGAGTCCGGCAATGGTGTGGCTGGGGGGTTAG	1	bc
AAGACTGTAC	GAAACACCGGTTGGTTACATTGTCGTTTAGATTTATGACGGGGGGGTTAA	1	bc
AGTCGTAGTA	GAAACACCGGTCCGTAGGAGACCCGTGTGGCATGTACCTGTGGGGTTAGA	1	bc
TACATAGACG	GAAACACCGGTCGGGGCCACTCAGTGGTGGGTTAGAGCTAGAAATAGAAA	1	bc
ACATGTACCG	GAAACACCGGTCGGGGCCACTCAGTGGTGGGGTTAGAGCTAGAAATAGCA	1	bc
GCGACAGAGA	GAAACACCGGTAGCAAGTGCGAGACGTGTTAGAGCTAGAAATAGCACCGG	1	bc
CCTCCGCTAC	GAAACACCGGTGTACGTATGGACAGCACCAGGGTGGGCAAGGGGGGAGAG	1	bc
CACTCCCCAG	GAAACACCGGTCGGGGCCACTCAGTGGTGGGGTTAGAGCTAGAAATAGCA	1	bc
TACCACGCTC	GAAACACGGGTTAGAGCTAGAAATAGCAAGTTAACCTAAGGCTAGTCCGT	1	bc
GCGATGTATC	GAAACACCGGTTCCCGTCCAGTGGGGTTAGAGCTAGAAATAGCAAGTTAA	1	bc
ACTTCTAACG	GAAACACCGGTCGGCGGCACTCAGTGACAGGGGTAGAGATAGCTATAACA	1	bc
ATTAGCTAAG	GAAACACCGGTTGGGGTTAGAGCTAGAAATAGCAAGTTAACCTAAGGCTA	1	bc
GGATCTCTCC	GAAACACCGGTGTGGCTGAGAGTCCGGCAATGGTGTGGCTGTGGGGTTAG	1	bc
GCATGGTCGT	GAAACACCGGTGTACGTATGGACTGAACCAGGGTGTGCAAAGTGGGGTTA	1	bc
AGACACGTGC	GAAACACCGGTGCATTCGAAAGTCCGGTCGTAGTGTGGACGTGGGGTTAG	1	bc
TCGACAGGCA	GAAACACCGGTAAATTTGAGGCTCCGGCATGCAGGAGGCCGTGGGGTTAG	1	bc
TATCCTAGTT	GAAACACCGGTAACTATATTCATGCGATATCGCCGTATCAGTGGGGTTAG	1	bc
GCGTGATGTC	GAAACACCGGTGACATTGGGGTTAGAGCTAGAAATAGCAAGTTAACCTAA	1	bc
CCTTATCCGT	GAAACACCGGTCGGGGCCACGCAATGGCATGTGGAGATCTAGATAGAGCA	1	bc
ATCGGCCCGA	GAAACACCGGTCAGCTCTTATCAACTTGAAAAAGTGGCACCGAGTCGGTG	1	bc
CCCCACGCTC	GAAACACGGGTTAGAGCTAGAAATAGCAAGTTAACCTAAGGCTAGTCCGT	1	bc
AGCACTGTAC	GAAACACCGGTTCATGAAAAACATACTTAGACGACGGTCCGTGGGGTTAG	1	bc
CCTCTTCCTC	GAAACACCGGTCCGTAGGAGACCCGTGTGGTGTGGGGTTAGAGCTAGAAA	1	bc
AATCTTAAAC	GAAACACCGGTAACTATATTCATGCGATATCGCCGTATCAGTGGGGTTAG	1	bc
ACTCTACGTC	GAAACACCGGTGTACGTATGGACTGAACCAGGGTGTGCAAGTGGGGTTAG	1	bc
TACGACCAGC	GAAACACCGGTCGGCGGCAATCGGGCGGGTCTTCGAATTCGGGCCCATTG	1	bc
TCTACTCGTC	GAAACACCGGTGTGGCTGAGAGTCCGGCAATGGTGTGGCTGTGGGGTTAG	1	bc
CTCACTAGGC	GAAACACCGGTTACATTGGGGTTAGAGCTAGAAATAGCAAGTTAACCTAA	1	bc
GAATAAGCGA	GAAACACCGGTCGCCGGAGCGCAACGTGTTCTTAGGCTGGTAGGGCTTGA	1	bc
CAATGCATAG	GAAACACCGGTTTACGTTGCATCGGTGTGGGGTTAGAGCTAGAAATAGCA	1	bc
AAGTCTGCCA	GAAACACCGGTCCGTAGGAGACCCGTGTGGCATTGTGGGGTTAGAGCTAG	1	bc
AAAGACTTAA	GAAACACCGGTGCCCTTACTCTCACCTGATTACTTAATCCGTGGGGTTAG	1	bc
CCGTTAAAGC	GAAACACCGGTCGGGGCCACTCAGTGGTGGGGTTAGAGCTAGAAATAGCA	1	bc
ACGAATCGTT	GAAACACCGGTCTCGAGTGAGGTGTTCAGGTGGGGTTAGAGCTAGGAATA	1	bc
GCGACTCCTT	GAAACACCGGTCTCGAGTGAGGTGTTCAGGGTGGGGTTAGAGCTAGAAAT	1	bc
GCATATCGGC	GAAACACCGGTTTGAACTACCGGGGTTAGAGCTAGAAAAAGCAAGTTAAC	1	bc
CTACCCTTGC	GAAACACCGGTGCATTCGAAAGTCCGGTCGTAGTGTGGACGTGGGGTTAG	1	bc
ATGTTTCGAT	GAAACACCGGTTTACGTTGCATGGGGTTAGAGCTAGAAATAGCAAGTTAA	1	bc
AGAAGCTCTC	GAAACACCGGTGCATTCGAAAGTCCGGTCGTAGTGGGGACGTGGGGTTAG	1	bc
GTGGCTCCAA	GAAACACCGGTTCCCGTCCAGTGGGGTTAGAGCTAGAAATAGCAAGTTAA	1	bc
ATGGAGAATA	GAAACACCGGTTCCCGTCCAGTGGGGTTAGAGCTAGAAATAGCAGGCTAA	1	bc
CATCTATCGA	GAAACACCGGTTAACCTAAGGCTAGCCCGTTATCAACTTGAAAAAGTGGC	1	bc
TTTGCGCATA	GAAACACCGGTTAAGCCGAGGGTTAGAGCTAGAAATAGCAAGTTAACCTA	1	bc
GACTTTACCG	GAAACACCGGTCGGGGCCACTCAGTGGTGGGGTTAGAGCTAGAAATAGCA	1	bc
GGAACGCTAC	GAAACACCGGTAACTATATTCATGCGATATCGCCGTATCAGTGGGGTTAG	1	bc
GACGTTCGGT	GAAACACCGGTCGATTCATATCGAAACCTTCCCGTGACAGTGGGGTTAGA	1	bc
GGGGAGTCGC	GAAACACCGGTTCCCGTCCAGTGGGGTTAGAGCTGGAGATAGCAAGTTAA	1	bc
ATGCATCGAT	GAAACACCGGTTTACGTTGCATCGGTGTGGGGTTAGAGCTAGAAATAGCA	1	bc
AAGACTATCG	GAAACACCGGTGCATTCGAAAGTCCGGTCGTAGTGTGGACGTGGGGTTAG	1	bc
GAGAAGCTGC	GAAACACCGGTCGGCGGCAATCGTGGGTGGGGGTAGAGCTAGAAATAGCA	1	bc
ATACATTATA	GAAACACCGGTAACTATATTCATGCGATACCGCCGTATCTAGAAATAGCA	1	bc
TCAGGTAAGT	GAAACACCGGTTACATTGAGGGTTAGAGCTAGAAATAGCAAGTTAACCTA	1	bc
CGTCGTGGCT	GAAACACCGGTGTACGTATGGACTGAACCAGGGTGTGCAAGTGGGGTTAG	1	bc
TAACGCTATA	GAAACACCGGTGCCCTTACTCTCACCTGATTACTTAATCCGTGGGGTTAG	1	bc
GTAACAATCC	GAAACACCGGTGTGGCTGAGAGTCCGGCAATGGTGTGGCTGTGGGGTTAG	1	bc
AGCACTATAC	GAAACACCGGTGTGGCTGAGAGTCCGGAAATGGTGTGGCTGTGGGGGTAG	1	bc
GCGCTGACTT	GAAACACCGGTTCCCGTCCAGTGGGGTTAGAGCTAGAAATAGCAAGTTAA	1	bc
CTCGTAAGGC	GAAACACCGGTCGGGGCAACTCAGTGGTGGGGTAGGGGCTAGAATTAGCA	1	bc
CATTTCGGGT	GAAACACCGGTCGATTCATATCGAAACCTTCCCGTGACAGTGGGGTTAGA	1	bc
AACGTCACAC	GAAACACCGGTGCCCTTACTCTCACCTGATTACTTAATCCGTGGGGTTAG	1	bc
ATGCTGCGAT	GAAACACCGGTTTACGTTGCATCGGTTGTGGGGTTAGAGCTAGAAATAGC	1	bc
GTGCGCGACC	GAAACACCGGTACCTTTGTTGATGCTGGGCGTGGTTAGAGCTAGAGATAG	1	bc
GTAGAGCATA	GAAACACCGGTTAAGCCGAGTTTAGAGCTAGAAATAGCAAGTTAACCTAA	1	bc
CCCAAAACCA	GAAACACCGGTAGAATGTGCGAGACGTGTTTGTGGGGGTAGAGCTAGAAA	1	bc
ACTATATCCC	GAAACACCGGTCGGGGCCACTCAGTGGTGGGGTTAGAGCTAGAAATAGCA	1	bc
TACACGGGAC	GAAACACCGGTTTGAACTACCGGGGTTAGAGCTAGAAATAGCAAGTTAAC	1	bc
ACCTAGTAGA	GAAACACCGGTGTACGTATGGACTGAACCAGGGTGTGCAAGTGGGGTTAG	1	bc
GACTTTGCGG	GAAACACCGGTCGGGGCCACTCAGTGATGGGGTTAGAGCTAGAAATAGCA	1	bc
AGTGTAGACT	GAAACACCGGTTCCCGTCCAGTGGGGTTAGAGCTAGAAATAGCAAGTTAA	1	bc
AGACGGACTA	GAAACACCGGTCCGTAGGAGACCCGTGTGGCATGTACCTGTGGGGTTAGA	1	bc
CAGAACGCAA	GAAACACCGGCTTGAACTAGAAATAGCAAGTTAACCTAAGGCTAGTCCGT	1	bc
TGAACCATCC	GAAACACCGGTGTGGCTGAGAGTCCGGCAATGGTGTGGCTGTGGGGTTAG	1	bc
AACGGCATAA	GAAACACCGGTGCCCTTACTCTCACCTGATTACTTAATCCGTGGGGTTAG	1	bc
TCACGACATA	GAAACACCGGTGCCCTTACTCTCACCTGATTACTTAATCCGTGGGGTTAG	1	bc
ACCTGTACCG	GAAACACCGGTCGGGGCCACTCAGTGGTGGGGTTAGAGCTAGAAATAGCA	1	bc
AATAATCCTT	GAAACACCGGTCTCGAGTGAGGTGTTCAGGGTGGGGTTAGAGCTAGAAAT	1	bc
AGACTAAGTC	GAAACACCGGTCGATTCATATCGAAACCTTCCCGTTACAGTTGGGGTAGA	1	bc
ACGACTCCTT	GAAACACCGGTCTCGAGTGAAGTGTTCAGGGTGGGGTTAGAGCTAGAAAT	1	bc
AGATATTCGC	GAAACACCGGTGCATTCGAAAGTCCGGTCGTAGTATGGACGTGGGGTTAG	1	bc
ATGGTTGTAT	GAAACACCGGTGACATTGGGTACAAGTGGGGTTAGAGCTAGAAATAGCAA	1	bc
ACGAGTCCTT	GAAACACCGGTCTCGAGTGAGGTGTTCAGGGTGGGGTTAGAGCTAGAAAT	1	bc
TCCTCTGAGG	GAAACACCGGTTATCTCTGTACGTGGGGGTAGATATAGCTAGAGCTAGCT	1	bc
CTAGTTGGCT	GAAACACCGGTACCTTTGTTGATGCTGGGTGGGGTTAGAGCTAGAAATAG	1	bc
GCGGAGCTTT	GAAACACCGGTTCCCGTCCAGTGGGGTTAGAGCTAGAAATAGCAAGTTAA	1	bc
AGTGGGGCCT	GAAACACCGGTTCCCGTCCAGTGGGGTTAGAGCTAGAAATAGCAAGTTAA	1	bc
AATCTTATCT	GAAACACCGGTTTACGTTGCATCGGGTTAGAGGTTGCATCGGGTTAGTGG	1	bc
GTGGTTCACC	GAAACACCGGTTTACGTGGGGTTAGAGCTAGAAATAGCAAGTTAACCTAA	1	bc
ACGGGTTGTC	GAAACACCGGTGACATTGGGTACAGGGTGGGGTTAGAGCTAGAAATAGCA	1	bc
GGTGACGTAT	GAAACACCGGTTACATTGAGGGGTTAGAGCTAGAAATAGCAAGTTAACCT	1	bc
GATGACAGGC	GAAACACCGGTCGGCGGCAATCGGGGGTGGGGTTAGAGCTAGAAATAGCA	1	bc
GAGACCACCA	GAAACACCGGTTTAAGTTGCATCAGTGGGGGGTTGAAGTAAGAAATAGAA	1	bc
AATTGAGCAT	GAAACACCGGTTAAGCCGAGTGGGGTTAGAGCTAGAAATAGCAAGTTAAC	1	bc
ATAACGCTCA	GAAACACCGGTCCGTAGGAGACCCGTGTGGCATGTACCTGTGGGGTTAAA	1	bc
CCAATCAATT	GAAACACCGGTCTCGAGTGAGGGGTTCAGGGTGGGGTTAGAGCTAGAAAT	1	bc
ATCCTTTACC	GAAACACCGGTCGGGGCCACGGGTTAGAGCTAGAAATAGCAAGTTAACCT	1	bc
TGAGGAGCCC	GAAACACCGGTTCCCGTCCAGTGGGGTTAGAGCTAGAAATAGCAAGTTAA	1	bc
GGCGACAGCT	GAAACACCGGTCCCAGTAGAACCAAAGGCTGTGGGGTTAGAGCTAGAAAT	1	bc
CACAGCCCTC	GAAACACCGGTTTGAACTAGAAATAGCAAGTTAACCTAAGGCTAGTCCGT	1	bc
AACTGACTAT	GAAACACCGGTGCCCTTACTCTCACCTGATTACTTAATCCGGGGGGTTAG	1	bc
TAGGGAAGCA	GAAACACCGGTTAAGCCGGGGGTTAAAGCTAGAAATAGAAAGTTAACCTA	1	bc
ATGAGACCTA	GAAACACCGGTTAAGCCGAGGGTTAGAGCTAGAAATAGCAAGTTAACCTA	1	bc
ATGGCAATGT	GAAACACCGGTTACATTGAGGGGTTAGAGCTAGAAATAGCAAGTTAACCT	1	bc
CGACCCATTT	GAAACACCGGTCTCGAGTGAGGTGTTCAGGGTGGGGTTAGAGCTAGAAAT	1	bc
TAGGATATGT	GAAACACCGGTTACATTGAGGGTTAGAGCTAGAAATAGCAAGTTAACCTA	1	bc
GGAGATATTT	GAAACACCGGTTACATTGAGGGTTAGAGCTAGAAATAGCAAGTTAACCTA	1	bc
AGAGTGCTTT	GAAACACCGGTCTCGAGTGAGGAGTTCAGGGTGGGGTTAGAGCTAGAAAT	1	bc
GTCGAATCAT	GAAACACCGGTCTCGAGTGAGGTGTTCAGGGTGGGGTTAGAGCTAGAAAT	1	bc
ACATCGGCGT	GAAACACCGGTGTACGTATGGACTGAACCAGGGTGTTAGGTGGGGTTAGA	1	bc
CGAGCCCCGC	GAAACACCGGTCGGCGGGTTAGAAAACAGCAAGTTAACCTAAGGCTAGTC	1	bc
TGAGCCTTAC	GAAACACCGGTGCATTCGAAAGTCCGGTCGTAGTGTGGACGTGGGGTTAG	1	bc
ACATAGTCGT	GAAACACCGGTGTACGTATGGACTGAACCAGGGTGTGCAAGCGGGGTTAG	1	bc
CTGTACCCTC	GAAACACCGGTATATAAAAATACGAGTACAGTGGGGTTAGAGCTAGAAAT	1	bc
GAAATGCACA	GAAACACCGGTAGCAAGTGCGGTAGCAAAAAGTGGGGTTAGAGCTAGAAA	1	bc
GACATTCTGT	GAAACACCGGTCGATTCATATCGAAACCTTCCCGTGACAAGTGGGGTTAG	1	bc
CAGATCGTCT	GAAACACCGGTTTGAACTAGAAATAGCAAGTTAACCTAAGGCTAGTCCGT	1	bc
ACCAACGGCC	GAAACACCGGTTTGAACTAGAAATAGCAAGTTAACCTAAGGCTAGTCCGT	1	bc
AGAAGAACCG	GAAACACCGGTCGGCGGCAATCGCCCGTGGGGTTAGAGCTAGAAATAGCA	1	bc
GAGAGACTCG	GAAACACCGGTGCATTCGAAAGTCCGGTCGTAGTGTGGACGTGGGGTTAG	1	bc
CCGCAGCCTC	GAAACACCGGTTCCCGTCCAGTGGGGTTAGAGCTAGAACTAGCAATATAA	1	bc
AGTGGATACA	GAAACACCGGTTCCCGTCCAGTGGGGTTAGAGCTAGAAATAGCAAGTTAA	1	bc
AAAGGATCAG	GAAACACCGGTCGGCGGCAATCGTGGGTGGGGTTAGAGCTAGAAATAGCA	1	bc
GTGAGTAGCT	GAAACACCGGTTTACGTTGCATCGGTGTGGGGTTAGAGCTAGAAATAGCA	1	bc
ACTACTAGGC	GAAACACCGGTACCTTTGTTGATGCTGGGTGGGGTTAGAGCTAGAAATAG	1	bc
GACTATGACA	GAAACACCGGTAGCAAGTGCGAGACGTGTTAGAGCTAGAAATAGCACCGG	1	bc
GGGGACTCTC	GAAACACCGGTGTGGCTGAGAGTCCGGCAATGGTGTGGCTGTGGGGTTAG	1	bc
AACGGGACTA	GAAACACCGGTGCCCTTACTCTCACCTGATTACTTAATCCGTGGGGTTAG	1	bc
AATCACGCCC	GAAACACCGGTTTGAACTACCGGGGTTAGAGCTAGAAATAGCAAGTTAAC	1	bc
ACACAATGCC	GAAACACCGGTTTGAACTACCGGGGTTAGAGCTAGAAATAGCAAGTTAAC	1	bc
ACGGGTTGGC	GAAACACCGGTGACATTGGGGTGGGGTTAGAGCTAGAAATAGCAAGTTAA	1	bc
CACGACCTCC	GAAACACCGGTGCCCTTACTCTCACCTGATTACTTAATCCGTGGGGTTAG	1	bc
GTAGTGGCCC	GAAACACCGGTTCCCGTCCAGTGGGGTTAGAGCTAGAAATAGCTAGTTAA	1	bc
ATTATCCATG	GAAACACCGGTTACATTGAGGGTTAGAGCTAGAAATAGCAAGTTAACCTA	1	bc
ACACAACGCA	GAGCTAGAAATAGCAAGTTAACCTAAGGCTAGTCCGTTATCAACTTGAAA	1	bc
TATATCGCTG	GAAACACCGGTTATATTTGTAAGTGTGTGGGGTTAGAGCTAGAAATAGCA	1	bc
ACTACTAGGA	GAAACACCGGTACCTTTGTTGATGCTGGGTGGGGTTAGAGCTAGAAATAG	1	bc
AAATGCAGTA	GAAACACCGGTGCCCTTACTCTCACCTGATTACTTAATCCGTGGGGTTAG	1	bc
ACGTGTCGTC	GAAACACCGGTGACATTGGGTACAGGGTGGGGTTAGAGCTAGAAACAGCA	1	bc
GGCACTAAGC	GAAACACCGGTGTGGCTGAGAGTCCGGCAATGGTGTGGCTGTGGGGTTAG	1	bc
AATGAGAATA	GAAACACCGGTTAAGCCGAGGCTAGAAATAGCAAGTTAACCTAAGGCTAG	1	bc
CATTTACTGT	GAAACACCGGTCGGGGCCACTCAGTGGTGGGGTTAGAGCTAGAAATAGCA	1	bc
CGTAGTGGTC	GAAACACCGGTGTACGTATGGACTGAACCAGGGTGTGCAAGTGGGGTTAG	1	bc
AAACGCTCGA	GAAACACCGGTGCCCTTACTCTCACCTGATTACTTAATCCGTGGGGATAG	1	bc
GGGGCGCATC	GAAACACCGGTTCCCGTCCAGTGGGGTTAGAGCTAGAAATAGCAAGTTAA	1	bc
AAACACACGC	GAAACACCGGTCGGCGTGGGGTTAGAGCTAGAAATAGCAAGTTAACATAA	1	bc
AGAAGACTCG	GAAACACCGGTCGGCGGCAATCGTGGGTGGGGTTAGAGCTAGAAATAGCA	1	bc
GTGGGTCGTC	GAAACACCGGTTCCCGTCCAGTGGGGTTAGAGCTAGAAATAGCAAGTTAA	1	bc
ACTCGTAGTC	GAAACACCGGTGTACGTATGGACTGAACCAGGGTGTGCAAGTGGGGTTAG	1	bc
AAACGCTCAA	GAAACACCGGTGCCCTTACTCTCACCTGATTACTTAATCCGTGGGGTTAG	1	bc
ACATAGTCGT	GAAACACCGGTGTTCGTATGGACTGAACCAGGGTGTGCAAGTGGGGTTAG	1	bc
ATTGAGCATC	GAAACACCGGTTAAGCCGAGTGGGGTTAGAGCTAGAAATAGCAAGTTAAC	1	bc
CGAGTTGTGC	GAAACACCGGTGACATTAGAGCTAGGAACAGAAAGTTAACCTAAGGCTAG	1	bc
GAAGACCAAT	GAAACACCGGTCGGCGGTGGGGGTAGAGCTAGAAATAGGAAGTTAAACTA	1	bc
GGCGACATCC	GAAACACCGGTGTGGCTGAGAGTCCGGCAATGGTGTGGCTGTGGGGTTAG	1	bc
AAACTGCGCT	GAAACACCGGTTTACGTTGCATCGGTGTGGGGTTAGAGCTAGAAATAGCA	1	bc
AAACTAGGGC	GAAACACCGGTACCTTTGTTGATGCTGGGTGGAAGGTGCTTTTTTTCCTG	1	bc
AAAGAGCCAC	GAAACACCGGTGCCCTTACTCTCACCTGATTACTTAATCCGTGGGGTTAG	1	bc
AGAAGAACTG	GAAACACCGGTCGGCGGATAGCAAGTTAACCTAAGGCTAGTCCGTTATCA	1	bc
GTGACACTCC	GAAACACCGGTGTGGCTGAGAGTCCGGCAATGGTGTGGCTGTGGGGTTAG	1	bc
TCACTACGTC	GAAACACCGGTTTGAACTACCGGGGTTAGAGCTAGAAATAGCAAGTTAAC	1	bc
GTGGCGCATG	GAAACACCGGTTCCCGTCCAGTGGGGTTAGAGCTATAAATAGCACTTTCC	1	bc
GAAGAGCATA	GAAACACCGGTTCCCGTCCAGTGGGGTTAGAGCTAGAAATAGCAAGTTAA	1	bc
AGGCCCCGAC	GAAACACCGGTAAATTTGAGGCTCCGGCATGCAGGAGGCCGTGGGGTTAG	1	bc
AGACGTAGTG	GAAACACCGGTTTACGTTGCATCGGTGTGGGGTTAGAGCCAGAAATAGCA	1	bc
TCACAACGAT	GAAACACCGGTTTGAACTACCGGGGTTAGAGCTAGAAATAGCAAGTTAAC	1	bc
GCGTGGTGTC	GAAACACCGGTGACATTGGGTACAGGGTGGGGTTAGAGCTAGAAATAGCA	1	bc
GTAGACCCTT	GAAACACCGGTCGGCGGCAATCGTGGGTGGGGTTAGAGCTAGAAATAGCA	1	bc
CTGGACGGCC	GAAACACCGGTTACTATCTTCATGCGATATCGCCGTATCAGTGGGGTTAG	1	bc
ACACACCCTC	GAAACACCGGTGTGGCTGAGAGTCCGGCAATGGTGTGGCTGTGGGGTTAG	1	bc
AACTTTATCG	GAAACACCGGTCGGGGCCACTCAGTGATGGGGTTAGAGCTAGAAATAGCA	1	bc
ACGCGGTGTC	GAAACACCGGTGACATTGGGTACAGGGTGGGGTTAGAGCTAGAAATAGCA	1	bc
TCACAATGCC	GAAGCACCGGTTTGAACTACCGGGGTTAGAGCTAGAAATAGCAAGTTAAC	1	bc
TCAGCTTCCT	GAAACACCGGTCCGTAGGAGACCCGTGTGGCATGTGGGGTTAGAGCTAGA	1	bc
AGTGGAGACT	GAAACACCGGTTCCCGGCCAGTGTGGTTAGAGCTAGAAATAGCAAGTTAA	1	bc
AAGCTTCGCC	GAAACACCGGTTTACGTTGCATCGGTGTGGGGTTAGAGCTAGAAATAGCA	1	bc
GATGATTAGC	GAAACACCGGTTTACGTTGCATCGGTTGTGGGGTTAGAGCTAGAAATAGC	1	bc
ACAAAGAGAT	GAAACACCGGTAGCAAGTGCGAGACGTGTTTGTGGGGCTAGAGCTAGAAA	1	bc
GATGACTGGC	GAAACACCGGTCGGCGGCAATCGTGGGTGGGGTTAGAGCTAGAAATAGCA	1	bc
CCGTTACGGA	GAAACACCGGTCGGGGCCACTCAGTGGTGGGGTTAGAGCTAGAAATAGCA	1	bc
GAACGACCTA	GAAACACCGGTGCCCTTACTCTCACCTGATTACTTAATCCGTGGGGTTAG	1	bc
ATAACAGGTA	GAAACACCGGTCGTTTCATATCGAAACCTTCCCGAGACCGAGGAGTTAGA	1	bc
TTACACTGCC	GAAACACCGGTCGGCGGCAATCGTGGGTGGGGTTAGAGCTAGAAATAGCA	1	bc
TTACGCAGAT	GAAACACCGGTTAAGCCGAGGTGGGGTTAGAGCTAGAAATAGCAAGTTAA	1	bc
ACGGAAGTTT	GAAACACCGGTGCATTCGAAAGTCCGGTCGTAGTGTGGACGTGGGGTTAG	1	bc
ACTAATACTT	GAAACACCGGCCTCGAGTGAGGTGTTCAGGGTGGGGTTAGAGCTAGAAAT	1	bc
GGCACCGGCA	GAAACACCGGTGTGGCTGAGAGTCCGGCAATGGTGTGGCTGAGGGGTTAG	1	bc
CGCCTCCGTC	GAAACACCGGTCTCGAGTGAGGTGTTCAGGGTGGGGTTAGAGCTAGAAAT	1	bc
ACTATTCGGC	GAAACACCGGTACCTTTGTTGATGCTGGGTGGGGTTAGAGCTAGAAATAG	1	bc
TAAGCCATAC	GAAACACCGGTGCCCTTACTCTCACCTGATTACTTAATCCGTGGGGTTAG	1	bc
GGCGCTGTCC	GAAACACCGGTGTGGCTGAGAGTCCGGCAATGGTGTGGCTGTGGGGTTAG	1	bc
ATAATAGGCC	GAAACACCGGTACCTTTGTTGATGCTGGGTGGAAGGTGCTTTTTTTCCTG	1	bc
GGCGTTGTCC	GAAACACCGGTTAGAGCGAGAAATAGCAAGTTAACCTAAGGCTGGTCCGT	1	bc
GGACACTCAC	GAAACACCGGTAAATTTGAGGCTCCGGCATGCAGGAGGCCGTGGGGTTAG	1	bc
ACTTCGTCGT	GAAACACCGGTGTACGTATGGACTGAACCAGGGTGTGCAAGTGGGGTTAG	1	bc
ACACACCGGC	GAAACACCGGTTTGAACTAGAAATAGCAAGTTAACCTAAGGCTAGTCCGT	1	bc
CGGTTCTCAT	GAAACACCGGTGACATTGGGTGTCCACTGTAGGACTTGGAATATGACAAG	1	bc
CTGAGAGGCC	GAAACACCGGTACCTTTGTTGATGCTGGGTGGGGTTAGAGCTAGAAATAG	1	bc
ACCAACGCCA	GAGCTAGAAATAGCAAGTTAACCTAAGGCTAGTCCGTTATCAACTTGAAA	1	bc
ACCGTTACCG	GAAGCACCGGTCGGGGCCACCCAGTGGTGGGGTTAGAGCTAGAAATAGCA	1	bc
GGGAACGTTA	GAAACACCGGTGTGGCTGAGAGTCCGGCAATGGTGTGGCTGTGGGGTTAG	1	bc
GCATAGTCGT	GAGACACCGGTGTACGTATGGACTGAACCAGGGTGTGCAAGTGGGGTTAG	1	bc
TCCCACGCAC	GAAACACCGGTTTGAACTAGAAATAGCAAGTTAACCTAAGGCTAGTCCGT	1	bc
CCTCTAAGCT	GAAACACCGGTTTACGTTACTTCGGGGTGGGGTTAGAGCTAGAAATAGCA	1	bc
TATATCAAGA	GAAACACCGGTTATATTTGTAAGTGGGGTTAGAGCTAGAAATAGCAAGTT	1	bc
CATAGTGGGC	GAAACACCGGTGTACGTATGGACTGAACCAGGGTGTGCAAGTGGGGTTAG	1	bc
GGGCGCTACG	GAAACACCGGTAAATTTGAGGCTCCGGCATGCAGGAGGCCGTGGGGTTAG	1	bc
AAAAACGCTC	GAAACACGGGTTAGAGCTAGAAATAGCAAGTTAACCTAAGGCTAGTCCGT	1	bc
CACCTCGCCA	GAAACACCGGTTTGAACTACCGGGGTTAGAGCTAGAAATAGCAAGTTAAC	1	bc
AACGTGTTGT	GAAACACCGGTGACATTGGGTACAGGGTGGGGTTAGAGCTAGAAATAGCA	1	bc
GAAGACTAGA	GAAACACCGGTCGGCGGCAATCGTGGGTGGGGTTAGAGCTAGAAATAGCA	1	bc
GAGTAGACTC	GAAACACCGGTTCCCGTCCAGTGGGGTTAGAGCTAGAAATAGCAAGTTAA	1	bc
TGCCCCCTAC	GAAACACCGGTAAATTTGAGGCTCCGGCATGCAGGAGGCCGTGGGGTTAG	1	bc
AAAAACGCAC	GAAACACCGGTTTGAACTACCTAGTTCAAACCGGTGGGGTTAGAGCTAGA	1	bc
GTGTATCCGC	GAAACACCGGTTCCCGTCCAGTGGGGTTAGAGCTAGAAATAGCAAGTTAA	1	bc
CAACTTGTAA	GAAACACCGGTAACTATATTCATGCGATATCGCCGTATCAGTGGGGTTAG	1	bc
ATGCGTTGTT	GAAACACCGGTTTACGTTGCATCGGTGTGGGGTTAGAGCTAGAAATAGCA	1	bc
GCTCTACGCT	GAAACACCGGTTTACGTTGCATCGCTGCGTGGTTAGAGAGAGATATAAAA	1	bc
ACTGCGCGTA	GAAACACCGGTTAAGCCGGGGTTAGAGCTAGAAATAGCAAGTTAACCTAA	1	bc
CACCGCGATC	GAAACACCGGTTTGAACTACCGGGGTTAGAGCTAGAAATAGCAAGTTAAC	1	bc
AATGAGCATA	GAAACACCGGTTAAGCCGAGTGGGGTTAGAGCTAGAAATAGCAAGTTAAC	1	bc
ATCCATCGAG	GAAACACCGGTTATATTTGTAATGGGGTTAGAGCTAGAAATAGCAAGTTA	1	bc
GTCTAGCATA	GAAACACCGGTTAAGCCGAGGGTTAGAGCTAGAAATAGCAAGTTAACCTA	1	bc
CCCTTCCTGC	GAAACACCGGTCGGGGCCACTCAGTGGTGGGGTTAGAGCTAGAAATAGCA	1	bc
TCTAATGGGC	GAAACACCGGTAATAATATTAATGCGATATCGCTGTATCTAGGGGGAGAG	1	bc
GACAACGAAT	GAAACACCGGTTTGAACTACCGGGGTTAGAGCTAGAAATAGCAAGTTAAC	1	bc
AGGAATCCTT	GAAACACCGGTCTCGATGGAGGTGTTCCAATGGGGGTGATATCTAGATAT	1	bc
TCAACTCGGC	GAAACACCGGTTAGAGCTAGAAATAGCAAGTTAACCTAAGGCTAGTCCGT	1	bc
TGCACAGTCA	GAAACACCGGTAGCAAGTGCGCGTCGTGTTAAATAGCACGTTAACCTAAG	1	bc
GTAGACACGT	GAAACACCGGTCGGTGGGGTTAGAGCTAGAAATAGCAAGTTAACCTAAGG	1	bc
TCGACCCTCG	GAAACACCGGTGCATTCGAAAGTCCGGTCGTAGTGTGGACGTGGGGTTAG	1	bc
CTTCTGGATC	GAAACACCGGTCCGTAGGAGACCCGTGTGGCATGTACCTGTGGGGTTAGA	1	bc
CTTTGACAGC	GAAACACCGGTCGGGGCCACTCAGTGGTGGGGTTAGAGCTAGAAATAGCA	1	bc
TTGTGAATGA	GAAACACCGGTTAAGCCGAGTGGGGTTAGAGCTAGAAATAGCAAGTTAAC	1	bc
ATAAGCTAGG	GAAACACCGGTTACATTGAGGGTTAGAGCTAGAAATAGCAAGTTAACCTA	1	bc
TGACAGAGAC	GAAACACCGGTAGCAAGTGCGAGACGTGTTTTAGAGCTAGAAATAGCAAG	1	bc
ATACCAGGCT	GAAACACCGGTACCTTTATTGATGCTGGGTGGGGCTAGAGCTCGAAATAG	1	bc
AGGGCACGAC	GAAACACCGGTAAATTTGAGGCTCCGGCACGCAGGAGGCCGTGGGGTTAG	1	bc
AATAATCGGC	GAAACACCGGTACCTTTGGTTAGAGCTAGAAATAGCAAGTTAACCTAAGG	1	bc
GAGTCCTGAC	GAAACACCGGTGCCCTTACTCTCACCTGATTACTTAATCCGTGGGGTTAG	1	bc
ACCTACGGCT	GAAACACCGGTCGATTCATATCGAAACCTTCCCGTGAAGGTTTCGTGGGG	1	bc
CTAGATCTGT	GAAACACCGGTTACATTGGGGTTAGAGCTAGAAATAGCAAGTTAACCTAA	1	bc
AGGGCGCCTA	GAAACACCGGTGTGGCTGTGGGTCCGGCTATGGGGTGGCTGGGGGGATAG	1	bc
AGGGTAGGCT	GAAACACCGGTCACTTTGGGTCAGAACTAGAAATAGCAAGTTAACCTAGG	1	bc
GGTACCCCCA	GAAACACCGGTGTGGCTGAGAGTCCGGCAATGGTGTGGCTGTGGGGTTAG	1	bc
CTAGTACGCC	GAAACACCGGTACCTTTGTTGATGCTGGGTGGAAGGAATTTTTGTGGGGT	1	bc
GAAGCGCCTC	GAAACACCGGTCGGCGGCAATCGTGGGTGGGGTTAGAGCTAGAAATAGCA	1	bc
AGAATCGTTG	GAAACACCGGTCTCGAGTGAGGTGTTCAGGGTGGGGTTAGAGCTAGAAAT	1	bc
CATACCGCCA	GAAACACCGGTTTGAACTAGAAATAGCAAGTTAACCTAAGGCTAGTCCGT	1	bc
CCCTACGCCG	GAAACACCGGTTTGAACTACCGGGGTTAGAGCTAGAAATAGCAAGTTAAC	1	bc
CGCGTCGGTT	GCAACACCGGTCGATTCATATCGAAACCTTCCCGTGACAGTGGGGTTAGA	1	bc
ACTTAGTATG	GAAACACCGGTGTACGTATGGACTGAACCAGGGTGTGCAAGTGGGGTTAG	1	bc
AACGAAGTAC	GAAACACCGGTGCCCTTACTCCCACCTGATTACTTAATCCGTGGGGTTAG	1	bc
GAGCGTCGTG	GAAACACCGGTGTACGTATGGACTGAACCAGGGTGTGCAAGTGGGGTTAG	1	bc
CCTCCCCGTC	GAAACACCGGTGTACGTATGGACTGAACCAGGGTGTGCAAGTGGGGTTAG	1	bc
GAACGCAATA	GAAACACCGGTGCCCTTACTCTCACCTGATTACTTAATCCGTGGGGTTAG	1	bc
GGAATCCCTC	GAAACACCGGTTCCGAGTGAGGTGTTCTAGAGGTGGAAAGAGCTAGTTAA	1	bc
CAATACGCAC	GAAACACCGGTTTGAACTAGAAATAGCAAGTTAACCTAAGGCTAGTCCGT	1	bc
GCGGCTCCTG	GAAACACCGGTCTCGAGTGAGGTGCTCAGGGTGGGGTTAGAGCTAGAAAT	1	bc
CTTTTCTCAT	GAAACACCGGTGACATTGGGTGTCCACTGTAGGACTTGGAGTATGACAAG	1	bc
AATATTCGGC	GAAACACCGGTACCTTTGTTGATGCTGGGTGGGGTTAGAGCTAGGAATAG	1	bc
CACACCCTAA	GAAACACCGGTGCCCTTACTCTCACCTGATTACTTAATCCGTGGGGTTAG	1	bc
TACGCGATAC	GAAACACCGGTGCCCTTACTCTCACCTGATTACTTAATCCGTGGGGTTAG	1	bc
ACCTCTACCG	GAAACACCGGTCGGGGCCAGCTAGAAATAGCAAGTTAACCTAAGGCTAGT	1	bc
TAGACCATCG	GAAACACCGGTGCATTCGAAAGTCCGGTCGTAGTGTGGACGTGGGGTTAG	1	bc
CGCAATGCGC	GAAACACCGGTTTGAACTACCGGGGTTAGAGCTAGAAATAGCAAGTTAAC	1	bc
GAGGTGGTCT	GAACCACCGGTCCGTAGGAGACCCGGGTGGCATGTACCTGTGGGGTTAGA	1	bc
AGTGGAGCAT	GAAACACCGGTTCCCGTCCAGTGGGGTTAGAGCTAGAAGTAGCAAGTTAA	1	bc
AATCAGTGCC	GAAACACCGGTTTGAACTAGAAATAGCAAGTTAACCTAAGGCTAGTCCGT	1	bc
AACAATACCT	GAAACGCCGGTTTGAACTACCGGGGTTAGAGCTAGAAATAGCAAGTTAAC	1	bc
AAAAGTGTAC	GAAACACCGGTAACTATACTCATGCGATATCGCCGTATCAGTGGGGTTAG	1	bc
ATGGCAAGGT	GAAACACCGGTTACATTGAGGGTTAGAGCTAGAAATAGCAAGTTAATCTA	1	bc
AGAAGACCTG	GAAACACCGGTCGGCGGCAATCGTGGGTGGGGTTAGAGCTAGAAATAGCA	1	bc
TAGGAGACTC	GAAACACCGGTTCCCGTCCAGTGGGGTTAGAGCTAGAAATAGCAAGTTAA	1	bc
AGATTCATTT	GAAACACCGGTCTCGAGTGAGGTGTTCAGGGTGGGGTTAGAGCTAGAAAT	1	bc
ATTCTCTATG	GAAACACCGGTTACATTGAGGGTTAGAGCTAGAAATAGCAAGTTAACCTA	1	bc
TCGCCCTGCA	GAAACACCGGTGCATTCGAAAGTCCGGTCGTAGTGTGGACGTGGGGTTAG	1	bc
ATAATCGGCA	GAAACACCGATACCTTTGTTGATGCTGGGTGTGGGGTTAGAGCTAGATAT	1	bc
GGTCCCTTTC	GAAACACCGGTCTCGAGTGAGGTGTCCAGGGTGGGGTTAGAGCTAGAAAT	1	bc
CAATGCTTAG	GAAACACCGGTTTACGTTGCATCGGTGTGGGGTTAGAGCTAGAAATAGCA	1	bc
GAACCAGACC	GAAACACCGGTAGCAAGTGCGAGACGTTTTTGTGGGGTTAGAGCTAGAAA	1	bc
ACACCACGCC	GAAACACCGGTTTGAACTAGAAATAGCAAGTTAACCTAAGGCTAGTCCGT	1	bc
CCCTGACTAC	GAAACACCGGTGCCCTTACTCTCACCTGATTACTTAATCCGTGGGGTTAG	1	bc
TGACCCTTTT	GAAACACCGGTCTCGAGCGAGGTGTTCTGGGTGGGGTTAGAGCTAGTAAT	1	bc
AGAAGACCAG	GAAACACCGGTCGGCGGTTAGAGCTAGAAAAAGCAAGTTAACCTAAGGCT	1	bc
AAGTCTGCCA	GAAACACCGGTCCGTAGGAGACCCGTGTGGCATGTACCTGTGGGGTTAGA	1	bc
TATTGCCATC	GAAACACCGGTGTACGTATGGACTGAACCAGGGTGTGCAAGTGGGGTTAG	1	bc
TGACTCATTT	GAAACACCGGTCTCGAGAGTGGTGCTAAGTGTGGGTATAGAGCTAGTAAT	1	bc
AGCAGACCCG	GAAACACCGGTCGGCGGGGTTAGAGCTAGAAATAGCAAGTTAACCTAAGG	1	bc
ATGAATCCTT	GAAACACCGGTCTCGAGTGAGGTGTTCAGGGTGGGGTTAGAGCTAGAAAT	1	bc
AGACTTACAC	GAAACACCGGTACATTTATTCATCCGGTCTCGCTGTAACCGTGGGGTTAG	1	bc
ATATGCCCTA	GAAACACCGGTGCCCTTACTCTCACCTGATTACTTAATCCGTGGGGTTAG	1	bc
TAAGCTACGA	GAAACACCGGTTACATTGAGGGGTTAGAGCTAGAAATAGCAGGTTAACCT	1	bc
CATAGTAGGC	GAAACGCCGGTGTACGTATTGACTGCACCAGGGTTTACATGTGGGGTTAG	1	bc
ACGCGACGTT	GAAACACCGGTCTCGAGTGGGGTTAGAGCTAGAAATAGCAAGTTAACCTA	1	bc
TCAGCTACGC	GAAACACCGGTTACATTGAGGGGTTAGAGCTAGAAATAGCAAGTTAACCT	1	bc
GTGATCATAC	GAAACACCGGTTAAGCCGAGTGGGGTTAGAGCTAGAAATAGCAAGTTAAC	1	bc
AAAGGACCTA	GAAACACCGGTGCCCTTACTCTCACCTGATTACTTAATCCGTGGGGTTAG	1	bc
GAGTCTGCAT	GAAACACCGGTCCGTAGGAGACCCGTGTGGCATGTACCTGTGGGGTTAGA	1	bc
AGCTTTACCG	GAAACACCGGTCGGGGCCGCTCAGTGGTGGGGTTAGAGCTAGAAATAGCA	1	bc
AAGGCACTCG	GAAACACCGGTGCCCTTACTCTCACCTGATTACTTAATCCGTGGGGATAG	1	bc
ACCACCGCCC	GAAACACCGGTTTGAACTAGAAATAGCAAGTTAACCTAAGGCTAGTCCGT	1	bc
ATTAGCCATG	GAAACACCGGTTACATTGAGGGGTTAGAGCTAGAAATAGCAAGTTAACCT	1	bc
TAGCGTTGAC	GAAACACCGGTGACATTGGGTACAGGGGTGGGGTTAGAGCTAGAAATAGC	1	bc
AAGACCCTTT	GAAACACCGGTCTCGAGAGAGGTGTTCAGGGGTGGGGTTAGAGCTAGAAA	1	bc
TAACGCCCAA	GAAACACCGGTGCCCTTACTCTCACCTGATTACTTAATCCGTGGGGTTAG	1	bc
TTAGCTCCTT	GAAACACCGGTTTATGTTGCATCGGTGTGGGGTTAGAGCTAGAAATAGCA	1	bc
GAATGCCCTA	GAAACACCGGTGCCCTTACTCTCACCTGATTACTTAATCCGTGGGGTTAG	1	bc
ATTCTGAGGT	GAAACACCGGTTTACGTTGCATCGGTGTGGGGTTAGAGCTAGAAATAGCA	1	bc
AGATGCGAGC	GAAACACCGGTGCATTCGAAAGTCCGGTCGTAGTGTGGACGTGGGGTTAG	1	bc
CAGCTTGGCT	GAAACACCGGTTTACGTTGCATCGGGGTTAGAGCTAGAAATAGCAAGTTA	1	bc
ACTTTACCTA	GAAACACCGGTCGGGGCCACTCAGTGGTGGGGTTAGAGCTAGAAATAGCA	1	bc
ATGCTGATAC	GAAACACCGGTCCGTAGGAGACCCGTGTGGCATGTACCTGTGGGGTTAGA	1	bc
CCAGACCTAC	GAAACACCGGTGCCCTTACTCTCACCTGATTACTTAATCCGTGGGGTTAG	1	bc
ACTATTCTCA	GAAACACCGGTGACATTGGGTGTCCACTGTAGGACTTGGAATATGACAAG	1	bc
AAGACCCCCG	GAAACACCGGTGCATTCGAAAGTCCGGTCGTAGTGTGGACGTGGGGTTAG	1	bc
GAGCGGCTGC	GAAACACCGGTTTACGTTGCATCGGTGTGGGGTTAGAGCTAGAAATAGCA	1	bc
GTGGGGACTA	GAAACACCGGTTCCCGTCCAGTGGGGTTAGAGCTAGAAATAGCAAGTTAA	1	bc
ACGTATCCTT	GAAACACCGGTCTCGAGTGAGGTGTTCAGGGTGGGGTTAGAGCTAGAAAT	1	bc
CGCCAGACTC	GAAACACCGGTCCGTAGGAGACCCGTGTGGCATGTACCTGTGGGGTTAGA	1	bc
GTAAAGCATA	GAAACACCGGTTCCCGTCCAGTGGGGTTAGAGCTAGAAATAGCAAGTTAA	1	bc
ACATCGACGT	GAAACACCGGTGTACGTATGGACTGAACCAGGGTGTGCCAGTGGGGTTAG	1	bc
ATTAGCAATG	GAAACACCGGTTACATTGAGGGTTAGAGCTAGAAATAGCAAGTTAACCTA	1	bc
ATGAGCAGAT	GAAACACCGGTTTACGTTGCATCGGTGTGGGGTTAGAGCTAGAAATAGCA	1	bc
AGCGTCTGCT	GAAACACCGGTCCGTAGGAGACCCGTGTGGCATGTACCTGTGGGGTTAGA	1	bc
GCCAGCCGCC	GAAACACCGGTGTGGCTGAGAGTCCGGCAATGGTGTGGCTGTGGGGTTAG	1	bc
CGTTTCTCAT	GAAACACCGGTGACGTTGGGTGTCCACTGTAGGACTTGGAATATGACAAG	1	bc
GAGTCTGTCT	GAAACACCGGTTCCCGTCCAGTGGGGTTAGAGCTAGAAATAGCAAGTTAA	1	bc
TCCGTAGGTT	GAAACACCGGTCGATTCATATCGAAACCTTCCCGTGACAGTGGGGTTAGA	1	bc
GCGAGTTGTC	GTGGGGTTAGAGCTAGAAATAGCAAGTTAACCTAAGGCTAGTCCGTTATT	1	bc
AAAATTCGGT	GAAACACCGGTCGATTCATATCGAAACCTTCCCGTGACAGTGGGGTTAGA	1	bc
GGGGAGCTTA	GAAACACCGGTTCCCGTCCAGTGGGGTTAGAGCTAGAAATAGCAAGTTAA	1	bc
CACTCTCAAG	GAAACACCGGTCGATCCATATCGAAACCTTCCCGTGACAGTGGGGTTAGA	1	bc
ATGATCGCTT	GAAACACCGGTCTCGAGCGAGGTGTTCAGGGTGGGGTTAGAGCTAGAAAT	1	bc
ATTCTCGGTC	GAAACACCGGTACCTTTGTTGATGCTGGGTGGGGTTAGAGCTAGAAATAG	1	bc
TGCAGCCTAA	GAAACACCGGTTAAGCCGAGGGGGGGGTAGAGCTAGAAATAGCAAGTTAA	1	bc
AAGACACAGA	GAAACACCGGTAGCAAGTTGTGGGGTTAGAGCTAGAAGTAGCAAGTTAAC	1	bc
ATACACCGAC	GAAACACCGGTAGCAAGTGCGAGACGTGTTTGTGGGGTTAGAGCTAGAAA	1	bc
TACGCTCTAT	GAAACACCGGTGCCCTTACTCTCACCTGATTACTTAATCCGTGGGGTTAG	1	bc
AATGCTGAGC	GAAACACCGGTTTACGTTGCATCGGCGTGGGGTTAGAGCTAGAAATAGCA	1	bc
AGAAACAGAC	GAAACACCGGTAGCAAGTGCGAGACGTGTTTGTGGGGTTAGAGCTAGAAA	1	bc
GTACGTGGCC	GAAACACCGGTACCTTTGTTGATGCTGGGTGGAAGGAATTTTGTGGGGTT	1	bc
AGACGACCCG	GAAACACCGGTCGGCGGCAAAGCTAGAAATAGCAAGTTAACCTAAGGCTA	1	bc
TAACGCCATA	GAAACACCGATGCCCTTACTCTCACCTGATTACTTAATCCGTGGGGTTAG	1	bc
TTACCACGAA	GAAACACCGGTAACTATATTCATGCGATATCGCCGTATCAGTGGGGTTAG	1	bc
CGTTTTCGCA	GAAACACCGGTGACATTGGGTACAGGGGTGGGGGTAGAGCTAGTAATAGC	1	bc
ATCATTCTCC	GAAACACCGGTGTGGCTGAGAGTCCGGCAATGGTGTGGCTGTGGGGATAG	1	bc
AGGCACCATC	GAAACACCGTGTGGCTGAGAGTCCGGCAATGGTGTGGCTGTGGGGTTAGA	1	bc
ATCCGCATAA	GAAACACCGGTTAAGCCGCGTGGGGTTAGAGCTAGAAATAGCAAGTTAAC	1	bc
ATACTGACTT	GAAACACCGGTCCGTAGGAGACCCGTGTGGCATGTACCTGTGGGGTTAGA	1	bc
ACGGAACATC	GAAACACCGGTTCCCGTCCAGTGGGGTTAGAGCTAGAAATAGCAAGTTAA	1	bc
TCTGCTTATC	GAAACACCGGTTTACGTTGCATCGGTGAGCTAGAAATAGCAAGTTAACCT	1	bc
TAGGCTGCCT	GAAACACCGGTCCGTAGGAGACCCGTGTGGCATGTACCTTGTGGGGTTAG	1	bc
TGGGACCACC	GAAACACCGGTGTGGCTGAGAGTCCGGCAATGGTGTGGCTGTGGGGTTAG	1	bc
TATCGTAGAC	GAAACACCGGTTACATTGAGGGTTAGAGCTAGAAATAGCAAGTTAACCTA	1	bc
GAGACGCTTG	GAAACACCGGTGCATTCGAAAGTCCGGTCGTAGTGTGGACGTGGGGTTAG	1	bc
ACTTTACATC	GAGACACCGGTCGGGGCCACTCAGTGGTGGGGTTAGAGCTAGAAATAGCA	1	bc
AAGAGCCACG	GAAACACCGGTGCATTCGAAAGTCCGGTCGTAGTGTGGACGTGGGGTTAG	1	bc
GATTGAGCAT	GAAACACCGGTTAAGCCGAGGGTTAGAGCTAGAAATAGCAAGTTAACCTA	1	bc
GGGGAGCTCT	GAAACACCGGTGACATTCGGGTTAGAGCTAGAAATAGCAAGTTAACCTAA	1	bc
AACGAGAGAC	GAAACACCGGTGCCCTTACTCTCACCTGATTACTTAATCCGTGGGGTTAG	1	bc
CGAACTCACC	GAAACACCGGTGTGGCTGAGAGTCCGGCAATGGTGTGGCTGTGGGGTTCG	1	bc
AGCCCGGCTC	GAAACACCGGTCCGAGGGAGCCCCGTGTGGCATGTAACTGTGGGGTTAGA	1	bc
GCCCTACGCC	GAAACACCGGTTTGAACTAGAAATAGCAATGTGACGTTAGACTTAGCCGT	1	bc
GAATCGTCGT	GAAACACCGGTGTACGTATGGACTGAACCAGGGGGTGCAAAGTGGGGTTA	1	bc
GGAAGATTCG	GAAACACCGGTCGGCGGCAATCGTGGGTGGGGTTAGAGCTAGAAATAGCA	1	bc
ATCACAGCTC	GAAACACCGGTTCCCGTCCAGTGGGGTTAGAGCTAGAAATAGCAAGTTAA	1	bc
ATTAGCTGTG	GAAACACCGGTTACATTGAGGGTTAGAGCTAGAAATAGCAAGTTAACCTA	1	bc
ATAGTCATTT	GAAACACCGGTCTCGAGTGAGGTGTTCAGGGTGGGGTTAGAGCTAGAAAT	1	bc
ACGTCCTGGA	GAAACACCGGTGCATCCGAGAGGCCAGTTAGAGGGTGGAGGTGGGGATAG	1	bc
AGACTACTTT	GAAACACCGGTCTCGAGTGAGGTGTTCAGGGTGGGGTTAGAGCTAGAAAT	1	bc
GTTACCCGCC	GAAACACCGGTGTGGCTGAGAGTCCGGCAATGGTGTGGCTGTGGGGTTAG	1	bc
CGTCTGCTCT	GAAACACCGGTGACATTGGGTACAGGCAAGTTAACCTAAGGCTAGTCCGT	1	bc
GGTGCAGTCT	GAAACACCGGTAGCAAGTGCGACACGTGTTTTTGTGGGGTTAGAGCTAGA	1	bc
GTGTATTGAA	GAAACACCGGTTATATTTGTAAGTGTGTGGGGTTAGAGCTAGAAATAGCA	1	bc
ACCTTTACTG	GAAACACCGGTCGGGGCCACTCAGTGGTGGGGTTAGAGCTAGAAATAGCA	1	bc
AGCGTTGTAT	GAAACACCGGTGACATTGGGTACAGGGGTGGGGTTAGAGCTAGAAATAGC	1	bc
CGAACCGTTC	GAAACACCGGTGTGGCTGCGAGTCAGGCAATGGTGATGCTGGGGGGTAGG	1	bc
AGACACAGAG	GAAACACCGGTAGCAAGTGGGGTTAGAGCTAGAAATAGCAAGTTAACCTA	1	bc
GGACACCGAC	GAAACACCGGTAGCAAGTGCGAGACGTGTTAGAGCTAGAAATAGCAAGTT	1	bc
AATAACGCCG	GAAACACCGGTTTGAACTAGAAATAGCAAGTTAACCTAAGGCTAGTCCGT	1	bc
ACTCGGTTCC	GAAACACCGGTCGATTCATATCGAAACCTTCCCGTGACAGTGGGGTTAGA	1	bc
AGATACTCTC	GAAACACCGGTGCATTCGAAAGTCCGGTCGTAGTGTGGACGTGGGGTTAG	1	bc
AGGACCACGC	GAAACACCGGTTAAGCCGTGGGGTTAGAGCTAGAGATAGCAAGTTAACCT	1	bc
ATCGATCGAG	GAAACACCGGTTATATTTGTAAGTGTGTGGGGCTAGAGCTAGAAATAGCA	1	bc
ATATTCGACC	GAAACACCGGTAGATTCATATAGAAACCTTCTCGTGATAAGGGGGGTTAG	1	bc
AAGTATGCAT	GAAACACCGGTCCGTAGGAGACCCGTGTGGCATGTACCTGTGGGGTTAGA	1	bc
GACGTGCCGC	GAAACACCGGTCCGTAGGAGTCCTGTCTGGTTTGGGGTTAGATCTAGCAA	1	bc
AGGGATCCTC	GAAACACCGGTGTGGCTGAGAGTCCGGCAATGGTGTGGCTGTGGGGTTAG	1	bc
CGTCTAGTGT	GAAGCAACGGTGTTAGAGCTAGAAATAGCAAGTTAACCTAAGGCTAGTCA	1	bc
GGTAACTTAT	GAAACACCGGTAACTATATTCATGCGATATCGCCGTATCAGTGGGGTTAG	1	bc
TTTTTAACGC	GAAACACCGGTCGGGGCCACTCAGTGGTGGGGTTAGAGCTAGAAATAGCA	1	bc
GGCCCACTTC	GAAACACCGGTGTGGCTGAGAGTCCGGCAATGGTGTGGCTGTGGGGTTAG	1	bc
CCTTCCGCCC	GAAACACCGGTCGGGGCCACTCAGTGGTGGGGTTAGAGCTAGAAATAGCA	1	bc
ATGTCTAGGT	GAAACACCGGTTCACGTTGCATCGGTGTGGGGTTAGAGCTAGAAATAGCA	1	bc
TTGGGTATGA	GAAACACCGGTTACATGAGGGTTAGAGCTAGAAATAGCAAGTTAACCTAA	1	bc
AACGAATCCT	GAAACACCGGTCTCGAGTGAGGTGTTCAGGGTGGGGTTAGAGCTAGAAAT	1	bc
ATGCATCGCA	GAAACACCGGTTTACGTTGCATCGGTGTGGGGTTAGAGCTAGAAATAGCA	1	bc
CCTTGCCCGG	GAAACACCGGTCGGGGCCACTCAGTGGTGGGGTTAGAGCTAGAAATAGCA	1	bc
ACGAATCATG	GAAACACCGGTCTCGAGTGAGGTGTTCAGGGTGGGGTTAGAGCTAGAAAT	1	bc
GCGCTTGGGC	GAAACACCGGTTTACGTTGCATCGGGGTGGGGTTAGAGCTAGAAATAGCA	1	bc
CTCGAAGCGT	GAAACACCGGTCTCGAGTGAGGTGTTCAGGGTGGGGTTAGAGCTAGAAAT	1	bc
CAGTTACCGA	GAAACACCGGTCGGGGCCACTCAGTGGTGGGGTTAGAGCTAGAAATAGCA	1	bc
CCAGAACCGC	GAAACACCGGTCGGCGGCAATCGTGGGTGGGGTTAGAGCTGGAAATAGCA	1	bc
AACTGCATAA	GAAACACCGGTGCCCTTACTCTCACCTGATTACTTAATCCGTGGGGTTAG	1	bc
AAAGCGTCGT	GAAACACCGGTGTACGTATGGACTGAACCAGGGTGTGCAAAGTGGGGTTA	1	bc
AAAGGCACGC	GAAACACCGGTGCGTTCGAAAGTCCGGTCGTAGTGTGGACGTGGGGTTAG	1	bc
ACTGCTGAGC	GAAACACCGGTTTACGTTGCATCGGTGTGGGGTTAGAGCTAGAAATAGCA	1	bc
CCAAGTAGTC	GAAACACCGGTGTACGTATGGACTGAACCAGGGTGTGCAAGCGGGGTTAG	1	bc
AGAACTGCGG	GAAACACCGGTGCATTCGAAAGTCCGGTCGTAGTGTGGACGTGGGGTTAG	1	bc
GACCTCCACA	GAAACACCGGTAAATTTGAGGCTCCGGCATGCAGGAGGCCGTGGGGTTAG	1	bc
GAAGACAAGA	GAAACACCGGTCGGCGGTGGGGTTAGAGCTAGAAATAGCAAGTTAACCTA	1	bc
CACCCATGCA	GAAACACCGGTGTGGCTGAGAGTCCGGCAATGGTGTGGCTGTGGGGTTAG	1	bc
TTCGCCCTCT	GAAACACCGGTTACATTGAGGGTTAGAGCTAGAAATAGCAAGTTAACCTA	1	bc
ACAAGATCGT	GAAACACCAGTGCATTGGAAAGTCCGGTCGTAGTGTGGCCGTAGGATTCG	1	bc
TTTTAGAGTC	GAAACACCGGTTCCCGTCCAGTGGGGTTAGAGCTAGAAATAGCAAGTTAA	1	bc
TCGACTCCTT	GAAACACCGGTCTCGAGTGAGGTGTTCAGGGTGGGGTTAGAGCTAGAAAT	1	bc
GAGGAGCCGG	GAAACACCGGTCGGCGGCAATCGTGGTATAAGCCACGTGGGGTTAGATCG	1	bc
GGAGACATGC	GAAACACCGGTCGGCGGCAATCGTGGGTGGGGTTAGAGCTAGAAATAGCA	1	bc
TTATCGTTGT	GAAACACCGGTTACATTGAGGGGTTAGAGCTAGAAATAGCAAGTTAACCT	1	bc
AGACAACGCC	GAAACACCGGTTTGTACTACCGGGGTTAGAGCTAGAAATAGCAAGTTAAC	1	bc
ACCAACGACC	GAAACACCGGTTTGAACTACCGGGGTTAGAGCTAGAAATAGCAAATTAAC	1	bc
GTGACGAATA	GAAACACCGGTTCCCGTCCAGTGGGGTTAGAGCTAGAAATAGCAAGTTAA	1	bc
TATAACGAGT	GAAACACCGGTTTGAACTACCTAGTTCAAACTGGTGGTGGTAGAGCTAGA	1	bc
ATTGAGAATA	GAAACACCGGTTAAGCCGAGTGGGGCTAGAGCTAGAAATAGCAAGTTAAC	1	bc
TAGCGTATCT	GAAACACCGGTTTACGTATGGACTGAACCAGGGAGTGCAAGTGGGGTTAG	1	bc
ATGGAGCTTT	GAAACACCGGTTCCCGTCCAGTGGGGCTAGAGCTAGAAATAGCAGGTAAA	1	bc
GGCGACCCTA	GAAACACCGGTAAATTTGAGGCTCCGGCATGCAGGAGGCCGTGGGGTTAG	1	bc
GAATAGCCGT	GAAACACCGGTCGGCGGCAATCGTGGGTGGGGTTAGAGCTAGAAATAGCA	1	bc
GACTACTCGG	GAAACACCGGTACCTTTGTTGATGCTGGGTGGGGTTAGAGCTAGAAATAG	1	bc
GAAGAAGACA	GAAACACCGGTAGCAAGTGGGGTTAGAGCTAGAAATAGCAAGTTAACCTA	1	bc
TGAGCCATGA	GAAACACCGGTAAATTTGAGCCTAATAGCAAGTTAACCTAAGGCTAGTCC	1	bc
AGTGATGTAT	GAAACACCGGTGACATTGGGTAAAAAAGTGGGGTTAGAGCTAGAAATAGC	1	bc
ATCGCTCTAA	GAAACACCGGTTACATTGAGGGCTAGAGCTAGAAATAGCAAGTTAACCTA	1	bc
ATTAGGAATG	GAAACACCGGTTACATTGGGGTTAGAGCTAGAAATAGCAAGTTAACCTAA	1	bc
GATGTGCCGC	GAAACACCGGTCGGCGGCAATCGTGGGTGGGGTTAGAGCTAGAAATAGCA	1	bc
AAACAACGCC	GAACCACCGGTTTGAACTACCGGGGTTAGAGCTAGAAATAGCAAGTTAAC	1	bc
CGAGATGTCA	GAAACACCGGTGACATTGGGGATAGAGCTAGAAATAGCAAGTTAACCTAA	1	bc
AAGGATCCTT	GAAACACCGGTCTCGAGTGAGGTGTTCAGGTGGGGTTAGAGCTAGAAATA	1	bc
GCACAACGCA	GGAACACCGGTTTGAACTAGAAATAGCAAGTTAACCTAAGGCTAGTCCGT	1	bc
TCCACAGAAC	GAAACACCGGTAGCAAGTGCGGGGTTAGAGCTAGAAATAGCAAGTTAACC	1	bc
ATTCGCTATG	GAAACACCGGTTACATTGGGGTTAGAGCTAGAAATAGCAAGTTAACCTAA	1	bc
TTTAACTATG	GAAACACCGGTTACATTGAGGGGTCAGAGCTAGAAATAGCAAGTTAACCT	1	bc
ATAAGTATGT	GAAACACCGGTTACATTGAGGGTTAGAGCTAGAAATAGCGAGTTAACCTA	1	bc
CAGAACACTC	GAAACACCGGTTTGAACTACCGGGGTTAGAGCTAGAAATAGCAAGTTAAC	1	bc
CAGCACGCCG	GAAACACCGGTTTGAACTACCTAGTTCAAACCGGTGGGGTTAGAGCTAGA	1	bc
GAGGTGACTC	GAAACACCGGTTCCCGTACAGAGGGGTTAGAGCTAGAAATAGCAAGTTAA	1	bc
GGCAGAATCC	GAAACACCGGTGTGGCTGAGAGTCCGGCAATGGTGTGGCTGTGGGGTTAG	1	bc
AAAACCCTCG	GAAACACCGGTGCATTCGAAAGTCCGGTCGTAGTGTGGACGTGGGGTTAG	1	bc
AAAAGCCATT	GAAACACCGGTCTCCAGTCTGGCATTCAGGGAGGGGTTAGGGCTAGAAAT	1	bc
AACGTACCAC	GAAACACCGGTGCCCTTACTCTCACCTGATTACTTAATCCGTGGGGTTAG	1	bc
AGGGAAACGC	GAAACACCGGTGTGGCTGAGAGTCCGGCAATGGTGTGGCTGTGGGGTTAG	1	bc
TTAGATCTAT	GAAACACCGGTTACATTGGGGTTAGAGCTAGAAATAGCAAGTTAACCTAA	1	bc
AGGCCCCGAC	GAAACACCGGTAAATTTGAGGCTCCGGCACGCAGGAGGCCGTGGGGTTAG	1	bc
ATGAGTAGAT	GAAACACCGGTTTACGTTGCATCGGTGTGGGGTTAGAGCTAGAAATAGCA	1	bc
AAAGGCGCTA	GAAACACCGGTGCCCTTACTCTCACCTGATTACTTAATCCGTGGGGTTAG	1	bc
AAGTCTGGCT	GAAACACCGGTCCGTAGGAGACCCGTGTGGCATGTACCTGTGGGGTTAGA	1	bc
GAGACCTCCA	GAAACACCGGTAAATTTGAGGCTCCGGCATGCAGGAGGCCGCGGGGTTAG	1	bc
AACCTTCGCT	GAAACACCGGTTTACGTTGCATCGGTGTGGGGTTAGAGCTAGAAATAGCA	1	bc
AGTCACAGAC	GAAACACCGGTAACACGTGCGAGACGTGTAACAGAGCTAGAGATAGAGAG	1	bc
GAGTGTTGTC	GAAACACCGGTGACATTGGGGGTGGGGTTAGAGCTAGAAATAGCAAGTTA	1	bc
ATACACACTC	GAAACACCGGTAGCAGTTGCGGGACGTGTTTGTGGGGGTAGAGCTAGTAA	1	bc
TCGTGTTTTC	GGGTTAGAACTAGAAATAGCAAGTTAACCTAAGGCTAGTCCGTTACCAAC	1	bc
GTAAGAATAA	GAAACACCGGTTAAGCCGAGGTGTGCTTTTTTCCTGCAGGGTATGCTCAA	1	bc
TCGGGTTGTC	GAAACACCGGTGGGGTTAGAGCTAGAAATAGCAAGTTAACCTAAGGCTAG	1	bc
CGAGGTATGT	GAAACACCGGTTACATTGAGGGTTAGAGCTAGAAATAGCAAGTTAACCTA	1	bc
GGCTCATCCA	GAAACACCGGTAAATTTGAGGCTCCGGCATGCAGGAGGCCGTGGGGTTAG	1	bc
ACGTTACGGT	GAAACACCGGTTTACGTTGCATCGGTGTGGAGTTAGAGCTAGAAATAGCA	1	bc
GTGAGCATCC	GAAACACCGGTTAAGCCGAGTGGGGTTAGAGCTAGAAATAGCAAGTTAAC	1	bc
CGACCGTTGC	GAAACACCGGTGCATTCGAAAGTCCGGTCGTAGTGTGGACGTGGGGTTAG	1	bc
GGACGCTAGC	GAAACACCGGTGCATTCGAAAGTCCGGTCGTAGTGTGGACGTGGGGTTAG	1	bc
AAAAACTGAG	GAAACACCGGTCGGGGCCACTCCTTTGTGTGGTTCGATCTATAACGATCA	1	bc
CACGACGTAC	GAAACACCGGTGCCCTTACTCTCACCTGATTACTTAATCCGTGGGGTTAG	1	bc
TAACGCCCGA	GAAACACCGGTGCCCTTACTCTCACCTGATTACTTAATCCGTGGGGTTAG	1	bc
GAGGCGTCGC	GAAACACCGGTTTACGTTGCATCGGGTTACGTTGCATCGGGGTTAGAGCT	1	bc
GACAGCCTAC	GAAACACCGGTGCCCTTACTCTCACCTGATTCCTTGATCCGTGGGGTTAG	1	bc
AACACAACGC	GAAACACCGGTCGGCGGCAATCGTGGGTGGGGTTAGAGCTAGAAATAGCA	1	bc
AAGTTTGCCT	GAAACACCGGTCCGTAGGAGACCCGTGTGGCCTGTACCTGTGGGGTTAGA	1	bc
AAGGAGGCGC	GAAACACCGGTACCCGTCACTCCTGGGGTGGGGTTAGTGCTGGAAGTAAC	1	bc
CATAGTGGAC	GAAACACCGGTGTACGTATGGACTGAACCAGGGTGTGCAAGTGGGGTTAG	1	bc
GGGGCTGAAA	CCGGTAAATTTGAGGCTCCGGCATGCAGGAGGCCGTGGGGTTAGAGCTAG	1	bc
AACATCGTCG	GAAACACCGGTGTACGTATGGACTGAACCAGGGTGTGCAAGTGGGGTTAG	1	bc
ATACTAGGCA	GAAACACCGGTACCTTTGTTGATGCTGGGTGGGGTTAGAGCTAGAAATAG	1	bc
ACGACTCGGG	GAAACACCGGTACCTTTGTTGATGCTGGGTGGGGTTAGAGCTAGAAATAG	1	bc
AGGCCTTCCC	GAAACACCGGTTTACGTTGCATCGGGGTTAGAGCGAGAAATAGCAGGTAA	1	bc
AGATGGATTT	GAAACACCGGTCTCGAGGGAGGTGTTCAGGGTGGGGTTAGAGCTAGAAAT	1	bc
GACACTGTCC	GAAACACCGGTGTGGCTGAGAGTCCGGCAATGGTGTGGCTGGTGGGTTAG	1	bc
CTACCCGGTA	GAAACACCGGTACCTTTGTTGATGCTGGGTGGGGTTAGAGATAGAAATAG	1	bc
ATCGTAGTAT	GAAACACCGGTGCCCTTACTCTCACCTGATTACTTAATCCGTGGGGTTAG	1	bc
GAGCGAGCCA	GAAACACCGGTAGCAAGTGCGAGACGTGTTAGAGCTAGAAATAGCACCGG	1	bc
ACAATTCGGC	GAAACACCGGTACCTTTGTTGATGCTGGGTGGGGTTAGAGCTAGAAATAG	1	bc
TCAGTCCCGC	GAAACACCGGTCGGCGGCAATCGTGGGCGGGGTTAGAGCTAGAAATAGCA	1	bc
CTTCTTATCT	GAAACACCGGTTTACGTTGCATCGGGGTTAGAGCTAGAAATAGCAAGTTA	1	bc
ACGGCACTCC	GAAACACCGGTGCCCTTACTCTCACCTGATTACTTAATCCGTGGGGTTAG	1	bc
ATGTTATCGT	GAAACACCGGTTTACGTTACATCGGTTGGGGGGTTAGGGCTAGAATAAGC	1	bc
CCAGTAGGTT	GAAACACCGGTCGATTCATATCGAAACCTTCCCGTGACAGTGGGGTTAGA	1	bc
ACCAAACTAC	GAAACACCGGTGCCCTTACTCTCACCTGATTACTTAATCCGTGGGGTTAG	1	bc
AGGCGGACTC	GAAACACCGGTCCGTAGGAGACCCGTGTGGCATTGTGGGGTTAGAGCTAG	1	bc
GATGCTGTAA	GAAACACCGGTCAGCCAGAGGGGATTACATCTAGAAATAGCACGTTAACC	1	bc
GAGGGACCGC	GAAACACCGGTCGGCGGCAATCGTGGGTGGGGTTAGAGCTAGAAATAGCA	1	bc
ACGAACCCTT	GAAACACCGGTCTCGAGTGAGGTGTTCAGGGTGGGGTTAGAGCTAGAAAT	1	bc
ACAACCGCGC	GAAACACCGGTGCATTCGAAAGTCCGGTCGTAGTGTGGACGTGGGGTTAG	1	bc
AGCTCGCATC	GAAACACCGGTCCGTACGAAACCTGTGTGGCATGTACCTGAGGGGTTACA	1	bc
ATTTGCTATT	GAAACACCGGTTACATTGAGGGTTGGAGCTAGAAATAGCAAGTTAACCTA	1	bc
ATTAGCTCTG	GAAACACCGGTTACATTGGGGTTAGAGCTAGAAATAGCAAGTTAACCTAA	1	bc
AGAAGTCCCG	GAAACACCGGTCGGCGGCAATCGTGGGGTGGGGTTAGAGCTAGAAATAGC	1	bc
AACTACCTTC	GAAACACCGGTGCCCTTACTCTCACCTGATTACTTAATCCGTGGGGTTAG	1	bc
GGACACTTCA	GAAACACCGGTAAATTTGAGGCTCCGGCATGCAGGAGGCCGTGGGGTTAG	1	bc
ACAGAACGCC	GAAACACCGGTCTGAACTAGAAATAGCAAGTTAACCTAAGGCTAGTCCGT	1	bc
ATGCGTCGTT	GAAACACCGGTTTACGTTGCATCGGTTTGTGGGGTTAGAGCTAGAAGTAG	1	bc
ACGACTCCTT	GAAACACCGGTCTCGAGTGGTGGGGTTAGAGCTAGAAATAGCAAGTTAAC	1	bc
AAGAAACCAG	GAAACACCGGTGTGGCTGAGAGTCCGGCAATGGTGTGGCTGTGGGGTTAG	1	bc
AAGTATGCCT	GAAACACCGGTCCGTAGGAGACCCGTGTGGCATGTACCTTGTGGGGTTAG	1	bc
AATGATTAGA	GGAACACCGGTTTACGTTGGGGTTAGAGCTAGAAATAGCAAGTTAACCTA	1	bc
ACCGTAAAAG	GAAACACCGGTCGGGGCCACTCAGTGGTGGGGTTAGAGCTAGAAATAGCA	1	bc
GTAGTGCCCC	GAAACACCGGTCCCCTTCCTGTGGGGTTAGAGCTAGAATTAGCAAGTTAA	1	bc
AGGCACACTC	GAGACACCGGTGTGGCTGAGAGTCCGGCAATGGTGTGGCTGTGGGGTTAG	1	bc
AGGGGAGCGT	GAAACACCGGTTCCCGTCCAGTGGGGTTAGAGCTAGAAATAGCAAGTTAA	1	bc
CACTTCCTTC	GAAACACCGGTCGGGGGCTCGCGGAGGTATAGCTAGATCACCTAATACCA	1	bc
GACTTTAACG	GAAACACCGGTCGGGGCCACTCAGTGGTGGGGTTAGAGCTAGAAATAGCA	1	bc
CAGTGGAGCC	GAAACACCGGTTCCCGTCCAGTGGGGTTAGAGCTAGAAATAGCAAGTTAA	1	bc
ACCTTTACGG	GAAACACCGGTCGGGGCCACTCAGTGGTGGGGTTAGAGCTAGAAATAGCA	1	bc
GGAACCGCGC	GAAACACCGGTGCATTCGAAAGTCCGGTCGTAGTGTGGACGTGGGGTTAG	1	bc
CGCCGCCTTC	GAAACACCGGTGTACGTATGGACTGAACCAGGGTGTGCAAGTGGGGTTAG	1	bc
GTAGAGCAGC	GAAACACCGGTCGGCGGCACTAGAAATAGCAAGTTAACCTAAGGCTAGTC	1	bc
AAGACCCACG	GAAACACCGGTGCATTCGAAAGTCCGGTCGTAGTGTGGACGTGGGGTTAG	1	bc
CTCCCCTGCA	GAAACACCGGTGTGGCTGAGAGTCCGGCAATGGTGTGGCTGTGGGGATAG	1	bc
AAGGCTAGCA	GAAACACCGGTGCCCTTACTCTCACCTGATTACTTAATCCGTAAGGTTAG	1	bc
TACACCGAGG	GAAACACCGGTAGCAAGTGCGAGACGTTTTTGTGGGGTTAGAGCTAGAAA	1	bc
CAATTCCATG	GAAACACCGGTCTCGAGTGAGGTGTTCAGGGTGGGGTTAGAGCTAGAAAT	1	bc
CTTCTTGGAT	GAAACACCGGTTTACGTTGCATCGGTGTGAGGTTAGAGCTAGAAATAGCA	1	bc
GGAGGCTGCA	GAAACACCGGTCCGTAGGAGACCCGTGTGGCATGTACCTGTGGGGTTAGA	1	bc
AGTTTACTTC	GAAACACCGGTCGGGGCCACTCAGTGGTGGGGTTAGAGCTAGAAATAGCA	1	bc
CAGCACGTCA	GAAACACCGGTTTACGTTGCATCGGTGTGGGGTTAGAGCTAGAAATAGCA	1	bc
GAATCCCCGT	GAAACACCGGCTCGGGGTTAGAGCTAGAAATAGCAAGTTAACCTAAGGCT	1	bc
TTCGCACTGT	GAAACACCGGTTACATTGAGGGTTAGAGCTAGAAATAGCAAGTTAACCTA	1	bc
ATGAGCTCGC	GAAACACCGGTGCATTCGAAAGTCCGGTCGTAGTGTGGACGTGGGGTTAG	1	bc
CTCGAGCCCC	GAAACACCGGTCCCCGTCCAGTGGGGTTAGAGCTGGAAATAGCAAGTTAA	1	bc
TAGCGTATAA	GAAACACCGGTAACTATATTCATGCGATATCGCCGTATCAGTGGGGTTAG	1	bc
ATGGCGGGTC	GAAACACCGGTTCCCGTCCAGTGGGGTTAGAGCTAGAAATAGCAAGTTAA	1	bc
TATACCCTCC	GAAAAACCGGTGTGGCTGAGAGTCCGGCAATGGTGTGGCTGTGGGGATAG	1	bc
CCTTTTGTCG	GAAACACCGGTGGCATTAGGATGAGGGGAGGGGTGAGAGCTAGAAATAGC	1	bc
GAAAACGAGC	GAAACACGGTTAGAGCTTGAAATAGCAAGTTAACCTGAGCCTAGACCGTT	1	bc
ATTAACTATG	GAAACACCGGTTACATTGAGGGTTAGAGCTAGAAATAGCAAGTTAACCTA	1	bc
AATATACCGC	GAAACACCGGTCGGGGCCACTCAGTGGTGGGGTTAGAGCTAGAAATAGCA	1	bc
AGACGATCGT	GAAACACCGGTGCATTCGAAAGTCCGGTCGTAGGGTGGACGTGGGGATAG	1	bc
CGAACGGCTC	GAAACACCGGTTTGAACTACCGGGGTTAGAGCTAGAAATAGCAAGTTAAC	1	bc
TAGACCCACG	GAAACACCGGTGCATTCGAAAGTCCGGTCGTAGTGTGGACGTGGGGTTAG	1	bc
AAACGACCTA	GAAACACCGGTGCCCTTATTCTCACCTGATTACTTAATCCGTGGGGTTAG	1	bc
GAAGCCTTCC	GAAACACCGGTCGGCGGCAACGTGGGGTTAGAGCTAGAAATAGCAAGTTA	1	bc
GAGGAAGGTC	GAAACACCGGTTCCCGTCCAGTGGGGTTAGAGCTAGAAATAGCAAGTTAA	1	bc
AGGCACGCTT	GAAACACCGGTGTGGCTGAGAGTGCGGCAATGGTGTGGCTGTGGGGTTAG	1	bc
TAAGAATCGA	GAAACACCGGTCGGCGGCAATCGTGGGTGGGGTTAGAGCTAGAAATAGCA	1	bc
TAAACCGACA	GAAACACCGGTAGCAAGTGCGAGACGTGTTTTAGAGCTAGAAATAGCAAG	1	bc
ACTAATCGGA	GAAACACCGGTACCTTTGTTGATGCTGGGTGGGGTTAGAGCTAGAAATAG	1	bc
GTGGCGGCGC	GAAACACCGGTTCCCGTCCAGTGGGGTTAGAGCTAGAAATAGCAAGTTAA	1	bc
CTACGTGGGC	GAAACACCGGTACCTTTGTTGATGCTGGGTGGGGTTAGAGCTAGAAATAG	1	bc
GCCAAAGACC	GAAACGCCGGTAGCAAGTGCGAGACGTGTTTGTGGGGTTAGAGCTAGGAA	1	bc
ATAATATCGC	GAAACACCGGTGCATTCGAAAGTCCGGTCGTAGTGTGGACGTGGGGCTAG	1	bc
GAACTCCGCC	GAAACACCGGTTGGCGGCAATAGCAAGTTAACCTAAGGCTAGTCCGTTAA	1	bc
ATTAATCGAG	GAAACACCGGTACCTTTGTTGATGCTGGGTGGAAGGAATTTGTGGGGTTA	1	bc
AGGCTGACTA	GAAACACCGGTCCGTAGGAGACCCGTGTGGCATTGTGAGGCTAGAGCTAG	1	bc
AGAGAAGCAT	GAAACACCGGTTCCCGTCCAGTGGGTTAGAGCTAGAAATAGCAAGTTAAC	1	bc
AAACCTATTC	GAAACACCGGTAACTCTATTCATGCGTTATCGCCGTATCAGTGTGGTTAG	1	bc
AAAAACGCAA	GAAACACCGGTTTGAACTACCTAGAGCTAGAAATAGCAAGTTAACCTAAG	1	bc
TGTCTGTCGC	GAAACACCGGTCCGTAGGAGACCCGTGTGGCATGTACCTGTGGGGTTAGA	1	bc
TATCGTTGTT	GAAACACCGGTGTACGTATGGACTGAACCAGGGTGTGCAAAGTGGGGTTA	1	bc
ACTTTTACCT	GAAACACCGGTCTAGGCCACTCCGTGGTGGGGTTAGAGCTAGAAATAGCA	1	bc
AATTCTGGCT	GAAACACCGGTCCGTAGGAGACCCGTGTGGCATGTACCTGTGGGGTTAGA	1	bc
ACATTTACCG	GAAACACCGGTCGGGGCCACTCAGTGGCGGGGGTTGAGCTAGAAATAGCA	1	bc
AGACCAAGAC	GAAACACCGGTAGCAAGTGCGAGACGTGTTTGTGGGGTTAGAGCTAGAAA	1	bc
ATTAGATACG	GAAACACCGGTTACATTGAGGGTTAGAGCTAGAAATAGCAAGTTAACCTA	1	bc
AACTTACCCG	GAAACACCGGTCGGGGCCACTCAGTGGTGGGGTTAGAGCTAGAAATAGCA	1	bc
ACATAAGACC	GAAACACCGGTTTGAACTAGAAATAGCAAGTTAACCTAAGGCTAGTCCGT	1	bc
AAGAATCCTT	GAAACACCGGTCTCGAGTGTAGCAAGTTAACCTAAGGCTAGTCCGTTATC	1	bc
AGAACTCTTG	GAAACACCGGTCTCGAGTGAGGTGTTCAGGGTGGTGTTAGAGCCAGGGGA	1	bc
GCGCACCCGC	GAAACACCGGTGTGGCTGAGAGTCCGGCAATGGAGTGGCTGTGGGGTTAG	1	bc
GGTATACAGC	GAAACACCGGTCGGGGCCACTCAGTGGTGGGGTTAGAGCTAGAAATAGCA	1	bc
AGACTGCAAC	GAAACACCGGTCCGTAGGAGACCCGTGTGGCATGTACCTGTGGGGGTAGA	1	bc
ACGCTTCGGC	GAAACACCGGTGTACGTATGGACTAAACCAGGGTGTGCATGTGGGGTTAG	1	bc
ACACCGTCGT	GAAACACCGGTGTACGTATGGACTGAACCAGGGTGTGCAAGTGGGGTTAG	1	bc
AAGGGGCTAC	GAAACACCGGTAACTATATTCATGCGATATCGCCGTATCTAGAAATATCA	1	bc
GTCTCCTGCA	GAAACACCGGTGTGGCTGAGAGTCCGGCAATGGTGTGGCTGTGGGGTTAG	1	bc
GATGAGAATA	GAAACACCGGTTAAGCCGAGGAGTTAGAGCTAGAAATAGCAAGTTAACCT	1	bc
AACATCTCCG	GAAACACCGGTGCATTCGAAAGTCCGGTCGTAGTGTGGACGTGGGGTTAG	1	bc
AGCTTTACCG	GAAACACCGGTCGGGGCCACTCAGTGGTGGGGTTAGAGCTAGAAATAGCA	1	bc
GAGCTTCCCT	GAAACACCGGTTTACGTTGCATCGGTTGAGGGGTTAGAGCTAGAAATAGA	1	bc
TCGCGTTGTC	GAAACACCGGTGACATTGGGGTTAGAGCTAGAAATAGCAAGTTAACCTAA	1	bc
ACTTTTCCCG	GAAACACCGGTCGGGGCCACTCAGTGGTGGGGTTAGAGCTAGAAATAGCA	1	bc
AATACTCGGC	GAAACACCGGTACCTTTGTTGATGCTGGGTGGAAGGAATGGTGGGGTTAG	1	bc
GGCAGCGTGC	GAAACACCGGTGTGGCTGAGAGTCCGGCAATGGTGTGGCTGTGGGGTTAG	1	bc
GTAAGACACG	GAAACACCGGTCGGCGGCAATCGTGGGTGGGGTTAGAGCTAGAAATAGCA	1	bc
CTCGAATCAT	GAAACACCGGTCTCGAGTGAGGTGTTCAGGGGTGGGGTTAGAGCTAGAAA	1	bc
AGAGGAGCAT	GAAACACCGGTTCCCGTCCAGTGGGGTTAGAGCTAGAAATAGCAAGTTAA	1	bc
CACCGCGCTC	GAAAAACCGGTTTGAACTACCGGGGTTAGAGCTAGAAATAGCAAGTTAAA	1	bc
GGGGATGCTC	GAAACACCGGTTCCCGTCCAGTGGGGTTAGAGCTAGAAATAGCAAGTTAA	1	bc
CTCCCCTGCA	GAAACACCGGTGTGGCTGGGAGTCGGGCACTGGTGTGGCTGGGGGGTTAG	1	bc
ATGAACGAAA	GAAACACCGGTTTGAACTACCGGGGTTAGAGCTAGAAATAGCAAGTTAAC	1	bc
AGCCTTTACC	GAAACACCGGTCGGGGCCACTCAGTGGTGGGGTTAGAGCTAGAAATAGCA	1	bc
AGGCCACCTC	GAAACACCGGTGTGGCTGAGAGTCCGGCAATGGTGTGGCTGTGGGGTTAG	1	bc
ACAATCCGCC	GAAACACCGGTTTGAACTACCGGGGTTAGAGCTAGAAATAGCAAGTTAAC	1	bc
ACACGTCGAC	GAAACACCGGTTTGAACTACCTAGTTCAAACCGATAGCAAGTTAACCTAA	1	bc
AAAAGCCTTA	GAAACACCGGTGCCCTTACTCTCACCTGATTACTTAATCCGTGGGGTTAG	1	bc
GTGGTGTATC	GAAACACCGGTGTACGTATGGACTGAACCAGGGTGTGCAAGTGGGGTTAG	1	bc
CATTACCGCC	GAAACACCGGTCGGGGCCACTCAGTGGTGGGGTTAGAGCTAGAAATAGCA	1	bc
AACAGAGCCA	GAAACACCGGTAGCAAGTGCGAGACGTGTTTGTGGGGTTAGAGCTAGAAA	1	bc
TCGCAACGCC	GAAACACCGGTTTGAACTAGAAATAGCAAGTTAACCTAAGGCTAGTCCGT	1	bc
ACACGACGCC	GAAACACCGGTTTGAACTAGAAATAGCAAGTTAACCTAAGGCTAGTCCGT	1	bc
AGAACCGAGA	GAAACACCGGTGCATTCGAAAGTCCGGTCGTAGTGTGGACGTGGGGTTAG	1	bc
CGGCTCGGCT	GAAACACCGGTACCTTTGTTGATGCTGGGTGGGGTTAGAGCTAGAAATCG	1	bc
AGTGGATCCT	GAAACACCGGTTCCCGTCCAGTGGGGTTAGAGCTAGAAATAGCAAGTTAA	1	bc
TACTCGTCGT	GAAACACCGGTGTACGTATGGACTGAACCAGGGTGTGCAAGTGGGGTTAG	1	bc
TTGCGCGTCC	GAAACACCGGTACCTTTGTTGATGCTGGGTGGAAGGAATTTTTGTGGGGT	1	bc
CTGCCCGGAC	GAAACACCGGTACCTTTGTTGATGCTGGGTGGAAGGAAGGAGTGGGGATA	1	bc
GCCCGCCTCC	GAAACACCGGTGTGGCTGAGAGTCCGGCAATGGTGTGGCTGTGGGGTTAG	1	bc
TGGACGTCGC	GAAACACCGGTGCCTCAATAAGCCCGGGCGCAGTGTTGACGTTGGGTTAG	1	bc
GCGAATCGTT	GAAACACCGGTCTCGAGTGAGGTGTTCAGGGTGGGGTAGAGCTAGAAATA	1	bc
ACGTTAACGC	GAAACACCGGTCGGGGCCACTCAGTGGTGGGGTTAGAGCTAGAAATAGCA	1	bc
TGAGTAGTCC	GAAACACCGGTGACATTGGGTACAGGGTGGGGTTAGAGCTAGAAATAGCA	1	bc
AGGCATAGTC	GAAACACCGGTGTGGCTGAGAGTCCGGCAATGGTGTGGCTGAGGGGGTAG	1	bc
GTGGTAACTC	GAAACACCGGTTCCCGTCCAGTGGGGTTAGAGCTAGAAATAGCAAGTTAA	1	bc
ACGTGGAGTC	GAAACACCGGTGACATTGGGTTAGAGCTAGAAATAGCAAGTTAACCTAAG	1	bc
TTGCGGAGTA	GAAACACCGGCTAGAGCTAGAAATAGCAAGTTAACCTTAGGCTAGTACGT	1	bc
ACACAACGCG	GAAACACCGGTTTGAACTAGAAATAGCAAGTTAACCTAAGGCTAGTCCGT	1	bc
AAAAAAGACT	GAAACACCGGTTTGAACTAGAAATAGCAAGTTAACCTAAGGCTAGTCCGT	1	bc
ACTACTGGGC	GAAACACCGGTACCTTTGTTGATGCTGGGTGGGGTTAGAGCTAGAAATAG	1	bc
GCGTTGGGTT	GAAACACCGGTGGCTGCATATCGCAACCTTGCCGTGTTAGTGCGAGTAGT	1	bc
ACGATCGGGT	GAAACACCGGTTAAATTTGCAAGTGTGTGGGGGTAAAGCCAAGAAAAGCA	1	bc
ACAAAACGCC	GAAACACGGGTTAGAGCTAGAAATAGCAAGTTAACCTAAGGCTAGTCCGT	1	bc
GCACCGTCGT	GAAACACCGGTTACATTGAGATTGGGGTTAGAGCTAGAAATAGCAAGTTA	1	bc
CAGAATGGTC	GAAACACCGGTTTGAACTACCGGGGTTAGAGCTAGAAATAGCAAGTTAAC	1	bc
GCTTAGGAAC	GAAACACCGGTTCCCGTCCAGTGGGGTTAGAGGTAGTAATAGCAAGTTAA	1	bc
GGACGATACA	GAAACACCGGTAAATTTGAGGCTCCGGCATGCAGGAGGCCGTGGGGTTAG	1	bc
CATAGAGGTC	GAAACACCGGTGTACGTATGGACTGAACCAGGGTGTGCAAAAGTGGGGTT	1	bc
AGTGCTGTCC	GAAACACCGGTGACATTGGGTATGGGGTTATAGCTAGAAATAGCAAGTTA	1	bc
GATGATCCCA	GAAACACCGGTCAGGAGGAGACCCTAGAGCTATGTATCTGAAGGTTTAGA	1	bc
GCCCTCCTTC	GAAACACCGGTGGGGCTGAGAGTGCTACAATGGTGTGGCGGTCTGGATAG	1	bc
ATGCTGGCTA	GAAACACCGGTCCGTAGGAGACCCGTGCGGCATGTACCTGTGGGGTTAGA	1	bc
TGACATTCGC	GAAACACCGGTGCATTCGAAAGTCCGGTCGTAGTGTGGACGTGGGGTTAG	1	bc
TATAGTCGTT	GAAACACCGGTCTATTCATATCGAAACCTTCCCGTGACAGTGGGGTTAGA	1	bc
AATGCGTAGC	GAAACACCGGTTTACGTTGCATCGGGGTTAGAGCTAGAAATAGCAAGTTA	1	bc
GAGACGCTGG	GAAACACCGGTGCATTCGAAAGTCCGGTCGTAGTGTGGACGTGGGGTTAG	1	bc
GAGAACGCTA	GAAACACCGGTCGGCGGCAATCGTGGGTGGGGTTAGAGCTAGAAATAGCA	1	bc
TCAGTACTGT	GAAACACCGGTCAGAGTCAGGCAGTGGGGTAGATATAGCTAGTAATAGCA	1	bc
CTTCGTCTGC	GAAACACCGGTGTACGTATGGACTGAACCAGGGTGTGCAAGTGGGGTTAG	1	bc
GCCATAGGAC	GAAACACCGGTGTGGCTGAGAGTCCGGCAATGGTGTGGCTGGGGGGTTAG	1	bc
AGCCTCCCGC	GAAACACCGGTGCATTCGAAAGTCCGGTCGTAGTGTGGACGTGGGGTTAG	1	bc
AAGTCTGCCG	GAAACACCGGTCCGTAGGAGACCCGTGTGGCATGTACCTGTGGGGTTAGA	1	bc
AGCAATGCAC	GAAACACCGGTTTGAACTACCGGGGCTAGCGCTAGAAATAGCAAGTTAAC	1	bc
GACACAGGTC	GAAACACCGGTAGCAAGTGCGAGACGTGTTTGTGGGGTTAGAGCTAGAAA	1	bc
GTTAGCACTG	GAAACACCGGTTACATTGAGGGTTAGAGCTGGAAATAGCAAGTTAACCTA	1	bc
GGGATGCTCC	GAAACACCGGTGTGGCTGAGAGTCCGGCAATGGTGTGGCTGTGGGGTTAG	1	bc
GCCCCAGAAA	GAAACACCGGTAGCAAGTGCGTGGGGTTAGAGCTAGAAATAGCAAGTTAA	1	bc
CTACTAGTCA	GAAACACCGGTACCTTTGTTGATGCTGGGTGTGGGGTTAGAGCTAGAAAT	1	bc
CGACCCTAGA	GAAACACCGGTGCATTCGAAAGTCCGGTCGTAGTGTGGACGTGGGGTTAG	1	bc
GAAACGCCGT	GAAACACCGGTGCCCTTACTCTCACCTGATTACTTAATCCGTGGGGTTAG	1	bc
ACCGCCCTGA	GAAACACCGGTGCCCTTACTCTCACCTGATTACTTAATCCGTGGGGTTAG	1	bc
GTGGCGACTG	GAAACACCGGTTCCCGTCCAGTGGGGTTAGAGCTAGAAATAGCAAGTTAA	1	bc
AACGATCTTC	GAAACACCGGTGCCCTTACTCTCACCTGATTACTTAATCCGTGGGGTTAG	1	bc
AGACCCCAAG	GAAACACCGGTGCATTCGAAAGACCGGTCGTAGTGTGGCTGGGGGTATAG	1	bc
ACAGTGGGTA	GAAACACCGGTCGATTCATATCGAAACCTTCCCGTGACAGTGGGGTTAGA	1	bc
ACGTGTTGTA	GAAACACCGGTGTTAGAGCTAGAAATAGCAAGTTAACCTAAGGCTAGTCC	1	bc
AGAATGGTTT	GAAACACCGGTCTCGAGTGAGGTGTTCAGGGTGGGGTTAGAGCTAGAAAT	1	bc
TCGCCCTGCA	GAAACACCGGTGCATTCGAAAGAGAAATGGTAGTAAGGACGAGAGGTTAG	1	bc
GACGATATGT	GAAACACCGGTTACATTGGGGTTAGAGCTAGAAATAGCAAGTTAACCTAA	1	bc
AAATCTCTAA	GAAACACCGGTGCCCTTACTCTCACCTGATTACTTAATCCGTGGGGTTAG	1	bc
ATAGATATGC	GAAACACCGGTTAAATTGAGGGTTAGAACTAAAAATAAGAAGTTAACCTA	1	bc
ACTGAGCATA	GAAACACCGGTTAAGCCGAGTGGGGTTAGAGCTAGAAATAGCAAGTTAAC	1	bc
AAAATAGGTA	GAAACACCGGTCGATTCATATCGAAACCTTCCCGTGACAGTGGGGTTAGA	1	bc
AGCGTGTTGT	GAAACACCGGTGACATTGGGTACAGGGGTGGGGTTAGAGCTAGAAATAGC	1	bc
AGGTTCCTTT	GAAACACCGGTCTCGAGTGAGGTGTTCAGGGTGGGGTTAGAGCTAGAAAT	1	bc
ATGCTAAGAA	GAAACACCGGTTTACGTTGCATCGGTGTGGGGTTAGAGCTAGAAATAGCA	1	bc
GTTGAGAATA	GAAACACCGGTTAAGCCGAGGGTTAGAGCTAGAAATAGCAAGTTAACCTA	1	bc
TCGCTCGGTG	GAAACACCGGTTATATTTGTAAGTGTTGTGGGGTTAGAGCTAGAAATAGC	1	bc
AAACAACGCA	GAAACACCGGTTTGAACTACCGGGGTTAGAGCTAGAAATAGCAAGTTAAC	1	bc
TTCACACTCC	GAAACACCGGTGTGGCTGAGAGTCCGGCAATGGTGTGGCTGTGGGGTTAG	1	bc
GCAGTACGCC	GAAACACCGGTTTGCACTACCGGGGTTAGAGCTAGGAGTAGCAAGTTAAC	1	bc
TTCATTCGGT	GAAACACCGGTCGATTCATATCGAAACCTTCCCGTGACAGTGGGGTTAGA	1	bc
TAATCGTCGT	GAAACACCGGTGTACGTATGGACTGAACCAGGGTGTGCAAGTGGGGTTAG	1	bc
GCAGAGTCGT	GAAACACCGGTCGGCGGCAATCGTGGGTGGGGTTAGAGCTAGAAATAGCA	1	bc
GAATTCCGGC	GAAACACCGGTCGGCGGCAATCGTGGGTGGGGTTAGAGCTAGAAATAGCA	1	bc
AGAACGCCCC	GAAACACGGGTTAGAGCTAGAAATAGCAAGTTAACCTAAGGCTAGTCCGT	1	bc
TCGTGCCTAC	GAAACACCGGTTAAGCCGAGGCGTTAGAGCTAGAAATAGCAAGTTAACCT	1	bc
TAGACGGCCT	GAAACACCGGTCCGTAGGAGACCCGTGTGGCATGTACCTGTGGGGTTAGA	1	bc
CCATACCTAC	GAAACACCGGTGCCCTTACTCTCACCTGATTACTTAATCCGTGGGGTTAG	1	bc
AGCTCCGCGC	GAAACACCGGTGCATTCGAAAGTCCGGTCGTAGTGTGGACGTGGGGTTAG	1	bc
CTACCACGCC	GAAACACCGGTACCTTTGTTGATGCTGGTGTGGGGTTAGAGCTAGAAATA	1	bc
GTGGTACCTT	GAAACACCGGTTCCCGTCCAGTGGGGTTAGAGCTAGAAATAGCAAGTTAA	1	bc
GACAACGTCA	GAAACACCGGTAGCAAGTGCGAGAAGTTTTTGTTGGGTTAGAGCTAGAAA	1	bc
CATAAAACCC	GAAACACGGGTTAGAGCTAGAAATAGCAAGTTAACCTAAGGCTAGTCCGT	1	bc
GAGACCCTAG	GAAACACCGGTGCATTCGAAAGTCCGGTCGTAGTGTGGACGTGGGGTTAG	1	bc
TATACACCTG	GAAACACCGGTAAATTTGAGGCTCCGGCATGCAGGAGGCCGTGGGGTTAG	1	bc
AGAAGACTCG	GAAACACCGGTCGGCGGCAATCGTTAATCGGTTAATCGTGGGGTTAGAGC	1	bc
CACAATGAAC	GAAACACCGGTTTGCACTACCGAGCTAGAAATAGCAAGTTAACCTAAGGC	1	bc
TTAGACATTT	GAAACACCGGTTACATTGGGGTTAGAGCTAGAAATAGCAAGTCAACCTAA	1	bc
GTGTGGAGCC	GAAACACCGGTTCCCGTCCAGTGGGGTTAGAGCTAGAAATAGCAAGTTAA	1	bc
TCAGTAGGTT	GAAACACCGGTCGATTCATATCGAAACCTTCCCGTGACAGTGGGGTTAGA	1	bc
AAGCCCAAAT	GAAACACCGGTTGACACGCTAGGTGTTGAAAAACTTGTTGGTGGGGTTAG	1	bc
CCAAACCTGT	GAAACACCGGTCTCGAGCAATCGTGGCAGGGGTTGGATCGTGAAATAAAT	1	bc
GGCACATTGC	GAAACACCGGTGTGGCTGAGAGTCCGGCAGTGGTGTGGCTGTGGGGTTAG	1	bc
GTAGACATGC	GAAACACCGGTCGGCGGCAATCGTGGGTGGGGTTAGAGCTAGAAATAGCA	1	bc
GAAGAGTACT	GAAACACCGGTCTCGAGTGAGGTGTTCAGGGTGGGGTTAGAGCTAGAAAT	1	bc
CACGACGGAC	GAAACACCGGTGCCCTTACTCTCACCCGATTACTTAATCCGTGGGGTTAG	1	bc
GAACGCGCGA	GAAACACCGGTGCCCTTACTCTCACCTGATTACTTAATCCGTGGGGTTAG	1	bc
AGACGCACTC	GAAACACCGGTGCATTCGAAAGTCCGGTCGTAGTGTGGACGTGGGGTTAG	1	bc
TCTCGTGGTG	GAAACACCGGTGTACGTATGGACTGAACCAGGGTGTGCAAGTGGGGTTAG	1	bc
AGAGCGATGT	GAAACACCGGTTACATTGAGGGTTAGAGCTAGAAATAGCAAGTTAACCTA	1	bc
TATAAACCTG	GAAACACCGGTAAATTTGAGGCTCCGGCATGCAGGAGGCCGTGGGGTTAG	1	bc
TCGTTCGGTC	GAAACACCGGTCGATTCATATCGAAACCTTCCCGTGACAGTGGGGTTAGA	1	bc
AGAATCGCGG	GAAGCACCGGTTATATTTGTAATTGTGTGTGGGGTTGGAGCTAGAGATAG	1	bc
ACTTCTCCGC	GAAACACCGGTCGGGGCCACTCAGTGGGGTTAGAGCTAGAAATAGCAAGT	1	bc
CGAACTCTGC	GAAACACCGGTTACATTGAGGGGTTAGAGCTAGAAATAGCAAGTTAACAT	1	bc
GGTAGCTATG	GAAACACCGGTTATTGGGGTTAGAGCTAGAAATAGCAAGTTAACCTAAGG	1	bc
AAGTCACTAC	GAAACACCGGTGCCCTTACTCTCACCTGATTACTTAATCCGTGGGGTTAG	1	bc
GTGTCGCATC	GAAACACCGGTTCCCGTCCCGTGGGGTTAGAGCTAGAAATAGCAAGTTAA	1	bc
CCTATCGCCG	GAAACACCGGTTATATTTGTAAGTGGGGTTAGAGCTAGAAATAGCAAGTT	1	bc
AGTCGTAGCC	GAAACACCGGTTTACGTTGCATCGGTGTGGGGTTAGAGCTAGAAATAGCA	1	bc
AACATTCGGG	GAAACACCGGTCGATTCATATCGAAACCTTCCCGTGACAGTGGGGTTAGA	1	bc
ACTATAGCGC	GAAACACCGGTCGGGGCCACTCAGTGGTGGGGTTAGAGCTAGAAATAGCA	1	bc
AAATACTTGG	GAAACACCGGTACCTTTGTTGATGCTGGGTGGGGTTAGAGCTAGAAATAG	1	bc
ATTCTTCGTC	GAAACACCGGTTTACGTTGCATCGGTGTGAGGTTAGAGCTAGAAATAGCA	1	bc
AGTGGGGTAC	GAAACACCGGTGCCCTTACTCTCACCTGATTACTTAATCCGTGGGGTTAG	1	bc
TAGGCCCTCG	GAAACACCGGTGCATTCGAAAGTCCGGTCGTAGTGTGGACGTGGGGTTAG	1	bc
GACGACCTCC	GAAACACCGGTGCCCTTACTCTCACCTGATTACTTAATCCGTGGGGTTAG	1	bc
CAGGTTAGCA	GAAACACCGGTTTACGTTGCATCGGTGTGGGGTTAGAGCTAGAAATAGCA	1	bc
ATGATACCTC	GAAACACCGGTGTGGCTGAGAGTCCGGCAATGGTGTGGCTGTGGGGTTAG	1	bc
ATAACTTATT	GGAACACCGGTAACTATATTCATGCGATATCGCCGTATCAGTGGGGTTAG	1	bc
TCACCCATGT	GAAACACCGGTTACATTGAGGGTTAGAGCTAGAAATAGCAAGTTAACCTA	1	bc
AACTTTACCG	GAAACACCGGTCGGGGCCACTCAGTGGAGGTGTTAGAGATAGGAATAGCA	1	bc
ACGATCGGAT	GAAACACCGGTCGATTCATATCGAAACCTTCCCGGGACAGTCGGGTTAAA	1	bc
AGATTAGGAT	GAAACACCGGTCGATTCATATCGAAACCTTCCCGTGACAGTGGGGTTAGA	1	bc
CTGCTGGGCA	GAAACACCGGTACCTTTGTTGATGCTGGGTGGGGTTAGAGCTAGAAATAG	1	bc
AGATGGTTCA	GAAACACCGGTCCGTAGGAGACCCGTGTGGCATGTACCTGTGGGGGTAGA	1	bc
ACGTGTTGCC	GAAACACCGGTGACATTGGGTACAGGGGTGGGGTTAGAGCTAGAAATAGC	1	bc
GGTAGCCTCA	GAAACACCGGTGTGGCTGAGAGTCCGGCAATGGTGTGGCTGTGGGGTTAG	1	bc
TCATCAGGGC	GAAACTCCGGTTATATATGTTAGTGAGGGGGGGTTGAGGTAGAAATAAGC	1	bc
GGGCCATATC	GAAACACCGGTAAATCTGAGGCTCCGGCATGCAGGAGGCCGTGGGGTTAG	1	bc
TGTGCTATCT	GAAACACCGGTGTGGCTGAGAGTCCGGCAATGGTGTGGCTGTGGGGGTAG	1	bc
AGAGCGACGT	GAAACACCGGTTACATTGAGATGTTTCTAGAAATAGCAAGTTAACCTAAG	1	bc
AATCACGTAC	GAAACACCGGTGCGGCCACGTCAGGTGTGGGGTTAGAGCTAGAAATAGCA	1	bc
GTCACCTATA	GAAACACCGGTAAATTTGAGGCTCCGGCATGCAGGAGGCCGTGGGGTTAG	1	bc
AATGATGAGC	GAAACACCGGTTTACGTTTTTGTGGGGTTAGAGCTAGAAATAGCAAGTTA	1	bc
TTGATTACAC	GAAACACCGGTAACTATATTCATGCGATATCGCCGTATCAGTGGGGTTAG	1	bc
GAAGATCAGT	GAAACACCGGTCGGCGGCAATCGTGGGTGGGGTTAGAGCTAGAAATAGCA	1	bc
ACCGTTAACG	GAAACACCGGTCGGGGCCACTCAGTGGTGGGGTTAGAGCTAGAAATAGCA	1	bc
GGCATCGATC	GAAACACCGGTAGCAAGTGCGAGACGTGTTAGAGCTAGAAATAGCACCGG	1	bc
TTAACTATTG	GAAACACCGGTTACATTGAGGGTTAGAGCTAGAAATAGCAAGTTAACCTA	1	bc
ATACCTAGTT	GAAACACCGGTTTACGTTTTTGTGGGGTTAGAGCTAGAAATAGCAAGTTA	1	bc
CTGCGTGGGT	GAAACACCGGTTTACGTTGCATCGGTTTGTGGGGTTAGAGCTAGAAATAG	1	bc
ACATTGTGTA	GAAACACCGGTCGATTCATATCGAAACCTTCCCGTGGTGTTAGAGCTAGA	1	bc
TACACATGAC	GAAACACCGGTAAATTTGAGGCTCCGGCATGCAGGAGGCCGTGGGGTTAG	1	bc
GGCGCCCGCA	GAAACACCGGTCCCGGTAGAACCAAAGGCTGTGGGGTTAGAGCTAGAAAT	1	bc
AGGCCCCCTC	GAAACACCGGTGTGGCTGAGAGTCCGGCAATGGCGTGGCTGTGGGGTTAG	1	bc
TATCGATGCA	GAAACACCGGTGGATGTATGAACTTATCCAGTGGGTGCAAGTGGAGATAG	1	bc
ACAATTCCCT	GAAACACCGGTCGGGGGCCAAGTTAACCTAAGGCTAGTCCAGTTCAACTT	1	bc
CGAAGGTTAA	GAAACACCGGTTACATTGAGGGATAGAGCGAGGGATAGCAAGTTAACCTA	1	bc
TGTCATCCTC	GAAACACCGGTGTGGCTGAGAGTCCGGCAATGGTGTGGCTGTGGGGTTAG	1	bc
AATGCAATAC	GAAACACCGGTGCCCTTACTCTCACCTGATTACTTAATCCGTGGGGTTAG	1	bc
TAGGCCCGTC	GAAACACCGGTGCCCTTACTCTCACCTGATTACTTAATCCGTGGGGTTAG	1	bc
GTTCACATTA	GAAACACCGGTGTGGCTGAGAGTCCCGCAATGGTGTGGCTGTGGGGTTAG	1	bc
GTCACCATAC	GAAACACCGGTTAAGCCGAGTGCGGGTAGAGCTAGGAATAGCAAGTTAAC	1	bc
ACTAGTCGTC	GAAACACCGGTGTACGTATGGACTGAACCAGGGTGTGCAAGTGGGGTTAG	1	bc
TGACTCAGAA	GAAACACCGGTAGCAAGTGCGAGACGTGTTTGTGGGGTTAGAGCTAGAAA	1	bc
TATACTGCAC	GAAACACCGGTGACATTGGAAACATGGGGGGGGTTAAGGCTGGAAATGCC	1	bc
AGACAGTTGC	CAAAACACCGGTGCATTCGAAAGTCCGGTCGTAGTGTGGACGTGGGGTTA	1	bc
TCGTTATCGT	GAAACACCGGTCGGGGCCACTCAGTGGTGGGGTTAGAGCTAGAAATAGCA	1	bc
CACAAAGTAC	GAAACACCGGTTTGAACTACCGGGGTTAGAGCTAGAAATAGCAAGTTAAC	1	bc
GCCGACCTCA	GAAACACCGGAGCCCTTACTCTCACCTGATTACTTAATCCGTGGGGTTAG	1	bc
AACCAGCGCC	GAAACACCGGTGCCCTTACTCTCACCTGATTACTTAATCCGTGGGGTTAG	1	bc
ATGTTTGGTT	GAAACACCGGTTTACGTTGCATCGGTTGTGGGGTTAGAGCTAGAAATAGC	1	bc
AAAGACCATC	GAAACACCGGTGCATTCGAAAGTCCGGTCGTAGTGTGGACGTGGGGTTAG	1	bc
TAGCCATGGA	GAAACACCGGTTACAGTAAGGGGTTAGAGCTAGAAATAGCAAGTTAACCT	1	bc
GACGACCCTA	GAAACACCGGTCGGCGGTGGGGTTAGAGCTAGAAATAGCAAGTTAACCTA	1	bc
CACATTGGCT	GAAACACCGGTTTGAACTAGAAATAGCAAGTTAACCTAAGGCTAGTCCGT	1	bc
ACAAAACGCC	GAAACACCGGTTTGAACTAGAAATAGCAAGTTAACCTAAGGCTAGTCCGT	1	bc
TCGATGGATG	GAAACACCGGTTATATTTGTAAGTGTTTTGTGGGGTTAGAGCTAGAAATA	1	bc
ATAAGACCCG	GAAACACCGGTCGGCGGCAATCGTGGGTGGGGTTAGAGCTAGAAATAGCA	1	bc
CTCCCCTGCA	GAAACACCGGTGTGGCTGAGAGTCCGGCGATGGTGTGGCTGTGGGGTTAG	1	bc
AGGACCCGAC	GAAACACCGGTAAATTTGAGGCTCCGGCATGCAGGAGGCCGTGGGGTTAG	1	bc
GAGCCATGTA	GAAACACCGGTTCCCGTCCAGAGGTATTAGAGCTAGAAAGAGCAAGAAAT	1	bc
AGTTAGCTAT	GAAACACCGGTTACATTTGAGGGTTAGAGCTAGAAATAGCAAGTTAACCT	1	bc
AGAAGACCGG	GAAACACCGGTCGGCGGTGGGGTTAGAGCTAGAAATAGCAAGTTAACCTA	1	bc
GCCTCCTACT	CCGGTAAATTTGAGGCTCCGGCATGCAGGAGGCCGTGGGGTTAGAGCTAG	1	bc
ATGTAGCGAG	GAAACACCGGTGAGACTGGGAAGCGGGCGGTGTTAGAGCTAGAAATATCA	1	bc
ACACAATGCC	GAAACGCCGGTACCCTGCTGGGTTAGAGCTAGAAATAGCAAGTTAACCTA	1	bc
GATCTCACCT	GAAACACCGGTTACATTGGGGTTAGAGCGAGGAATGGCGAATTAACCTAA	1	bc
CGATTACCGT	GAAACACCGGTCTCGAGTGATGTGCTCAGGGTGGGGTTAGAGCTAGAAAT	1	bc
AAGGCTTAGC	GAAACACCGGTTTACGTTGCATCGGTGTGGGGTTAGAGCTAGAAATAGCA	1	bc
ACACAAAGCC	GAAACACCGGTTTGAACTAGAAATAGCAAGTTAACCTAAGGCTAGACCGT	1	bc
AGAGTGATTC	GAAACACCGGTCCGTAGGAGACCCGTGTGGCATGTACCTGTGGGGTTAGA	1	bc
ATAACTCATA	GAAACACCGGTAACTATATTCATGCGATATCGCCGAGTGGGGTTAGAGCT	1	bc
ACTACTAGCC	GAAACACCGTTACCTTTGTTGATGCTGGGTGGGGTTAGAGCTAGAAATAG	1	bc
CGAGACGCTT	GAAACACCGGTGCATTCGAAAGTCCGGTCGTAGTGTGGACGTGGGGTTAG	1	bc
GCTTTGCAGC	GAAACACCGGTCGGGGCCACTCAGTGGTGGGGTTAGAGCTAGAAATAGCA	1	bc
AAGGACCTTC	GAAACACCGGTGCCCTTACTCTAACCTGATTACTTAATCCGTGGGGTTAG	1	bc
GTTAGCTAAG	GAAACACCGGTTACATTGAGGGTTAGAGCTAGAAATAGCAAGTTAACCTA	1	bc
ATAGAGATGT	GAAACACCGGTTACATTGAGATGCTGCTAGAAATAGCAAGTTAACCTAAG	1	bc
TAAGATAGGA	GAAACACCGGTTACATTGAGATGTTGCTAGAAATAGCAAGTTAACCTAAG	1	bc
AAGATGCCTC	GAAACACGGGTCCGTAGGAGACCCGGGAGGCATATACCTGTGGAGTTAGA	1	bc
TGAAGCGTTT	GAAACACCGGTCTCGAGTGAGGTGTTCAGGGTGGGGTTAGAGCTAGAAAT	1	bc
AGTGGAGCCA	GAAACACCGGTTCCCGTCCAGTGGGGTTAGAGCTAGAAATAGCAAGTTAA	1	bc
GTCACCGAGA	GAAACACCGGTAGCAAGTTAACCTAAGGCTAGTCCGTTATCAACTTGAAA	1	bc
AAGGTCGTAG	GAAACACCGGTGCCCTTACTCTCACCTGATTACTTAATCCGTGGGGTTAG	1	bc
AACAAAGCAC	GAAACACCGGTTTGAACTACCGGGGTTAGAGCTAGAAATAGCAAGTTAAC	1	bc
GGAACCCGCT	GAAACACCGGTGTGGCTGAGAGTCCGGCAATGGTGTGGCTGTGGGGTTAG	1	bc
GGATCCTACC	GAAACACCGGTAAATTTGAGGCTCCGGCATGCAGGAGGCCGTGGGGTTAG	1	bc
AGACAATAGC	GAAACACCGGTGCATTCGAAAGTCCGGTCGTAGTGTGGACGTGGGGTTAG	1	bc
AGACAACGCC	GAAACACCGGTTTGAACTACCGGGGTTAGAGCTAGAAATAGCAAGTTAAC	1	bc
ACTACTAGGC	GAAACACCGGTACCTTTGTTGATGGGGTTAGAGCTAGAAATAGCAAGTTA	1	bc
GAGACAGCAA	GAAACACCGGTAGCAAGTGCGAGACGTGTTAGAGCTAGAAATAGCACCGG	1	bc
AAAAAACGCC	GAAACACCGGTTTGAACTACCGGGGTTAGAGCTAGAAATAGCAAGTTAAC	1	bc
AATCTCGAGG	GAAACACCGGTTATATTTGTAAGTGGGGTTAGAGCTAGAAATAGCAAGTT	1	bc
ACCCAACGCC	GAAACACCGGTTTGAACTACCGGGGTTAGAGCTAGAAATAGCAAGTTAAC	1	bc
ACGTGTTGTA	GAAACACCGGTGACATTGGGTACAGGGGTGGGGTTAGAGCTAGAAATAGC	1	bc
GTGAAGACCC	GAAACACCGGTTCCCGTCCAGTGGGGTTAGAGCTAGAAATAGCAAGTTAA	1	bc
AACGAGCTAT	GAAACACCGGTGCCCTTACTCTCACCTGATTACTTAATCCGTGGGGTTAG	1	bc
GAAAGTTGTA	GAAACACCGGTAACTATATTCATGCGATATCGCCGGATCAGTGGGGTTAG	1	bc
GACGTCGACT	GAAACACCGGTCTCGAGTGAGTAGTTCAGGGGGGGGTTAGAGCTAGAAAT	1	bc
CCACTGGGTC	GAAACACCGGTACCTTTGTTGATGCTGGGTGGAAGGAGCTAGATGCTGGT	1	bc
CGTCTGCCAA	GAAACACCGGTCCGTAGGAGACCCTTGTGGCATGTACCTGTGGGGTTAGA	1	bc
TATCTGCCTA	GAAACACCGGTCCGTAGGAGACCCGTGTGGCGTGTACCTGTGGGGTTAGA	1	bc
AACTTCGGTC	GAAACACCGGTCGATTCATATCGAAACCTTCCCGTGACAGTGGGGTTAGA	1	bc
ACTTTAACGT	GAAACACCGGTCGGGGCCACTCAGTGGTGGGGTTAGAGCTAGAAATAGCA	1	bc
ACTCCCTGTT	GAAACACCGGTCGATTCATATCGAAACCTTCCCGTGACAGTGGTGTTAGA	1	bc
GTGCCCTGCA	GAAACACCGGTGTGGCTGAGAGTCCGGCAATGGTGTGGCTGTGGGGTTAG	1	bc
GGGAGCCTAA	GAAACACCGGTGTGGCTAAGAGTCCGGCAATGGTGTGGCTGTGGGGTTAG	1	bc
AAACCCCTTC	GAAACACCGGTGCCCTTAATCTCACCTGATTACTTAATCCGTGGGGTTAG	1	bc
GTTGCGCAGC	GAAACACCGGTTTACGTTGCATCGGTGTGGGGTTAGAGCTAGAAATAGCA	1	bc
ATAATCCTGT	GAAACACCGGTTTGAACTAGAAATAGCAAGTTAACCTAAGGCTAGTCCGT	1	bc
ATGCATCGAT	GAAACACAAGTTTACGTTTACGGGGTTAGAACTAGAAATAGCAAGTTAAC	1	bc
ATCATTCCCG	GAAACACCGGTCGGGGCCACTCAGTGGTGGGGTTAGAGCTAGAAATAGCA	1	bc
GCTCAACGCC	GAAACACCGGTTCCCGTCCAGTGGGGTTAGAGCTAGAAATAGCAAGTTAA	1	bc
TCCTTGACCG	GAAACACCGGTCGGGGCCACTCAGTGGTGGGGTTAGAGCTAGAAATAGCA	1	bc
GATCCCCGCA	GAAACACCGGTGTATTTGCGGCTCCGGCATGCAGGAGGCAGTGGGGTTAG	1	bc
TCTTTTAGCG	GAAACACCGGTCGGGGCCACTCAGTGGTGGGGTTAGAGCTAGAAATAGCA	1	bc
ACTAACCGGT	GAAACACCGGTACCTTTGTTGATGCTGGGTGGGGTTAGAGCTAGAAATAG	1	bc
ATCTATCGCG	GAAACACCGGTTATATTTGTAAGTGTGTGGGGTTAGAGCTAGAAATAGCA	1	bc
GACCTTTAGC	GAAACACCGGTCGGGGCCACTCAGTGGTGGGGTTAGAGCTAGAAATAGCA	1	bc
AGGCAGCATG	GAAACACCGGTGTGGCTGAGAGTCCGGCAATGGTGTGGCTGTGGGGTTAG	1	bc
AGAAGCCCCG	GAAACACCGGTCGGTGGGGTTAGAGCTAGAAATAGCAAGTTAACCTAAGG	1	bc
AGAAGATCCG	GAAACACCGGTCGGCGGCTAGAAATAGCAAGATAACCTAAGGCTAGTCCG	1	bc
CCGTTATCGA	GAAACACCGGTCGGGGCCACTCCGTGGTGGGGTTAGAGCTAGAAATAGCA	1	bc
AACACCATCA	GAAACACCGGTGCCCTTACTCTCACCTGATTACTTAATCCGTGGGGTTAG	1	bc
GGAACCGACA	GAAACACCGGTAAATTTGAGGCTCCGGCATGCAGGAGGCCGTGGGGTTAG	1	bc
TAAATGGTGG	GAAACACGGGTTATATTTGTACGGGTATGGGGTTAGGGCTAGAAATAACA	1	bc
TACATCGCAC	GAAACACCGGTTTGAAATAGCAAGTTAAACTACGGCTAGTCCGTTATCAA	1	bc
GTACAGTTTT	GAAACACCGGTTCCCGCACAAGTGGGGTTAGAGCTAGAAATAGCAAGTTA	1	bc
TTGATGCTAC	GAAACACCGGTCCGGAGGAGACCCGAGTGGCATGTACCTTGTGGGGTTAG	1	bc
AAGGCCAGAT	GAAACACCGGTGCCCTTACTCTCACCTGATTACTTAATCCGTGGGGTTAG	1	bc
AAGAATCGTT	GAAACACCGGTCTCGAGTGAGGTGTTCAGGGTGGGGTTAGAGCTAGAAAT	1	bc
GTCAGACTAA	GAAACACCGGTGTGGCTGAGAGTCCGGCAATGGTGTGGCTGTGGAGTTAG	1	bc
ACTTCGTAGA	GAAACACCGGTGTACGTATGGACTGAACCAGGGTGTGCAAGTGGGGTTAG	1	bc
CACCTGCATC	GAAACACCGGTGTACGTATGGACTGAACCAGGGTGTGCAAAGTGGGGTTA	1	bc
ATTGTTACCA	GAAACACCGGTTTACGTCGCATCGGTGTGGGGTTAGAGCTAGAAATAGCA	1	bc
AGAAGACCAA	GAAACACCGGTCGGCGGCAATCGTGGGTGGGGTTAGAGCTAGAAATAGCA	1	bc
CAACATCGTT	GAAACACCGGTGTACGTATGGACTGAACCAGGGTGTGCAAGTGGGGTTAG	1	bc
TCCAGCGTGG	GAAACACCGGTTATATTTGTAAGTGTGTGGGGTTAGAGCTAGAAATAGCA	1	bc
CAAGAATCTC	GAAACACCGGTGCATTCGAAAGTCCGGTCGTAGTGTGGACGTGGGGTTAG	1	bc
AAAGACATAC	GAAACACCGGTGCCCTTACTCTCACCTGATTACTTAATCCGTGGGGTTAG	1	bc
AGGATCCGTT	GAAACACCGGTCTCGAGTGAGGTGTTCAGGGTGGGGTTAGAGCTAGAAAT	1	bc
AAATAGTCGT	GAAACACCGGTGTACGTATGGACTGAACCAGGGTGTGCAAGTGGGGTTAG	1	bc
AACTGGCTAT	GAAACACCGGTGCCCTTACTCTCACCTGATTACTTAATCCGTGGGGTTAG	1	bc
ATATACGGCC	GAAACACCGGTACCTTGGTTGATGATGGGTGGATAGAGTGTGGGGTTAGA	1	bc
AATAGCCCTA	GAAACACCGGTGCCCTTACTCTCACCTGATTACTTAATCCGTGGGGTTAG	1	bc
CCATTATCTC	GAAACACCGGTCGGGGCCACTCAGTGGTGTGGTTAGAGCTAGAAATAGCA	1	bc
ATCCTGTTCT	GCAACACCGGTGTTAGAGCTAGAAATAGCAAGTTAACCTAAGGCTAGTCC	1	bc
ACGGGCCTAA	GAAACACCGGTACCCTGGCTGGCACCTGAGTACTTAATCTAGGAGTATAG	1	bc
GCTATTCGGC	GAAACACCGGTGCTTTTTTTCCTGCAGGGGCCGAGTAGGAATTCGGGCCC	1	bc
GGCACGAGCG	GAAACACCGGTGTGGCTGAGAGTCCGGCAATGGTGTGGCTGTGGGGTTAG	1	bc
ACTTTAGTGC	GAAACACCGGTCGGGGCCACTCAGTGGTGGGGTTAGAGCTAGAAATAGCA	1	bc
TAGCTTAGCC	GAAACACCGGTAACTATATTCATGCGATATCGCCGTATCAGTGGGGTTAG	1	bc
CTCCCATGCA	GAAACACCGGTGTGGCTGAGAGTCCGGCAATGGTGTGGCTGTGGGGTTAG	1	bc
AATGCTTGGC	GAAACACCGGTTTACGTTGCATCGGTGTGGGGTTAGAGCTAGAAATAGCA	1	bc
GACTATCGAG	GAAACACCGGTTATATTTGTAAGTGTTGTGGGGTTAGAGCTAGAAATAGC	1	bc
ACTAATCGGA	GAAACACCGGTACCTTTGTTGATGCCGGGTGGAAGGAATTTGTGGGGTTA	1	bc
CTGGTGTTGT	GAAACACCGGTTACATTGAGGGTTAGAGCTAGAAATAGCAAGTTACCATA	1	bc
GGCCTCGCAC	GAAACACCGGTAAATTTGAGGCTCCGGCATGCAGGAGGCCGTGGGGTTAG	1	bc
AAGACACCCG	GAAACACCGGTGCATTCGAAAGTCCGGTCGTAGTGTGGACGTGGGGTTAG	1	bc
AGTATAGCGA	GAAACACAGGTCGGGGCCACTCAGTGGGGGGGTTAGAGCTAGAAATAGCA	1	bc
AGGCCCCCTT	GAAACACCGGTGTGGCTGAGAGTCCGGCAATGGTGTGGCTGTGGGGTTAG	1	bc
GCCTCAGAAA	GAAACACCGGTAGCAAGTGCGGAAGCTAGAAATAGCAAGTTAACCTAAGG	1	bc
AAAAAAGGTG	GAAACACCGGTCGGCGGCAATCGTGGGTGGGGTTAGAGCTAGAAATAGCA	1	bc
CTATACGGTA	GAAACACCGGTACCTTTGTTGATGCTGGGTGTGGGGTTAGAGCTAGAAAT	1	bc
GACTGGAGGT	GAAACACCGGTTCCCGTCCAGGCGGGGTAGAGCTAGAGCTAGCAAGATAA	1	bc
GAGCCCGATA	GAAACACCGGTAAATTTGAGGCTCCGGCATGCAGGAGGCCGTGGGGTTAG	1	bc
GAGTGGATAT	GAAACACCGGTTAAGCCGAGGGTTAGAGCTAGAAATAGCAAGTTAACCTA	1	bc
AGGAAGACTC	GAAACACCGGTGTGGCTGAGAGTCCGGCAATGGTGTGGCTGTGGGGTTAG	1	bc
CGTGGTGGTT	GAAACACCGGTGTTAGAGCTAGAAATAGCAAGTTAACCTAAGGCTAGTCC	1	bc
AGACGCGCGA	GAAACACCGGTGCATTCGAAAGTCCGGTCGTAGTGTGGACGTGGGGTCAG	1	bc
AAGAATTCTT	GAAACACCGGTCTCGAGTGAGGTGTTCCGGGTGGGGTTAGAGCTAGAAAT	1	bc
CGAGCCTCCC	GAAGCACCGGTGCTTTCGAAAGTCCGGTCGTATTGTGGGCGTGGGTTATG	1	bc
AGACCGTGGG	GAAACACCGGTGCATTCGAAAGTCCGGTCGTAGTGTGGACGTGGGGTTAG	1	bc
AAAGCTCATC	GAAACACCGGTGCCCTTACTCTCACCTGATTACTTAATCCGTGGGGTTAG	1	bc
TGTACCGCGT	GAAACACCGGTGCATTCGAAAGTCCGGTCGTAGTGTGGACGTGGGGATAG	1	bc
CGGGGTGTGC	GAAACACCGGTGACATTGGGTACGAAATAGCAAGTTAACCTAAGGCTAGT	1	bc
GATACCGTAA	GAAACACCGGTAGCAAGTGCGGTAGCAAGTGCGGGCGGGGTTAGAGCTAG	1	bc
TTCAATCGCG	GAAACACCGGTTATATTTGTAAGTGTGTGGGGTTAGAGCTAGAAATAGCA	1	bc
ATAACTAATA	GAAACACCGGTAACTATATTCATGCGATATCGCCGTATCAGTGGGGTTAG	1	bc
GGAGCCAGCC	GAAACACCGGTGTGGCTGAGAGTCCGGCAATGGTGTGGCTGTGGGGTTAG	1	bc
ATCGCGCTCC	GAAACACCGGTGCCCTTACTCTCACCTGATTACTTAATCCGTGGGGTTAG	1	bc
ATTGAGAATA	GAAACACCGGTTAAGCCGTGGGGTTAGAGCTAGAAATAGCAAGTTAACCT	1	bc
TTACGCATAC	GAAACACCGGTTAAGCCGAGGAGTTAGAGCTAGAAATAGCAAGTTAACCT	1	bc
AGACATTCGG	GAAACACCGGTCGATTCATATCGAAACCTTCCCGTGACAGTGGGGTTAGA	1	bc
GAGAGAGGAA	CAAAACACCGGTAGCAAGTGCGAGACATGTTTTAGAGCTAGAAATAGCAA	1	bc
ATACTCAGGC	GAAACACCGGTTTACGTTGCATCGGGGTTAGAGCTAGAAATAGCAAGTTA	1	bc
TTGGATACGC	GAAACACCGGTTCCCGTCCAGTGGGGTTAGAGCTAGGAATAGCAAGTTAA	1	bc
GTGGATACTA	GAAACACCGGTTCCCGTCCAGTGGGGTTAGAGCTAGAAATAGCAAGTTAA	1	bc
TAACGGCGTT	GAAACACCGGTGTACGTATGGACTGAACCAGGGTGTGCAGGGGGGGGGAT	1	bc
GCGAATTCTT	GAAACACCGGTCTCGAGTGAGGTGTTCAGGGTGGGGTTAGAGCTAGAAAT	1	bc
CTGCATATCT	GAAACACCGGTTTACGTTGCATCGGTGTGGGGTTAGAGCTAGAAATAGCA	1	bc
ACTCTATCGT	GAAACACCGGTCTGGGCCTCTCAAGGGTTGGGGTAGATCTAGCAAGAACA	1	bc
GCCACATACC	GAAACACCGGTAGCAAGTGCGAGACGTGTTAGAGCTAGAAATAGCAAGTT	1	bc
CAGGGGCCTC	GAAACACCGGTTCCCGTCCAGTGGGGTTAGAGCCAGAAATAGCAAGTTAA	1	bc
CATGTCTGTT	GAAACACCGGTGACATTGTGGACAGTCACAGGGGGGGGTTAGAGCTAGAA	1	bc
ATTGCTCAAC	GAAACACCGGTAAATTTGAGGCTCCGGCATGCAGGAGGCCGTGGGGTTAG	1	bc
AATTTACTGC	GAAACACCGGTCGGGGCCACTCAGTGGTGGGGTTAGAGCTAGAAATAGCA	1	bc
AAAGCTGTGT	GAAACACCGGTTACATTTGAGGGTTAGAGCTAGAAATAGCAAGTTAACCT	1	bc
TGAATTCTAT	GAAACACCGGTCTCGAGTGAGGTGTTCAGGGTGGGGTTAGAGCTAGAAAT	1	bc
GATAACGAGC	GAAACACCGGTCGGCGGCAATCGTGGGTGGGGTTAGAGCTAGAAATAGCA	1	bc
CATCACTTAT	GAAACACCGGTAACTATATTCATGCGATATCGCCGTATCAGTGGGGTTAG	1	bc
CGTCTTGCGC	GAAACACCGGTGACAATTGGGGTTAGAGATAGAAATAGCAAGTTAACCTA	1	bc
AGACCTTGCA	GAAACACCGGTGTGGCTGAGAGTCCGGCAATGGTGTGGCTGTGGGGTTAG	1	bc
TAACCCGGCA	GAAACACCGGTAAATTTGAGGCTCCGGCATGCAGGAGGCCGTGGGGTTAG	1	bc
AATCCACTTC	GAAACACCGGTACCCTTACTCTCACCTGATGACTTAATCCGTGGGGTTAG	1	bc
AAAGACCTGA	GAAACACCGGCTCGGGGTTAGAGCTAGAAGTAGCAAGTTAACCTAAGGCT	1	bc
ACGCGGCCAC	GAAACACCGGTCCGTAGGAGACCCGTGTGGCATGTACCTGTGGGGTCAGA	1	bc
GGACGCTGGG	GAAACACCGGTGCATTCGAAAGTCCGGTCGTAGTGTGGACGTGGGGTTAG	1	bc
GGCATTCTGC	GAAACACCGGTGTGGCTGAGAGTCCGGCAATGGTGTGGCTGTGGGGTTAG	1	bc
GTGGCGACGC	GAAACACCGGTTCCCGTCCAGTGGGGTTAGAGCTAGAAATAGCAAGTTAA	1	bc
GGAACCGTGA	GAAACACCGGTGTGGCTGAGAGTCCGGCAATGGTGTGGCTGTGGGGTTAG	1	bc
AGTGTTGCCC	GAAACACCGGTCCGTATGAGACGCGTGTGGCATGTACCTTTGGGGTTAGA	1	bc
GGACACCTCT	GAAACACCGGTGTGGCTGAGAGTCCGGCAATGGTGTGGCTGTGGGGTTAG	1	bc
CCGACACCGA	GAAACACCGGTCGGGGCCACTCAGGGGTGGGGGTAGAGCTAGAAATAGCA	1	bc
ACCTTCGGCA	GAAACACCGGTCGATTCATATCGAAACCTTCCCGTGACAGTGGGGGTAGA	1	bc
TCAATCATTT	GAAACACCGGTCTCGAGTGAGGTGTTCAGGGTGGGGTTAGAGCTAGAAAT	1	bc
CCTCGACGCC	GAAACACCGGTGTACGTATGGACTGAACCAGGGTGTGCAAGTGGGGTTAG	1	bc
GAAGACGATC	GAAACACCGGTCTCGAGTGAGGTGTTCAGGGTGGGGTTAGAGCTAGAAAT	1	bc
CTATTGTGCC	GAAACACCGGTACCTTTGTTGATTTTTGCTGGGTTAGAGCTAGAAATAGC	1	bc
TAAACCCGGC	GAAACACCGGTCGGCGGGGTTAGAGCTAGAAATAGCAAGTTAACCTAAGG	1	bc
GCATCGTGGT	GAAACACCGGTGTACGTATGGACTGAACCAGGGTGTGCAAAGTGGGGTTA	1	bc
AACAAAGCAG	GAAACACCGGTTTGAACTACCTAGTTCAAACCGGTGGGGTTAGAGCTAGA	1	bc
AAAAGCGCCC	GAAACACCGGTTTGAACTAGAAATAGCAAGTTAACCTAAGGCCAGTCCGT	1	bc
CATTGAGCAT	GAAACACCGGTTAAGCCGAGGGTTAGAGCTAGAAATAGCAAGTTAACCTA	1	bc
ACCTTTAACG	GAAACACCGGTCGGGGCCACTCAGTGGTGGGGTTAGAGCTAGAAGTAGCA	1	bc
ACCGCTTAGC	GAAACATCGGTTTACGTTGCATCGGTTGTGGGGTTAGAGCTAGAAATAGC	1	bc
AGACCCCTTC	GAAACACCGGTGCATTCGAAAGTCCGGTCGTAGTGTGGGCGTGGGGTTAG	1	bc
TGAACTATGC	GAAACACCGGTTACATTGGGGTTAGAGCTAGAAATAGCAAGTTAACCTAA	1	bc
ATTGAGCATC	GAAACACCGGTTAAGCCGAGTGGGGTTAGAGCTAGAGATAGCAAGTTAAC	1	bc
ACATCGACGT	GAAACACCGGTGTACGTATGGACTGAACCAGGGTGTGCAAGTGGGGTTAG	1	bc
GATCTATCGA	GAAACACCGGTTATATTTGTAAGTGTGTGGGGTTAGAGCTAGAAATAGCA	1	bc
AGAAGACACG	GAAACACCGGTCGGCGGCAATCGCGGGGTGGGGTTAGAGCTAGAAATAGC	1	bc
GTGGCGACCC	GAAACACCGGTTCCCGTCCAGTGGGGTTAGAGCTAGAAATAGCAAGTTAA	1	bc
ACGCTCGACT	GAAACACCGGTTTACGTTGCATCGGTGTGGGGTTAGAGCTAGAAATAGCA	1	bc
CAGAGCGCAC	GAAACACCGGTTTAGCCTACCTATATAGCTAGTTAGAGCTAGTAAACGTA	1	bc
ATCATAAGAT	GAAACACCGGTTTACGTTGCATCGGTGTGGGGTTAGAGTTAGAAATAGCA	1	bc
GCCTTAACCG	GAAACACCGGTCGGGGCCACTCAGTGGTGGGGTTAGAGCTAGAAATAGCA	1	bc
GGCCGTCTCC	GGTGTGGCTGAGAGTCCGGCAATGGTGTGGCTGTGGGGTTAGAGCTAGAA	1	bc
ACTTTTACGC	GAAACACCGGTCGGGGCCACTCAGTGGTGGGGTTAGAGCTAGAAATAGCA	1	bc
CCGTTCCTTA	GAAACACCGGTCTAGAGTGAGGGGTTCAGGGTGGGGTTAGAGCTAGAAAT	1	bc
AAAAATGACC	GAAACACCGGTTTGAACTACCGGGGTTAGAGCTAGAAATAGCAAGTTAAC	1	bc
GACATAAATA	GAACACCGGTAGCAAGTGCGGGACGTTTTTTGCGGGGTTACAGCTAGAAA	1	bc
CCGCGAGGTA	GAAACACCGGTGTACGTATGGACTGAACCAGGGTGTGCAAGTGGGGTTAG	1	bc
AGGCCCAGGC	GAAACACCGGTGCATTCGAAAGTCCGGTCGTAGTGTGGACGTGGGGTTAG	1	bc
TAGACAGATA	GAAACACCGGTAGCAAGTGCGAGACGGGTTTTAGAGCTAGAAATAGCAAG	1	bc
AACTTCCCAC	GAAACACCGGTGCCCTTACTCTCACCTGATTACTTAATCCGTGGGGTTAG	1	bc
GGGACTGCAT	GAAACACCGGTGTGGCTGAGAGTCGGGCAGTGGGGTGGGTGTGGGGTTAG	1	bc
AGTCGGGATC	GAAACACCGGTCCGTAGGAGACCCGTGTGGCATGTACCTGTGGGGTTAGA	1	bc
TCATCCGGGG	GAGACACCGGTTATTTTTGTAAGGGGGGATAGAGCTAGAAATAGAAAGAT	1	bc
ACGAATCATT	GAAACACCGGTCTCGAGTGGGGTGTTCAGGGTGGGGTTAGAGCTAGAAAT	1	bc
GCCATTCGGT	GAAACACCGGTCGATTCATATCGAAACCTTCCCGTGACAGTGGGGTTAGA	1	bc
ACTAGATAAG	GAAACACCGGTTACATTGAGATTGGGGTTGGAGCTAGAAATAGCAAGTTA	1	bc
CACATACTAT	GAAACACCGGTCTCGAGTGAGGTGTTCAGGGTGGGGTTAGAGCTAGAAAT	1	bc
GAAGCGACGC	GGAAAACCGGTCGGCGGCAATCGTGGGTGGGGTTAGAGCTAGAAATAGCA	1	bc
TACGCCACAC	GAAACACCGGTGCCCTTACTCTCACCTGATTACTTAATCCGTGGGGTTAG	1	bc
TAGTATGGCT	GAAACACCGGTCCGTAGGAGACCCGTGTGGCATGTACCTGTGGGGTTAGA	1	bc
AACCCAGCCA	GAAACACCGGTTTGAACTAGAAATAGCAAGTTAACCTAAGGCTAGTCCGT	1	bc
AATATGTAGG	GAAACACCGGTTATATTTGTAAGTGTGTGGGGTTAGAGCTAGAAATAGCA	1	bc
AGGACCATAC	GAAACACCGGTAAATTTGAGGCTCCGGCATGCAGGAGGCCGTGGGGTTAG	1	bc
ACAACCTCGT	GAAACACCGGTGCATTCGAAAGTCCGGTCGTAGTGTGGACGTGGGGTTAG	1	bc
GAAGTCTTCC	GAAACACCGGTCCGTAGGAGACCCGTGTGGCATGTACCTGTGGGGTTAGA	1	bc
GAGGTAACTC	GAAACACCGGTTCCCGTCCAGTGGGTTTAGAGCTAGAAATAGCAAGTTAA	1	bc
GGAGTCCCTC	GAAACACCGGTCGGCGGCAATCGTGGGTGGGGCTAGAGCTAGAAATAGCA	1	bc
GTGGACCAGT	GAAACACCGGTCGGCGGCAATCTAGGGTTAGAGCTAGAAATAGCAAGTTA	1	bc
AAGAACGACC	GAAACACCGGTTTGAACTAGAAATAGCAAGTTAACCTAAGGCTAGTCCGT	1	bc
GGCTGCTACC	GAAACACCGGTAAATTTGAGGCTCCGGCATGCAGGAGGCCGTGGGGTTAG	1	bc
AATAACGCAC	GAAACACCGGTTTGAACTAGAAATAGCAAGTTAACCTAAGGCTAGTCCGT	1	bc
AAAGCTTAGC	GAAACACCGGTTTACGTTGCATCGGTTGTGGGGTTAGAGCTAGAAATAGC	1	bc
ATCTAGCGAG	GAAACACCGGTTATATTTGTAAGTGTGTGGGGTTAGAGCTAGAAATAGCA	1	bc
AGAACGCCTC	GAAACACCGGTCCGTAGGAGACCCGTGTGGCATGTACCTGTGGGGTTAGA	1	bc
CACATCCTGC	GAAACACCGGTGTGGCTGAGAGTCCGGCAATGGTGTGGCTGCGGGGGTAA	1	bc
CTTTTACTGA	GAAACACCGGTCGGGGCCACTCAGTGGTGGGGTTAGAGCTAGAAATAGCA	1	bc
AAAATGCGGT	GAAACACCGGTCGATTCATATCGAAACCTTCCCGTGACAGTGGGGTTAGA	1	bc
AAGCATATAT	GAAACACCGGTCTCGAGGGAGGTGTTCAGGGTGGGGTTAGAGCTAGAAAT	1	bc
AAGAGTGGAC	GAAACACCGGTCCAGCCGAGTGGGGTTAGAGCTAGAAATAGCAAGTTAAC	1	bc
CTCCATAGGC	GAAACACCGGTTTACGTTGCATCGGCGCGGGGTTAGAGCTAGAAATAGCA	1	bc
GATGATTAGT	GAAACACCGGTTTACGTTGCATCGGTGTGGGGTTAGAGCTAGAAATAGCA	1	bc
TCATAGTCCT	GAAACACCGGTGTACGTATGGACTGAACCAGGGTGTGCAAGTGGGGTTAG	1	bc
CAAAAAGCCA	GAAACACCGGTTTGAACTACCGGGGTTAGAGCTAGAAATAACAAGTTAAC	1	bc
TATGCTGAGC	GAAACACCGGTTTACGTTGCATCGGTTGTGGGGTTAGAGCTAGAAATAGC	1	bc
GGAGATGTGT	GAAACACCGGTTACATTGAGGGTTAGAGCTAGAAATAGCAAGTTAACCTA	1	bc
TGAACCATCC	GAAACACCGGTGTGGCTGAGAGTACGGCAATGGTGTGGCTGTGGGGTTAG	1	bc
AAACCTCGGT	GAAACACCGGTTACATTGGGGTTAGAGCTAGAAATAGCAAGGTAACCTAA	1	bc
ATTGAGAATA	GAAACACCGGTTAAGCCGAGGGTTAGAGCTAGAAATAGCAAGTTAACCTA	1	bc
AGTCCCCTAC	GAAACACCGGTAAATTTGAGGCTCCGGCATGCAGGAGGCCGTGGGGTTAG	1	bc
CTTCACGGTC	GAAACACCGGTACCTTTGTTGATGCTGGGTGGTTTGTGGGGTTAGAGCTA	1	bc
GACCCTGAGA	GAAACACCGGTAGCAAGTGGGGTTAGAGCTAGAAATAGCAAGTTAACCTA	1	bc
TGTGCTTAGC	GAAACACCGGTTTACGTTGCATCGGGGTTAGAGCTAGAAATAGCAAGTTA	1	bc
AGACACAGTC	GAAACACCGGTAGCAAGTGCGAGACGTGTTTGTGGGGTTAGAGCTAGAAA	1	bc
ATGTGTATCA	GAAACACCGGTTTACGTTGCATCGGTGTGGGGTTAGAGCTAGAAATAGCA	1	bc
GCTTTTCCCG	GAAACACCGGTCGGGGCCACTCAGTGGTGGGGTTAGAGCTAGAAATAGCA	1	bc
AGGGACCCTC	GAAACACCGGTGTGGCTGAGAGTCCGGCAATGGTGTGGCTGTGGGGTTAG	1	bc
CTGAGTATTA	GAAACACCGGTTAAGCCGAGGATTAGAGCTAGAAATAGCAAGTTAACCTA	1	bc
GAGACAGTCG	GAAACACCGGTGCATTCGAAAGTCCGGTCGTAGTGTGGACGTGGGGTTAG	1	bc
AGTCCAGCTA	GAAACACCGGTGCATTCGAAAGTCCGGTCGTAGTGTGGACGTGGGGTTAG	1	bc
ATAGATAAGT	GAAACACCGGTTACATTGGGGTTAGAGCTAGAAATAGCAAGTTAACCTAA	1	bc
GCGTACTTGC	GAAACACCGGTCGGCGGGAATCGTGGGTGGGGTTAGAGCTAGAAATAGCA	1	bc
AGAACAGTTT	GAAACACCGGTCGCGAGTGAGGGGCTCGTTTGTGGGGTAAGAGCTAGAAA	1	bc
AACCACGCTC	GAAACACCGGTTTGAACTACCGGGGTTAGAGCTAGAAATAGCAAGTTAAC	1	bc
AGTTAGCTAT	GAAACACCGGTTACATTGAGTGGGGTTAGAGCTAGAAATAGCAAGTTAAC	1	bc
GGCAGCATAC	GAAACACCGGTGTGGCTGAGAGTCCGGCAATGGTGTGGCTGTGGGGTTAG	1	bc
TCTCTCGTTG	GAAACACCGGTTATATTTGTAAGTGTGTGGGGTTAGAGCTAGAAATAGCA	1	bc
CGTTTATAGC	GAAACACCGGTCGGGGCCACTCAGTGGTGGGGTTAGAGCTAGAAATAGCA	1	bc
GGCAGCCGCT	GAAACACCGGTGTGCCTGAGAGTCCGGCGATGGTGTGGCTGGGGGGTTCG	1	bc
ACATCGTGGT	GAAACACCAGTGTACGTATGGACTGAACCAGGGTGTGCAAGTGGGGTTAG	1	bc
ACATGAGATT	GAAACACCGGTCGATTCATATCGAAACCTTCCCGTGACAGTGGGGTTAGA	1	bc
ACCTTTAACG	GAAACACCGGTCGGGGCCACTCAGTGGGGTTAGAGCTAGAGATAGCAAGT	1	bc
GTCAAACTGC	GAAACACCGGTGTGGCTGAGAGTCCGGCAATGGTGTGGCTGTGGGGTTAG	1	bc
AAGTATGCCT	GAAACACCGGTCCGTAGGAGACCCGTGTGGCATGTACCTGTGGGGCTAGA	1	bc
ACGTGTCGTC	GAAACACCGGTGACATTGGGGTTAGAGCTAGAAATAGCAAGTTAACCTAA	1	bc
CTGCTCAGTC	GAAACACCGGTTTACGTTGCATCGTGGGGTTAGAGCTAGAAATAGCAAGT	1	bc
CCCAAAGCAC	GAAACACCGGTTTGAACTACCGGGGTTAGAGCTAGAAATAGCAAGTTAAC	1	bc
GCTCGGCGCC	GAAACACCGGTGTACGTATGGACTTAACCAGGGTGTGCAAGTAGGGTTAG	1	bc
AATGCGTAGG	GAAACACCGGTTTACGTTGCATCGGGGTTAGAGCTAGAAATAGCAAGTTA	1	bc
GAGGACCTCC	GAAACACCGGTGCCCTTACTCTCACCTGATTACTTAGTCCGTGGGGTTAG	1	bc
CGTTTGACTC	GAAACACCGGTCCGTAGGAGACCCGTGTGGCATGTACCTGTGGGGTTAGA	1	bc
AGTATGAATC	GAAACACCGGTCCGTAGGAGACCCGTGTGGCATGTACCTGTGGGGTTAGA	1	bc
AGCACAATAC	GAAACACCGGTGTGGCTGAGAGTCCGGCAATGGTGTGGCTGTGGGGTTAG	1	bc
GGCAACTAAA	CCGGTAAATTTGAGGCTCCGGCATGCAGGAGGCCGTGGGGTTAGAGCTAG	1	bc
ATTCTTGACC	GAAACACCGGTTTACGTTGCATCGGTGTGGGGTTAGAGCTAGAAATAGCA	1	bc
CTCCTTATTA	GAAACACCGGTTTACGTTGCATCGGTGTGGGGTTAGAGCTAGAAATAGCA	1	bc
GGGCTCATGC	GAAACACCGGTACATTTGAGGCTCCGGCATGCAGGAGGCCGTGGAGTTAG	1	bc
TCCCAACGCC	GAAACACGGGTTAGAGCTAGAAATAGCAAGTTAACCTAAGGCTAGTCCGT	1	bc
AAATTCATTT	GAAGCACCGGTTACATTGAGGGTTAGAGCTAGAAATAGCAAGTTAACCTA	1	bc
CACTCTCTAC	GAAACACCGGTGCCCTTACTCTCACCTGATTACTTAATCCGTGGGGATAG	1	bc
CCAACCGAGG	GAAACACCGGTTATATTTGTAAGTGTTTTGTGGGGTTAGAGCTAGAAATA	1	bc
AAAGTCCTGA	GAAACATGGTTAGAGCTAGAAATAGCAAGTCAACCTAAGGCTAGTCCGTT	1	bc
TATATTTAGG	GAAACACCGGTTATATTTGTAAGTGGGGTTAGAGCTAGAAATAGCAAGTT	1	bc
ACGAGTGGAC	GAAACACCGGTGTGGCTGAGAGTCCGGCAATGGTGTGGCTGTGGGGTTAG	1	bc
ATAGCACATC	GAAACACCGGTCCTGTCGCCACGGGTGTGGGGTTAGGGCTAGAAATAGCA	1	bc
GGGACTGTCC	GAAACACCGGTGTGGCTGAGAGTCCGGCAATGGTGTGACTGTGGGGTTAG	1	bc
AAGTGGAGCC	GAAACACCGGTTCCCGTCCAGTGGGGTTAGAGCTAGAAATAGCAAGTTAA	1	bc
ATTGTGGTTA	GAAACACCGGTTAAGCCGAGGAGTTAGAGCTAGAAATAGCAAGTTAACCT	1	bc
ATCCCTTGCA	GAAACACCGGTGTGGCTGAGAGTCCGGCAATGGTGTGGCTGTGGGGTTAG	1	bc
GCGGCTCTAT	GAAACACCGGTGCCCTTACTCTCACCTGATTACTTAATCCGTGGGGTTAG	1	bc
ACACAACACC	GAAACACCGGTTTGAACTAGAAATAGCAAGTTAACCTAAGGCTAGTCCGT	1	bc
ATAGCAACAC	GAAACACCGGTTCCCTTACTCTCGCCTGATTACTTAATCCGTGAGGATAG	1	bc
ATTGCGCTTA	GAAACACCGGTTAAGCCGAGGGTTAGAGCTAGAAATAGCAAGTTAACCTA	1	bc
AAACGTCGTA	GAAACACCGGTGTACGTATGGACTGAACCAGGGTGTGCAAGTGGGGTTAG	1	bc
CAATTCGTCC	GAAACGCCGGTACCTTTGTTGATGCTGGGTGGGGATAGAGCTAGAAATAG	1	bc
GAGACGGACC	GAAACACCGGTAGCAAGTGCGAGACGTTTTTGTGGGGTTAGAGCTAGAAA	1	bc
GAAATTAAAC	GAAACACCGGTAACTATATTCATGCGATATCGCCGTATCAGTTAGAGCTA	1	bc
CTCCCCTGCA	GAAACACCGGTGTGGCTGAGAGTCCGGCAATGGTGCGGCTGTGGGGTTAG	1	bc
ACGCATCCTT	GAAACACCGGTCTCGAGTGAGGTGTTCAGGGTGGGTTAGAGCTAGAAATA	1	bc
AGACTCTCTT	GAAACACCGGTGCATTCGAAAGTCCGGTCGTAGTGTGGACGTGGGGTTAG	1	bc
ACACAAAGCC	GAAACACCGGTTTGAACTACCTAGTTCAAACCGGTGGGGTTAGAGCTAGA	1	bc
GAGGAGCACA	GAAACACCGGTTCCCGTCCAGTGGGGTTAGAGCTAGAAATAGCAAGTTAA	1	bc
TATTTGATGC	GAAACACCGGTAACTATATTCATGCGATATCGCCGTATCAGGGAGGAGAG	1	bc
CGGGTGACTC	GAAACACCGGTTCGCGTCCAGCGGGGTTAGAGCTAGAAATAGCAAGTTAG	1	bc
GGATCACAGC	GAAACACCGGTGTGGCTGAGAGTCCGGCAATGGTGTGGCTGTGGGGTTAG	1	bc
GGGGATGTTT	GAAACACCGGTGACATTAGAGCTAGAAATAGCAAGTTAACCTAAGGCTAG	1	bc
CTGCGTCGAC	GAAACACCGGTGTACGTATGGACTGAACCAGGGTGTGCAAGTGGGGTTAG	1	bc
GGGGAGATGT	GAAACACCGGTTACATTGAAGACATAGAGCTTGAAATAACAAGTTAACCT	1	bc
ACATCTTCGT	GAAACACCGGTGTACGTATGGACTGAACCAGGGTGTGCAAGTGGGGTTAG	1	bc
GGTGGAGAAT	GAAACACCGGTTCCCGTCCAGTGGGGTTAGAGCTAGAAATAGCAAGTTAA	1	bc
ACTTGACAGC	GAAACACCGGTCGGGGCCACTCAGTGGTGGGGTTAGAGCTAGAAATAGCA	1	bc
CAATAAGCCT	GAAACACCGGTTTGAACTACCGGGGTTAGAGCTAGAAATAGCAAGTTAAC	1	bc
AGAATATCCG	GAAACACTAGAAATAGCAAGTTAACCTAAGGCTAGTCCGTTATCAACTTG	1	bc
AGTCCACTAC	GAAACACCGGTAAATTTGAGGCTCCGGCATGCAGGAGGCCGTGGGGATAG	1	bc
CGAGCCGCGC	GAAACACCGGTGCATTCGAAAGTCCGGTCGTAGTGCGGACGTGGGGTTCT	1	bc
AATAGTAGTC	GAAACACCGGTGTACGTATGGACTGAACCAGGGTGTGCAAGTGGGGTTAG	1	bc
TGCCGAAACA	GAAACACCGGTGGGGTTAGAGCTAGAAATAGCAAGTTATCCTAAGGCTAG	1	bc
GCGCCATACA	GAAACACCGGTAAATTGGAGGCTCCGGCATGCAGGAGGCCGTGGGGATAG	1	bc
AATGATCAGC	GAAACACCGGTTTACGTTGCATCGGTGTAGGGTTAGAGCTAGAAATAGCA	1	bc
CATAGACGTA	GAAACACCGGTGTACGTATGGACTGAACCAGGGTGTGCAAGTGGGGTTAG	1	bc
GCCCACTCAA	CCGGTAAATTTGAGGCTCCGGCATGCAGGAGGCCGTGGGGTTAGAGCTAG	1	bc
AGAAGCAGAC	GAAACACCGGTAGCAAGTGCGAGACGTGTTAGAGCTAGATATAGCACCGG	1	bc
CATCTTTCTC	GAAACACCGGTGTACGTATGGACTGAACCAGGGTGTGCAAAGTGGGGTTA	1	bc
GTGACTAGCT	GAAACACCGGTTTAGGTGAGAGTATGACATTGAAGTGGCTGCAGGGTGAC	1	bc
TTTGCGAGGT	GAAACACCGGTTACATTGAGGGTTAGAGCTAGATATAGCAAGTTAACCTA	1	bc
TGACACAGAT	GAAACACCGGTAGCAAGTGCGAGCATTTGTGGGGTTAGAGCTAGAAATAG	1	bc
ATACGGGGCC	GAAACACCGGTACCTTTGTTGATGCTGGGTGGGGTTAGAGCTAGAAATAG	1	bc
GACAGTGCCC	GAAACACCGGTAGCAAGTGCGAGACGTGTTTGTGGGGTTAGAGCTAGAAA	1	bc
ACCGACATAC	GAAACACCGGTGCCCTTACTCTCACCTGATTACTTAATCCGTGGGGTTAG	1	bc
CTTGGTGGTC	GAAACACCGGTGTACGTATGGACTGAACCAGGGTGTGCAAGTGGGGTTAG	1	bc
ACGAAAACTT	GAAACACCGGTCTCGAGTGGGGTTAGAGCTAGAAATAGCAAGTTAACCTA	1	bc
GAGGCACGCA	GAAACACCGGTTCCCGTCCAGTGGGGTTAGAGCTAGAAATAGCAAGTTAA	1	bc
CACACCACGC	GAAACATCGGTTTGAACTAGAAATAGCAAGTTAACCTAAGGCTAGTCCGT	1	bc
ACATCCACAG	GAAACACCGGTCGGGGCCACTCAGTGGTGGGGTTAGAGCTAGAAATAGCA	1	bc
ATGCCTCTAA	GAAACACCGGTAAATTTGAGGCTCCGGCATGCAGGAGGCCGTGGGGTTAG	1	bc
CCAGTACCAC	GAAACACCGGTGCCCTTACTCTCACCTGATTACTTAATCCGTGGGGATAG	1	bc
TGGCATAGCT	GAAACACCGGTTTACGTTTTTGTGGGGTTAGAGCTAGAAATAGCAAGTTA	1	bc
GGCATCGGCA	GAAACACCGGTGTGGCTGAGAGTCCGGCAATGGTGTGGCTGTGGGGTTAG	1	bc
AGGCCCCCTC	GAAACACCGGTGTGGCTGAGAGTCCGGCAATGGTGTGGCTGTGGGGTTAG	1	bc
TCTGCTTCGT	GAAACACCGGTTTACGTTGCATCGGGTTAGAGCTAGAAATAGCAAGTTAA	1	bc
CTCCCCTGCA	GAAACACCGGTGTGGCTGAGAGTCCGGCAATGGTGTGGCTGTGGGGGTAG	1	bc
AAGAGATGAC	GAAACACCGGTGCCCTTACTCTCACCTGATTACTTAATCCGTGGGGTTAG	1	bc
AGCCTCTCCA	GAAACACCGGTAAATTTGAGGCTCCGGCATGCAGGAGGCCGTGGGGTTAG	1	bc
GCTATCCTTG	GAAACACCGGTTATATTTGTAAGGGTGTGGGGTTAGAGCTAGAAATAGAA	1	bc
TATCTCGGTC	GAAACACCGGTTATATTTGTAAGTGTGTGGGGTTAGAGCTAGAAATAGCA	1	bc
TGCATCCTCT	GAAACACCGGTGTGGCTGAGAGTCCGGCAATGGTGTGGCTGTGGGGTTAG	1	bc
AGAAGTCCCG	GAAACACCGGTCGGCGGCAATCGTGGGTGGGGTTAGAGCTAGAAATAGCA	1	bc
ATAGCCAGGT	GTGAGGGTTAGAGCTAGAAATAGCAAGTTAACCTAAGGCTAGTCCGTTAT	1	bc
AATGACACGC	GAAACACCGGTCGGCGGCAATCTTTAGAGCTAGAAATAGCAAGTTAACCT	1	bc
ACTACTCGAC	GAAACACCGGTACCTTTGTTGATGCTGGGTGGGGTTAGAGCTAGAAATAG	1	bc
GAATCGTCGT	GAAACACCGGTGTACGTATGGACTGAACCAGGGTGTGCAAGTGGGTTAGA	1	bc
TACGCCGTGC	GAAACACCGGTTACCTTGCGGTTAGCGGTAGAAATAGCCAGTTAACCTAA	1	bc
GGCACTCTGT	GAAACACCGGTGTGGCTGAGAGTCCGGCAATGGTGTGGCTGTGGGGTTAG	1	bc
AACGTTCGGT	GAAACACCGGTCGATTCATATCGAAACCTTCCCGTGACAGTGGGGTTAGA	1	bc
AGTCGGATTA	GAAACACCGGTCAGTAGGAGACCCGTGTAGCTTGTACCAGCAGGGTTACC	1	bc
AAGATAATCG	GAAACACCGGTGCATTCGAAAGTCCGGTCGTAGTGTGGACGTGGGGTTAG	1	bc
ACATCGTGGT	GAAACACCGGTGTACGTATGGACTGAACCAGGGTGTGCAAGTGGGGTTAG	1	bc
TACAACAGAA	GAAGCACCGGTAAATTTGAGGCTCCGGCATGCAGGAGGCCGTGGGGTTAG	1	bc
CTGATACTAC	GAAACACCGGTTAAGCCGAGGAGTTAGAGCTAGAAATAGCAAGTTAACCT	1	bc
ACGTGCTGTC	GAAAGACCGGTGACATTTGGGGTTAGAGCTAGAAATAGCAAGTTAACCTA	1	bc
TAGAACAGCG	GAAACACCGGTGCATTCGAAAGTCCGGTCGTAGTGTGGACGTGGGGTTAG	1	bc
GGATCCATCT	GAAACACCGGTGTGGCTGTGAGTCCGGCAATGGTGTGGCTGTGGTGGTGG	1	bc
AACCCCCGGT	GAAACACCGGTGCCCTTACTCTCACCTGATTACTTAATCCGTGGGGTTAG	1	bc
GTGGTGACGC	GAAACACCGGTTCCCGTCCGGTGGGGTTAGAGCTAGAAATAGCAGGTTAA	1	bc
CCATTTGTGT	GAAACACCGGTCGATTCATATCGAAACCTTCCCGTGACAGTGGGGTTAGA	1	bc
CCTTCCCCGT	GAAACACCGGTCGGGGCCACTCAGTGGTGGGGTTAGAGCTAGAAATAGCA	1	bc
TGCGTTGGCT	GAAACACCGGTGACATGGGGTTAGAGCTAGAAATAGCAAGTTAACCTAAG	1	bc
TTCTTTAACG	GAAACACCGGTCGGGGCCACTCAGTGGTGGGGTTAGAGCTAGAAATAGCA	1	bc
GGGAAGAATC	GAAACACCGGTTCCCGTCCAGTGGGGTTAGAGCTAGAAATAGCAAGTTAG	1	bc
AGACAGAGAC	GAAACACCGGTAGCAAGTGCGGGGTTAGAGCTAGAAATAGCAAGTTAACC	1	bc
TTGCATATAA	GAAACACCGGTTAAACCGGAGACGTTAGAGCTAGAAATATCAAAATAACC	1	bc
GTGGATCAGC	GAAACACCGGTTCCCGTCCAGTGGGGTTAGAGCTAGAAATAGCAAGTTAA	1	bc
AACGACAAAC	GGAACACCGGTGCCCTTACTCTCACCTGATTACTTAATCCGTGGGGTTAG	1	bc
TCATAGTCGT	GAAACACCGGTGTACGTATGGTCTGAACCAGGGTGTGCAAGTGGGGTTAG	1	bc
AGAATCGTAT	GAAACACCGGTCTCGAGTGAGGTGTTCAGGGTGGGGTTAGAGCTAGAAAT	1	bc
TGGGGAGAGG	GAAACACCGGTTCCCGTCCAGTGGGGTTAGAGCTAGAAATAGCAAGTTAA	1	bc
TGCCACTAAC	GAAACACCGGTAAATTTGAGGCTCCGGCATGCAGGAGGCCGTGGGGTTAG	1	bc
GAGGCGGCTC	GAAACACCGGTTCCCGTCCAGTGGGGTTAGAGCTAGAAATAGCAAGTTAA	1	bc
TTGGGACTAA	GAAACACCGGTTAAGCCGAGTGGGGTTAGAGCTAGAAATAGCAAGTTAAC	1	bc
AGTGTGGCTA	GAAACACCGGTCCGTATGAGAACCGTGTGGCATGTACCTGAGAGGTTAGA	1	bc
ACTACTCTGC	GAAACACCGGTACCTTTGTTGATGCTGATTTTGATGATGCTTTGTTGATG	1	bc
ACCTTTAGTG	GAAACACCGGTCGGGGCCACTCAGTGGTGGGGTTAGAGCTAGAAATAGCA	1	bc
ACAGCCATAC	GAAACACCGGTGCCCTTACTCTCACCTGATTACTTAATCCGTGGGGTTAG	1	bc
AAGATAAGCG	GAAACACCGGTTTACGTTGCATCGGTGTGGGGTTAGAGCTAGAAATAGCA	1	bc
GAGCGCTGTC	GAAACACCGGTGTACGTAAGGCCTGAACCAGGGGGTGCCCGGGGGGGTTA	1	bc
ACGTGTTGTG	GAAACACCGGTGACATTGGGTACAGGCAAGTTAACCTAAGGCTAGTCCGT	1	bc
ACGTGCTGTC	GAAACACCGGTGACATTGGGGTTAGAGCTAGAAATAGCAAGTTAACCTAA	1	bc
CTTCTCCTTC	GAAACACCGGTGTACGTATGGACTGAACCAGGGTGTGCAAGTGGGGTTAG	1	bc
ACAGCATAAC	GAAACACCGGTTTACGAGCTAGAAATAGCAAGTTAACCTAAGGCTAGTCC	1	bc
AATGGTCTTC	GAAACACCGGTGTACGTATGGACTGAACAAGAGTGTGCACGTGGGGTTAG	1	bc
GCCAAAGACC	GAAACACCGGTAGCAAGTGCGAGACGTGTTTTTTGTGGGGTTAGAGCTAG	1	bc
GGCCCAGTAA	GAAACACCGGTAAATTTGAGGCTCCGGCATGCAGGAGGCCGTGGGGTTAG	1	bc
CACTACGTCT	GAAACACCGGCTACAATTGCCTTAGATCTAGCTATAAATAGCAAGCTAAC	1	bc
TGTGTTGAGT	GAAACACCGGTAACATTTGAGGTTAGAGCTAGAAATAGCAAGTTAACCTA	1	bc
CATCGCCGGT	GAAACACCGGTGTACGTATGGACTGAACCAGGGTGTGCAAGTGGGGTTAG	1	bc
GAATAAACGC	GAAACACCGGTCGGCGGCTAGAAATAGCAAGTTAACCTAAGGCTAGTCCG	1	bc
GAGGCACCGC	GAAACACCGGTCGGCGGATAGCAAGTTAACCTAAGGCTAGTCCGTTATCA	1	bc
ATCGGCCCAC	GAAAAACCGGTGCCCTTACTCTCACCTGATTACTTAATCCGTGGGGTTAG	1	bc
GACATCAGCC	GAAACACCGGTCGGGGCCAGAGCTAGAAATTGCTAGTTCACCTAAGGCTA	1	bc
GCTAGTCGTC	GAAACACCGGTGTGGCTATGAACTGGACAAGGGTGGCTGTGGGGGTAGAG	1	bc
GCGAATCGTT	GAAACACCGGTCTCGAGTGAGGTGTTCAGGGTGGGGTTAGAGCTAGAAAT	1	bc
TTAGCGCTGC	GAAACACCGGTTACATTGAGTGGGGTTAGAGCTAGAAATAGCAAGTTAAA	1	bc
GTGGTGTATC	GAAACACCGGTTCCCGTCCAGTGGGGTTAGAGCTAGAAATAGCAAGTTAA	1	bc
TGAAACAGAC	GAAACACCGGTAGCAAGTGCGAGACGTGTTTTAGAGCTAGAAATAGCAAG	1	bc
GCTATTGACA	GAAACACCGGTTATATTTGTAATGGGGTTAGGGCTAGAAATAGCAAGTTA	1	bc
GAGGAGGCGC	GAAACACCGGTCGGCGGCAATCGTGGGTGGGGTTAGAGCTAGAAATAGCA	1	bc
CAACTAGGCA	GAAACACCGGTACCTTTGTTGATGCTGGGTGGGGTTAGAGCTAGAAATAG	1	bc
GCACAACACC	GAAACACCGGTTTGAACTAGAAATAGCAAGTTAACCTAAGGCTAGTCCGT	1	bc
GGAAATTTGT	GAAACACCGGTCGATTCATATCGAAACCTTCCCGTGACAGTGGGGTTAGA	1	bc
AATCGTCGCA	GAAACACCGGTGTACGTATGGACTGAACCAGGGTGTGCAAGTGGGGTTAG	1	bc
TCTCTCTTAG	GAAACACCGGTTATATTTGTAAGTGTGTGGGGTTAGAGCTAGAAATAGCA	1	bc
GATTAGCTAT	GAAACACCGGTTACATTGAGATTGGGGTTAGAGCTAGAAATAGCAAGTTA	1	bc
GTCGATATGT	GAAACACCGGTTACAATTGGGGTTAGAGCTAGAAATAGCAAGTTAACCTA	1	bc
TCACCCTGCC	GAAACACCGGTAAATTTGAGGCTCCGGCATGCAGGAGGCCGTGGGGTTAG	1	bc
TTTAGCGACT	GAAACACCGGTTAAGCCGAGTGGGGTTAGAGCTAGAAATAGTAAGTTAAC	1	bc
AGCAAAGCAT	GAAACACCGGTTCCCGTCCAGTGGGGTTAGAGCTAGAAATAGCAAGTTAA	1	bc
GGCACAACAC	GAAACACCGGTCCTGTCGCCACGGGTGTGGGGTTAGGGCTAGAAATAGCA	1	bc
AGCAAACCGC	GAAACACCGGTTTGAACTAGAAATAGCAAGTTAACCTAAGGCTAGTCCGT	1	bc
AGGATACACA	GAAACACCGGTAAATTTGAGGCTCCGGCATGCAGGTCGCCGTGTGGTTAG	1	bc
CAGCGTCCTA	GAAACACCGGTGTACGTATAGACTGAACCAGGGTGTGCAAGTGGGGTTAG	1	bc
AGAAGATCCG	GAAACACCGGTCGGCGGATAGCAAGTTAACCTAAGGCTAGTCCGTTATCA	1	bc
TCTTATAACC	GAAACACCGGTAACAAATGCGGGGTTAAAGCTAGAAATAGCACGTTAACC	1	bc
ATTCGGCTAC	GAAACACCGGTCCGTAGGAGACCCGTGTGGCATGTACCTCAGGGTGGCTT	1	bc
TCCGGACTAA	GAAACACCGGTGCCCTTACTCTCACCTGATTACTTAATCCGTGGGGTTAG	1	bc
GAGACTGCCT	GAAACACCGGTCCGTAGGAGACCCGTGTGGCATGTACCTGTGGGGTTAGA	1	bc
CGTGTTGAAG	GAAACACCGGTGACATTGGGTACGGTGGGGTTAGAGCTAGAAATAGCAAG	1	bc
ATTAGCTAGG	GAAACACCGGTCCGTAGGAGACCCGTGTGGCATGTACCTGTGGGGTTAGA	1	bc
AATTCTTCGC	GAAACACCGGTTTACGTTGCATCGGTTGTGGGGTTAGAGCTAGAAATAGC	1	bc
CCGCTTGGCT	GAAACACCGGTTTACGTTGCATCGGTGTGGGTTAGAGCTAGAAATAGCAA	1	bc
GCGTTGCCTA	GAAACACCGGTTCCCGTCCAGTGGGGTTAGAGCTAGAAATAGCAAGTTAA	1	bc
GCTTGACTGC	GAAACACCGGTCGGGGCCACTCGGTGGTGGGGTTAGAGCTGGAAATAGCA	1	bc
CTGTTTACCT	GAAACACCGGTTTACGTTGCATCGGGGTTAGAGCTAGAAATAGCAAGTTA	1	bc
AAATTAGGTG	GAAACACCGGTCGATTCATATCGAAACCTTCCCGTGACAAGTGGGGTTAG	1	bc
ACAATCTCGG	GAAACACCGGTGCATTCGAAAGTCCGGTCGTAGTGTGGACGTGGGGTTAG	1	bc
CCTGTTGTGC	GAAACACCGGTCGGGGCCACTCAGTGGTGGGGTTAGAGCTAGAAATAGCA	1	bc
AATCGTAGCC	GAAACACCGGTTTACGTTGCATCGGGTTAGAGCTAGAAATAGCAAGTTAA	1	bc
GAAGAGACGA	GAAACACCGGTCGGCGGCAATCGTGGGTGGGGTTAGAGCTAGAAATAGCA	1	bc
GGTGGTATCT	GAAACACCGGTTCCCGTCCAGTGGGGTTAGAGCTAGAAATAGCAAGTTAA	1	bc
GTCAGCATAT	GAAACACCGGTTAAGCCGAGGGTTAGAGCTAGAAATAGCAAGTTAACCTA	1	bc
CGGCTTCGTT	GAAACACCGGTGTACGTATGGACTGAACCAGGGGGGGCAAGTGGGGTTAT	1	bc
GGAACAGAAA	GAAACACCGGTAGCAAGTGCGAGACGTGTTAGAGCTAGAAATAGCACCGG	1	bc
GTGGCGCGCC	GAAACACCGGTTCCCGTCCAGTGGGGTTAGAGCTAGAAATAGCAAGTTAA	1	bc
GCAAGCTCTA	GAAACACCGGTGCCCTTACTCTCACCTGATTACTTAATCCGTGGGGTTAG	1	bc
CCGACCTGCA	GAAACACCGGTGCATTCGAAAGTCCGGTCGTAGTGTGGACGTGGGGTTAG	1	bc
CTGCGTCGCT	GAAACACCGGTTTACGTTGCATCGGTGTGGGGTTAGAGCTAGAAATAGCA	1	bc
GTCACGCTAC	GAAACACCGGTGTGGCTGAGAGTCCGGCAATGGTGTGGCTGTGGGGTTAG	1	bc
ATGCTCAGAC	GAAACACCGGTTTACGTTGCATCGGTTATTAGAGCTAGAAATAGCAAGTT	1	bc
AACACAGTAC	GAAACACCGGTGCCCTTACTCTCACCTGATTACTTAATCCGTGGGGTTAG	1	bc
GAGACAAAGC	GAAACACCGGTTTGAACTACCGGGGTTAGAGCTAGAAATAGCAAGTTAAC	1	bc
ACTACTAGGC	GAAACACCGGTACCTTTGTTGATGCTGGGTGGAAGGAATTTTTGTGGGGT	1	bc
GTGGTACCGC	GAAACACCGGTCGGCTGGTTATCAAATAGCAATTTAACCTAAGGCTAGAC	1	bc
TAAGCACCGC	GAAACTCCGGTCGGCGGGGTTAGAGCTAGAAATAGCAAGTTAACCTAAGG	1	bc
AGAAGAAGCG	GAAACACCGGTCGGCGGCAATCGTGGGTGGGGTTAGAGCTAGAAATAGCA	1	bc
GGTCGTCATA	GAAACACCGGTAAATTTGAGGCCCCGGCATGCAGGAGGCCGTGGGGTTAG	1	bc
CCTAGACTGC	GAAACACCGGTCGGGGCCACTCAGTGGTGGGGTTAGAGCTAGAAATAGCA	1	bc
AATGCTTAGG	GAAACACCGGTTTACGTTGCATCGGTGTGGGGTTAGAGCTAGAAATAGCA	1	bc
TACTACTGAA	GAAACACCGGTAAATTTGAGGCTCCGGCATGCAGGAGGCCCGTGGGGTTA	1	bc
AGGAGCCCCG	GAAACACCGGTCGGCGGCAATCGGGGTTAGAGCTAGAAATAGCAAGTTAA	1	bc
ACACAAAGCC	GAAACACCGGTTTGAACTAGAAATAGCAAGTTAACCTAAGGCTAGTCCGT	1	bc
CCAAAAATTT	GAAACACCGGTCTCGAGTGAGGTGTTCAGGGTGGGGTTAGAGCTAGAAAT	1	bc
ATAGCCCGAC	GAAACACCGGTGCCCTTACTCTCACCTGATTACTTAATCCGTGGGGTTAG	1	bc
ACGAGCTGAC	GAAACACCGGTGACAGTGGGGTTAGAGCTAGAAATAGCAAGTTAACCTAA	1	bc
AGATACGGTC	GAAACACCGGTCGGTTGATATCGAGAACTTCCCGTGCCTGTGGGGCTAGA	1	bc
AGGGTTGGCT	GAAACACCGGTGACATTGGGTTAGAGCTAGAAATAGCAAGTTAACCTAAG	1	bc
ACTTTAGGGC	GAAACACCGGTCGGGGCCACTCAGTGGTGGGGTTAGAGCTAGAAATAGCA	1	bc
TTAGTCAGGT	GAAACACCGGTTACATTGGGGTTAGAGCTAGAAATAGCAAGTTAACCTAA	1	bc
AAAACGTCGT	GAAACACCGGTGTAAGAATGGACTGAACCAGGGTGTGCAAAAGTGGGGTT	1	bc
GAGCCATGCA	GAAACACCGGTCGATGGAAAATAGCATCGTAAGGTGTGACTGGTAGAAAT	1	bc
GCCGGAGACA	GAAACACCGGTAGCAAGTGCGGGGTTAGGGCTAGAAATAGCAAGTTAACC	1	bc
ACTCCGTCTC	GAAACACCGGTCCGTAGGAGACCAGTGTGGCATGTACCTGTGGGGTTAGA	1	bc
CCTGTCGCCC	GAAACACCGGTTTGATCTAGTTCGTTCTAACGGGAGGGGTTGGAGCTAGA	1	bc
AGCGGGTTGT	GAAACACCGAGTGGGGTTAGAGCTAGAAATAGCAAGTTAACCTAAGGCTA	1	bc
GACCCCTGAA	GAAACACCGGTAAATTTGAGGCTCCGGCATGCAGGAGGCCGTGGGGTTAG	1	bc
AGAAGCCACG	GAAACACCGGTCGGCGGTGGGGTTAGAGCTAGAAATAGCAAGTTAACCTA	1	bc
GGAATCCTAC	GAAACACCGGTGTGGCTGAGAGTCCGGCAATGGTGTGGCTGTGGGGTTAG	1	bc
GTGGCCCTTC	GAAACACCGGTGTGGCTGAGAGTCCGGCAATGGTGTGGCTGTGGGGTTAG	1	bc
TGCGCGATGT	GAAACACCGGTGTGGCTGAGAGTCCGGCAATGGTGTGGCTGTGGTGGTAG	1	bc
AAGAACCTCG	GAAACACCGGTTATATTTGTAAGTGTGTGGGGTTAGAGCTAGAAATAGCA	1	bc
AGCCACTAAA	GAAACACCGGTAAATTTGAGGCTCCGGCATGCAGGAGGCCGTGGGGTTAG	1	bc
GAGACCCACG	GAAACACCGGTGCATTCGAAAGTCCGGCCGTAGTGTGGACGTGGGGTTAG	1	bc
TGTGGCTCCT	GAAACACCGGTTCCCGTCCAGTGGGGTTAGAGCTAGAAATAGCAAGTTAA	1	bc
GTGAATCACT	GAAACACCGGTCTCGAGTGAGGTGTTCAGGGTGGGGTTAGAGCTAGAAAT	1	bc
GAGGCACCGA	GAAACACCGGTCGGCGGCAATCGTGGGTGGGGTTAGAGCTAGAAATAGCA	1	bc
GATGCCTCGC	GAAACACCGGTCGGCGGCAATCGTGGGTGGGGTTAGAGCTAGAAATAGCA	1	bc
TATGTTAAGA	GAAACACCGGTTTACGTTGCATCGGTGTGGGGTTAGAGCTAGAAATAGCA	1	bc
TGAACACCCG	GAAACACCGGTCGGCGGGGTTAGAGCTAGAAATAGCAAGTTAACCTAAGG	1	bc
GCGATCGGCT	GAAACACCGGTCGGTTCATATCGCCACCATCGCGTGGCCGTGGGGTTAGA	1	bc
CTCTCCTTCA	GAAACACCGGTGTGGCTGAGAGTCCGGCAATGGTGTGGCTGTGGGGGTAG	1	bc
CAACTTCTAT	GAAACACCGGTAACTTTACCCATGCGATATCGCCGTATCAGTGTGGTTAG	1	bc
CATGGTGGCT	GAAACACCGGTGTTAGAGCTAGAAATAGCAAGTTAACCTAAGGCTAGTCC	1	bc
ATGTTCGGCT	GAAACACCGGTTTACGCTGCATCGGTGTGGGGTTAGAGCTAGAAATAGCA	1	bc
ATCTTATGAG	GAAACACCGGTTATATTTGTAAGTGTTGTGGGGTTAGAGCTAGAAATAGC	1	bc
GAGGTGCCCC	GAAACACCGGTTCCCGTCCAGTGGGGTTAGAGCTAGAAATAGCAAGTTAA	1	bc
AGAGTTAAGT	GAAACCCCGGTTACATTGAGTGGGGTTAGAGCTAGAAATAGCAAGTTAAC	1	bc
ACGCGTAGAT	GAAACACCGGTTTACGTTGCATCGGGTTAGAGCTAGAAATAGCAAGTTAA	1	bc
ACTCTCCTAC	GAACACCGGGGGCCTTACTCGCACCGGATTACTTAATTCGAGCTGGTAGA	1	bc
GAATTCGGTA	GGAACACCGGTAGCAAGTGCGAGACGTCTCTGCGGGGTTAGAGCTAGAAA	1	bc
ACGTCCGGTA	GAAACACCGGTCGATTCATATCGATACCTTCCCGTGACAGAGCTGTTAGA	1	bc
AGAATCGCTC	GAAACACCGGTCCGTAGGAGACCCGTGTGTCCTGTACCTGTGGGGTTAGA	1	bc
CCTAATGCCC	GAAACACCGGTTTGAACTAGAAATAGCAAGTTAACCTAAGGCTAGTCCGT	1	bc
CACGACCTTT	GAAACACCGGTGCCCTTACTCTCACCTGATTACTTAATCCGTGGGGTTAG	1	bc
GAGGGTACGC	GAAACACCGGTCGGCGGCAATCGTGGGTGGGGTTAGAGCTAGAAATAGCA	1	bc
GAGGAGCTTT	GAAACACCGGTTCCCGTCCAGTGAGGTCAGAGCTAGAAATAGCAATTTAA	1	bc
GAAGAAGCGA	GAAACACCGGTCGGCGGCAATCGTGGCGTTAACCTAAGGCTAGTCCGTTA	1	bc
TTAACTCTGC	GAAACACCGGTTACATTGGGGGTACAGCTAGAAATAGCATGTTAACCTAA	1	bc
ACACTACTGC	GAAACACCGGTCGGGGCCACTCAGTGGTGGGGTTAGAGCTAGAAATAGCA	1	bc
ACACAACGTC	GAAACACCGGTTTGAACTACCGGGGTTAGAGCTAGAAATAGCAAGTTAAC	1	bc
AGAAGACACG	GAAACACCGGTCGGCGGCGATCGCCCGTGGGGTTAGAGCTAGAAATAGCA	1	bc
AGACAGCCGC	GAAACACCGGTCCGTAGGAGACCCGTGTGGCATGTACCTGTGGGGTTAGA	1	bc
CCGAAATCTC	GAAACACGGGTTAGAGCTAGAAGTAGCAAGGTAACGTAAGGCTAGTCCGT	1	bc
GGAAACTTTA	GAAACACCGGTCTCGAGTGAGGTGTTCAGGGTGGGGTTAGAGCTAGAAAT	1	bc
TTAATACGAA	GAAACACCGGTTAAGCCGAGGAGTTAGAGCTAGAAATAGCAAGTTAACCT	1	bc
AACGAACAAC	GAAACACCGGTGCCCTTACTCTCACCTGATTACTTAATCCGTGGGGTTAG	1	bc
AGTAGCTATG	GAAACACCGGTTACATTGAGGGTTAGAGCTAGAAATAGCAAGTTAACCTA	1	bc
TTGCGTATCT	GAAACACCGGTTAAGCCGAGGGTTAGAGATAGAAATAGAAAGTTAACCTA	1	bc
ACGTGTTGTA	GAAACACCGGTGACATTGGGTACAGGGTGGGGTTAGAGCTAGAAATAGCA	1	bc
GCCGACACCC	GAAACACCGGTCGGCGGCAATCGTTTTGTGGGGTTAGAGCTAGAAATAGC	1	bc
ACCATTCCCG	GAAACACCGGCCGGGGCCACTCAGTGGTGGGGTTAGAGCTAGAAATAGCA	1	bc
ACTGATCATA	GAAACACCGGTTAAGCCGAGGGTTAGAGCTAGAAATAGCAAGTTAACCTA	1	bc
GGCCTCCACC	GAAACACCGGTAAATTTGAGGCTCCGGCATGCAGGAGGCCGTGGGGTTAG	1	bc
CATAGGCGTA	GAAACACCGGTGTACGTATGGACTGAACCAGGGTGTGCAAGTGGGGTTAG	1	bc
ATATATCGAG	GAAACACCGGTTATATTTGTAAGTGTGTGGGGTTAGAGCTAGAAATAGCA	1	bc
ACCTTTAGAG	GAAACACCGGTCGGGGCCACTCAGTGGTGGGGTTAGAGCTAGAAATAGCA	1	bc
ACAATCCTCC	GAAACACCGGTGCGGCTGAGAGTCCGGCAATGGTGTGGCTGTGGGGTAAG	1	bc
AGAATACGCC	GAAACACCGGTCGATTCATATCGAAACCTTCCCGTGACATTGGGGGTAGA	1	bc
TCGGTAGTCC	GAAACACCGGTTCCGCCGAGTCGGGTTAGAGCTAGAAATAGCAAGTTAAA	1	bc
AGAGGACCCG	GAAACACCGGTCGGCGGCAATCGTGGGTGGGGTTAGAGCTAGAAATAGCA	1	bc
GAAGGACCTA	GAAACACCGGTGCCCTTACTCTCACCTGATTACTTAATCCGTGGGGTTAG	1	bc
GCTGGGCGTC	GAAACACCGGTTCCCGTCCAGACTGGTTAGAGCTAGACATAGCAAGTTAA	1	bc
GCGGAGGCTA	GAAACACCGGTTTGAACTACCGGGGTTAGAGCTTGAAATAGCAAGTTAAC	1	bc
ACGTGGTGTC	GAAACACCGGTGACATTGGGTACAGGGGTGGGGTTAGAGCTAGAAATAGC	1	bc
GCCACGGACC	GAAACACCGGTAGCAAATGCGAGACGTGTTTGGGGGGTTAGAGCTAGAAA	1	bc
GTCGCCCGAC	GAAACACCGGTGCCCTTACTCTCACCTGATTACTTAATCCGTGGGGTTAG	1	bc
ATAAGCTATG	GAAACACCGGTTACATTGAGGGTTAGAGCTAGAAATAGCAAGTTAACCTA	1	bc
TACAGTAGGT	GAAACACCGGTCGATTCATATCGAAACCTTCCCGTGACAGTGGGGTTAGA	1	bc
TCACATCCTT	GAAACACCGGTCTCCTTACAGGCATTCGAGTAGTGGTTACAGCTAGATAT	1	bc
TCAGCAGTTT	GAAACACCGGTTACATTGAGTGGTAGAGCTAGAAATAGCAAGTTAACCTA	1	bc
AAAGAGCCTC	GAAACACCGGTTCCCGTCCAGTAGGGGTATAGCTAGAAATAGCAAGTTAA	1	bc
TAACCTCTGT	GAAACACCGGTTACATTGAGTGGGGTTAGAGCTAGAAATAGCAAGTTAAC	1	bc
GGAATGCATC	GAGACACCGGTCCGTAGGGGACCCGTGTGGCATGTACCTGTGGGGTTAGA	1	bc
ACTCCCTGTT	GAAACACCGGTACCCTTACCGTCACCTGTGTACTTAATACGTCTGGTTAT	1	bc
ATGATACGCT	GAAACACCGGTTTACGTTGCATCGGCGTGGGGGTAGAGCTAGAAATAGCA	1	bc
ATAGCTTGTA	GAAACACCGGTAACTATATTCATGCGATATCGCCGTATCAGTGGGGTTAG	1	bc
GCGCGTTGTC	GAAACACCGGTGACATTGGGTACAAGTGGGGTTAGAGCTAGAAATAGCAA	1	bc
ACACGCACTA	GAAACACCGGTGCCCTTACTCTCACCTGATTACTTAATCCGTGGGGTTAG	1	bc
GCGGAGCGTT	GAAACACCGGTTCCCGTCCAGTGGGGTTAGAGCTAGAAATAGCAAGTTAA	1	bc
AACGCGCGAA	GAAACACCGGTGCCCTTACTCTCACCTGATTACTTAATCCGTGGGGTTAG	1	bc
GTGCACGTAA	GAAACACCGGTTAAGCCGAGTGGGGTTAGAGCTAGAAATAGCAAGTTAAC	1	bc
AACAGCCGCA	GAAACACCGGTGCCCTTACTCTCACCTGATTACTTAATCCGTGGGGTTAG	1	bc
AGGCAACCTA	GAAACACCGGTGTGGCTGAGAGTCCGGCAATGGTGTGGCTGTGGGGTTAG	1	bc
TCATAACGAT	GAAACACCGGTACCCTGCTGGGTTAGAGCTAGAAATAGCAAGTTAACCTA	1	bc
GCAAACGCGC	GAAACACCGGTCATCGGCAGTGAAGGGTGGGGGTGGAGATAGCTATAGAA	1	bc
AGACAACGCA	GAAACACCGGTTTGAACTAGAAATAGCAAGTTAACCTAAGGCTAGTCCGT	1	bc
ATCAACTCCC	GAAACACGGGTTAGAGCTAGAAATAGCAAGTTAACCTAAGGCTAGTCCGT	1	bc
TATGTTAACG	GAAACACCGGTCGTCCTTTGGGGTTAGAGCTAGAAATAGCAAGTTAACCT	1	bc
TGCGCTACGT	GAAACACCGGTTACATTGAGGGTTAGAGCTAGAAATAGCAAGTTAACCTA	1	bc
AGGCCCACGT	GAAACACCGGTGCATTCGAAAGTCCGGTCGTAGTGTGGACGTGGGGTTAG	1	bc
ACGTTTAGTC	GAAACACCGGTCGGGGCCACTCAGTGGTGGGGTTAGAGCTAGAAATAGCA	1	bc
AGAGTTGTCA	GAAACACCGGTGACACTGGGGTTAGAGCTAGAAATAGCAAGTTAACCTAA	1	bc
ACACTCGGGG	GAAACACCGGTACCTTTGTTGATGCTGGGTAGGGATAGAGCTAGAAATAG	1	bc
ATTGAGCAGA	GAAACACCGGTTAGGCCGAGTGGGGTTAGAGCTAGAAATAGCAAGTTAAC	1	bc
ACAACCAATA	GAAACACCGGTAACTATATTCATGCGATATCGCCGTATCAAGTTAACCTA	1	bc
AACACAGTCC	GAAACACCGGTTCGCATAATCTGACCTGATGATTGAATTCGCAGGGTTAC	1	bc
AGCAGGACTA	GAAACACCGGTCCGTAGGAGACCCGTGTGGCATGTAACTGTGGGGTTAGA	1	bc
ACCTTTGGCG	GAAACACCGGTCGGGGCCACTCAGTGGTGGGGTTAGAGCTAGAAATAGCA	1	bc
AACATTCTTT	GAAACACCGGTCTCGAGTGAGGTGTTCAGGGTGGGGTTAGAGCTAGAAAT	1	bc
AGACAAGCGC	GAAACACCGGTGCATTCGAAAGTCCGGTCGTAGTGTGGACGTGGGGTTAG	1	bc
ATACTAGGCT	GAAACACCGGTACCGGTGGGTTAGAGCTAGAAATAGCAAGTTAACCTAAG	1	bc
CGAAACGGCC	GAAACACCGGTACCTTTGTTGTGGGGTTAGAGCTAGAAATAGCAAGTTAA	1	bc
GTCATCATCC	GAAACACCGGTGTGGCTGAGAGTCCGGCAATGGTGTGGCTGTGGGGTTAG	1	bc
GGTGGCGCCC	GAAACACCGGTTCTCGTCCAGTGGGGTTAGAGCTAGAAATAGCAAGTTAA	1	bc
AGCCCTTCAC	GAAACACCGGTGCATTCGAAAGTCCGGTTGTAGTGTGGACGTGGGGTTAG	1	bc
AAAGTCTGCC	GAAACACCGGTACCTTTGTTGATGCTGGGTGGGGGTAGAGCTAGAAATAG	1	bc
GGCAACCCGC	GAAACACCGGTCGGCGGCAATCGTGGGTGGGGTTAGAGCTAGAAATAGCA	1	bc
CCTTTCGGGC	GAAACACCGGTACCTTTGTTGATGCTGGTGGGGTTAGAGCTAGAAATAGC	1	bc
AGTGAGCATA	GAAACACCGGTTAAGCCGAGTGGGGTTAGAGCTAGAAATAGCAAGTTAAC	1	bc
TTAACTTGGT	GAAACACCGGTTACATTAAGGGATAGAGCTAGAAATAGCAAGTTAACCTA	1	bc
ACATTATGCT	GAAACACCGGTCGATTCTGGTCGAAACCTTCCCGTGACAGAGGGGTTAGA	1	bc
CATTGACCGA	GAAACACCGGTCGGGGCCACTCAGTGGTGGGGTTAGAGCTAGAAATAGCA	1	bc
GAGGCGCATG	GAAACACCGGTTCCCGTCCAGTGGGGTTAGAGCTAGAAATAGCAAGTTAA	1	bc
GGTCACAGAC	GAAACACCGGTAGCAAGTGCGAGACGTGTTTGTGGGGTTAGAGCTAGAAA	1	bc
TTAGCAAAGA	GAAACACCGGTTACATTGAGATCTCTTTTGTGGGGTTAGAGCTAGAAATA	1	bc
AGAACCCTTC	GAAACACCGGTCTCGAGTGAGGTGTTCAGGGTGGGGTTAGAGCTAGAAAT	1	bc
AGATATAGGC	GAAACACCGGTGCATTCGAAAGTCCGGTCGTAGTGTGGACGTGGGGTTAG	1	bc
AAGAACCTCG	GAGACACCGGTGCATTCGAAAGTCCGGTCGTAGTGTGGACGTGGGGTTAG	1	bc
CTAATAGGCA	GAAACACCGGTACCTTTGTTGATGCTGGGTGGAAGGAATTTGTGGGGTTA	1	bc
AGCAGACCCG	GAAACACCGGTCGGCGTGGGGTTAGAGCTAGAAATAGCAAGTTAACCTAA	1	bc
GAAGACTATC	GAAACACGGTTAGAGCTAGAAATAGCAAGTTAACCTAAGGCTAGTCCGTT	1	bc
GTATAAATGT	GAAACACCGGTTACATTGAGGGTTAGAGCTAGAAATAGCAAGTTAACCTA	1	bc
GGTCCCAGCC	GAAACACCGGTGTGGCTGAGAGTCCGGCAATGGTGTGGCTGTGGGGTTAG	1	bc
CGAAACATTA	GAAACACCGGCCTCGAGGGAGGTGTTCAGGGTGGGGTTAGAGCTAGAAAT	1	bc
CTGGTTGTGT	GAAACACCGGTGACATTGGGGTTAGAGCTAGAAATAGCAAGTTAACCTAA	1	bc
CTAATCGGGA	GAAACACCGGTACCTTTGTTGATGCTGGGTGGGGTTAGAGCTAGAAATAG	1	bc
GAAGTCACAC	GAAACACCGGTCGGCGGCAATCGTGGGTGGGGTTAGAGCTAGAAATAGCA	1	bc
TGATTGCTCT	GAAACACCGGTCTCGAGTGAGGTGTTCAGGGGTGGTGATAGAGCTAGAAA	1	bc
AAGCGTAGGG	GAAACACCGGTTTACGTTGCATCGGTGTGGGGTTAGAGCTAGAAATAGCA	1	bc
AGAATCATAT	GAAACACCGGTCTCGAGTGAGGATAGCAAGTTAACCTAAGGCTAGTCCGT	1	bc
AAAACTTATA	GAAACACCGGTAACTATGTTCATGCGATATCGCCGTATCAGTGGGGTTAG	1	bc
TTCCGTATAA	GAAACACCGGTTAAACCGAGTGGTTTTAGAGGTTGAAACTGCAAATAAAC	1	bc
AAACTTATCA	GAAACACCGGTAACTATATTCATGCGATATCGCCGTATCAGTGGGGTTAG	1	bc
ACTACGCGGC	GAAACACCGGTACCTTTGTTGATGCTGGGTGGGGTTAGAGCTAGAAATAG	1	bc
CCAATCGCGT	GAAACACCGGTCGCGGCCGATGAGTTCTGGGTGTAGAGCTAGAAATAACA	1	bc
ACATCGACGT	GAAACACCGGTGTACGTATGGACTGAACCAGGGTGTGCAAAAGTGGGGTT	1	bc
CAACGTCTTT	GAAACACCGGTGTACGTATGGACTGAACCAGGGTGTGCAAGTGGGGTTAG	1	bc
GTCCACCTCC	GAAACACCGGTGTGGCTGAGAGTCCGGCAATGGTGTGGCTGTGGGGTTAG	1	bc
ACACTGAGCT	GAAACACCGGTTTACGTTGCATCGGGGTTAGAGCTAGAAATAGCAAGTTA	1	bc
GGGACCATCA	GAAACACCGGTGTGGCTGAGAGTCCGGCAATGGTGTGGCTGTGGGGTTAG	1	bc
AACGTTCGGT	GAAACACCGGTCGATTCATATCGAGACCTTCCCGTGACAGTGGGGTTAGA	1	bc
CGAAGCATTA	GAAACACCGGTCTCGAGTGCGGAGTTCAGGGTGGGGTTAGAGCTAGAAAT	1	bc
AGACGCACGA	GAAACACCGGTGCATTCGAAAGTCCGGTCGTAGTGTGGACGTGGGGTTAG	1	bc
GCGAATAATT	GAAACACCGGTCTCGAGTGAGGTGTTCAGGGTGGGGTTAGAGCTAGAAAT	1	bc
AAGAAGACAC	GAAACACCGGTCGGCGGCAATCGTGGGTGGGGTTAGAGCTAGAAATAGCA	1	bc
ACATTACGGC	GAAACACCGGTCGGGGCCACTCAGTGGTGGGGTTAGAGCTAGAAATAGCA	1	bc
GGCATACTCT	GAAACACCGGTGTGGCTGAGAGTCCGGCAATGGTGTGGCTGTGGGGTTAG	1	bc
AAGACACTAG	GAAACACCGGTGCATTCGAAAGTCCGGTCGTAGTGTGGACGTGGGGTTAG	1	bc
TGTCTGCGTT	GAAACACCAGTCCGTAGGAGACCCGTGTGGCATGTACCTGTGGGGTTAGA	1	bc
ACGAATCATT	GAAACACCGGTCTCGAGTGAGGTGTTCAGGTGGGGTTAGAGCTAGAAATA	1	bc
TAATTACCGC	GAAACACCGGTCAAGGCGACTCCGTGGCCTTGACTGGGATGTGGGGCTAG	1	bc
CGATTAGTCG	GAAACACCGGTGTACGTATGGACTGAACCAGGGTGTGCAAGTGGGGTTAG	1	bc
GCGAAGTATA	GAAACACCGGTTCCCGTCCAGTGGGGTTAGAGCTAGAAATAGCAAGTTAA	1	bc
AGACAACTGT	GAAACACCGGTGCATTCGAAAGTCCGGTCGTAGTGTGGACGTGGGGTTAG	1	bc
CTAGCTCAGT	GAAACACCGGTTACATTGAGGGTTAGAGCTAGAAATAGCAAGTTAACCTA	1	bc
ACGGATCCTT	GAAACACCGGTCTCGAGTGAGGTGTTTAGGGTGGGGTTAGAGCTAGAGAT	1	bc
TTTCGCTATG	GAAACACCGGTTACAATTGGGGTTAGAGCTAGAAATAGCAAGTTAACCTA	1	bc
TTAGCTACAC	GAAACACCGGTTACATTGAGGGTTAGAGCTAGAGATAGCAAGTTAACCTA	1	bc
ACTTGCCGTT	GAAACACCGGTCGATTGATATCGAAACCTTCCCGTGACAGTGGGGTTAGA	1	bc
GCTACTCGTT	GAAACACCGGTACCTTTGTTGATGCTGGGTGGAAGGAGTTTTGTGGGGTT	1	bc
AAGAAGGCCC	GAAACACCGGTTTGAACTACCGGGGTTAGAGCTAGAAATAGCAAGTTAAC	1	bc
AGGATGCCTA	GAAACACCGGTCCGTAGGAGACCCGTGTGGCATGTACCTGTGGGGTTAGA	1	bc
TGACGATCCG	GAAACACCGGTCGGCGGTTAGAGCTAGAAATAGCAAGGTAACCTAAGGCT	1	bc
AATACATGCA	GAAACACCGGTAAATTTGAGGCTCCGGCATGCAGGAGGCCGTGGGGTTAG	1	bc
TTTGAGAATA	GAAACACCGGTTAAGCCGAGTGGGGTTAGAGCTAGAAATGGCAAGTTAAC	1	bc
ACTATATGTT	GAAACACCGGTTTTATTTGTAGGAGTTTGGGGGGTTATAGCTAGAGAAAG	1	bc
TTTAGCGATG	GAAACACCGGTTACATTGAGGGGTTAGAGCTAGAAATAGCAAGTTAACCT	1	bc
TAACTCGCTA	GAAACACCGGTGCCCTTACTCTCACCTGATTACTTAATCCGTGGGGTTAG	1	bc
GCAGGCCGGC	GAAACACCGGTCGGCGGCAATCGTGGGTGGGGTTAGAGCTAGAAATAGCA	1	bc
ATAGAGACGT	GAAACACCGGTTACATTGAGGGTTAGAGCTAGAAATAGCAAGTTAACCTA	1	bc
AACTATACAG	GAAACACCGGTCGGGGCCACCCAGTGGTGGGGGTAGAGCTAGAAATAGCA	1	bc
CCTTGTTGTT	GAAACACCGGTGTACGTATGGACTGAACCAGGGTGTGCAAAAAGTGGGGT	1	bc
AGAAACAGAG	GAAACACCGGTAGCAAGTGCGAGACGTGTTTGTGGGGTTAGAGCTAGAAA	1	bc
AACACCCTCT	GAAACACCGGGGCATTCGAACGACCGGTCGTAGTGTGGACGTGGGGATAG	1	bc
AGGCTCTAAA	GAAACACCGGTAAATTTGAGGCTCCGGCATGCAGGAGGCCGTGGGGTTAG	1	bc
GGTGCTGTCC	GAAACACCGGTGAGGCTGAGAGCAGGGCGAGGGTAGGGCTAGGAGGAGCG	1	bc
AAAGCTAAGT	GAAACACCGGTTACATTGAGGGTTAGAGCTAGAAATAGCAAGTTAACCTA	1	bc
CAGGCCTTCA	GAAACACCGGTGCCCTTACTCTCACCTGATTACTTAATCCGTGGGGTTAG	1	bc
AAGCGACGAC	GAAACACCGGTGTACGTATGGACTGAACCAGGGTGTGCAAGTGGGGTTAG	1	bc
AAACACAGAC	GAAACACCGGTAGCAAGTGCGAGACGCAGAAATAGCAAGTTAACCTAAGG	1	bc
GAGGAGCCGA	GAAACACCGGTTCCCGTCCAGTGGGGTTAGAGCTAGAAATAGCAAGTTAA	1	bc
CTTGCTGTCA	GAAACACCGGTGACATTGGGTACAGGGGTGGGGTTAGAGCTAGAAATAGC	1	bc
AGTATACCTA	GAAACACCGGTCCGTAGGAGACCCGTGTGGCATGTACCTGTGGGGTTAGA	1	bc
GCTGATCCTC	GAAACACCGGTTCCCGTCCAGTGGGGTTAGAGCTAGAAATAGCAAGTTAA	1	bc
GAGAAGACCC	GAAACACCGGTCGGCGGTTAGAGCTAGGAATAGCAAGTTAACCTAAAGCT	1	bc
CCATGACCGA	GAAACACCGGTCGGGGCCACTCAGTGGTGGGGTTAGAGCTAGAAATAGCA	1	bc
ATCTATAGAG	GAAACACCGGTTATATTAAGTGGGGTTAGAGCTGGAAATAGCAAGTTAAC	1	bc
AAATGCTGTT	GAAACACCGGTCGATTCATATCGAAACCTTCCCGTGACAGTGGGGTTAGA	1	bc
GTCATGCTCC	GAAACACCGGTGTGGCTGAGGGTCCGGCCATGGTGTGGATGTGGGGTAAA	1	bc
ACACCGTCGA	GAAACACCGGTGCATTCGAAAGTCCGGTCGTAGTGTGGACGTGGGGTTAG	1	bc
GGGGATGTCC	GAAACACCGGTGACATTGGGTACAGGGGTGGGGTTAGAGCTAGAAATAGC	1	bc
CCATCTACGC	GAAACACCGGTTACATTGAGGGTTAGAGCTAGAAATAGCAAGTTAACCTA	1	bc
TACAACCCTT	GAAACACCGGTCCAAGATGTGGGGACGTGGGGGTGGAGCTAGGAAGAGCA	1	bc
GGCACCCCTT	GAAACACCGGTGTGGCTGAGAGTCCGGCAATGGTGTGGCTGTGGGGTTAG	1	bc
CGAATCGTCC	GAAACACCGGTACCTTTGTTGATGCTGGGTGGAAGGAATTTGTGGGGTTA	1	bc
TGACCCCTGC	GAAACACCGGTGCATTCGAAAGTCCGGTCGTAGTGTGGACGTGGGGTTAG	1	bc
ATCATTACTG	GAAACACCGGTCGGGGCCACTCAGTGGTGGGGTTAGAGCTAGAAATAGCA	1	bc
ATCCCCAGCA	GAAACACCGGTGTGGCTGAGAGTCCGGCAATGGTGTGGCTGTGGGGTTAG	1	bc
AATAATCGGC	GAAACACCGGTACCTTTGTTGATGCTGGGTGGAAGGAATTTTGTGGGGTT	1	bc
ATCCCTTACC	GAAACACCGGTGTGGCTGAGAGTCCGGCAATGGTGTGGCTGTGGGGTTAG	1	bc
CCGACGCCCG	GAAACACCGGTTTAAATTAACACGTTCAGAGCGGTGGGGTTAGAGCTGGA	1	bc
AGACATACGC	GAAACACCGGTGCATTCGAAAGTCCGGTCGTAGTGTGGACGTGGGGTTAG	1	bc
ACTATCGGTA	GAAACACCGGTTAAGCAAGTTAACCTAAGGCTAGTCCGTTATCAACTTGA	1	bc
CACCTTAACC	GAAACACCGGTCGGGGCCACTCAGTGGTGGGGTTAGAGCTAGAAATAGCA	1	bc
CATGCTGCCT	GAAACACCGGTGACGTTGGGTACAGGGGTGGGGTTAGGGCTAGAAATAGC	1	bc
GTACTAGGCT	GAAACACCGGTACCTTTGTTGATGCTGGTGGGGTTAGAGCTAGAAATAGC	1	bc
TCGGGAATAA	GAAACACCGGTTAAGCCGAGTGGGGTTAGAGCTAGAAATAGCAAGTTAAC	1	bc
AGGGCAACTT	GAAACACCGGTGTGGCTGAGAGTCCGGCAATGGTGTGGCTGTGGGGTTAG	1	bc
TTGCTTAGAC	GAAACACCGGTTTACGTTGCATCGGGTGTGGGGTTAGAGCTAGAAATAGC	1	bc
AGACACCGAC	GAAACACCGGTAGCAAGTGCGAGACGTTGTTGTGGGGTTAGAGCTAGAAA	1	bc
ATGTGCAGAA	GAAACACCGGTTAAGCCGAGTGGGGTTAGAGCTAGAAATAGCAAGTTAAC	1	bc
AGGACCATAA	GAAACACCGGTAAATTTGAGGCTCCGGCATGCAGGAGGCCGTGGGGTTAG	1	bc
GTCGAATCCG	GAAACACCGGTCTCGAGTGAGGTGTTCAGGGTGGGGTTAGAGCTAGAAAT	1	bc
AAATTACCGC	GAAACACCGGTCGGGGCCACTCAGTGGTGGGGTTAGAGCTAGAAATAGCA	1	bc
ATAGCTCAGT	GAAACACCGGTTACCTTGAGGGTTAGAGCTAGAAATAGCAAGTTAACCTA	1	bc
CTGATTAGAT	GAAACACCGGTTTAGCTAGAAATAGCAAGTTAACCTAAGGCTAGTCCGTT	1	bc
AAAACTCGGT	GAAACACCGGTACCTTTGTTGATGCTGGGTGTGGGGTTAGAGCTAGAAAT	1	bc
ATGGATATGT	GAAACACCGGTTACATTGAGGGGTTAGAGCTAGAAATAGCAAGTTAACCT	1	bc
ACACAACGAC	GAAACACCGGTTTGAACTAGAAATAGCAAGTTAACCTAAGGCTAGTCCGT	1	bc
GCATTACTGC	GAAACACCGGTCGGGGCCACTCAGTGGTGGGGTTAGAGCTAGAAATAGCA	1	bc
TCACAACTCC	GAAACACCGGTTTGAACTACCGGGGTTAGAGCTAGAAATAGCAAGTTAAC	1	bc
TTATCCTGCC	GAAACACCGGTAAATTTGAGGCTCCGGCATGCAGGAGGCCGTGGGGTTAG	1	bc
AAAGATTAGC	GAAACACCGGTTTACGTTGCATCGGTTGTGGGGTTAGAGCTAGAAATAGC	1	bc
AGAAGACACG	GAAACACCGGTCGGCGGCTAGAAATAGCAAGTTAACCTAAGGCTAGTCCG	1	bc
TCAGCTCTTT	GAAACACCGGTTACATTGAGGGTTAGAGCTAGAAATAGCAAGTTAACCTA	1	bc
CGTCTCGCTC	GAAACACCGGTCCGTAGGATACCCGTGTGGCATGTACCTGTGGGGATAGG	1	bc
GGCAAGCTTC	GAAACGCCGGTTCCCGTGAGGTGCAGGTAGTGCTATGACTAGCAAGTTAC	1	bc
GTCCACTACC	GAAACACCGGTAAATTTGAGGCTCCGGCATGCAGGAGGCCGTGGGGTTAG	1	bc
AGCACAACCA	GAAACACCGGTCCTGTCGCCACGGGTGTGGGGTTAGGGCTAGAAATAGCA	1	bc
TATATCTGCC	GAAACACCGGTAAATTTGAGGCTCCGGCATGCAGGAGGCCGTGGGGTTAG	1	bc
CTTGTGATCT	GAAACACCGGTGACATTGGGTACAGGGGTGGGGTTAGAGCTAGAAATAGC	1	bc
ATACTTGGTT	GAAACACCGGTTTACGTTGCATCGGTTGTGGGGTTAGAGCTAGAAATAGC	1	bc
TCCAACTGAA	GAAACACCGGTAAATTTGAGGCTCCGGCATGCAGGAGGCCGTGGGGTTAG	1	bc
AGGTACCATC	GAAACACCGGTGTGGCTGAGAGTCCGGCAATGGTGTGGCTGTGGGGTTAG	1	bc
AAGTCGGCCG	GAAACACCGGTCCGTAGGAGACCCGTGTGGCATGTACCTGTGGGGATAGA	1	bc
AACCACGAAC	GAAACACCGGTTTGAACTAGAAATAGCAAGTTAACCTAAGGCTAGTCCGT	1	bc
GATACATACC	GAAACACCGGTAGCAAGTGCGAGACGTGTTTTTGTGGGGTTAGAGCTAGA	1	bc
TCCCTTACCG	GAAACACCGGTCGGGGCCACTCAGTGGTGGGGTTAGAGCTAGAAATAGCA	1	bc
AAGCTTATAT	GAAACACCGGTTTACGTTGCATCGGTGTGGGGTTAGAGCTAGAAATAGCA	1	bc
AGACACAGCC	GAAACACCGGTAGCAAGTGGGGTTAGAGCTAGAAATAGCAAGTTAACCTA	1	bc
AGAACAGCCG	GAAACACCGGTCGGCGGCAATCGTGGGTGGGGTTAGAGCTAGAAATAGCA	1	bc
ACCTCGTCGT	GAAACACTAAGGCTAGTCCGTTATCAACTTGAAAAAGTGGCACCGAGTCG	1	bc
GCCTTGACCA	GAAACACCGGTCGGGGCCACTCAGTGGTGGGGTTAGAGCTAGAAATAGCA	1	bc
AATGCTTCGC	GAAACACCGGTTTACGTTGCATCGGTTGTGGGGTTAGAGCTAGAAATAGC	1	bc
GCGGACCCGA	GAAACACCGGTCGGCGGCAAGTTAACCTAAGGCTAGTCCGTTATCAAATT	1	bc
AGGGGGGGCA	GAAACACCGGTTCCCGTCCAGTGGGGCTAGAGCTAGAAATAGCAAGTTAA	1	bc
GCTTTACGGA	GAAACACCGGTCGGGGCCACTCAGAGGGCTGGTTAGATCTAGAAATAGCA	1	bc
ATGAGATTCA	GAAACACCGGTTAAGCCGAGGAGTTAGAGCTAGAAATAGCAAGTTAACCT	1	bc
CTTAGACACT	GAAACACCGGTTGCGGGTGCGGCGAGCAGGATGATGTTAGGGCTGGAAAT	1	bc
TGTCACAGAC	GAAACACCGGTAGCAAGTGGGGTTAGAGCTAGAAATAGCAAGTTAACCTA	1	bc
TGCAGACCCG	GAAACACCGGTCGGCGGCAATCGTGGCTAGAAATAGCAAGTTAACCTAAG	1	bc
CTAATAGTCC	GAAACACCGGTACCTTTGTTGATGCTGGGTGGGGTTAGAGCTAGAAATAG	1	bc
ACGGAGCCGC	GAAACACCGGTTCCCCTCCGGTGGGGTTTGAGCTAGAAATAGCAAGTTAA	1	bc
AGCAGCTCAC	GAAACACCGGTCCGTTTTCAACTTGGGAGGGGGTCGACGAGGCGGTAGCT	1	bc
GCCGTGACCG	GAAACACCGGTCGGGGCCACTCAGTGGTGGGGTTAAAGCTAGAAATAGCA	1	bc
ATCCCCTGCA	GAAACACCGGTGCATTCGAAAGTCCGGTCGTAGTGTGGACGTGGGGTTAG	1	bc
TTGGTCGAGG	GGAACACCGGTTATATTTGTAAGTGGGGTTAGAGCTAGAAATAGCAAGTT	1	bc
ACGAGTTGTC	GAAACACCGGTAAATTTGAGGCTCCGGCATGCAGGAGGCCGTGGGGTTAG	1	bc
CCTTAACTGA	GAAACACCGGTCGGGGCCACTCAGTGGTGGGGTTAGAGCTAGAAATAGCA	1	bc
CGAATGCCTC	GAAACACCGGTTCCGGGCGAGGGGTTTTGGGGGTGGATAGAGCTAGAAAT	1	bc
GGACCCATTC	GAAACACCGGTGTGGCTGAGAGTCCGGCAATGGTGTGGCTGTGGGGTTAG	1	bc
GACCTGCATA	GAAACACCGGTCCATACGAGACCCGTGTGGCATGATCCTGGGGGGTTAGA	1	bc
GTGGAGCACA	GAAACACCGGTTCCCGTCCAGTGGGGTTAGAGCTAGAAATAGCAAGTTAA	1	bc
AGTAGACCCG	GAAACACCGGTCGGCGGCACGTGGGGTTAGAGCTAGAAATAGCAAGTTAA	1	bc
GATTAGCGAT	GAAACACCGGTTACAATTGGGGTTAGAGCTAGAAATAGCAAGTTAACCTA	1	bc
CACTCACTAC	GAAACACCGGTGCCCTTACTCTCACCTGATTACTTAATCCGTGGGGTTAG	1	bc
ACTTAACAGC	GAAACACCGGTCGGGGCCACTCAGTGGTGGGGTTAGAGCTAGAAATAGCA	1	bc
AAACAAAGCC	GAAACACCGGTTTGAACTACCGGGTTAGAGCTAGAAATAGCAAGTTAACC	1	bc
TGCAGACGCG	GAAACACCGGTCGGTGGGGTTAGAGCTAGAAATAGCAAGTTAACCTAAGG	1	bc
TAGTTTACTC	GAAACACCGGTAACTATATTCATGCGATATCGCCGTATCAGTGGGGTTAG	1	bc
AGAAGAGACT	GAAACACCGGTCGGCGGCAATCGTGGGTGGGGTTAGAGCTAGAAATAGCA	1	bc
AGTGGAGACT	GAGACACCGGTTCCCGTCCAGTGGGGTTAGAGCTAGAAATAGCAAGTTAA	1	bc
TGAATTGTAC	GAAACGCCGGTAACTATATTCATGCGATATCGCCGTATCAGTGGGGTTAG	1	bc
AAAAGAGACA	GAAACACCGGTAGCAAGTGCGAGACGTGTTAAATAGCAAGTTAACCTAAG	1	bc
GACGAAGAGC	GAAACACCGGTCCACGGAAATAGCAAGTTAACCTAAGGCTAGTCCGTTAT	1	bc
AATGTCTTCC	GAAACACCGGTGCCCTTACTCTCACCTGATTACTTAATCCGTGGGGTTAG	1	bc
GCAGCTATCG	GAAACACCGGTGTGGCTGAGAGTCCGGCAATGGTGTGGATGTGGGGTTAG	1	bc
ATGCAGATCA	GAAACACCGGTTAAGCCGAGGGTTAGAGCTAGAAATAGCAAGTTAACCTA	1	bc
CCTGTCGTGG	GAAACACCGGTTATATTTGTAAGTGGGGTTAGAGCTAGAAATAGCAAGTT	1	bc
AGTAATGGTC	GAAACACCGGTGTACGTATGGACTGAACCAGGGTGTGCAAGTGGGGTTAG	1	bc
AGAAGCGTCT	GAAACACCGGTCTCGCGGGCGGAGTTCAGCGGGGGGTAAAGCTTGGAATA	1	bc
ACTCGCCACC	GAAACACCGGTATACGTATGGACTGAACCAGGGTGTGCAAGTGTGGTTAG	1	bc
GTGACGATCT	GAAACACCGGTGTACGTATGGAATGAACCAGGGTGTGAAGGTGGGGTTAG	1	bc
TCAGAAGAGC	GAAACACGGTTAGAGCTAGAAATAGCAAGTTAACCTAAGGCTAGTCCGTT	1	bc
ACTCTCGAAG	GAAACACCGGTTATATTTGTAAGTGTGTGGGGTTAGGGCTAGAAATAGCA	1	bc
AGATAGAGAC	GAAACACCGGTAGCAAGTGGGGTTAGAGCTAGAAATAGCAAGTTAACCTA	1	bc
GCGAATCATT	GAAACACCGGTCTCGAGTGAGGTGTTCAGGGTGGGGTTAGAGCTAGAAAT	1	bc
GTCTCTCGAG	GAAACACCGGTTATATTTGTAAGTGTGTGGGGTTAGAGCTAGAAATAGCA	1	bc
AGACTCATTT	GAAACACCGGTCTCGAGTGAGGCGCTCAGGGTGGGGTTAGAGCTAGAAAT	1	bc
TAATATAGAA	GAAACACCGATTACAATTGGGGTTAGAGCTAGAAATAGCAAGTTAACCTA	1	bc
CGTAACGCTT	GAAACACCGGTCGGCGGCAATCGTGGGTGGGGTTAGAGCTAGAAATAGCA	1	bc
GCGTGTTGCC	GAAACACCGGTGACATTGGGGTGGGGTTAGAGCTAGAAATAGCAAGTTAA	1	bc
GTACTAGCAG	GAAACACCGGTACCTTTGTTGATGCTGGGTGGGGTGGGGTTAGAGCTAGA	1	bc
AGATGGACTC	GAAACACCGGTCCGTAGGAGACCCGTGTGGCATGTACCTTGTGGGGTTAG	1	bc
TACCCTATGT	GAAACACCAGTTACATTGAGGGGTTAGAGCTAGAAATAGCAAGTTAACCT	1	bc
ATTGCGCATA	GAAACACCGGTTAAGCCGAGGAGTTAGAGCTAGAAATAGCAAGTTAACCT	1	bc
AGGCACCATC	GAAACACCGGTGTGGCTGAGAGTCCGGCAATGGTGTGGCTGTGGGGTTAG	1	bc
CGCCCCGACT	CCGGTAAATTTGAGGCTCCGGCATGCAGGAGGCCGTGGGGTTAGAGCTAG	1	bc
GGTACGATCA	GAAACACCGGTGTGGCTGAGAGTCCGGCAATGGTGTGGCTGTGGGTTAGA	1	bc
AAGAATCATT	GAAACACCGGTCTCGAGTGAGGTGTTCAGGGTGGGGTTAGAGCTAGAAAT	1	bc
AATGCGTAGC	GAAACACCGGTTTACGTTGCATCGGTTGTGGGGTTAGAGCTAGAAATAGC	1	bc
AGAAGACCAG	GAAACACCGGTCGGCGGCAATTAGAGCTAGAAATAGCAAGTTAACCTAAG	1	bc
GGACCAGCTC	GAAACACCGGCGCATTCGAAAGTCCGGTCGTAGTGTGGACGTGGGGTTAG	1	bc
GTGGAACGGC	GAAACACCGGTCGGCGGCAATCGTGGGTGGGGTTAGAGCTAGAAATAGCA	1	bc
CGGATTAGAT	GAAACACCGGTTTACGTTGCATCGGTGTGGGGTTAGAGCTAGAAATAGCA	1	bc
AGCTACCAGC	GAAACACCGGTTTGGCTGAGAGTACGGCAGTGGTGTGGCTGGAGGGATAA	1	bc
AGACACTAGG	GAAACACCGGTGCATTCGAAAGTCCGGTCGTAGTGTGGACGTGGGGTTAG	1	bc
ACTTTACCTT	GAAACACCGGTCGGGGCCACTCAGTTGTGGGGTTAGAGCTAGAAATAGCA	1	bc
GGTGTGGCCT	GAAACACCGGTGGGGTTAGAGCTAGAAATAGCAAGTTAACCTAAGGCTAG	1	bc
CTTGGTGTGT	GAAACACCGGTTGGGGTTAGAGCTAGAAATAGCAAGTTAACCTAAGGCTA	1	bc
AAGTTTGCGG	GAAACACCGGTCCGTAGGAGACCCGTGTGTCATGTACCTGTGGGGTTAGA	1	bc
ACACAGCGCC	GAAACACCGGTTTGAACTACCGGGGTTAGAGCTAGAAATAGCAAGTTAAC	1	bc
AGAAGACTCG	GAAACACCGGTCGGTGAGGTTAGAGCTAGAAATAGCAAGTTAACCTAAGG	1	bc
AAGAGCGCCC	GAAACACGGGTTAGAGCTAGAAATAGCAAGTTAACCTAAGGCTAGTCAGT	1	bc
TAACGTCCTA	GAAACACCGGTGCTCTTACTCTCACCTGATTACTTAATCCGTGGGGTTAG	1	bc
GACATCTGAA	GAAACACCGGTCTCGAGTGAGGTGTTCGGTGGGGTTAGAGCTAGAAATAG	1	bc
TCGTTACCCC	GAAACACCGGTCGGGGCCACTCAGTGGTGGGGTTAGAGCTAGAAATAGCA	1	bc
GAATATCTGC	GAAACACCGGTCGGCGGCAATCGTGGGTGGGGTTAGAGCTAGAAATAGCA	1	bc
GACACCCAAC	GAAACACCGGTGTGGCTGAGAGTCCGGCAATGGTGTGGCTGTGGGGTTAG	1	bc
CGGGTTGGAT	GAAACACCGTGGGGTTAGAGCTAGAAATAGCAAGTTAACCTAAGGCTAGT	1	bc
ACATCGTCCT	GAAACACCGGTGTACGTATGGACTGAACCAGGGTGTGCAAGTGGGGTTAG	1	bc
ATGCTGGGCA	GAAACACCGGTACCTTTGTTGATGCTTGGGGGGGTTAGAGCTAGAAATAG	1	bc
AGACCAGCTC	GAAACACCGGTGCATTCGAAAGTCCGGTCGTAGTGTGGACGTGGGGCTAT	1	bc
GTGAGTACAA	GAAACACCGGTTAAGCCGAGGTTAGAGCTAGAAATAGCAAGTTAACCTAA	1	bc
CGAATGGGTA	GAAACACCGGTCTCGAGTGAGGTGTTCAGGGTGGGGTTAGAGCTAGAAAT	1	bc
TTAGTTACGC	GAAACACCGGTTACATTGAGATTGGGGTTAGAGCTAGAAATAGCAAGTTA	1	bc
GAGAATCCTT	GAAACACCGGTCTCGAGTGAGGTGTTCAGGGGGTGGGGTTAGAGCTAGAA	1	bc
GGAAAGATTT	GAAACACCGGTCTCGCGTGAGGTGTTCAGGGTGGGGTTAGAGCTAGAAAT	1	bc
AAACAATGAA	GAAACACCGGTAGCAAGTGCGAGACGTGTTTGTGGGGTTAGAGCTAGAAA	1	bc
GAGACACAGA	GAAACACCGGTAGCAAGTGCGGGGTTAGAGCTAGAAATAGCAAGTTAACC	1	bc
GCATAGTCGT	GAAACACCGGTGTACGTATGGACTGAACCAGGGTGTGCAAGTGGGGTTAG	1	bc
TGACCCATGT	GAAACACCGGTTACTTTGAGGGTTCGATCTAGAAGTGGCAAGTTAACCAA	1	bc
GCTGTAACGC	GAAACACCGGTCGGGGCCACTCAGTGGTGGGGTTAGAGCTAGAAATAGCA	1	bc
GTGAATGCTC	GAAACACCGGTTCCCGTCCAGTGGGGTTAGAGCTAGAAATAGCAAGTTAA	1	bc
GACGACTCGA	GAAACACCGGTCGGCGGCAATCGTGGGGTGGGGTTAGAGCTAGAAATAGC	1	bc
CATTTATTGC	GAAACACCGGTCGGGGCCACTCAGTGGTGGGGTTAGAGCTAGAAATAGCA	1	bc
TCAGCGCTGT	GAAACACCGGTTACATTGGGGTTAGAGCTAGAAATAGCAAGTTAACCTAA	1	bc
AGGGGGTCTT	GAAACACCGGTTCGCGTACAGGGGGGTTAGAGGTAGAAATAGCAAGTAAA	1	bc
CAGTGCTGTT	GAAACCCCGGTGACCGTATGGGCTGAACCAGGGTGGGCATAGGGGGGATA	1	bc
AAAATCCTGT	GAAACACCGGTAACGGGTATATGGTGCAGGGGAGCGTTAGAGGTAGAAAT	1	bc
CGATTACATT	GAAACACCGGTCTCGAGTGAGGTGTTCAGGGTGGGGTTAGAGCTAGAAAT	1	bc
ACGGCTTCTC	GAAACACCGGTTTACGTTGCATCGGTGTGGGGTTAGAGCTAGAAATAGCA	1	bc
CATGTTCTCG	GAACCACCGGTGTTAGAGCTAGAAATAGCAAGTTAACCTAAGGCTAGTCC	1	bc
ACCCAACGCC	GAAACACCGGTTTGAACTAGAAATAGCAAGTTAACCTAAGACTAGTCCGT	1	bc
AGGTACCGTC	GAAACACCGGTGTGGCTGAGAGTCCGGCAATGGTGTGGCTGTGGGGTTAG	1	bc
CGTTTCTCAT	GAAACACCGGTGACATTGGGTGTCCTCTGTAGGACTTGGAATATGACGAG	1	bc
ACGCGGCTCC	GAAACACCGGTTTACGTTGCATCGGGGTTAGAGCTTGAAATAGCAAGATA	1	bc
TCACCGTCGT	GAAACACCGGTGTACGTATGGACTGAACCAGGGTGTGCAAGTGGGGTTAG	1	bc
TGAAACAGAC	GAAACACCGGTAGCAAGTGCGAGACGTGTTAGAGCTAGAAATAGCACCGG	1	bc
AAACAACGCA	GAAGCACCGGTTTGAACTAGAAATAGCAAGTTAACCTAAGGCTAGTCCGC	1	bc
CACCCCCACA	GAAACACCGGTGCCCTTACTCTCCCCTGATTACTTAATCCGTGGGGTTAG	1	bc
GAGAGGAGCC	GAAACACCGGTTCCCGTCCAGTGGGGTTAGAGCTAGAAATAGCAAGTTAA	1	bc
GGACACCTAC	GAAACACCGGTGTGGCTGAGAGTCCGGCAATGGTGTGGCTGTGGGGTTAG	1	bc
GAACCAGCCC	GAAACACCGGTATGTTTGTTGATGCTGGGTGGAAGGAAATTGCGGGGATA	1	bc
CGCTAATCGG	GAAACACCGGTACCTTTGTTGATTCTAGCTGGGTTAGAGCTAGAAATAGC	1	bc
GGCAACTCCA	GAAACACCGGTAAATTTGAGGCTCCGGCATGCAGGAGGCCGTGGGGTTAG	1	bc
GTGTCACCTC	GAAACACCGGTTCCCGTCCAGTGGGGTTAGAGCTAGAAATAGCAAGTTAA	1	bc
ATAATAGGCA	GAAACACCGGTTTGAACTACCTAGTTCAAACCGGTGGGGTTAGAGCTAGA	1	bc
GACAACGAAC	GAAACACCGGTAGCAAGTGCGAGACGTGTTTGTGGGGTTAGAGCTAGAAA	1	bc
GACCTAGGAA	GAAACACCGGTTTACGGTTCATCTGAGGGTGGTTAGATCTAGAAATGACA	1	bc
GGGTGCCATG	GAAACACCGGTCTCGAGTGAGGTGTTCAGGGTGGGGGTAGAGCTAGAAAT	1	bc
ATCGCCCGAA	GAAACACCGGTGCCCTTACTCTCACCTGATTACTTAATCCGTGGGGTTAG	1	bc
AGGAAAGCTT	GAAACACCGGTCTCGAGTGAGGTGTTCAGGTGGGGTTAGAGCTAGACATA	1	bc
AACAAAGCAC	GAAACACCGGTACCCTGCTGGGTTAGAGCTAGAAATAGCAAGTTAACCTA	1	bc
AACGTGCTTT	GAAACACCGGTGCCCTTACTCTCACCTGATTACTTAATCCGTGGGGTTAG	1	bc
ATGATTATGC	GAAACACCGGTAACCTTTGATTCTAGAGCTAGAAATAGCAAGTTGACCTA	1	bc
GAAGATGCTC	GAAACACCGGTCGGCGGCAATCGTGGGTGGGGTTAGAGCTAGAAATAGCA	1	bc
AGGCTACTAC	GAAACACCGGTAAATTTGAGGCTCCGGCATGCAGGAGGCCGTGGGGTTAG	1	bc
CCTCGACCGA	GAAACACCGGTCGGGGCCACTCAGTGGTGGGGTTAGAGCTAGAAATAGCA	1	bc
AGACAAGGCC	GAAACACCGGTTTGAACTAGAAATAGCAAGTTAACCTAAGGCTAGTCCGT	1	bc
GAAACCGTCA	GAAACACCGGTGTGGCTGAGAGTCCGGCAATGGTGTGGCTGTGGGGTTAG	1	bc
GTACTCTGCA	GAAACACCGGTGTGGCTGAGAGTCCGGCAATGGTGTGGCTGTGGGGTTAG	1	bc
CGTGTCGCAT	GAAACACCGGTGACATTGGGTACAGGGTGGGGTTAGAGCTAGAAATAGCA	1	bc
ACGCCCCAAC	GAAACACCGGTAAATTTGAGTCTCCGGCATGCAGGAAGCTGTGGGGTTAG	1	bc
ATGGGTATAT	GAAACACCGGTTTACGTTGCATCGGTGTGGGGTTAGAGCTAGAAATAGCA	1	bc
AAGATTAGAT	GAAACACCGGTTTACGTTGCATCGGGGTTAGAGCTAGAAATAGCAAGTCG	1	bc
GGAACAGCTA	GACACACCGTTGTGTCTGAGAGTCCGGCAATGGTGTGGCTGTGGGGTTAG	1	bc
AAATCGTCGA	GAAACACCGGTGTACGTATGGACTGAACCAGGGTGTGCAAGTGGGGTTAG	1	bc
CCTTTGCATC	GAAACACCGGTCCGTAGGGGACCCGTGTGGCATGTACCTCTGTGGGGTTA	1	bc
GGCCACTAAC	GAAACACCGGTAAATTTGAGGCTCCGGCATGCAGGAGGCCGTGGGGTTAG	1	bc
CGATTGATTT	GAAACACCGGTCTCGAGTGAGGTGTTCAGGGTGGGGTTAGAGCTAGAAAT	1	bc
CAGAGCATAT	GAAACACCGGTAGCAAGTGCGAGGCTAGAAATAGCAAGTTAACCTAAGGC	1	bc
CATTTACCTA	GAAACACCGGTCGGGGCCCAAGTTGACCTAAGGCTAGTCCGTTACAACTT	1	bc
TGGCCCATAA	GAAACACCGGTAAATTTGAGGCTCCGGCATGCAGGAGGCCGTGGGGTTAG	1	bc
ACGAATCGTT	GAAACACCGGTCTCGAGTGAGGTGTTCAGGGTGGGGTTAGAGCTAGAAAT	1	bc
AGTGAAGCCG	GAAACACCGGTCGGGGTCACGCAGTGGTAGGGCTAGAGCTAGAAATTTAA	1	bc
ACGTGATGTC	GAAACACCGGTGACATTGGGTACAAAAGTGGGGTTAGAGCTAGAAATAGC	1	bc
GAGGACGAGC	GAAACACCGGTCGGCGGCAATCTCGAAAAAGTGGCACCGAGTCGGTGCTT	1	bc
GGAATAGATA	GAAACACCGGTAGCAAGTGCGAGACGTGTTAGAGCTAGAAATAGCAAGTT	1	bc
ATCTTTACAG	GAAACACCGGTCGGGGCCACTCAGTGGTGGGGTTAGAGCTAGAAATAGCA	1	bc
TTAGAACCGA	GAAACACCGGTTAAATTGGGGTTAGAGCTAGAAATAACAAGTAAACCTAT	1	bc
AGGTGGAGCC	GAAACACCGGTTCCCGTCCAGTGGGGTTAGAGCTAGAAATAGCTAGTTAA	1	bc
AAAGCCCTCA	GAAACACCGGTGCCCTTACTCTCACCTGATTACTTAATCCGTGGGGTTAG	1	bc
GAGGACCATA	GAAACACCGGTCGGCGGCAATCGTGGGTGGGGTTAGAGCTAGAAATAGCA	1	bc
TAATTTTTCC	GAAACACCGGTAACTATATTCATGCGATATCGCCGTATCAGTGGGGTTAG	1	bc
ACAGCGCTAC	GAAACACCGGTGCCCTTACTCTCACCTGATTACTTAATCCGTGGGGTTAG	1	bc
AATGCGTAGC	GAAACACCGGTTTACGTTGCATCGGTTTGTGGGGTTAGAGCTAGAAATAG	1	bc
AGGGTACCCT	GAAACACCGGTGTGGCTGAGAGTCCGGCAATGGTGTGGCTGTGGGGTTAG	1	bc
AGGCACGCTC	GAAACACCGGTGTGGCTGAGAGTCCGGCAATGGTGTGGCTGTGGGGTTAG	1	bc
CCTCCATCGT	GAAACACCGGTCGGGGCCACTCAGTGGTGGGGTTAGAGCTAGAAATAGCA	1	bc
TATCTGGAGT	GAAACACCGGTTATATTTGTAAGTGTTGTGTGGCTAGAGCTAGAAATAGC	1	bc
AGGCACACTA	GAAACACCGGTGTGGCTGAGAGTCCGGCAATGGTGTGGCTGTGGGGTTAG	1	bc
CTAATTATTT	GAAACACCGGTCTCGATTGGGGGGTTCAGGTAGGGGTTAGAGCTAGACAT	1	bc
AATGATTAGC	GAAACACCGGTTTACATTGCATCGGTGTGGGGTTAGAGCTAGAAATAGCA	1	bc
AGCACAACAA	GAAACACCGGTCCTGTCGCCACGGGTGTGGGGTTAGGGCTAGAAATAGCA	1	bc
TATACACGGC	GAAACACCGGTACCTTTGTTGATGCTGGGTGGGGTTAGAGCTAGAAATAG	1	bc
ATCAGTAGGT	GAAACACCGGTTTACGTTGCATCGGGTTAGAGCTAGAAATAGCAAGTTAA	1	bc
AATGTAGAGA	GAAACACCGGTTTACGTTGCATCGGTGTGGGGTTAGAGCTAGAAATAGCC	1	bc
GAACCTCCTT	GAAACACCGGTCCGTAGGAGACCCGTGTGGCATGTACCTGTGGGGTTAGA	1	bc
TGACATAGAA	GTAACACCGGTAGCAAGTGCGAGACGTTGTTGTGGGGTTAGAGCTAGAAA	1	bc
CTGCTTTGAT	GAAACACCGGTTTACGCATGCTCGGCTGTGGGGATAGAGCTAGAGATAAC	1	bc
AACCTGCTGT	GAAACACCGGTGCCCTTACTCTCTATTGATTACTTGATCAGTGGGGTTAG	1	bc
CTCCTCCCTC	GAAACACCGGTCCGTAGGAGACCCGTATGGCATGTACCTGTGGGGTTAGA	1	bc
AAAGGCCTAT	GAAACACCGGTGCCCTTACTCTCACCTGATTACTTAATCCGTGGGGTTAG	1	bc
AGGCACCGAC	GAAACACCGGTAAATTTGAGGCTCCGGCATGCAGGAGGCCGTGGGGTTAG	1	bc
ATGAAGAGAT	GAAACACCGGTTTACGTTGCATCGGTGTGGGGTTAGAGCTAGAAATAGCA	1	bc
CATGGTTTCC	GAAACACCGGTGACATATGCATGAGTGTGGGGTTAGAGCTAGAAATAGCA	1	bc
GTGGTGGCTA	GAAACACCGGTTCCCGTCCAGTGGGGTTAGAGCTAGAAATAGCAAGTTAA	1	bc
TGTGTGGCCT	GAAACACCGGTTCCCGTCCAGTGGGGTTAGAGCTAGAAATAGCAAGTTAA	1	bc
AAACGATCGC	GAAACACCGGTGCATTCGAAAGTCCGGTCGTAGTGTGGACGTGGGGTTAG	1	bc
GAGAACCTCG	GAAACACCGGTGCATTCGAAAGCCCGGTCGTAGTGTGGACGTGGGGTTAG	1	bc
AAACTTTTAT	GAAACACCGGTAACTATATTCATGCGATATCGCCGTATCAGAGGGGTTAG	1	bc
AGAGTTGTAT	GAAACACCGGTGTTAGAGCTAGAAATAGCAAGTTAACCTAAGGCTAGTCC	1	bc
GGCACCAGTG	GAAACACCGGTGTGGCTGAGAGTCCGGCAATGGTGTGGCTGTGGGGATAG	1	bc
ATTGCTCGGC	GAAACACCGGTACCTTTGTTGATGCTGGGTGGGGTTAGAGCTAGAAATAG	1	bc
AATGCTGTAC	GAAACACCGGTGCCCTTACTCTCACCTGATTACCTAATCCGTGGGGTTAG	1	bc
AACATCGCTC	GAAACACCGGGTTGAACTAGAAATAGCATGTTAACCTAAGGCTAGTCCGT	1	bc
TGCATCCTCT	GAAACACCGGTCTCGAGGGAGGTGTTCAGTTGGGTTAGATCTAGAAATAG	1	bc
TCACAACTCT	GAAACACCGGTTTGAACTAGAAATAGCAAGTTAACCTAAGGCTAGTCCGT	1	bc
GAGACACTCG	GAAACACCGGTAGCAAGTGCGAGACGTGTTTTAGAGCTAGAAATAGCAAG	1	bc
TAGCACTCCC	GAAACACCGGTTTGAACTAGAAATAGCAAGTTAACCTAAGGCTGGTCCGT	1	bc
AGCATGCCTA	GAAACACCGGTCCGTAGGAGACCCGTGTGGCATGTACCTGTGGGGTTAGA	1	bc
GTAGTTTGGT	GAAACACCGGTTACATTGAGGGTTAGGGCTAGACATAGCAAGTTAACCTA	1	bc
TCACAAAGTC	GAAACACCGGTTTGAACTACCTAGTTCAAACCGGTGGGGTTAGAGATAGA	1	bc
GGCCACTTCC	GAAACACCGGTGTGGCTGAGAGTCCGGCAATGGTGTGGCTGTGGGGTTAG	1	bc
ATCAATCGAG	GAAACACCGGTTATATTTGTAAGTGTTTGTGGGGTTAGAGCTAGAAATAG	1	bc
GTCTCTCGCG	GAAACACCGGTTATATTTGTAAGTGTTTTGTGGGGTTAGAGCTAGAAATA	1	bc
GCCGTTACAG	GAAACACCGGTCGGGGCCACTCAGTGGTGGGGTTAGAGCTAGAAATAGCA	1	bc
AATCGCTCTC	GAAACACCGGTGTACGTATGGACTGAACCAGGGTGTGCAAGTGGGGTTAG	1	bc
GTACCTTAGT	GAAACACCGGTAAATTTGAGGCTCCGGCCTGCAGGAGGCCGTGGGGTTAG	1	bc
GGCGACCGCA	GAAACACCGGTGTGGCTGAGAGTCAGGCATTGGTGTGGCTGGGGGGTTAG	1	bc
TTTGACGATA	GAAACACCGGTTAAGCCGAGTGGGGTTAGAGCTAGAAATAGCAAGTTAAC	1	bc
AACACCGCAC	GAAACACCGGTTTGAACTACCGGGGTTAGAGCTAGAAATAGCAGGTTAAC	1	bc
ACTCATAGCC	GAAACACCGGTTTACGTTGCATCGGATTAGAGCTAGAAATAGCAAGTTAA	1	bc
AGGTGCTCGT	GAAACACCGGTGCATTCGAAAGTCCGGTCGTAGTGGGGACGGGGGGTTAG	1	bc
GCGAAGCCTT	GAAACACCGGTCTCGAGTGAGGTGTTCAGGGTGGGGTTAGAGCTAGAAAT	1	bc
AATCTCCGTC	GAAACACCGGTGTACGTATGGACTGAACCAGGGTGTGCAAGTGGGGTTAG	1	bc
AGTCAGTACA	GAAACACCGGTGGGGATAGAGCTAGAAATAGCAAGTTAACCTAAGGCTAG	1	bc
GGCGGAGCCT	GAAACACCGGTTCCCGTCCAGTGGGGTTAGAGCTAGAAATAGCAAGTTAA	1	bc
AGGCGCCCTG	GAAACACCGGTGTGGCTGAGAGTCCGGCAATGGTGTGGCTGTGGGGTTAG	1	bc
AAGTCTGAAT	GAAACACCGGTCCGTAGGAGACCCGTGTGGCATGTACCTGTGGGTTAGAG	1	bc
AGTGTTGTAC	GAAACACCGGTATGGGGTTAGAGCTAGAAATAGCAAGTTAACCTAAGGCT	1	bc
TCTCGACGTC	GAAACACCGGTGTACGTATGGACTGAACCAGGGTGTGCAAGTGGGGATAG	1	bc
TAAATAACTT	GAAACACCGGTCCGCCCCAATCGTGGGTGGGGTTAGAGCTAGAAATAGCA	1	bc
AATACTCGGA	GAAACACCGGTACCTTTGTTGATGCTGGGTGGAGCTAGAAATAGCAAGTT	1	bc
CACTCTGTCC	GAAACACCGGTTTGAACTAGAAATAGCAAGTTAACCTAAGGCTAGTCCGT	1	bc
CCGTCGGCTT	GAAACACCGGTCGATTCATATCGAAACCTTCCCGTGACAGTAGGGTTAGA	1	bc
GGACCCTAAC	GATACACCGGTAAATTTGAGGCTCCGGCATGCAGGAGGCCGTGGGGTTAG	1	bc
ATATATCGAG	GAAACACCGGTTATATTTGTAATGGGGTTAGAGCTAGAAATAGCAAGTTA	1	bc
TGGAGACGGT	GAAACACCGGTGAGGCTGAGAGTCCGGCAATGGTGTGGCTGGAGGGATAA	1	bc
CAGTTAGAGC	GAAACACCGGTCGGGGGTAGAGCTAGAAATAGCAAGTTAACCTAAGGCTA	1	bc
TACACTTGGC	GAAACACCGGTAAATTTGAGGCTCCGGCATGCAGGAGGCCGTGGGGTTAG	1	bc
CCTGTTGCTT	GAAACACCGGTGACATTGGGTACAGGGTGGGGTTAGAGCTAGAAATAGCA	1	bc
AATGTACAGC	GAAACACCGGTCGGGGCCACTCAGTGGTGGGGTTAGAGCTAGAAATAGCA	1	bc
AAAGCATTAA	GAAACACCGGTGCCCTTACTCTCACCTGATTACTTAATCCGTGGGGTTAG	1	bc
AAGCTTGCCG	GAAACACCGGTCCGTAGGAGACCCGTGTGGCATGTACCTGTGGGGTTAGA	1	bc
AGAGGAGACT	CAAAACACCGGTTCCCGTCCAGTGGGGTTAGAGCTAGAAATAGCAAGTTA	1	bc
TCTTTAGCGT	GAAACACCGGTCGGGGCCACTCAGTGGTGGGGTTAGAGCTAGAAATAGCA	1	bc
CAAAAAGCCT	GAAACACGGGTTAGAGCTAGAAATAGCAAGTTAACCTAAGGCTGTCCGTT	1	bc
ACGAGATGGC	GAAACACCGGTGACATTGGGTTAGAGCTAGAAATAGCAAGTTAACCTAAG	1	bc
AGGCCACGAC	CCGGTAAATTTGAGGCTCCGGCATGCAGGAGGCCGTGGGGTTAGAGCTAG	1	bc
AGCCACTCTA	GAAACACCGGTAAATTTGAGGCTCCGGCATGCAGGAGGTGGGGTTAGAGC	1	bc
CAGTACTCGC	GAAACACCGGTTTGAACTAGAAATAGCAAGTTAACCTAAGGCTAGTCCGT	1	bc
AATGCCTTAT	GAAACACCGGTGCCCTTACTCTCACCTGATTACTTAATCCGTGGGGTTAG	1	bc
ACCTACGGTC	GAAACACCGGTCGATTCATATCGAAACCTTCCCGTGACAGTGGGGTTAGA	1	bc
GCCTCAGCGA	GAAACACCGGTAGAAAGTGCGAGACGTGTTTGTGGGGTTAGAGCTAGAAA	1	bc
AAAGTCCCAC	GAAACACCGGTGCCCTTACTCTCACCTGATTACCTAATCCGTGGGGTTAG	1	bc
GTCCTTATCC	GAAACACCGGTTTACGTTGCATCGGGGTTAGAGCTAGAAATAGCAAGTTA	1	bc
AGCCCAAATC	GAAACACCGGTTGACACGCTAGGTGTTGAAAAACTTGTTGGTGGGGTTAG	1	bc
AGGCGCCGTC	GAAACACCGGTGTGGCTGAGAGTCCGGCAATGGTGTGGCTGTGGGGTTAG	1	bc
GAATCCTCGT	GAAACACCGGTGTACGTATGGACTGAACCAGGGTGTGCAAGTGGGGTTAG	1	bc
TCACTTACTT	GAAACACCGGTAACTATATTCATGCGATTTCGGCGTATCAGGGGGGATAG	1	bc
TCCTTGACAG	GAAACACCGGTCGGGGCCACTCAGTGGTGGGGTTAGAGCTAGAAATAGCA	1	bc
AATATTCGGT	GAAACACCGGTCGATTCATATCGAAACCTTCCCGTGACAGTGGGGTTAGA	1	bc
AAGAACATCG	GAAACACCGGTGCATTCGAAAGTCCGGTCGTAGTGTGGACGTGGGGTTAG	1	bc
GGCAGCTTCA	GAAACACCGGTAAATTTGAGGCTCCGGCATGCAGGAGGCCGTGGGGTTAG	1	bc
AATGCACTCC	GAAACACCGGTGCCCTTACTCTCACCTGATTACTTAATCCGTGGGGTTAG	1	bc
AGTACTTGGC	GAAACACCGGTACCTTTGTTGATGCTGGGTGTGGGGTTAGAGCTAGAAAT	1	bc
GGGAGAATAA	GAAACACCGGTTAAGCCGAGTGGGGTTAGAGCTAGAAATAGCAAGTTAAC	1	bc
GTGTGGATAA	GAAACACCGGTTAAGCCGAGTGGGGTTAGAGCTAGAAATAGCAAGTTAAC	1	bc
CAATTTGGTT	GAAACACCGGTCGATTCATATCGAAACCTTCCCGTGACAGTGGGGTTAGA	1	bc
CTGAACGCAC	GAAACACCGGTTTGCACTACCGGGGGTAGAACTAGTAATAAGCAAATAAA	1	bc
CGACTCTTTC	GAAACACCGGTCTCGTGGGAGGTGCTCAGGGTGGGGTTAGAGCTAGAAAT	1	bc
CGTTTATCAT	GAAACACCGGTGACATTGGGTGTCCACTGTAGGACTTGGAGTATGACAGG	1	bc
CACAGTCGGC	GAAACACCGGTGTACGTATGGACTGAACCAGGGGGTGCGAGTGGGGTTAG	1	bc
GTAGAACCGA	GAAACACCGGTCGGCGGCAATCGTGGGTGGGGTTAGAGCTAGAAATAGCA	1	bc
GTCCTTTACT	GAAACACCCGTCGGGGCCACTCAGTGGTGGGGTTAGAGCTAGAAATAGCA	1	bc
TAGTATGCCT	GAAACACCGGTCCGTAGGAGACCCGTGTGGCATGTACCTGTGGGGTTAGA	1	bc
ACACAACGAC	GAAACACCGGTTTGAACTACCTAGTTCAAACCGGTGGGGTTAGAGCTAGA	1	bc
ATCGGTCGAT	GAAACACCGGTGCCCTTACTCTCACCTGATTACTTAATCCGTGGGGTTAG	1	bc
ACACTAGTTT	GAAACACCGGTCGATTCATATCGAAACCTTGTTAGAGCTAGAAATAGCAA	1	bc
GGGCTGCCCC	GAAACACCGGTCCGCAGGAGACCCGTGCGGCGTGTACCTGTGGGGTTAGA	1	bc
AATAGGTACG	GAAACACCGGTTACATTGGGGTTAGAGCTAGAAATAGCAAGTTAACCTAA	1	bc
ATATAGCCCT	GAAACACCGGTTTACGTATGGACTGAACCAGGGTGTGCAAGTGGGGTTAG	1	bc
AAGTCGGCCT	GAAACACCGGTCCGTAGGAGACCCGTGTGGCATGTACCTTGTGGGGTTAG	1	bc
GTGTTGCATC	GAAACACCGGTTCCCGTCCAGTGGGGTTAGAGCTAGAAATAGCAAGTTAA	1	bc
GGAATCCTGC	GAAACACCGGTGTGGCTGAGAGTCCGGCAATGGTGTGGCTGTGGGGTTAG	1	bc
AGTAGGTCGC	GAAACACCGGTGCATTCGAAAGTCCGGTCGTAGTGTGGACGTGGGGTTAG	1	bc
AACGTGTAGG	GAAACACCGGTGACATTGGGTACAGGGTGGGGTTAGAGCTAGAAATAGCA	1	bc
AGAGATGTAT	GAAACACCGGTGGGGTTAGAGCTAGAAATAGCAAGTTAACCTAAGGCTAG	1	bc
GAAACGGCCT	GAAACACCGGTGCCCTTACTCTCACCTGATTACTTAATCCGTGGGGTTAG	1	bc
GGCCTCCTGC	GAAACACCGGTGTGGCTGAGAGTCCGGCAATGGTGTGGCTGTGGGGATAG	1	bc
CCAGGTCGTC	GAAACACCGGTGTACGTATGGACTGAACCAGGGTGTGCAAAAGTGGGGTT	1	bc
AGAAACTAGC	GAAACACCGGTGCATTCGAAAGTCCGGTCGTAGTGTGGACGTGGGGTTAG	1	bc
ATGTCTAGCA	GAAACACCGGTTTACGTTGCATCGGTTTGTGGGGTTAGAGCTAGAAATAG	1	bc
AAGCACGCCC	GAAACACCGGTTTGAACTACCGGGGTTAGAGCTAGAAATAGCAAGTTAAC	1	bc
CATATTCCGA	GAAACACCGGTCGGGGCCACTCAGTGGTGGGGTTAGAGCTAGAAATAGCA	1	bc
AGAATTGACC	GAAACACCGGTCGGGGCCACTCAGTGGTGGGGTTAGAGCTAGAAATAGCA	1	bc
ACATCCGTAT	GAAACACCGGTCGATTCATATCGAAACCTTCACGTGACAGGGGGGTTAGA	1	bc
AAAAACGTCA	GAAACACCGGTTTGAACTACCGGGGTTAGGGCTAGAAATAGCAAGTTAAC	1	bc
ACTTAACTGT	GAAACACCGGTCGGGGCCACTCAGTGGTGGGGTTAGAGCTAGAAATAGCA	1	bc
AGATTGCGTT	GAAACACCGGTCGATTCATATCGAAACCTTCCCGTGACAGTGGGGTTAGA	1	bc
GCATCGCCGT	GAAACACCGGTGTACGTATGGACTGAACCAGGGTGTGCAAGTGGGGTTAG	1	bc
AGGCCTTCTC	GAAACACCGGTGTGGCTGAGAGCCCGGCAATGGTGTGGCTGTGGGGTTAG	1	bc
TTGATTATGT	GAAACACCGGTTAAAGTGAGATCGGGGTTGGAAATAAACAAAGTAACCTA	1	bc
AGGACCCTAC	GAAACACCGGTAAATTTGAGGCTCCGGCATGCAGGAGGCCGTGGGGTTAG	1	bc
CGGTGGAGCC	GAAACACCGGTTCCCGTCCAGTGGGGTTAGAGCTAGAAATAGCAAGTTAA	1	bc
AGTGATGTTA	GAAACACCGGTGACTTTGGGTACAGGGTGGGGTTAGAGATAGATATAGAA	1	bc
CCACTCACTC	GAAACACCGGTCCGTAGGTGAACCGTGTGGCATGGGCCAGAGGTGGTAAT	1	bc
GGGCACCCTA	GAAACACCGGTGTGGCTGAGAGTCCGGCAATGGTGTGGCTGTGGGGTTAG	1	bc
CGTATTGTAA	GAAACACCGGTGACATTGGGCACAGGGTGGGGTTAGAGCTAGAAATAGCA	1	bc
CGGATCGTTC	GAAACACCCGTCTCGAGTGAGGTGTTCAGGGTGGGGTTAGAGCTAGAAAT	1	bc
GACGTTCGGG	GAAACACCGGTCGGTTCATATCGAAACCTTCCCGTGACGGTGGGGTTAGA	1	bc
TTGCACCCTC	GAAACACCGGTGTGGCTGAGGGTCCGGCAATGGTGTGGCTGTGGGGTTAG	1	bc
AAGCGTCGCC	GAAACACCGGTGTACGTATGGACTGAACCAGGGAGTGCAAGTGGGGTTAG	1	bc
CCTTACAGCC	GAAACACCGGTCGGGGCCACTCAGTGGTGGGGTTAGAGCTAGAAATAGCA	1	bc
ACGCAGAGGT	GAAACACCGGTTTACGTTGCATCGGTTATTAGAGCTAGAAATAGCAGGTT	1	bc
CGTATCAATT	GAAACACCGGTCTCGAGTGAGGTGTTCAGGGTGGGGTTAGAGCTAGAAAT	1	bc
ATGACTGGCA	GAAACACCGGTTTACGTTGCATCGGTGTGGGGTTAGAGCTAGAAATAGCA	1	bc
GTATGTACCG	GAAACACCGGTCGGGGCCACTCAGTGGTGGGGTTAGAGCTAGAAATAGCA	1	bc
AGAAGCCCCG	GAAACACCGGTCGGCGGCAATCGTGGGTGGGGTTAGAGCTAGAAATAGCA	1	bc
GCGGCGCCTT	GAAACACCGGTTCCCGTCCAGTGGGGTTAGAGCTAGAAATAGCAAGTTAA	1	bc
AAGTATGATT	GAAACACCGGTCCGTAGGAGACCCGTGTGGCATGTACCTGTGGGGTTAGA	1	bc
GGCAGTCTTC	GAAACACCGGTGTGGCTGAGAGTCCGGCAATGGTGTGGCTGTGGGGTTAG	1	bc
AATGCTATAC	GAAACACCGGTGCCCTTACTCTCACCTGATTACTTAATCCGTGGGGTTAG	1	bc
GCAGACTCGA	GAAACACCGGTCGGCGGGTTAGAGCTAGAAATAGCAAGTTAACCTAAGGC	1	bc
GTGGCACTTT	GAAACACCGGTGTGGCTGAGAGTCCGGCAATGGTGTGGCTGTGGGGTTAG	1	bc
AACAATGGCC	GAAACACCGGTTTGAACTACCGGGGTTAGAGCTAGAAATAGCAAGTTAAC	1	bc
AAATAACCTG	GAAACACCGGTGTGGCTGAGAGTCCGGCAATGGTGTGGCTGTGGGGTTAG	1	bc
GGCTACCCGC	GAAACACCGGTGTGGCTGAGTGTCCGGCAATGGTGAGGCTGTGGGGTTAG	1	bc
TGTGACGATA	GAAACACCGGTGTGGCTGAGAGTCCGGCAATGGTGTGGCTGTGGGGTTAG	1	bc
AACTTCGGAT	GAAACACCGGTCGATTCATATCGAAACCTTCCCGTGACAGTGGGGTTAGA	1	bc
GGAATCCGTG	GAAACACCGGTCTCTAGTGGAGGGTTGCGGGTGGGGTTAGAGCTAGAAAT	1	bc
ACCACGTTGT	GAAACACCGGTGTACGTATGGACTGAACCAGGGTGTGAAAGCGAGGATAG	1	bc
AGTGAGCATA	GAAACACCGGTTAAGCCGAGGAGTTAGAGCTAGAAATAGCAAGTTAACCT	1	bc
CATTTACTTG	GAAACACCGGTCGGGGCCACTCAGTGGTGGGGTTAGAGCTAGAAATAGCA	1	bc
GCAGACGCTC	GAAACACCGGTCGTGGGGTTAGAGCTAGAAATAGCAAGTTAACCTAAGGC	1	bc
ACTAGTCGGC	GAAACACCGGTACCTTTGTTGATGATGGGTGGGGTTAGAGCTAGAAATAG	1	bc
GAGAGCCTCT	GAAACACCGGTTAAGCCGAGGAGTTAGAGCTAGAAATAGCAAGTTAACCT	1	bc
CAAATCCCTC	GAAACACCGGTCTCGAGTGAAGTGTTCAGGGTGGGGTTAGAGCTTGAGAT	1	bc
ACATTGGCTC	GAAACACCGGTCGATTCATATCGAAACTTTCCTGTGACTGTGGGGTTAGA	1	bc
ATAGAGCATA	GAAACACCGGTTAAGCCGAGTGGGGTTAGAGCTAGAAATAGCAAGTTAAC	1	bc
AGTCTATCGT	GAAACACCGGTTATATTTGTAAGTGTTTGTGGGGTTAGAGCTAGAAATAG	1	bc
TGACTCAGAC	GAAACACCGGTAGCAAGTGCGAGACGTGTTAGACGTGGGGTTAGAGCTAG	1	bc
ACATCGTTGT	GAAACACCGGTGTACGTATGGACTGAACCAGGGTGTGCAAGTGGGGTTAG	1	bc
AGTGTGGCCT	GAAACACCGGTGACATTTGGGGTTAGAGCTAGAAATAGCAAGTTAACCTA	1	bc
ACTCACCGCC	GAAACACCGGTACCTTTGTTGATTCTAGCTGGGTTAGAGCTAGAAAGAGC	1	bc
AAAGCTACGT	GAAACACCGGTTACATTGAGGGTTGGAGCTGGGAATAGCGAGTTAGACTA	1	bc
GACATTCGCT	GAAACACCGGTCGATTCATATCGAAACCTTCCCGTGACAGTGGGGTTAGA	1	bc
ACACACTCGG	GAAACACCGGTGCATTCGAAAGTCCGGTCGTAGTGTGGACGTGGGGTTAG	1	bc
CATTACAAGC	GAAACACCGGTCGGGGCCACTCAGTGGTGGGGTTAGAGCTAGAAATAGCA	1	bc
ACACAAAGCC	GAAACACCGGTTCGAACTAGAAATAACAAGTTAACCTAAGGCTAGTCCGT	1	bc
GTTATACGCC	GAAACACCGGTAGCAAGTGCGGGAGCTAGAAATAGCAAGTTAACCTAAGG	1	bc
GCTGTCGCGG	GAAACACCGGTTATATTTGTAAGTGTGTGGGGTTAGAGCTAGAAATAGCA	1	bc
GAACGCCGTA	GAAACACCGGTGCCCTTACTCTCACCTGATTACTTAATCCGTGGGGTTAG	1	bc
AGAAGACGCG	GAAACACCGGTCGGCGGCAATCGTGGGTGGGGTTAGAGCTAGAAATAGCA	1	bc
TACCTTCTCC	GAAACACCGGTAACTATATTCATGCGATATCGCCGTATCAGTGGGGTTAG	1	bc
AAGTCGGCCG	GAAACACCGGTCCGTAGGAGACCCGTGTGGCATGTACCTGTGGGGTTAGA	1	bc
ATGCCCTAGC	GAAACACCGGTGCATTCGAAAGTCCGGTCGTAGTGTGGACGTGGGGTTAG	1	bc
CAGATCATTT	GAAACACCGGTCTCGAGTGAGGTGTTCAGGGTGGGGTTAGAGCTAGAAAT	1	bc
GGTCTACCCC	GAAACACCGGTGTGGCTGAGAGTCCGGCAATGGTGTGGCTGTGGGGGTAG	1	bc
GCCTTCCACA	GAAACACCGGTCGGGGCCACTCAGTGGTGGGGTTAGAGCTAGAAATAGCA	1	bc
GGTTCCTCCA	GAAACACCGGTAAATTTGAGGCTCCGGCATGCAGGAGGCCGTGGGGTTAG	1	bc
CAGTTACCGA	GAAACACCGGTCGGGGCCACTAGACTAGACTAGACTAGGTGGTTATTGCT	1	bc
GAAGCAGTCA	GAAACACCGGTAGCAAGTGCGAGACGTGTTAGAGCTAGAAATAGCACCGG	1	bc
AGGACCCACC	GAAACACCGGTGTGGCTGAGAGTCCGGCAATGGGGTGGCTGTGGGGTTAG	1	bc
AGACGATACG	GAAACACCGGTCGGCGGCAATCGTGGGTGGGGTTAGAGCTAGAAATAGCA	1	bc
TCATCGACGT	GAAACACCGGTGTACGTATGGACTGAACCAGGGTGTGCAAGTGGGGTTAG	1	bc
TAACGCCTAA	GAAACACCGGTTAAGACGAGGGTGAGAGCTAGAAATAGCAAGTTAGCCTA	1	bc
CTGCATAGCA	GAAACACCGGTTTACGTTGCATCGGTGTGGGGTTAGAGCTAGAAATATCA	1	bc
AACTACGCGC	GAAACACCGGTTTGAAATAGCAAGTTAACCTAAGGCTAGTCCGTTATCAA	1	bc
ACATCGACGG	GAAACACCGGTGTACGTATGGACTGAACCAGGGTGTGCAAGTGGGGTTAG	1	bc
TTTTATCGAG	GAAACACCGGTTATATTTGTAAGTGTTGTGGGGTTAGAGCTAGAAATAGC	1	bc
TTTAAATGAG	GAAACACCGGTTATAAATAGCAAGTTAACCTAAGGCTAGTCCGTTATCAA	1	bc
GACAGTGACC	GAAACACCGGTAGCAAGTGGGGTTAGAGCTAGAAATAGCAAGTTAACCTA	1	bc
AGTGAAGTCC	GAAACACCGGTTCCCGTCCAGTGGGGTTAGAGCTAGAAATAGCAAGTTAA	1	bc
AAGTTTGGTT	GAAACACCGGTTTACGTTGCATCGGTGTGGGGTTAGAGCTAGAAATAGCA	1	bc
GACATACGGT	GAAACACCGGTCGATTCATATCGAAACCTTCCCGTGACAGTGGGGTTAGA	1	bc
CACATCGAAC	GAAACACCGGTTTGAACTAGAAATAGCAAGTTAACCTAAGGCTAGTCTGT	1	bc
GCTAGTGAGC	GAAACACCGGTTATGTTTGTAAGTGAATGGGGTTAGAGCTAGAAATAGCA	1	bc
CGGCCAGTGC	GAAACACCGGTGTGGCTGAGAGTCCGGCAATGGTGTGGCTGTGGGGTTAG	1	bc
ACTAGACCGA	GAAACACCGGTCGGGGCCACTCAGTGGTGGGGTTAGAGCTAGAAATAGCA	1	bc
TTGCACCCTC	GAAACACCGGTGTGGCTGAGAGTCCGGCAATGGTGTGGCTGTGGGGTTAG	1	bc
AAACGCCCAA	GAAACACCGGTGCCCTTACTCTCACCTGATTACTTGATCCGTGGGGTTAG	1	bc
CAGAAGAACC	GAAACACCGGTCGGCGGCAATCGTTAATCGGTTAATCGTGGGGTTAGAGC	1	bc
CATCGTAGGT	GAAACACCGGTGTACGTATGGACTGAACCAGGGTGTGCAAGTGGGGTTAG	1	bc
GGGGAGGCTA	GAAACACCGGTTCCCGTCCAGTGGGGTTAGAGCTAGAAATAGCAAGTTAA	1	bc
CACCTTTACC	GAAACACCGGTCGGGGCCACTCAGTGGTGGGGTTAGAGCTAGAAATAGCA	1	bc
ACGTTCCGTC	GAAACACCGGTCGATTCATATCGAAACCTTCCCGTGACAGTGGGGTTAGA	1	bc
CACCACGGCT	GAAACACCGGTTTGAACTACCGGGGTTAGAGCTAGAAATAGCAAGTTAAC	1	bc
TTGATCGTAC	GAAACACCGGTTATGCCGAGTGGGGTTAGAGCTAGAAATAGCAAGTTACC	1	bc
AGAATAGCCC	GAAACACCGGTAGCCCGTGATTCTCCTGTTACATCTCCAAATATCACCGG	1	bc
AAGGCGCTCC	GAAACACCGGTGCGGCTGCGAGTCCGGCAATGGGGGGTCTGGCTGGTTAT	1	bc
AGGCCCATAC	GAAACACCGGTAAATTTGAGGCTCCGGCATGCAGGAGGCCGTGGGGTTAG	1	bc
AAGCCAGCCC	GAAACACCGGTCCGTAGGATACCCGTGTGGCATGTACCTGTGGGGTTAGA	1	bc
GTAGCTCGTT	GAAACACCGGTTACATTGAGGGTTAGAGCTAGAAATAGCAAGTTAACCTA	1	bc
GCGCTAAGGC	GAAACACCGGTTTACGTTGCATCGGGGTTAGAGCTAGAAATAGCAAGTTA	1	bc
TTGATCGACG	GAAACACCGGTTATATTTGTAATTTTGTGGGGTTAGAGCTAGAAATAGCA	1	bc
GTCGTCTGCT	GAAACACCAGTCCGTAGGAGACCCGTGTGGCATGTACCTGTGGGGTTAGA	1	bc
CTCCACTGCA	GAAACACCGGTGTGGCTGAGAGTCCGGCAATGGTGTGGCTGTGGGGTTAG	1	bc
TCACAACGAC	GAAACACCGGTTTGAACTACCTAGTTCAAACCGGTGGGGTTAGAGCTAGT	1	bc
ATAACATATA	GAAACACCGGTAACTATATTCATGCGATATCGCCGTATCAGTGGGGTTAG	1	bc
AACGCACGTC	GAAACACCGGTGCCCTTACTCTCACCTGATTACTTAATCCGTGGGGTTAG	1	bc
GCGATTAGCT	GAAACACCGGTTTACGTTGCATCGGTGTGGGGTTAGAGCTAGAAATAGCA	1	bc
AGAATCATGC	GAAACACCGGTGCATTCTAAAGTATGGTAGTAGTGGGGATGAGTGGTTAT	1	bc
TAAGAATCGA	GAAACACGGTTAGAGCTAGAAATAGCACGTCAACCTAAGGCTAGTCCGTT	1	bc
AAGCTTCGTC	GAAACACCGGTGTACGTATGGACTGAACCAGGGTGTGCAAGTGGGGTTAG	1	bc
AGTGAGAATA	GAAACACCGGTTAAGCCGAGTGGGGTTAGAGCTAGAAATAGCAAGTTAAC	1	bc
TTAACTGCGT	GAAACACCGGTTACATTGGGGTTAGAGCTAGAAATAGCAAGTTAACCTAA	1	bc
AAGACCCTCT	GAAACACCGGTGCATTCGAAAGTCCGGTCGTAGTGTGGACGTGGGGTTAG	1	bc
AAGACCATAA	GAAACACCGGTGCCCTTACTCTCACCTGATTACTTAATCCGTGGGGTTAG	1	bc
CTCGCTGTGC	GAAACACCGGTTACATTGAGGGTTAGAGCTAGAAATAGCAAGTTAACCTA	1	bc
AGAAGCTAGA	GAAACACCGGTGCATTCGAAAGTCCGGTCGTAGTGTGGACGTGGGGTTAG	1	bc
ACACAACGCA	GAAACACCGGTTTGAACTACCTAGTGCACACACTAGAGCTAGAAATAGCA	1	bc
CGCCTCGCCA	GAAACGCCGGTAAATTTGAGGCTCCGGCATGCAGGAGGCCGTGGGGTTAG	1	bc
TCGAGCGTAT	GAAACACCGGTTAAGCCGAGTGGGGTTAGAGCTAGAAATAGCAAGTTAAC	1	bc
GATGTCGCGC	GAAACACCGGTAGGCGGCAATCGTGGGTGGGGTTAGAGCTAGAAATAGCA	1	bc
ACACCACGCC	GAAACACCGGTTTGAACTACCGGGGTTAGAGCTAGAAATAGCAGGTTAAC	1	bc
GATCAACACG	GAAACACCGGTGCATTCGAAAGTCCGGTCGTAGTGTGGACGTGGGGTTGG	1	bc
AGGCACACTC	GAAACACCGGTTTACGTTGCATCGGTTGTGGGGTTAGAGCTAGAAATAGC	1	bc
GACGAATCCT	GAAACACCGGTCTCGAGTGAGGTGTTCAGGGTGGGGTTAGAGCTAGAAAT	1	bc
AAGTCGGCCT	GAAACACCGGTCCGTAGGAGACCCGTGGTGGGGTTAGAGCTAGAAATAGC	1	bc
GGAGATGTGC	GAAACACCGGTCGGCGGCAATCGTTTTGTGTGGTTAGAGCTAGAAATAGC	1	bc
AGAAACCGGT	GAAACACCGGTCTCGAGTAAGGGGTTCAGGGAGTGGTTAGAGCTAGAAAT	1	bc
AGACCCGAGG	GAAACACCGGTGCATTCGAAAGTCCGGTCGTAGTGTGGACGTGGGGTTAG	1	bc
AGCGTCGACT	GAAAAACCGGTGTTAGAGCTAGAAATAGCAAGTTAACATAAGGCTAGTTC	1	bc
ATCTATAGAG	GAAACACCGGTTATATTTGTAAGTGTTGTGGGGTTAGAGCTAGAAATAGC	1	bc
GACCCGCCCC	GAAACACCGGTGCATTGGAAAGTCCTGTCGTAGTGTGGACAGGGGGTTAG	1	bc
GCGCAAACTC	GAAACACCGGTTCCCGTCCAGTGGGGTTAGAGCTAGAAATAGCAAGTTAA	1	bc
TTGGAGTCTT	GAAACACCGGTTCCCGTCCAGTGGGGTTAGAGCTAGAAATAGCAAGTTAA	1	bc
GGGGAGAATC	GAAACACCGGTTCCCGTCCAGTGGGGTTAGAGCTAGAAATAGCAAGTTAA	1	bc
GCTAATCGGC	GAAACACCGGTACCTTTGTTGATGCTGGGTGGAAGGAATCTTTGTGGGGT	1	bc
ATAATCATTT	GAAACACCGGTCTCGAGTGAGGTGTTCAGGGTGGGGTTAGAGCTAGAAAT	1	bc
AAATACCGTC	GAAACACCGGTCGGCGGCATTTGAGGGAGGGAATAGAGGTGTGGGTATCA	1	bc
AAGCGCCGCC	GAAACACCGGTGTACGTATGGACTGAACCAGGGTGTGCAAGTGGGGTTAG	1	bc
CAACCTCAAC	GAAACACCGGTAACTATATTCATGCGATATCGCCGTATCAGTGGGGTTAG	1	bc
ACTTCACCTC	GAAACACCGGTCGGGGCCACTCAGTGGTGGGGTTAGAGCTAGAAATAGCA	1	bc
AATGCTTCGC	GAAACACCGGTTTACTAGCAAGTTAACCTAAGGCTAGTCCGTTATCAACT	1	bc
GTCATAGCGA	GAAACACCGGTGCATTCGAAAGTCCGGTCGTAGTGTGGACGTGGGGTTAG	1	bc
GGAACCATCA	GAAACACCGGTGTGGCTGAGAGTCCGGCAATGGTGTGGCTGTGGGGTTAG	1	bc
ACGACTCATT	GAAACACCGGTCTCGAGTGAGGTGTTCAGGTGGGGTTAGAGCTAGAAATA	1	bc
TAAGGTATTA	GAAACACCGGTTACATTGAGGGTTAGAGCTAGAAATAGCAAGTTAACCTA	1	bc
AAAGTCCTGC	GAAACACCGGTCGGCGGCGATCGTGGGAGGGGGGGGATATAGATATAGCT	1	bc
TCGTGTGCTC	GAAACACCGGTGCCTTTGCATACAGGTTTGGGTTAGATCTAGCAATAGCT	1	bc
CCTCTCTCGC	GAAACACCGGTCGGGCCGAGTCAGTGGCGTGGGTAGATCTAGATATAGCT	1	bc
TAAGTCCTTC	GAAACACCGGTTCCCGTACAGTGGGGTTAGAGCTAGAAATAGCAAGTTAA	1	bc
TCAGCCGTTT	GAAACACCGGTCGATTCGTATCGAAACCTTCCCGTGACAGTGGGGTTAGA	1	bc
TCCTCGTCGT	GAAACACCGGTGTACGTATGGACTGAACCAGGGTGTGCAAAGTGGGGTTA	1	bc
GAGGCACATC	GAAACACCGGTTCCCGTCCAGTGGGGTTAGAGCTAGAAATAGCAAGTTAA	1	bc
GACCGCAACA	GAAACACCGGTAAATTTGAGGCTCCGGCATGCAGGAGGCCGTGGGGTTAG	1	bc
AGTCGGACCC	GAAACACCGGTCCGTAGGAGACCCGTGTGGCATGTACCTGTGGGGTTAGA	1	bc
ACGGATCCTT	GAAACACCGGTCTCGGGTGAGGTGTTCAGGGTGGGGTTAGAGCTAGAAAT	1	bc
CTGCTCCGTT	GAAACACCGGTCTCGAGAGAGGTGTTCAGGGTGGGGTTAGAGCTAGAAAT	1	bc
ACATAGTCGT	GAAACACCGGTGTACGTATGGACTGAACCAGGGTGAGCTAGAAATAGCAA	1	bc
ACGCTCAGCC	GAAACACCGGTTTACGGTGCATCGGGTGTGGGGTTAGAACTAGAAATAGC	1	bc
GATAACCGGC	GAAAAACCGGTGTACGTATGGACTGAACCAGGGAGTGCAAGAGGGGTTAG	1	bc
AGAATATCGC	GAAACACCGGTGCATTCGAAAGTCCGGTCGTAGTGTGGACGTGGGGTTAG	1	bc
AATACTCGGC	GAAACACCGGTTAGAGCTAGAAATAGCAAGTTAACCTAAGGCTAGTCCGT	1	bc
ATGGCCGTAC	GAAACACCGGTGCCCTTACTCTCACCTGACTACTTAATCCGTGGGGTTAG	1	bc
AATCGATGTC	GAAACACCGGTGTACGTATGGACTGAACCAGGGTGTGCAAGTGGGGTTAG	1	bc
TCATCGTTGT	GAAACACCGGTGTACGTATGGACTGAACCAGGGTGTGCAAGTGGGGTTAG	1	bc
GTCGACTCGG	GAAACACCGGTACCTTTGTTGATGCTGGGTGGAAAGTACACCGGTACCTT	1	bc
CCTCTCAGCA	GAAACACCGGTGTACACAGAATCGACTACCCGTTATAGCCGTGGGGATAG	1	bc
AGCGAAGAGT	GAAACACCGGTCTCGAGTGAGGTGTTCAGGGTGGAGTTAGAGATAGAAAT	1	bc
CAGATATGTA	GAAACACCGGTCTCGAGTGAGGTATAGCAAGTTAACCTAAGGCTAGTCCG	1	bc
AATACGCTCG	GAAACACCGGTGCATTCGAAAGTCCGGTCGTAGTGTGGACGTGGGGTTAG	1	bc
CTGGTTCTCT	GAAACACCGGTTTACGTTGCATCGGTGTGGGGTTAGAGCTAGAAATAGCA	1	bc
GAGGATCAGC	GAAACACCGGTCGGCGGCAATCGTGGGTGGGGTTAGAGCTAGAAATAGCA	1	bc
ACGTCGCGCG	GAAACACCGGTCGATTCATATCGAAACCTTCCCGTGACAGTGGGGTTGGA	1	bc
TGGTGTTGTC	GAAACACCGGTGACATTGGGGTTAGAGCTAGAAATAGCAAGTTAACCTAA	1	bc
ACCTTTAATG	GAAACACCGGTCGGGGCCACTCAGTGGTGGGGTTAGAGCTAGAAATAGCA	1	bc
GAACAACGCC	GAAACACCGGTTTGAACTAGAAATAGCAAGTTAACCTAAGGCTAGTCCGT	1	bc
ACGAATCCCT	GAAACACCGGTCTCGAGTGAGGTGTTCAGGGTGGGGTTAGAGCTAGAAAT	1	bc
TTTGTGCATA	GAAACACCGGTTAAGCCGAGTGGGGTTAGAGCTAGAAATAGCAAGTTAAC	1	bc
ACGCACCCTC	GAAACACCGGTGTGGCTGAGAGTCCGGCAATGGTGTGGCTGTGGGGTTAG	1	bc
GAGACGGCAT	GAAACACCGGTCCGTAGGAGACCCGTGTGGCATGTACCTGTGGGGTTAGA	1	bc
ACTGATTAGC	GAAACACCGGTTTACGTTGCATCGGTGTGGGGTTAGAGCTAGAAATAGCA	1	bc
GATGACATGC	GAAACACCTAGAGCTAGAAATAGCAAGTTAACCTAAGGCTAGTCCGTTAT	1	bc
GGAGCCATCC	GAAACACCGGTGTGGCTGAGAGTCCGGCAATGGTGTGGCTGTGGGGTTAG	1	bc
CATCTCGAGG	GAAACACCGGTTATATTTGTAAGTGTGTGAGGTTAGAGCTAGAGATAGAA	1	bc
GCACAAGGAA	GAAACACCGGTAGCAAGTGCGAGACGTGTTTTAGAGCTAGAAATAGCAAG	1	bc
AGATCTGTAC	GAAACACCGGTCGATTCATATTGAAACCTTCCCGTGACAGTGGGGTTAGG	1	bc
ACATCGTAGT	GAAACACCGGTGTACGTATGGACTGAACCAGGGGGTGCAAGTGGGAATAG	1	bc
CCTGAGCCTC	GAAACACCGGTCCGTAGGAGACCCGTGTGGCATGTAACTATGTGGGGTTA	1	bc
CCAGGCGGCT	GAAACACCGGTCGATTCATATCGAAACCTTCCCGTGACAGTGGGGTTAGA	1	bc
AGACACAGCC	GAAACACCGGTAGCAAGTGCGAGCCGTGTTTTTGTGGGGTTAGAGCTAGA	1	bc
AAAAAGGCAC	GAGCTAGAAATAGCAAGTTAACCTAAGGCTAGTCCGTTATCAACTTGAAA	1	bc
TTGAATCCTT	GAAACACCGGTCTCGAGTGAGGTGTTAGAGCTAGAAATAGCATGTTAAAC	1	bc
AAGTCTGCTT	GAAACACCAGTCCGTAGGAGACCCGTGTGGCATGTACCTGTGGGGTTAGA	1	bc
TATTGTTGTC	GAAACACCGGTGACATTGGGTTAGAGCTAGAAATAGCAAGTTAACCTAAG	1	bc
TTAGCGCTGA	GAAACACCGGTTACATTGAGGGGGTAGAGCTAGAAATTGCAAGTTGACCT	1	bc
ATCATCGTCG	GAAACACCGGTGCACGTATGGACTGAACCAGGGTGTGCAAGTGGGGTTAG	1	bc
AGAAGACCCT	GAAACACCGGTCGGCGGCAATCGTGGGTGGGGTTAGAGCTAGAAATAGCA	1	bc
AAAGGCTCGA	GAAACACCGGTGCCCTTACTCTCACCTGATTACTTAATCCGTGGGGTTAG	1	bc
AAACGTCTTA	GAAACACCGGTGCCCTTACTCTCACCTGATTACTTAATCCGTGGGGTTAG	1	bc
TCATCGGAGT	GAAACACCGGTGTACGTATGGACTGAACCAGGGTGTGCAAGTGGGGTTAG	1	bc
TACCCGTACA	GAAACACCGGTAGCAAGTGCGAGACGTGTTTGTGGGGTTAGAGCTAGAAA	1	bc
GCACAACGAC	GAAACACCGGTTTGAACTACCGGGGTTAGAGCTAGAAATAGCAAGTTAAC	1	bc
GCGTGTTGGC	GAAACACCGGTGACGTTGGGTACAGGGTGGGGTTAGAGCTAGAAATAGCA	1	bc
GAGGCACCCT	GAAACACCGGTGTGGCTGAGAGTCCGGCAATGGTGTGGCTGTGGGGTTAG	1	bc
AAGAAGAACC	GAAACACCGGTCGGGGTTAGAGCTAGAAATAGCAAGTTAACCTAAGGCTA	1	bc
ATGCTTGTCA	GAAACACCGGTTTACGTTGCATCAGTTGTGGGGTTAGAGCTAGAAATAGC	1	bc
GAGGTACGTC	GAAACACCGGTTCCCGTCCAGTGGGGTTAGAGCTAGAAATAGCAAGTTAA	1	bc
CTACTCAGTT	GAAACACCGGTTTACGTTGCATCGGGGTTAGAGCTAGAAATAGCAAGATA	1	bc
TAGGACCTAC	GAAACACCGGTGCCCTTACTCTCACCTGATTACTTAATCCGTGGGGTTAG	1	bc
TCACGTCCTA	GAAACACCGGTGCCCTTACTCTCACCTGATTACTTAATCCGTGGGGTTAG	1	bc
TATACCGCGG	GAAACACCGGTTATATTTGTAAGTGTGTGGGGTTAGAGCTAGAAATAGCA	1	bc
AGGCAACATC	GAAACACCGGTGTGGCTGAGAGTCCGGCAATGGTGTGGCTGTGGGGTTAG	1	bc
TCCTTAACCG	GAAACACCGGTCGGGGCCACTCAGTGGTGGGGTTAGAGCTAGAAATAGCA	1	bc
ATAGCGGCGT	GAAACACCGGTGCCCTTACTCTCACCTGATTACTTAATCCGTGGGGTTAG	1	bc
AGTGGATGCT	GAAACACCGGTTCCCGTCCAGTGGGGTTAGAGCTAGAAATAGCAAGTTAA	1	bc
GGACTCAGAT	GAAACACCGGTGTGGCTGAGAGTCCGGCAAGGGTGTGGCTGTGGGGTTAG	1	bc
ACTAATAGGC	GAAACACCGGTACCTTTGTTGATGCTGGGTGGAAGGAGTTTTGTGGGGTT	1	bc
TGGGACTCTC	GAAACACCGGTGTGGCTGAGAGTCCGGCAATGGTGTGGCTGTGGGGTTAG	1	bc
CATAGGCTTA	GAAACACCGGTGTACGTATGGACTGAACCAGGGTGTGCAAGTGGGGTTAG	1	bc
GGAAGCGTCC	GAAACACCGGTGTGGCTGAGAGTCCGGCAATGGTGTGGCTGTGGGGTTAG	1	bc
AAGAGTAGAT	GAAACACCGGTCTCGAGTGAGGTGTTCAGGGTGGGGTTAGAGCTAGAAAT	1	bc
AGGAACACTC	GAAACACCGGTGTGGCTGAGAGTCCGGCAATGGTGTGGCTGTGGGGTTAG	1	bc
GAACAACGCC	GAAACACGGGTTAGAGCTAGAAATAGCAAGTTAACCTAAGGCTAGTCCGT	1	bc
CACATAGACT	CCGAGGGCCTAGAGCTAGAAATAGAAAGTTAACCTAGGGCTAGTCCGTTA	1	bc
CTACCAGCGC	GAAACACCGGTGCATTCGAAAGTCCGGTCGTAGTGTGGACGTGGGGTTAG	1	bc
TTGAATAGAT	GAAAAACCGGTTAGAGCTAGAAATAGCAAGTTAACCTAAGGCTAGTCCGT	1	bc
GTATCGACGT	GAAACACCGGTGTACGTATGGACTGAACCAGGGTGTGCAAGTGGGGTTAG	1	bc
GAGGTCACGC	GAAACACCGGTCGGCGGCAATCGTGGGTGGGGTTAGGGCTAGAAATAGCA	1	bc
TGGCACACTC	GAAACACCGGTGTGGCTGAGAGTCCGGCAATGGTGTGGCTGTGGGGTTAG	1	bc
AATACCTAGC	GAAACACCGGTGCATTCGAAAGTCCGGTCGTAGTGTGGACGTGGGGTTAG	1	bc
ACTGGCATAA	GAAACACCTGTTAAGCCGAGTGGGGTTAGAGCTAGAAATAGCAAGTTAAC	1	bc
GAGGAGCATG	GAAACACCGGTTCCCGTCCAGTGGGGTTAGAGCTAGAAATAGCAAGTTAA	1	bc
AAGTATGCCT	GAAACACCGGTCCGTAGGAGACCCGTGTGGCATTGTGGGGTTAGAGCTAG	1	bc
ACTGTTGTCC	GAAACACCGGTGACATTGGGTAAAAAAGTGGGGTTAGAGCTAGAAATAGC	1	bc
ACATAGTCGT	GAAACACCGGCGTACGTATGGACTGAACCAGGGTGTGCAAGTGGGGTTAG	1	bc
AAGATCCTCG	GAAACACCGGTGCATTCGAAAGTCCGGTCGTAGTGTGGACGTGGGGTTAG	1	bc
AACTTTAACG	GAAACACCGGTCGGGGCCACTCAGTGGTGGGGTTAGAGCTAGAAATAGCA	1	bc
AGTGGCTATG	GAAACACCGGTTACATTGAGGGTTAGAGCTAGAAATAGCAAGTGAACCTA	1	bc
GAACAATTGT	GAAACACCGGTCGATTCATATCGAAACCTTCCCGTGACAGTGGGGTTAGA	1	bc
AGACACGGAC	GAAACACCGGTAGCAAGTGCGAGACGTGTTTGTGGGGTTAGAGCTAGAAA	1	bc
GAAGAAACGA	GAAACACCGGTCGGCGGCAATCGTGGGTGGGGTTAGAGCTAGAAATAGCA	1	bc
AGAGATGTCA	GAAACACCGGTGACATTGGGGTTAGAGCTAGAAATAGCAAGTTAACCTAA	1	bc
TCGAGCAGAC	GAAACACCGGTTAAGCAACGGGTTAGAGCTAGAAATAGAAAGTTAACCTA	1	bc
ATACAACATT	GAAACACCGGTATCTTTGTTGATTCTAGTTGGGTTAGAGCTAGTAATAGC	1	bc
AGAAGAACCG	GAAACACCGGTCCACGGAAATAGCAAGTTAACCTAAGGCTAGTCCGTTAT	1	bc
ACTGCTCGGC	GAAACACCGGTCGGGGCCACTCAGTGGTGGGGTTAGAGCTAGAAATAGCA	1	bc
AGGCAGCATC	GAAGCACCGGTGTGGCTGAGAGTCCGGCAATGGTGTGGCTGTGGGGTTAG	1	bc
CATCGTAGCA	GAAACACCGGTGTACGTATGGACTGAACTAGGGTGTGCAAGTGGGGCTAG	1	bc
GTGTACTACA	GAAACACCGGTAAATTTGAGGCTCCGGCATGCAGGAGGCCGTGGGGTTAG	1	bc
AAACGCCATA	GAAACACCGGTGCCCTTACTCCCACCTGATTACTTAATCCGTGGGGTTAG	1	bc
ATGCAGCACC	GAAGCACCGGTCCGTAGGAGACCCGTGTGGCATGTACCTTGTGGGGTTAG	1	bc
ATCTTTCGCG	GAAACACCGGTCGGGGCCACTCGTGGGGTTAGAGCTAGAAATAGCAAGTT	1	bc
TAAGACATGC	GAAACACCGGTCGGCGGCAATCGTGGGTGGGGTTAGAGCTAGAAATAGCA	1	bc
GAAGAGACTC	GAAACACCGGTCGGCGGCAATCTTGAAAAAGTGGCACCGAGTCGGTGCTT	1	bc
GAAACAGGCG	GAAACACCGGTAGCAAGTGCGAGACGTGTTTGTGGGGTTAGAGCTAGAAA	1	bc
CGAGTATTTT	GAAACACCGGTGTTAGAGCTAGAAATAGCAAGTTAACCTAAGGCTAGTCC	1	bc
GTCCCCATCC	GAAACACCGGTGTGGCTGAGAGTCCGGCAATGGTGTGGCTGTGGGGTTAG	1	bc
GATGCTAAGC	GAAACACCGGTTTACTAGCAAGTTAACCTAAGGCTAGTCCGTTATCAACT	1	bc
TGGCACCGCA	GAAACACCGGTGTGGCTGAGAGTCCGGCAATGGTGTGGCTGTGGGGTTAG	1	bc
TCACGTCGCC	GAAACACCGGTGTACGTATGGACTGAACCAGGGGGTGCAAGTGGGGTTAG	1	bc
AAGCTAAGCG	GAAACACCGGTTTACGTTGCATCGGTGTGGGGTTAGAGCTAGAAATAGCA	1	bc
GAATGCTCGC	GAAACACCGGTCGGCGGCAATCGTGGGTGGGGTTAGAGCTAGAAATAGCA	1	bc
CAAAACGCAT	GAAACACCGGTTTGAACTAGAAATAGCAAGTTAACCTAAGGCTAGTCCGT	1	bc
GACAGCCCCC	GAAACACCGGTCGGCGGCAATCGGGGTTAGAGCTAGAAATAGCAAGTTAA	1	bc
AGGCTCTCCA	GAAACACCGGTAAATTTGAGGCTCCGGCATGCAGGAGGCCGTGGGGTTAG	1	bc
ATTAGTGTAA	GAAACACCGGTTAAGCCGAGTGGGGTTAGAGCTAGAAATAGCAAGTTAAC	1	bc
ATTCGCTATG	GAAACACCGGTTACATTGAGATGTTGCTAGAAATAGCAAGTTAACCTAAG	1	bc
AGCAGACACG	GAAACACCGGTCGGTGGGGTTAGAGCTAGAAATAGCAAGTTAACCTAAGG	1	bc
AACATTACAG	GAAACACCGGTCGGGGCCACTCAGTGGGGTTAGAGCTAGAAATAGCAAGT	1	bc
GGCAACGTAC	GAAACACCGGTGTGGCTGAGAGTCCGGCAATGGTGTGGCTGTGGGGTTAG	1	bc
CACACCTACC	GAAACACCGGTTTGAACTACCGGGGTTAGAGCTAGAAATAGCAAGTTAAC	1	bc
AGACACAGCT	GAAACACCGGTAGCAAGCGCGAGACGTGTTTGTGGGGTTAGAGCTAGAAA	1	bc
