CTCCCCTGCA	GAAACACCGGTGTGGCTGAGAGTCCGGCAATGGTGTGGCTGTGGGGTTAG	12	bc
GACACAAGAT	GTCGAATTCGGGCCCATTGGTATGGCAGATCGGAAGAGCACACGTCTGAA	6	bc
AGGCACACTC	GAAACACCGGTGTGGCTGAGAGTCCGGCAATGGTGTGGCTGTGGGGTTAG	4	bc
ACCTTGACCG	GAAACACCGGTCGGGGCCACTCAGTGGTGGGGTTAGAGCTAGAAATAGCA	4	bc
AGAGGAGCCT	GAAACACCGGTTCCCGTCCAGTGGGGTTAGAGCTAGAAATAGCAAGTTAA	3	bc
AAGAATCCTT	GAAACACCGGTCTCGAGTGAGGTGTTCAGGGTGGGGTTAGAGCTAGAAAT	3	bc
AAATCGTCGT	GAAACACCGGTGTACGTATGGACTGAACCAGGGTGTGCAAGTGGGGTTAG	3	bc
ATAAATTATA	GAAACACCGGTAACTATATTCATGCGATATCGCCGTATCAGTGGGGTTAG	3	bc
ACCTTTACAG	GAAACACCGGTCGGGGCCACTCAGTGGTGGGGTTAGAGCTAGAAATAGCA	3	bc
AAACAACGCC	GAAACACCGGTTTGAACTAGAAATAGCAAGTTAACCTAAGGCTAGTCCGT	3	bc
ACGAATACTT	GAAACACCGGTCTCGAGTGAGGTGTTCAGGGTGGGGTTAGAGCTAGAAAT	3	bc
AGGGACCCTC	GAAACACCGGTGTGGCTGAGAGTCCGGCAATGGTGTGGCTGTGGGGTTAG	3	bc
ACGAATCGTT	GAAACACCGGTCTCGAGTGAGGTGTTCAGGGTGGGGTTAGAGCTAGAAAT	2	bc
TCCCTTCTAC	GAAACACCGGTAACTATATTCATGCGATATCGCCGTATCAGTGGGGTTAG	2	bc
ATAACTTAGA	GAAACACCGGTAACTATATTCATGCGATATCGCCGTATCAGTGGGGTTAG	2	bc
ACCTTTAGCG	GAAACACCGGTCGGGGCCACTCAGTGGTGGGGTTAGAGCTAGAAATAGCA	2	bc
AGGCCACTAC	GAAACACCGGTAAATTTGAGGCTCCGGCATGCAGGAGGCCGTGGGGTTAG	2	bc
ATCTATCGCG	GAAACACCGGTTATATTTGTAAGTGTGTGGGGTTAGAGCTAGAAATAGCA	2	bc
AGGAAACCTC	GAAACACCGGTGTGGCTGAGAGTCCGGCAATGGTGTGGCTGTGGGGTTAG	2	bc
CTACATTCGG	GAAACACCGGTCGATTCATATCGAAACCTTCCCGTGACAGTGGGGTTAGA	2	bc
GAGACGCTCG	GAAACACCGGTGCATTCGAAAGTCCGGTCGTAGTGTGGACGTGGGGTTAG	2	bc
AAGAACCTCG	GAAACACCGGTGCATTCGAAAGTCCGGTCGTAGTGTGGACGTGGGGTTAG	2	bc
AGTGGAGCAT	GAAACACCGGTTCCCGTCCAGTGGGGTTAGAGCTAGAAATAGCAAGTTAA	2	bc
GTCACTTATA	GAAACACCGGTAACTATATTCATGCGATATCGCCGTATCAGTGGGGTTAG	2	bc
TAGACGCTCG	GAAACACCGGTGCATTCGAAAGTCCGGTCGTAGTGTGGACGTGGGGTTAG	2	bc
GAATCGTCGT	GAAACACCGGTGTACGTATGGACTGAACCAGGGTGTGCAAGTGGGGTTAG	2	bc
ACTATAGTGG	GAAACACCGGTTATATTTGTAAGTGTGTGGGGTTAGAGCTAGAAATAGCA	2	bc
AGGCAACCTC	GAAACACCGGTGTGGCTGAGAGTCCGGCAATGGTGTGGCTGTGGGGTTAG	2	bc
GACTTTACCG	GAAACACCGGTCGGGGCCACTCAGTGGTGGGGTTAGAGCTAGAAATAGCA	2	bc
GAGACACTCG	GAAACACCGGTGCATTCGAAAGTCCGGTCGTAGTGTGGACGTGGGGTTAG	2	bc
ATGAATCCTT	GAAACACCGGTCTCGAGTGAGGTGTTCAGGGTGGGGTTAGAGCTAGAAAT	2	bc
ACAACGTCGT	GAAACACCGGTGTACGTATGGACTGAACCAGGGTGTGCAAGTGGGGTTAG	2	bc
GAACGCGCTA	GAAACACCGGTGCCCTTACTCTCACCTGATTACTTAATCCGTGGGGTTAG	2	bc
AAACGCCGTA	GAAACACCGGTGCCCTTACTCTCACCTGATTACTTAATCCGTGGGGTTAG	2	bc
AACATTAGGT	GAAACACCGGTCGATTCATATCGAAACCTTCCCGTGACAGTGGGGTTAGA	2	bc
AAGACACTCG	GAAACACCGGTGCATTCGAAAGTCCGGTCGTAGTGTGGACGTGGGGTTAG	2	bc
GAGAACCTCG	GAAACACCGGTGCATTCGAAAGTCCGGTCGTAGTGTGGACGTGGGGTTAG	2	bc
GGTAGATATG	GAAACACCGGTTATTGGGGTTAGAGCTAGAAATAGCAAGTTAACCTAAGG	1	bc
AGTTTGGGTA	GAAACACCGGTCGATTCATATCGAAACCGTCACGTAACAGTGGGGTTAGA	1	bc
AACTCTCGGC	GAAACACCGGTGCCCTTACTCTCACCTGATTACTTAATCCGTGGGGTTAG	1	bc
GTACAACGCA	GCTAGAAATAGCAAGTTAACCTAAGGCTAGTCCGTTATCAACTTGAAAAA	1	bc
GCCTTTACAG	GAAACACCGGTCGGGGCCACTCGGTTAGAGCTAGAAATAGCAAGTTAACC	1	bc
ACCTCATCGT	GGAACACCGGTGTACGTATGGACTGAACCAGGGTGTGCAAGTGGGGTTAG	1	bc
CGGGTTGTAC	GAAACACCGGTGACATTGGGTACAGGGGTGGGGTTAGAGCTAGAAATAGC	1	bc
TAATTCAGAC	GAAACACCGGTAACTATATTCATGCGATATCGCCGTATCAGTGGGGTTAG	1	bc
GCTACGTAGC	GAAACACCGGTGTACGTATGGACTGAACCAGGGTGTGCAAGTGGGGTTAG	1	bc
GGCAGCCCAC	GAAACACCGGTGTGGCTGAGAGTCCGGCAATGGTGTGGCTGTGGGGTTAG	1	bc
CCACTCACTC	GAAACACCGGTAACTATATTCATGCTATATCGCCGGATCAGTGGGGTTAG	1	bc
ATTAGGTATG	GAAACACCGGTTACATTGAGATTGGGGTTAGAGCTAGAAATAGCAAGTTA	1	bc
GACGCAGCAA	GAAACACCGGTAGCACTTTGTGGGGTTAGAGCTAGAAATAGCAAGTTAAC	1	bc
AAGGCATTAA	GAAACACCGGTGCCCTTACTCTCACCTGATTACTTAATCCGTGGGGTTAG	1	bc
AAACTAAAAC	GAAACACCGGTAACTATATTCATGCGATATCGCCGTATCAGTGGGGTTAG	1	bc
GCACAAAGCC	GAAACACAGGTTTGAACTACCTAGTTCAAACCGGTGGGGTTAGAGCTAGA	1	bc
CCGAAGACAC	GAAACACCGGTTCCCGTCCAGTGGGGTTAGAGCTAGAAATAGCAATATCA	1	bc
AGGTCCATAA	GAAACACCGGTAAATTTGAGGCTCCGGCATGCAGGAGGCCGTGGGGTTAG	1	bc
AAGTGGAGCC	GAAACACCGGTTCCCGTCCAGTGGGGTTAGAGCTAGAAATAGCAAGTTAA	1	bc
CAAGCTCTAC	GAAACACCGGTGCCCTTACTCTCACCTGATTACTTAATCCGTGGGGTTAG	1	bc
TAATTTGGAC	GAAACACCGGTAACTATATTTATGAAATTTCCCGGTACCAGTGGGGTTAG	1	bc
ACGCTTGACT	GAAACACCGGTTTACGTTGCATCGGTGTGGGGTTAGAGCTAGAAATAGCA	1	bc
GAGCCAGCCA	GAAACACCGGTAGCAAGTGCGAGACGTGTTTGTGGGGTTAGAGCTAGAAA	1	bc
TGGATTAGGT	GAAACACCGGTCTGGCTGAGGGAACGACATGTGGGGGTAGAGCTAGATAT	1	bc
CGAAACCGAC	GAAACACCGGTGTGGCTGAGAGTCCGGCAATGGTGTGGCTGTGGGGTTAG	1	bc
ATGCAGACTT	GAAACACCGGTTCCCGTCCAGTGGGGGTAGAGCTAGAACTAGCAAGTTAA	1	bc
TATCTCTCGT	GAAACACCGGTGCATTCGAAAGTCCGGTCGTAGTGTGGACGTGGGGTTAG	1	bc
GGCATCATTC	GAAACACCGGTTTTCCTGAGAGGCCGTCAATGGGGGGTCTGTGGAGGTAG	1	bc
ATACACACGC	GAAACACCGGTGCATTCGAAAGTCCGGTCGTAGTGTGGACGTGGGGTTAG	1	bc
GGCTAGCGCG	GAAACACCGGTTATATTTGTAAGTGTGTGGGGTTAGAGCTAGAAATAGCA	1	bc
GTGGCGACTA	GAAACACCGGTTCCCGTCCAGTGGGGTTAGAGCTAGAAATAGCAAGTTAA	1	bc
TTCCACGGCC	GAAACACCGGTACCTTTGTTGATGCTGGGTGGAAGGAGTGGGGATAGAGC	1	bc
ACATCGCAGT	GAAACACCGGTGTACGTATGGACTGAACCAGGGCGAGCTAGTGTGGTTAG	1	bc
AGGAGACGAA	GAAACACCGGTTAAGCCGGAGGGGTTAGAGCTAGAAATAGCAAGTTAACC	1	bc
AGAAGAACCG	GAAACACCGGTCGGCGGCAATCGTGGGTGGGGTTAGAGCTAGAAATAGCA	1	bc
ACATCGTAGA	GAAACACCGGTGTACGTATGGACTGAACCAGGGTGTGCAAGTGGGGTTAG	1	bc
TTGGAGTACA	GAAACACCGGTTCCCGTCCAGTGGGGTTAGAGCTAGAAATAGCAAGTTAA	1	bc
AGTTGAGCCT	GAAACACCGGTTCCCGTCCAGTGGGGTTAGAGCTAGAAATAGCAAGTTAA	1	bc
TCGTGTTGGC	GAAACACCGGTGACATTGGATACGAGCTAGAAATAGCAAGTTAACCTAAG	1	bc
CGAAGCAGTC	GAAACACCGGTGTACGTATGGACTGAACCAGGGTGTGCAAGTGGGGTTAG	1	bc
AATGATCAGC	GAAACACCGGTTTACGCTGCATCGGTGTGGGGTTAGTGCTAGAAATAGCA	1	bc
ACATCGTAGT	GAAACACCGGTGTACGTATGGACTGAACCAGGGTGTGCAAGTGGGGTTAG	1	bc
ATAGCTCCTG	GAAACACCGGTTTACGTTGCATCGGGGTTAGAGCTAGAAATAGCAAGTTA	1	bc
ATTGCTAAGT	GAAACACCGGTTACATTGAGGGTTAGAGCTGGATATAGCAAGTTAAACTA	1	bc
CGAGCTGTTT	GAAACACCGGTTACAATTGGGGTTAGAGCTAGAAATAGCAAGTTAACCTA	1	bc
AGCAACTAAA	GAAACACCGGTAAATTTGAGGCTCCGGCATGCAGGAGGCCGTGGGGTTAG	1	bc
TATGCGCCGC	GAAACACCGGTTTACGTTGCATCGGTGTGGGGTCAGAGCTAGAAATAGCA	1	bc
CGAGTCGTGC	GAAACACCGGTGACATTGGGTACAGGGGGGTGGGGTTAGAGCTAGAAATA	1	bc
GACCGTCGCC	GAAACACCGGTGTACGTATGGACTGAACCAGGGTGTGCAAGAGGGGTTAG	1	bc
GGCACGTACC	GAAACCCCGGTAAATTTGAGGCTCCGGCATGCATGCCATAGCTACAATTA	1	bc
GCCACGTCGT	GAAACACCGGTGTACGTATGGACTGAACCAGGGTGTGCAAGTGGGGTTAG	1	bc
ACATAGTCGT	GAAACACCGGTGTACGTATGGTCTGAACCGGGGTATGCAAGTGGGGATCG	1	bc
GTCAAAGCTA	GTAACACCGGTAGAAAGTGCGGGGTTAGAGCTAGAAATAGCAAGTTATCC	1	bc
ACCCTTTGGC	GAAACACCGGTGCATTCGAAACACCGGTCGTAGTGTGGCCGTGGGGTTCT	1	bc
AACACCGCCA	GAAACACCGGTTTGAACTACCTAGCTCAAACCGGTGGGGTTAGAGCTAGA	1	bc
GCCACCCTAT	GAAACACCGGTGCCCTTACTCTCACCTGATTACTTAATCCGTGGGGTTAG	1	bc
CGAATTATTC	GAAACACCGGTCTCGAGTGAGGTGTTCAGGGTGGGGTTAGAGCTAGAAAT	1	bc
GACACGGATC	GAAACACCGGTAGCAAGTGGGGTTAGAGCTAGAAATAGCAAGTTAACCTA	1	bc
AGAAGACACG	GAAACACCGGTCGGCGGCAATCGTGGGTGGGGTTAGAGCTAGAAATAGCA	1	bc
TCTACTCGGT	GAAACACCGGTACCTTTGTTGATGCTGGGTGGAAGGAATGTGGGGTTAGA	1	bc
AAGACAGCCA	GAAACACCGGTAGCAAGGGCGAGACGTGTTTGTGGGGTTAGAGCTAGAAA	1	bc
ACATAGTCGT	GAAACACCGGTGTACGTATGGACTGAACCAGGGTGTGCAAGTGGGGTTAG	1	bc
GAATAAGACA	GAAACACCGGTAGCAAGTGCGAGACGTGTTTGTGGGGTTAGAGCTAGAAA	1	bc
CAGATACTTT	GAAACACCGGTCTCGAGTGAGGTGTTCAGGTGAGGTTAGAGCTAGAAATA	1	bc
ACTTTACCTA	GAAACACCGGTCGGGGCCACTCAGTGGTGGGGTTAGAGCTAGAAATAGCA	1	bc
GGCCTCTCCC	GAAACACCGGTAAATTTGAGGCTCCGGCATGCAGGAGGCCGTGGGGTTAG	1	bc
CCTATACTTC	GAAACACCGGTCTCGAGTGGAGCTAGAAATAGCAAGTTAACCTAAGGCTA	1	bc
GAAATAATAT	GAAACACCGGTAACTATATTCATGCGATATCGCCGTATCAGTGGGGTTAG	1	bc
CTACGCAGAC	GAAACACCGGTACCTTTGTTGATGCTGGGTGGAAGGGATTTGTGGGGTTA	1	bc
AATTATCGTC	GAAACACCGGTCCGGAGGATACCCGGGTGGCATGTAACTGGGGGGGTAAG	1	bc
TATAGCCGTC	GAAACACCGGTGTACGCATGGACTGAACGAGGGTGTACAAGGGGGGTTAG	1	bc
GCGACCGAGA	GAAACACCGGTGTGGCTGAGAGTCCGGCAATGGTGTGGATGTGGGGTTAG	1	bc
AACAACGGCA	GAAACACCGGTTTGAACTAGAAATAGCAAGTTAACCTAAGGCTAGTCCGT	1	bc
GCTGTGCCGC	GAAACACCGGTCGGGGCCACTCAGTGGTGGGGTTAGAGCTAGAAATAGCA	1	bc
TTGGTTATCT	GAAACACCGGTTTACGTTGCATCGGTTGTGGGGTTAGAGCTAGAAATAGC	1	bc
TAATCGTCGC	GAAACACCGGTGTACGTATGGACTGAACCAGGGTGTGCAAGTGGGGTTAG	1	bc
TAACAACGCC	GAAACACCGGTTTGAACTAGAATTAGCAAGTTAACCTAAGGCTAGTCCGT	1	bc
CAAATAGTTT	GAAACACCGGTCTCGGGTGAGGTGTTCAGGGTGGGGTTAGAGCTAGAAAT	1	bc
TAAATCGTGC	GAAACACCGGTAACTATATTCATGCGATATCGCCGTATCAGTGGGGTTAG	1	bc
ACCGCCAAAC	GAAACACCGGTGCCCTTACTCTCACCTGATTACTTAATCCGTGGGGTTAG	1	bc
GATGATTAGG	GAAACACCGGTTTAAGTTAGAGATAGGAATGGCTAGTTCAAGTAAGACTA	1	bc
TCGCTCGATG	GAAACACCGGTTATATTTGTAAGTGTGTGGGGTTAGAGCTAGAAATAGCA	1	bc
AGACACCATT	GAAACACCGGTCTCGAGTGAGGTGTTCAGGGTGGGGTTAGAGCTAGAAAT	1	bc
GGTCACCCGC	GAAACACCGGTGTGGCTGAGAGTCCGGCAATGGTGTGGCTGTGGGGTTAG	1	bc
GCACAACGCA	GAAACACCGGTTTGAACTACCTAGTTCAAACCGGTGGGGTTAGAGCTAGA	1	bc
GGACCAAACC	GAACCAACGGTTAAGACGGGCGGGGAGAAGGCTGGAAGTAGCGAGTTAGC	1	bc
GGCACCATAA	GAAACACCGGTGTGGCTGAGAGTCCGGCAATGGTGTGGCTGTGGGGTTAG	1	bc
ACGACTACTT	GAAACACCGGTCTCGAGTGAGGTGTTCAGGGTGGGGTTAGAGCTAGAAAT	1	bc
AGCTTTACCG	GAAACACCGGTCGGGGCCACTCAGTGGTGGGGTTAGAGCTAGAAATAGCA	1	bc
GGCAACGTAA	GAAACACCGGTGTGGCTGAGAGTCCGGCAGTGGTGTGGCTGGGGAGATAT	1	bc
GTCATTCGGT	GAAACACCGGTCGATTCATATCGAAACCTTCCCGTGACAGTGGGGTTAGA	1	bc
ACTACTCGGT	GAAACACCGGTACCTTTGTTGATGCTGGGTGGAAGGAATTTTGTGGGGTT	1	bc
GATAAACCGG	GAAACACCGGTCGGCGGCTCGGTGGGGTTAGAGCTAGAAATAGCAAGTTA	1	bc
GTGGACAGGC	GAAACACCGGTCTACGGCGATTGGGGTCGTTGTTTGAGCTAGTAGTAGCA	1	bc
TACGCTCTAA	GCTCTAGCCTGATTACTTAATGCGTGGGGTTATAGCTAGAAATAGCAAGT	1	bc
TTAGCAAGGC	GAAACACCGGTTACATTGAGGGTTAGAGCTAGAAATAGCAAGTTAACCTA	1	bc
TACGATATGT	GAAACACCGGTTACATTGGGGTTAGAGCTAGAAATAGCAAGTTAACCTAA	1	bc
AACGTATGAC	GAAACACCGGTGCCCTTACTCTCACCTGATTACTTAATCCGTGGGGTTAG	1	bc
CACACCGACT	GAAACACCGGTTTGAACTAGAAATAGCAAGTTAACCTAAGGCTAGTCCGT	1	bc
GCTTTAAAGA	GAAACACCGGTAGGGGCCACGCAGTGGTGGGGTTAGAGCTAGAAATAGCA	1	bc
ATTAACTATG	CAAAACACCGGTTACATTGGGGTTAGAGCTAGAAATAGCAAGTTAACCTA	1	bc
CAGCCAGGCC	GAAACACCGGTTTGTACAACCTAGAGTTAGAAATAGCAAGTTAAACTAAG	1	bc
AACGAAGTAC	GAAACACCGGTGCCCTTACTCTCACCTGATTACTTAATCCGTGGGGTTAG	1	bc
AACGTACTAA	GAAACACCGGTGCCCTTACTCTCACCTGATTACTTAATCCGTGGGGTTAG	1	bc
AAAACCGCGC	GAAAGGCCGGTGCATTCGAAAGTCCGGACGTAGTGTGGACGTGGGGTTAG	1	bc
GGGCGCTACC	GAAACACCGGTAAATTTGAGGCTCCGGCATGCAGGAGGCCGTGGGGTTAG	1	bc
GGGCACTATC	GAAACACCGGTAAATTTGAGGCTCCGGCATGCAGGAGTGGGGTTAGGGCT	1	bc
GCGGAACGTC	GAAACACCGGTTCCCGTACAGCGGGGTTAGAGGTAGTAATAGCAAGATAA	1	bc
TGTATCCTTC	GAAACACCGGTCTCGAGTGAGGTGTTCAGGGTGGGGTTAGAGCTAGTAAT	1	bc
GTAGAGGATC	GAAACACCGGTTCCTGTCCAGTGGGGTTAGAGCTAGAAATAGCAAGTTAA	1	bc
GTCCACTGCA	GAAACACCGGTGTGGCTGAGAGTCCGGCAATGGTGTGGCTGTGGGGTTAG	1	bc
GACTATACCG	GAAACACCGGTCGGGGCCACTCAGTGGTGGGGTTAGAGCTAGAAATAGCA	1	bc
ACGAGCGGGG	GAAACACCGGTTATCTTTGTAAGTGTGTGGGGTTAGAGCTAGAAATAGCA	1	bc
AGAATCGCTT	GAAACACCGGTCACGAGTGAGGTGTTCAGGGTGGGGTTAGAGCTAGAAAT	1	bc
CTACACGGAA	GAAACACCGGTACCTTTGTTGATGCTGGGTGGGGTTAGAGCTAGAAATAA	1	bc
AAACGACCTA	GAAACACCGGTGCCCTTACTCTCACCTGATTACTTAATCCGTGGGGTTAG	1	bc
GTAAATTATT	GAAACACCGGTAACTATATTCATGCGATATCGCCGTATCAGTGGGGCTAG	1	bc
TGCAACCTCA	GAAACACCGGTGTGGCTGAGAGTCCGGCAATGGTGTGGCTGTGGGGTTAG	1	bc
GGAACCGACA	GAAACACCGGTAAATTTGAGGCTCCGGCATGCAGGAGGCCGTGGGGTTAG	1	bc
CGAAAGGTTT	GAAACACCGGTCTCGAGTGAGGTGTTCAGGGTGGGGTTAGAGCTAGAAAT	1	bc
GAGACACAGA	GAAACACCGGTGGGGTTAGAGCTAGAAATAGCAAGTTAACCTAAGGCTAG	1	bc
TAGTCTGCCA	GAAACACCGGTCCGTAGGAGACCCGTGTGGCATGTACCTTGTGGGGTTAG	1	bc
AATAGTAGTC	GAAACGCCGGTGTACGTATGGACTGAACCAGGGTGTGCAAGTGGGGTTAG	1	bc
CACAGCCGTC	GAAACACCGGTGTACGTATGGACTGAACCAGGGTGTGCAAGTGGGGTTAG	1	bc
AAAAACGACC	GAAACACCGGTTTGAACTACCTAGAAAGGGTTAGAGCTAGAAATAGCAAG	1	bc
AGAAAACCCG	GAAACACCGGTCGGCGGCGGTGGGGTTAGAGCTAGAAATAGCAAGTTAAC	1	bc
AAGAATACTT	GAAACACCGGTCTCGAGTGAGGTGTTCAGGGTGGGGTTAGAGCTAGAAAT	1	bc
GCAGTCGGTC	GAAACACCGGTCGATTCATATCGAAACCTTCCCTATGGGTATAGATCTCG	1	bc
ACACTCTAGC	GAAACACCGGTGCATTCGAAAGTCCGGTCGTAGTGTGGACGTGGGGTTAG	1	bc
TGACACTCTT	GAAACACCGGTGCATTCGAAAGTCCGGTCGTAGTGTGGACGTGGGGTTAG	1	bc
AGCCACGCCC	GAAACACCGGTTTGAACTAGAAATAGCAAGTTAACCTAAGGCTAGTCCGT	1	bc
AGAAGCCGTT	GAAACACCGGTCTCGAGTGGGGTGTTCAGGGTGGGGTTAGAGCTAGAAAT	1	bc
TGGCAACCGC	GAAACACCGGTGTGGCTGAGAGTCCGGCAATGGTGTGGCTGTGGGGTTAG	1	bc
ACCTTTACTG	GAAACACCGGTCGGGGCCACTCAGTGGTGGGGTTAGAGCTAGAAATAGCA	1	bc
CTAGATAGGT	GAAACACCGGTTACATTTTGAGGGTTAGAGCTAGAAATAGCAAGTTAACC	1	bc
TCATCGTAGT	GAAACACCGGTGTACGTATGGACTGAACCAGGGTGTGCAGTGGGGTTAGA	1	bc
CACAAAGGCA	GAAACACGGGTTAGAGCTAGAAATAGCAAGTTAACCTAAGGCTAGTCCGT	1	bc
TCATTTCGAG	GAAACACCGGTACATCTATTCATGCGGTATCGCCGGTTAAGTGGGGATAG	1	bc
ATTGAGAATA	GAAACACCGGTTAAGCCGAGGATGGGGTTAGAGCTAGAAATAGCAAGTTA	1	bc
AAGCGTGGTC	GAAACACCGGTGTACGTATGGACTGAACCAGGGTGTGCAAAAGTGGGGTT	1	bc
GACGTCGCGC	GAAACACCGGTCGGCGGCAATAGAAATAGCAAGTTAACCTAAGGCTAGTC	1	bc
CGCGCTCTCC	GAAACACCGGTGAGGCTGAGAGTCCGACTTTGGCGAGGCTTAGGGCGTTA	1	bc
GACCTAGACC	GAAACACCGGTAGCAAGTGTGAGACGTGTTTGTGGGGTTAGAGCTAGAAA	1	bc
CGTGTGACTC	GAAACACCGGTCCGTAGGAGACCCGTGTGGCATGTACCTGTGGGGTTAGA	1	bc
GTGGCGGCAC	GAAACACCGGTTCCCGTCCAGTGGGGTTAGAGCTAGAAATAGCAAGTTAA	1	bc
TTCGCTAGGC	GAAACACCGGTTACATTGAGGGGTTAGAGCTAGAAGTAGCAAGTTAACCT	1	bc
AGTCCGCTGC	GAAACACCGGTCCGTAGGAGACCCGTGTGGCATGTACCTGTGGGGTTAGA	1	bc
AAGTCTGACT	GTAACACCGGTCCGTAGGAGACCCGTGTGGCATGTACCCTGTGGGGTTAG	1	bc
AGACAGAGAA	GAAACACCGGTAGCAAGTGCGAGCTAGAAATAGCAAGTTAACCTAAGGCT	1	bc
CTGCTTCGCC	GAAACACCGGTTTACGTTTCATCGGTGTGGGGTTAGAGCTAGAAATAACA	1	bc
GAATGTGTAA	GAAACACCGGTAACTATATTCATGCGATATCGCCGTATCAGTGGGGTTAG	1	bc
GTGGGTACTC	GAAACACCGGTTCCCGTCCAGTGGGGTTAGAGCTAGAAATAGCAAGTTAA	1	bc
GGCACGAACC	GAAACACCGGTGTGGCTGAGAGTCCGGCAATGGTGTGGCTGTAGGGTTAG	1	bc
GTAACTTCTG	GAAACACCGGTAACTATATTCATGCGATATCGCCGTATCAGTGGGGTTAG	1	bc
ATAACTTTTT	GAAACACCGGTAACTATATTCATGCGATATCGCCGTATCAGTGGGGTTAG	1	bc
AAACTCATGC	GAAACACCGGTAACTATATTCATGCGATATCGCCGTATCAGTGGGGTTAG	1	bc
AGTAGCTATG	GAAACACCGGTTACATTGAGTGGGGTTAGAGCTAGAAATAGCAAGTTAAC	1	bc
AGAGGCGTAT	GAAACACCGGTTAAGCCGAGTGGGGTTAGAGCTAGAATTAGCAAGTTAAC	1	bc
AGCGAGCATA	GAAACACCGGTTAAGCCGAGTGGGGTTAGAGCTAGAAATAGCAAGTTAAC	1	bc
AGGCTCCTTT	GAAACACCGGTCTCGAGTGAGGTGTTCAGGGTGGGGTTAGAGCTAGAAAT	1	bc
GAGGACGCCC	GAAACACCGGTTTGAACTAGAAATAGCAAGTTAACCTAAGGCTAGTCCGT	1	bc
AGGCAACCGC	GAAACGCCGGTGTGGCTGAGAGTCCGGCAATGGTGTGGCTGTGGGGTTAG	1	bc
GACATACCGC	GAAACACCGGTCTGGGCGACTCAGTGGTAGTGTTGTAGCTAGAGGGAGCA	1	bc
CGTCTGCATA	GAAACACTGGTCCGTAGGAGACCCGTGTGGCATGTACCTGTGGGGTTAGA	1	bc
TAGCTTAGAT	GAAACACCGGTAACTATATTCACGCGATATGGCGGTATCAGTGGGGTTAG	1	bc
ACTACTCTGC	GAAACACCGGTACCTTTGTTGATGCTGGGTGGAAGGAAAAAGTGGCACCG	1	bc
AAAACGGCTC	GAAACACCGGTCCGTAGGAGACCCGTGTGGCATGTACCTGGGGGGGTAGA	1	bc
AAACTCGCGC	GAAACACCGGTGCATTCGAAGGTCCGGTCGTAGTGTGGACGTGGGGTTAG	1	bc
TCGATAGCTG	GAAACACCGGTTATATTTGTAAGCGGGGTTAGAGCTAGAAATAGCAAGTT	1	bc
AACTTCTGTT	GAAACACCGGTCGTTTCGTATCATCACCGTCCTAGAGCTGGGAGTAGCGA	1	bc
TAGCGACGTC	GAAACACCGGTGGACGTATGGACTGAACCAGGGGGTGCAAGTGGGGTTAG	1	bc
ATAATTCTCC	GAAACACCGGTTTACGTTGCATTGGTGTGGGGTTAGAGCTAGAAATAGCA	1	bc
ACTTGAACGC	GAAACACCGGTCGGGGCCACTCAGTGGTGGGGTTAGAGTTAGAAATAGCA	1	bc
TTGCTAATAC	GAAACACCGGTTAAGCCGAGTGGGGTTAGAGCTAGAAATAGCAAGTTAAC	1	bc
AGCATCCCTC	GAAACACCGGTCCGTAGTAGACCCGTGTGGCATGTACCTCCTGTGGGGCT	1	bc
CGCAGACGTC	GAAACACCGGTCTCGGGAGAGGCTGACAGAGGGGGGGCAAGGGGAGTTAG	1	bc
GCTGACCGCA	GAAACACCGGTCGGGGCGGGGCTAAAGGTTGAAATAGTAAAGTTACCTAA	1	bc
GATGATCTGC	GAAACACCGGTCGGCGGGGGTAGAGCTAGAAATAGCAAGTTAACCTAAGG	1	bc
TTACTTTTGA	GAAACACCGGTTACGATACCTTTGCGATATGGCTAGAGCTAGGAATAGAA	1	bc
GTAACTCTCC	GAAACACCGGTGTGGCTGAGAGTCTGGCAATGGTGTGGCTGGGGGTATAA	1	bc
AATGGTCGGT	GAAACACCGGTTACATTGAGGGTTAGAGCTAGAAATAGCAAGTTAACCTA	1	bc
TGAAGAATCG	GAAACACCGGTCGGCGGCAATCGTGGGGTTAGATTAGATTAATCGTGGGG	1	bc
GCGATTTCTT	GAAACACCGGTCTCGAGTGAGGTGTTCAGGGTGGGGTTAGAGCTAGAAAT	1	bc
GGTAGGCCTC	GAAACACCGGTCTGTAGGAGACACGTGTAGCATGTAACTGTGGGATTAGA	1	bc
TTGCTTAGAA	GAAACACCGGTTAGTAATAGCAAGTTGATATAAGGCTAGTCCGTTCTCAA	1	bc
AGGGGAGGCT	GAAACACCGGTTCCCGTCCAGTGGGGTTAGAGCTAGAAATAGCAAGTTAA	1	bc
CAATTTCTTT	GAAACACCGGTCTCGAGTGTGGTGTTCAGGGTGGGGTTAGAGCTAGAAAT	1	bc
ATAATCATTT	GAAACACCGGTCTCGAGTGAGGTGTTCAGGGTGGGGTTAGAGCTAGAAAT	1	bc
ATGTTAAGCC	GAAACACCGGTTTACGTTGCATCGGTGTGGGGTTAGAGCTAGAAATAGCA	1	bc
AGTTTGCATT	GAAACACCGGTCCGTAGGAGACCCGTGTGGCATGTACCTGTGGGGTTAGA	1	bc
GAAAAAGCCA	GAAACACCGGTAGCAAGTGCGAGACGTGTTTGTGGGGTTAGAGCTAGAAA	1	bc
AGTCGTTGTC	GAAACACCGGTGTACGTATGGACTGAACCAGGGTGTGCAAGTGGGGTTAG	1	bc
CGCACCTACC	GAAACACCGGTAAATTTGAGGCTCCGGCATGCAGGAGGCCGTGGGGTTAG	1	bc
ACAGACCTGC	GAAACACCGGTCGGCGGCAATCGTGGGGTGGGGTTAGAGCTAGAAATAGC	1	bc
CTAATTGGCA	GAAACACCGGTACCTTTGTTGATGCTGGGTGGAAGGAATTTGTGGGGTTA	1	bc
GTCACTATGC	GAAACACCGGTGTGGCTGAGAGTCCGGCAATGGTGTGGCTGAGGGGTTAG	1	bc
AGAACCCTGT	GAAACACCGGTCTCGAGTGAGGTGTTCAGGGGGGGTTAGAGCTAGAAATA	1	bc
ATACCTGGCC	GAAACACCGGTACCTTTGTTGATGCTGGGTGGAAGGAATTTGTGGGGTTA	1	bc
AGAGTTGTGT	GAAACACCGGTGACATTGGGTACAGGGTTAGAGCTAGAAATAGCAAGTTA	1	bc
ATGCTGACTC	GAAACACCGGTCTGTAGTGGACCCGTGTGGCATTTACCCGAGGGGTTAGA	1	bc
AAGTATGCCG	GAAACACCGGTCCGTAGGAGACCCGTGTGGCATGTACCTGTGGGGTTAGA	1	bc
GGGCGCGTCC	GAAACACCGGTGTGGCTGAGAGTCCGGCAATGGTGTGGCTGTGGGGTTAG	1	bc
AAGAACCGCC	GAAACACCGGTTTGAAGTAGAAATAGCAAGTTATACTAAGGCTAGTCCGA	1	bc
TTACCCTTGA	GAAACACCGGTGCATTCGACAGTCCGGTCGTAGTGTGGACGTGGGGTTAG	1	bc
AAACGACGTC	GAAACACCGGTGTACGTATAGACTGAACCAGGGTGTGCAAGTGGGGTTAG	1	bc
TGAGACAGAC	GAAACACCGGTAGCAAGTGGGGTTAGAGCTAGAAATAGCAAGTTAACCTA	1	bc
GAATGCTTAG	GAAACACCGGTTTACGTTGCATCGGTTAGTGGGGTTAGAGCTAGAAATAG	1	bc
AGAACCATTT	GAAACACCGGTCTCGAGTGAGGTGTTCAGGGTGGGGTTAGAGCTAGTAAT	1	bc
ACCTATACTG	GAAACACCGGTCGGGGATACTCGGTTGTGGGGTTAGAGCTAGAAATAGCA	1	bc
CTACAGGGAT	GAAACACCGGTTATATTTGTAACTATTGTCGCATTAGAGCTAGAGGTTGC	1	bc
GCGAGCCTAC	GAAACACCGGTTAAGCCGAGAGGGGTTAGAGCTAGAAATAGCAAGTTAAC	1	bc
GGACCTACCA	GAAACACCGGTAAATTTGAGGCTCCGGCATGCAGGAGGCCGTGGGGTTAG	1	bc
AAACAACGCC	GAAACACGGGTTAGAGCTAGAAATAGCAAGTTAACCTAAGGCTAGTCCGT	1	bc
TCATTCGGAC	GAAACACCGGTCGATTCATATCGAAACCTTCCCGTGACAGTGGGGTTAGA	1	bc
ATGAGAAGTA	GAAACACCGGTTAAGCCGAGTGGGGTTAGAGCGAGAAATAGCAAGTTAAC	1	bc
CTGATAATTC	GAAACACCGGTCTCGAGTGAGGTGGTCAGGGTGGGGTTAGAGCTAGAAAT	1	bc
GCTATTCGGC	GAAACACCGGTACCTTTGTTGATGCTGGTTAGAGCTAGAAATAGCAAGTT	1	bc
GGAACAGCCA	GAAACACCGGTAAAATGTACGCGCCGGCATTGAGGGGTTCGTGGGAGTAA	1	bc
CGAACCGCGC	GAAACACCGGTGCATTCGAAAGTCCGGTCGTAGTGTGGACGTGGGGTTAG	1	bc
TAAGTGAGAC	GAAACACCGGTAACTATATTCGGGTTAGAGCTAGAAATAGCAAGTTAACC	1	bc
TCGCCCTGCA	GAAACACCGGTGCATTCGAAAGTCCGGTCGTAGTGTGGACGTGGGGTTAG	1	bc
TGCATACACG	GAAACACCGGTCGGCGGCAATCGTGGGTGGGGTTAGAGCTAGAAATAGCA	1	bc
GGGCACATTC	GAAACACCGGTGTGGCTGAGAGTCCGGCAAGGGTGTGGCTGTGGGGTTAG	1	bc
TTGCGCGTCA	GAAACACCGGTTAAGCCGAGGAGTTAGAGCTAGAAATAGCAAGTTAACCT	1	bc
AAGACGGCCC	GAAACACCGGTTTGACCTAACTCTGTCAGGGGGGAGAGCTAGAAACTGGA	1	bc
GGCGCCTAGT	GAAACACCGGTAAATTTGAGGCTCCGGCATGCAGGAGGCCGTGGGGTTAG	1	bc
GCAACCCGCC	GAAACACCGGTGTGGCTGAGAGTCCGGCAATGGTGTGGCTGTGGGGTTAG	1	bc
AGCGGATACG	GAAACACCGGTTCCCGTCCAGTGGGGTTAGAGCTAGAAATAGCAAGTTAA	1	bc
TAACGCCCCA	GAAACACCGGTGCCCTTACTCTCACCTGATTACTTAATCCGTGGGGTTAG	1	bc
AACCAAGTCC	GAAACACCGGTAGCAAGTGCGAGACGTGTTTATGGGGTTAGAGCTAGAAA	1	bc
TCACTCACGC	GAAACACCGGTAACTATATTCATGCGATATCGCCGTATCAGTGGGGTTAG	1	bc
CAGAACGCGA	GAAACACCGGTTTGAACTACCTAGTTCAAACCGGTGGGGTTAGAGCTAGA	1	bc
AACATCGGCC	GCTAGAAATAGCAAGTTAACCTAAGGCTAGTCCGTTATCAACTTGGAGAT	1	bc
ACTCGACGTC	GAGACACCGGTGTACGTATGGACTGAACCAGTGTGTGCAAGTGGGGTTAG	1	bc
GACGTTATAC	GAAACACCGGTAACTATATTCCTGCGATATCGCCGTATCAGTGGTGTTAG	1	bc
GATGCTGAGC	GAAACACCGGTTTACGTTGCATCGGTGTGGGGTTAGAGCTAGAAATAGCA	1	bc
GAGTGGAGCC	GAAACACCGGTTCCCGTCCAGTGGGGTTAGAGCTAGAAATAGCAAGTTAA	1	bc
ACTCTTCGCC	GAAACACCGGTTTACGTTGCATCGGGTTGTGGGGTTAGAGCTAGGAATAG	1	bc
AGATACGGAT	GAAACACCGGTCGTTTCATTTCGAAACCTGCCCTAGAGCGGGGGTATAGA	1	bc
AAAATCCTTA	GAAACACCGGTCTCGAGTGAGGTGTTCAGGTGGGGTTAGAGCTAGAAATA	1	bc
ATATCCTCGG	GAAACACCGGTTTACGTATGGACTGAACCAGGGTGTGCAAGTGGGGTTAG	1	bc
AGAAGAATCG	GAAACACCGGTCGGCGGCAATCGTGGTAGAGCTAGAAATAGCAAGTTAAC	1	bc
CGTCGTACTC	GAAACACCGGTCCGTAGGAGACCCGTGTGGCATGTACCTGTGGGGTTATA	1	bc
GGCACGTAAA	GAAACACCGGTAAATTTGAGGCTCCGGCATGCAGGAGGCCGTGGGGTTAG	1	bc
AGACAAAGAC	GAAACACCGGTAGCAAGTGCGAGACGTGTTAAATAGCAAGTTAACCTAAG	1	bc
GGATCCTAAA	GAAACACCGGTAAATTTGAGGCTCCGGCATGCAGGAGGCCGTGGGGTTAG	1	bc
AGCCTGACGC	GAAACACCGGTCCGTAGGAGACCCGTGTGGCATGTACCTGTGGGGTTAGA	1	bc
AGATTACCGC	GAAACACCGGTCGGGGCCACTCAGGGGTTAGAGCTAGAAATAGCAAGTTA	1	bc
CTATGTATGT	GAAACACCGGTTTGGGGTTAGAGCTAGAAATAGCAAGTTAACCTAAGGCT	1	bc
TAGACACCCG	GAAACACCGGTGCATTCGAAAGTCCGGTCGTAGTGTGGACGTGGGGTTGG	1	bc
AGAGTTGTCC	GAAACACCGGTGACATTGGGTACGCTAGAAATAGCAAGTTAACCTAAGGC	1	bc
TGTATGGCTC	GAAACACCGGTTCGTAGGAGACCCGTGTGGGATTAGACTGAGAGGTAGCA	1	bc
CATGGTGTTC	GAAACACCGGTGACATTGGGTACAATAGCAAGTTAACCTAAGGCTAGTCC	1	bc
GGCAGAACTG	GAAACACCGGTCGGCGGCAATCGTGGGGTGGGGTTAGAGCTAGAAATAGC	1	bc
AGTGGAGACT	GAAACACCGGTTCCCGTCCAGTGGGGTTAGAGCTAGAAATAGCAAGTTAA	1	bc
AAGTCTGGCT	GAAACACCGGTGACATTGGGTACAGGGGTGGGGTTAGAGCTAGAAATAGC	1	bc
ATGTGCAACC	GAAACACCGGTTAAGCCGAGGTTAGAGCTAGAAATAGTAAGTTAACCTAA	1	bc
TATATCGCCC	GAAACACCGGTTTGAACTACCTAGTTCAAACCGGTGGGGTTAGAGCTAGA	1	bc
TCTCACGCGT	GAAACACGGGTAAAATTGTAAGGGGTTTGTGGGGTTAGAGCTGGAATTAG	1	bc
AACAACTCTC	GAAACACCGGTTTGAACTACCTAGGTCAAACCGGTGGTAGTAGAGCTAGA	1	bc
GTCTTTATCG	GAAACACCGGTCGGGGCCACTCAGTGGTGGGGTTAGAGCTAGAAATAGCA	1	bc
GTATTCAGTT	GAAACACCGGTCAATTCATATCCAACCCTTCCCGAGACAGTGGGGTAAGA	1	bc
AGCGGAGCCT	GAAACACCGGTTCCCGTCCAGTGGGGTTAGAGCTAGAAATAGCAAGTTAA	1	bc
GTGGTTATGT	GAAACACCGGTTACATTGAGGGGTTAGAGCTAGGAATAGCGAGTTAACCT	1	bc
GCTTGCCGGC	GAAACACCGGTCGGGGCCACTCAGTGGTGGGGGTAGAGCTAGAAATAGCA	1	bc
GGGCAACCTC	GAAACACCGGTGTGGCTGAGAGTCCGGCAATGGTGTGGCTGTGGGGTTAG	1	bc
GAAGACAAGA	GAAACACCGGTCGGCGGCAATCGTGGGTGGGGTTAGAGCTAGAAATAGCA	1	bc
GGAGGAACCT	GAAACACCGGTTCCCGTCCAGTGGGGTTAGAGCTAGAAATAGCAAGTTAA	1	bc
GCTGGAAGTT	GAAACGCCGGTGACATTGGGTAAAATAGCAAGTTAACCCAAGGCAAGTCC	1	bc
GTAGTGGGCC	GAAACACCGGTACCTTTGTTGATGCTGGGTGGGGTTAGAGCTAGAAATAG	1	bc
ACAGCAATGT	GAAACATTGGGGTTAGAACTAGAAATAGCAAGTTAACCTAAGGCTAGTCC	1	bc
ATCGTATGAC	GAAACACCGGTCCGTAGGAGACCCGTGTGGCATGTACCTGTGGGGTTAGA	1	bc
AAGGACGTAC	GAAACACCGGTGCCCTTACTCTCACCTGATTACTTAATCCGTGGGGTTAG	1	bc
TAGATGATTC	GAAACACCGGTAACTATATTCATGCGATATCGCCGTATCAGTGGGGTTAG	1	bc
AGAATCTCGT	GAAACACCGGTGCATTCGAAAGTCCGGTCGTAGTGTGGACGTGGGGTTAG	1	bc
ACTTTACATC	GAAACACCGGTCGGGGCCACTCAGTGGTGGGGTTAGAGCTAGAAATAGCA	1	bc
GCAAATCGTT	GAAACACCGGTCTCGAGTGAGGTGTTCAGGGTGGGGTTAGAGCTAGAAAT	1	bc
TCGAATCATT	GAAACACCGGTCTCGAGTGAGGTGTTCAGGGGTGGGGTTAGAGCTAGAAA	1	bc
AAAAAACGCC	GCTAGAAATAGCAAGTTAACCTAAGGCTAGTCCGTTATCAACTTGAAAAA	1	bc
GTGGTGACCT	GAAACACCGGTTCCCGTCCAGTGAGGTTAAAGCTAGAAATAGCAAGTTAA	1	bc
CCGTTATCGA	GAAACACCGGTCGTGGCCACTCAGTGGTGGGGTTAGAGCTAGAAATAGCA	1	bc
AAAAGCCCTA	GAAACACCGGTGCCCTTACTCTCACCTGATTACTTAATCCGTGGGGTTAG	1	bc
ACCGTTATCG	GAAACACCGGTCGGGGCCACTCAGTGGTGGGGTTAGAGCTAGAAATAGCA	1	bc
ATAAATTCTA	GAAACACCGGTAACTATATTCATGCGATATCGCCGTATCAGTGGGGTTAG	1	bc
AGACACCGAC	GAAACACCGGTAGCAAGTGCGAGACGTGTTAAATAGCAAGTTAACCTAAG	1	bc
AGTCTGAAGT	GAAACACCGGTCCGAAGGAGACCCGTGTGGCATGAACCTTAGGGGTAACA	1	bc
GGAGCCCTCG	GAAACACCGGTGTGGCTGAGAGTCCGGCAATGGTGTGGCTGTGGGGTTAG	1	bc
TCATTTATTC	GAAACACCGGTAACTATATTCATGCGATATCGCCGTATCAGTGGGGTTAG	1	bc
AGCTACTCGG	GAAACACCGGTACCTTTGTTGATGCTGGGTGATTGTGGGGTTAGAGCTAG	1	bc
AGAGCGCCGT	GAAACACCGGTGTACGAATGGAGTGTAGAAGGGCGTGCAAGTGGGGTTAG	1	bc
CACGCTATAC	GAAACACCGGTGCCCTTACTCTCACCTGATTACTTAATCCGTGGGGTTAG	1	bc
TGCTCCTATA	GAAACACCGGTAAATTTGAGGCTCCGGCATGCAGGAGGCCGTGGGGTTAG	1	bc
CAAGGCCTTT	GAAACACCGGTCTCGAGGGAGGAGTTCAGGGTGGGGTTAGAGCTAGAAAT	1	bc
ACACCACGCC	GAAACACGGGTTAGAGCTAGAAATAGCAAGTTAACCTAAGGCCAGTCCGT	1	bc
AGAAGCTGGC	GAAACACCGGTGCATTCGAAAGTCCGGTCGTAGTGTGGACGTGGGGTTAG	1	bc
TGTATTGGCG	GAAACACCGGTGACATTGGGTGGTGGGGTTAGAGCTAGAAATAGCAAGTT	1	bc
AGTGATGTCC	GAAACACCGGTGACATTGGGTACAGGGGTGGGGTTAGAGCTAGAAATAGC	1	bc
ACGCGTTGTC	GCCTCCACGGCCACTAGTCTAAGGCGAGTCCGTTATCAACTTGAAAAAGT	1	bc
ATTGTGCATA	GAAACACCGGTTAAGCCGAGGAGTTTCGTTAGAGCTAGAAATAGCAAGTT	1	bc
GGTGGACGCG	GAAACACCGGTCGGCGGCAATCGTGGGTGGGGTTAGAGCTAGAAATAGCA	1	bc
AAGACTCTCG	GAAACACCGGTGCATTCGAAAGTCCGGTCGTAGTGTGGGCGTGGGGTTAG	1	bc
AAAGGCCCTA	GAAACACCGGTGCCCTTACTCTCACCTGATTACTTAATCCGTGGGGTTAG	1	bc
CCGTGACCAA	GAAACACCGGTTAGGCCGAGGAGTTAGAGGTAGAAGTAGCAGAATAACCA	1	bc
AAACTTAACT	GAAACACCGGTCGGGGCCACTCAGTGGTGGGGTTAGAGCTAGAAATAGCA	1	bc
AAGGACATAC	GAAACACCGGTGCCCTTACTCTCACCTGATTACTTAATCCGTGGGGTTAG	1	bc
TCGATCTGGG	GAAACACCGGTTAGATTTGTAGTAGTGTTGGGGTGGAGCTAGAAAGAAAA	1	bc
AAGTCTGCAT	GAAACACCGGTCCGTAGGAGACCCGTGTGGCATGTACCTGTGGGGTTAGA	1	bc
GAGAAGGACA	GAAACACCGGTTCCCGTCCAGTGGGTTAGAGCTAGAAATAGCAAGTTAAC	1	bc
AAAAACGCTC	GAAACACCGGTTTGAACTAGAAATAGCAAGTTAACCTAAGGCTAGTCCGT	1	bc
TAACCTACCT	GAAACACCGGTTACATTGAGGGTTAGAGCTAGAAATAGCAAGTTAACCTA	1	bc
CCTCTGCTGC	GAAACACCGGTCGGGGCCACTCAGTGGGGGGGTTAGAGCTAGAAATAGCA	1	bc
GGCAAAGATA	GAAACACCGGTAAATTTGAGGCTCCAGCATGCAGGAGGCCGTGGGGTTAG	1	bc
ACGTGAACTC	GAAACACCGGTCGGGGCCACTCAGTGGTGGGGTTAGAGCTAGAAATAGCA	1	bc
AAAGTGTCGT	GAAACACCGGTGTACGTATGGACTGAACCAGGGTGTGCAAGTGGGGTTAG	1	bc
AGGAGGCCCG	GAAACACCGGTCGGCGGCAATCGTGGGTGGGGTTAGAGCTAGAAATAGCA	1	bc
GCCTCCGACA	GAAACACCGGTAAGTTACATTCCTCGGCAGGCATAGAGCTGTGGGTATAG	1	bc
TATACTCGGC	GAAACACCGGTACCTTTGTTGATGCTGAGTGGAAGGAAAAAGTGGCACCG	1	bc
AAGCCTAGAC	GAAACACCGGTAACTATATTCATGCGATATCGCCGTATCAGGGGAGATAA	1	bc
TCTCTAGCGC	GAAACACCGGTCGCTAGAAATAGCAAGATAACCTAAGGCTAGTCCGTTAC	1	bc
TCATAGTCGT	GAAACACCGGTGTACGTATGGACTGAACCAGGGTGTGCAAGTGGGGTTAG	1	bc
GTTACTCTCC	GAAACACCGGTGTGGCTGAGAGTCCGGCAATGGTGTGGCTGTGGGGATAG	1	bc
GGGAATCGTT	GAAACACCGGTCTCGAGTGAGGTGTTCAGGGTGGGGTTAGAGCTAGAAAT	1	bc
TAGGATCCTC	GAAACACCGGTCGGCGGCTATCGCGTGTGGGGTTAGAGCTAGAAATAGCA	1	bc
GTGCTTATCC	GAAACACCGGTTTACGTTGGGGTTAGAGCTAGACATAGCAAGTTAACCTA	1	bc
AAGCCTGCCT	GAAACACCGGTCCGTAGGAGACCCGTGTGGCATGTACCTGTGAGGTTAGA	1	bc
TGGCTTGCAC	GAAACACCGGTCCGTAGGAGACCCGTGTGGCATGTACCTGTGGGGTTAGA	1	bc
ACCACCCGCC	GAAACACCGGTGTGGCTGAGAGTCCGGCAATGGTGTGGCTGTGGGGTTAG	1	bc
CTCCCCTGCA	GAAACACCGGTGTGGCTGAGAGTCCGGCAATGGTGTGGCTGGGGGGTTAG	1	bc
AGCAGGACAT	GAAACACCGGTCCGTAGGAGACCCGTGTGGCATGTACCTTGTGGGGTTAG	1	bc
AACGCTCGCC	GAAACACCGGTGCCCTTACTCTCACCTGATTACTTAATCCGTGGGGTTAG	1	bc
GCGGGACCGC	GAAACACCGGTTCCCGTCCAGTGGGGTTAGAGCTAGAAATAGCAAGTTAA	1	bc
AGAAGCCTTC	GAAACACCGGTCTCGAGTGAGGTGTTCAGGGTGGGGTTAGAGCTAGAAAT	1	bc
GTCGCGGTGC	GAAACACCGGTGCCCTTACTCTCACCTGATTACTTAATCCGTGGGGTTAG	1	bc
CGCGTTGGCA	GAAACACCGGTGACATTGGATTAGGGCTAGAAATAGCAAGTTAACCTAAG	1	bc
AGGGTGTCTC	GACACACCGGTCCGTAGGAGACCCGTGTGGCATGTACCTTGTGGGGTTAG	1	bc
AACTTTACCG	GAAACACCGGTCGGGGCCACTCAGTGGTGGGGTTAGAGCTAGAAATAGCA	1	bc
GTCATCGTCC	GAAACACCGGTACCTTTGTTGATGCTTTTTGGGTTAGAGCTAGAAATAGC	1	bc
GAAGGCATGA	GAAACACCGGTCGGCGGCAATCGTGGGTGGGGTTAGAGCTAGAAATAGCA	1	bc
ACGGGTTGTC	GAAACACCGGTGACAGGTGGGGTTAGAGCTAGAAATAGCAAGTTAACCTA	1	bc
AATGCTTAGA	GAAACACCGGTTTACGTTGCATCGGTGTGGGGTTAGAGCTAGAAATAGCA	1	bc
AGCCTTAGCC	GAAACACCGGTTTACGTTGCATCGGGGTTAGAGCTAGAAATAGCAAGTTA	1	bc
AATAGTCTTC	GAAACACCGGTGCACGTATGGACTGAACCAGGGTGTGCAAGTGGGGTTAG	1	bc
ACATCGGCGT	GAAACACAAGTTAACCTAAGGCTAGTCCGTTATCAACTTGAAAAAGTGGC	1	bc
ACCCAACGCT	GAAACACCGGTTTGAACTAGAAATAGCAAGTTAACCTAAGGCTAGTCCGT	1	bc
ATTGCTGCCT	GAAACACCGGTGACCATGGGGTTAGATCTAGAAATAGCAAGTTAACCTAA	1	bc
AGGATCCGTT	GAAACACCGGTCTTGAAAAAGTGGCACCGAGTCGGTGCTTTTTTTCCTGC	1	bc
TGCACCTACC	GAAACACCGGTAAATTTGAGGCTCCGGCATGCAGGAGGCCGTGGGGTTAG	1	bc
GGGAGCTACA	GAAACACCGGTAAATTTGAGGCTCCGGCATGCAGGAGGCCGTGGGGTTAG	1	bc
AAAGTTATCC	GAAACACCGGTAACTATATTCATGCGAGATCGCCGTATCAGTGGGGTTAG	1	bc
ACTACTAGGA	GAAACACCGGTAGCTTTGTTGATGCTGGGGTCTGTTTTTCGTTCGGGGGA	1	bc
TTACCAATAA	GAAACACCGGTTACATTGAGGGTTAGAGCTAGAAATAGCAAGTTAACCTA	1	bc
GACTCAGCTA	GAAACACCGGTAGCAAGTGCGAGACGTGTTTGTGGGGTTAGAGCTAGAAA	1	bc
AAATGTGGTT	GAAACACCGGTCGATTCATATCGAAACCTTCCCGTGACAGTGGGGTTAGA	1	bc
GCATCGTCCT	GAAACACCGGTGTACGTATGGACTGAACCAGGGTGTGCAAGTGGGGTTAG	1	bc
ACTACACGGC	GAAACACCGGTACCTTTGTTGATGCTGGGTGGAAATAGCAAGTTAACCTA	1	bc
GGCCCGTCAA	GAAACACCGGTAAATTTGAGGCTCCGGCATGCAGGAGGCCGTGGGGTTAG	1	bc
GAATACCCTG	GAAACACCGGTCGGCGGCAATCGTGGGTGGGGTTAGAGCTAGAAATAGCA	1	bc
AGATACGGGA	GAAACACCGGTGCATTCGAAAGTCCGGTCGTAGTGTGGACGAGAGGGTAG	1	bc
GCTAATCGGC	GAAACACCGGTACCTTTGTTGATGCTGGGTGGAAGGAATGGGGTTAGAGC	1	bc
TCACTGATGC	GAAACACCGGTAACTATATTTATGCGATATCGCCGTATCAGTGGGGTTAG	1	bc
AATGCATAGC	GAAACACCGGTTTCCGTTGCATCGGGGTTAGAGCTAGAAATAGCAAGTTA	1	bc
GATGATCCTC	GAAACACCGGTTCCCGTCCAGTGGGGTTAGAGCTAGAAATAGCAAGTTAA	1	bc
AAAAACGCCA	GAAACACCGGTTTGAACTACCTAGTAGCAAGTTAACCTAAGGCTAGTCCG	1	bc
AGAATACGCT	GAAACACCGGTATCGAGTGAGGTGTTCAGGGTGGGGTTAGAGCTAGAAAT	1	bc
TGGTGACGGC	GAAACACCGGTGTGGCTGAGAGACCGGCGATGTTGTAGCTGTGGGTTTAG	1	bc
ACTAATCGGC	GAAACACCGGTACCTTTGTTGATGCTGGGTGGAAGGATGCTGGGTGGGGT	1	bc
GGATGACCCG	GAAACACCGGTGGGGGGCAATTGCGGGTGGGGTTAGAGCTAGAAATAGCA	1	bc
ACGTGATGTC	GAAACACCGGTGACATGTGGGGTTAGAGCTAGAAATAGCAAGTTAACCTA	1	bc
GACCACTCCC	GAAACACCGGTTTGAGCTAGAAATAGCAAGTTAACCTAAGGCTAGTCCGT	1	bc
CCTTTTGGTT	GAAACACCGGTCGATTCATATCGAAACCTTCCCGTGACAGTGGGGTTAGA	1	bc
GAGGTGACTC	GAAACACCGGTTCCCGTTCAGTGGGGTTAGAGCTAGAAATAGCAAGTTAA	1	bc
GGCTACCGCC	GAAACACCGGTGTGGCTGAGAGTCCGGCAATGGTGTGGCTGTGGGGTTAG	1	bc
CAGCATATAT	GAAACACCGGTTTACGTTGGGGTTAGAGCTAGAAATAGCAAGTTAACCTA	1	bc
CAAACAACGC	GAAACACCGGTTTGAACTACCTAGTTCAAACCGGTGGGGTTAGAGCTAGA	1	bc
TTCACCATGT	GAAACACCGGTTACATTGAGGGTTAGAGCTAGAAATAGCAAGTTAACCTA	1	bc
ACACAAAGCC	GAAACACCGGTTTGAACTACCTAGTTCAAACCGGTGGGGTTAGAGCTAGA	1	bc
GGAGGAGCCT	GAAACACCGGTTCCCGTCCAGTGGGGTTAGAGCTAGAAATAGCAAGTTAA	1	bc
ACCTTGTCCG	GAAACACCGGTCTGGGCCACAAATAGCAAGTTAACCTAAGGCTAGTCCGT	1	bc
CCACTCGCTC	GAAACACCGGTACCTGTGTTGATGCTGCTAGGGGGGAAATAGCTGGAATT	1	bc
TAGTCTACAT	GAAACACCGGTCCGTAGGAGACCCGTGTGGCATGTACCTGTGGGGTTAGA	1	bc
CGTCACCCTC	GAAACACCGGTCTCGAGTGAGGTGTTCAGGGTGGGGGTAGAGCTAGAAAT	1	bc
CTACTTGTAT	GAAACACCGGTAACTATATTCATGCGATATCGCCGTATCAGTGGGGTTAG	1	bc
GAACACGCCG	GAAACACCGGTTTGAACTGCCTAGTTCAAACCGGTGGGGTTAGAGCTAGA	1	bc
AAGACACAGA	GAAACACCGGTAGCAAGTGCGAGACGTGTTTGTGGGGTTAGAGCTAGAAA	1	bc
GGCGGTGACT	CAAGATACCCTTAGGAAAGTGCGTTATAGCCTTGAATAGGTAGCAAAGCG	1	bc
GACAAAGTAC	GAAACACCGGTAGCAAGTGCGGGGTTAGAGCTAGAAATAGCAAGTTAACC	1	bc
GAAGACAAGA	GAAACACCGGTCGGTGGGGCTAGAGCTAGAAATAGCAAGTTAACCTAAGG	1	bc
CACGACCCTA	GAAACACCGGTTTGAACTAGAAATAGCAAGTTAACCTAAGGCTAGTCCGT	1	bc
GACGAATCCT	GAAACACCGGTCTCGAGTGAGGTGTTCAGGGTGGGGTTAGAGCTAGAAAT	1	bc
GATTACACGC	GAAACACCGGTCGGCGGCAATCGTGGTTAGAGCTAGAAATAGCAAGTTAA	1	bc
AAGAGTCGAC	GAAACACCGGTGTACGTATGGACTGAACCAGGGTGTGCAAGTGGGGTTAG	1	bc
ACACAATGCC	GAAACACCGGTTTGAACTAGAAATAGCAAGTTAACCTAAGGCTAGTCCGT	1	bc
GATGACGCTC	GAAACACCGGTTCTCGTCCAGTGGGGTTAGAGCTAGCAATAGCAAGTTAA	1	bc
GGGCTCCCTT	GAAACACCAGTCCGTAGGAGACCCGTGTGGCATGTACCTGTGGGGTTAGA	1	bc
GTCACAGAGT	GAAACACCGGTAGCAAGTGCGAGACGTGTTTGTGGGGTTAGAGCTAGAAA	1	bc
GAGAAGACTA	GAAACACCGGTTCCCGTCCAGTGGGGTTAGAGCTAGAAATAGCAAGTTAA	1	bc
GAAATCCTTA	GAAACACCGGTCTCGAGTGAGGTGTTCAGGGGGGGGTTAGAGCTAGAAAT	1	bc
ACCGAGCTAC	GAAACACCGGTGCCCTTACTCTCACCTGATTACTTAATCCGTGGGGTTAG	1	bc
AAGCGTCGGC	GAAACACCGGTGTACGTATGGACTGAACCAGGGTGTGCAAGTGGGGTTAG	1	bc
ATAATCCGGT	GAAACACCGGTCTCGAGTGAGGTGTTCAGGGTGTGGTTAGAGCTAGAAAT	1	bc
AAAAACGACC	GAAACACCGGTTTGAACTAGAAATAGCAAGTTAACCTAAGGCTAGTCCGT	1	bc
GCTACTAGGC	GAAACACCGGTACCTTTGTTGATGCTGGGTGGGAGGATGCTGGGTGGGGT	1	bc
AGGCACCCTA	GAAACACCGGTGTGGCTGAGAGTCCGGCAATGGTGTGGCTGTGGGGTTAG	1	bc
GGCGGCTACC	GAAACACCGGTAAGTTTGAGGCTCCGGCATGCAGGAGGCCGTGGGGTTAG	1	bc
GTACATTATA	GAAACACCGGTAACTATATTCATGCGATATCGCCGTATCAGTGGGGTTAG	1	bc
AGACTCTGGT	GAAACACCGGTGCATTCGAAAGTCCGGTCGTAGTGTGGACGGGGGGTTAG	1	bc
GACAGTGGTC	GAAACACCGGTGTCCGTATGGACTGAACCTGGGCGTGCAAGAGGGGTTAA	1	bc
CTTTTGTCGG	GAAACACCGGTGTAATCCAAAGCTATTAACATCATGAGTTGTGGGGTTAG	1	bc
AGAACCTACA	GAAACACCGGTAAATTTGAGGCCCCGGCATGCAGGAGGCCGTGGGGTTAG	1	bc
GAGGCGTAGA	GAAACACCGGTTTACGTTGCATCGGTTGTGGGGTTAGAGCTAGAAATAGC	1	bc
GGAATTCTCC	GAAACACCGGTAACTATATGCATGCGATATCGCCGTATCAGTGGGGTTAG	1	bc
TTGAGGATCT	GAAACACCGGTTAATCCGAGGAGTTAGAGCTAGAAATAGCAAGTTAACCT	1	bc
TACAACATCC	GAAACACCGGTTTGAACCGGTGGGGTTAGAGCTAGAAATAGCAAGTTAAC	1	bc
ATGCTTCCTA	GAAACACCGGTTTACGTTGCATCGGTGCCGGGTTGGATCTAGAAATAACA	1	bc
GGGTCCCACA	GAAACACCGGTAAGTTTGAGGCTCCGGCATGCAGGAGGCCGTGGGGTTAG	1	bc
AGTAGACGTC	GAAACACCGGTATCCGTATGGACTGAACCAGGGTGTGCAGGTGGGGGTCC	1	bc
AACGAATCCT	GAAACACCGGTCTCGAGTGAGGTGTTCAGGGTGGGGTTAGAGCTAGAAAT	1	bc
TATGGAGGCG	GAAACACCGGTTCCCGTCCAGTGGGGTTAGAGCTAGAAATAGCAAGTTAA	1	bc
ACGAAGACAT	GAAACACCGGTCTCGAGTGAGGTGTTCAGGGTGGGGTTAGAGCTAGAAAT	1	bc
ACATTTACAG	GAAACACCGGTCGGGGCCACTCAGTGGTGGGGTTAGAGCCAGAAATAGCA	1	bc
AGATGTGTAT	GAAACACCGGTAGCTATATTCATGCGATATCGCCGTATCAGTGGGGATAG	1	bc
AAACACGCCC	GAAACACCGGTTTGAAAGGTGGGGTTAGAGCTAGAAATAGCAAGTTAACC	1	bc
CATAATGGTC	GAAACACCGGTTTGAACTACCTAGAGCTAGAAATAGCAAGTTAACCTAAG	1	bc
TACCGTCGGC	GAAACACCGGTATACGGATGGAATGAACCAGGGTGTGCAAGGGGGGTTAG	1	bc
GCACGCGCTA	GAAACACCGGTGCCCTTACTCTCACCCGATTACTTAATCCGTGGGGTTAG	1	bc
CGGAGTCTTT	GAAACACCGGTCTCGAGTGAGGTGTTCAGGGGGGAGTTCGAGCTAGAACT	1	bc
GAGCCTCGCC	GAAACACCGGTCGGCGGCAATCGTGGGGCTAGAAGTAGCAAGTTAACCTA	1	bc
ACGCTTGGGC	GAAACACCGGTTTACGCTGCATCGGTGTGGGGTTAGAGCTAGAAATAGCA	1	bc
GGACATAGAC	GAAACACCGGTAGCAAGTGCGAGACGTGTTAAATAGCAAGTTAACCTAAG	1	bc
AAGGACCTCC	GAAACACCGGTGCCCTTACTCTCACCTGATTACTTAATCCGTGGGGTTAG	1	bc
GACAGAGCAA	GAAACACCGGTAGCAAGTGCGAGAGAAATAGCAAGTTAACCTAAGGCTAG	1	bc
AGAGTCGTTA	GAAACACCGGTCGATTCATATCGAAACCTTCCCGTGACAGTGGGGTTAGA	1	bc
ACACAAAGCC	GAAACACCGGTTTGAACTACCTAGTTCAAGCCGGTGGGGTTAGAGCTAGA	1	bc
AGGCCCTGGA	GAAACACCGGTGCATTCGAAAGTCCGGTCGTAGTGTGGACGTGGGGTTAG	1	bc
AGCAAGCCTC	GAAACACCGGTCCGTAGGAGACCTGTGTGGCATGCATCTGTGGGGTTAGA	1	bc
GCCTTGAGCG	GAAACACCGGTCGGGGCCACTCAGTGGTGGGGTTAGAGCTAGAAATAGCA	1	bc
GTAGATACGC	GAAACACCGGTCGGCGGCAATCGTGGGTGGGGTTAGAGCTAGAAATAGCA	1	bc
GAAACGCCCT	GAAACACCGGTGCCCTTACTCTCACCTGATTACTTAATCCGTGGGGTTAG	1	bc
AATGAGCATA	GAAACACCGGTTAAGCCGAGGAGTTTCGTTAGAGCTAGAAATAGCAAGTT	1	bc
AACGACGCAC	GAAACACCGGTGCCCTTACTCTCACCTGATTACTTAATCCGTGGGGTTAG	1	bc
CTGCGGCGTA	GAAACACCGGTGTACGTGTGACCTGAAGGGCGGTGTGCAGGTGGGGTTAG	1	bc
AAACCTGCTC	GAAACACCGGTGCATTCGAAAGTCCGGTCGTAGTGTGGACGAGGGGTTAG	1	bc
GCATAGTCGT	GAAACACCGGTGTACGTATGGACTGAACCAGGGTGTGCAAGTGGGGTTAG	1	bc
AGGCCCCGAC	GAAACACCGGTAAATTTGAGGCTCCGGCATGCAGGAGGCCGTGGGGTTAG	1	bc
ACCCCAGAAA	GAAACACCGGTAGCAAGTGCGAGACGTGTTAAATAGCAAGTTAACCTAAG	1	bc
CCACTAGCCC	GAAACACCGGTACCTTTGTTGCTGCTGGGGGGAAGGAATTTGTGGGGTTA	1	bc
ATGAGCTATG	GAAACACCGGTTACATTGAGTGGGGTTGGAGCTAGAAATAGCAAGTTAAC	1	bc
GGAGAGACGC	GAAACACCGGTGTGGCTGAGAGTCCGGCAATGGTGTGGCTGTGGGGTTAG	1	bc
ATCGTTATGT	GAAACACCGGTTACATTGGGGTTAGAGCTAGAAATAGCAAGTTAACCTAA	1	bc
GCACCACGTC	GCTAGAAACAGCAAGTTAACCTAAGGCTAGTCCGTTATCAACTTGAAAAA	1	bc
TAAGATGTGT	GAAACACCGGTTACATTTGAGGGGTTAGAGCTAGAAATAGCAAGTTAACC	1	bc
AACTTCGCCC	GAAACACCGGTTTGAACTACCTAGTTCAAACCGGTGGGGTTAGAGCTGGA	1	bc
ATTCGCAATG	GAAACACCGGTTACATTGAGGGTTAGAGCTAGAAATAGCAAGTTAACCTA	1	bc
GGACAGAATC	GAAACACCGGTCAGTAGAAGACGCGAGTGGGGTTAGAGTTAGAAGTAGCA	1	bc
TTAATTAGAA	GAAACACCGGTAACTATATTCATGCGATATCGCCGTATCAGTGGGGTTAG	1	bc
TCACCTATTC	GAGACACCGGTAACTATATTCATGCGATATCGCCGTATCAGTGGGGTTAG	1	bc
ACGATAGAGG	GAAACACCGGTTATATTTGTAAGTGGGGTTAGAGCTAGAAATAGCAAGTT	1	bc
AGATGATTAG	GAAACACCGGTTTACGTTGCATCGGTGTGGGGTTAGAGCTAGAAATAGCA	1	bc
AACGGTCAAC	GAAACACCGGTGCCCTTACTCTCACCTGATTACTTAATCCGTGGGGTTAG	1	bc
ACAAATCCTT	GAAACACCGGTCTCGAGTGAGGTGTTCAGGATGTGGGGATAGAGCTAGGA	1	bc
CAACAGGCCC	GAAACACCGGTTTGAACTACCTAGTTCAAACACCGGTTTGAGCTACCTAG	1	bc
ACCGACATAC	GAAACACCGGTGCCCTTACTCTCACCTGATTACTTAATCCGTGGGGTTAG	1	bc
TCGACCGTGG	GAAACACCGGTTATATTTGTAAGTGTGTGGGGTTAGAGCTAGCAATAGAA	1	bc
TGTATCGTTT	GAAACACCGGTTATATTTGTAAGTGTCAGGGGTTAGATCTAGCTATAACA	1	bc
AAACGCACTA	GAAACACCGGTGCCCTTACTCTCACCTGATTACTTAATCCGTGGGGTTAG	1	bc
AAGACGCTCG	GAAACACCGGTGCATTCGAAAGTCCGGTCGTAGTGTGGACGTGGGGTTAG	1	bc
GGAAACATCA	GAAACACCGGTGTGGCTGAGAGTCCGGCAATGGTGTGGCTGTGGGGTTAG	1	bc
GGATCCCTTC	GAAACACCGGTGTGGCTGAGAGTCCGGCAATGGTGTGGCTGTGGGGATAG	1	bc
ACACACCGCC	GAAACACCGGTTTGAACTACCTAGTAGCAAGTTAACCTAAGGCTAGTCCG	1	bc
AACGGCATAA	GAAACACCGGTGCCCTTACTCTCACTTGATTACTTAATCCGTGGGGTTAG	1	bc
GCCTTTAACG	GAAACACCGGTCGGGGCCACTCAGTGGTGGGGTTAGAGCTAGAAATAGCA	1	bc
ACAGAACGGC	GAAACACCGGTCGGCGGCGGTGGGGTTAGAGCTAGAAATAGCAAGTTAAC	1	bc
AACACGGCCC	GAAATAGCAAGTTAACCTAAGGCTAGTCCGTTATCAACTTGAAAAAGTGG	1	bc
CTCCCCTTCA	GAAACACCGGTGTGGCTGAGAGTCCGGCAATGGTGTGGCTGTGGGGTTAG	1	bc
TGCGGAGCCT	GAAACACCGGTTCCCGTCCAGTGGGGTTAGAGCTAGAAATAGCAAGTTAA	1	bc
CTCCCCTGCA	GAAACACCGGTGAGGCTGAGAGACCGGCAGTGGTATGGCTGGGGGGTTAT	1	bc
AGTCTATCGA	GAAACACCGGTTATATTTGTAAGTGTGTGGGGTTAGAGCTAGAAATAGCA	1	bc
AACGAAGTCT	GAAACACCGGTTCCCGTCCAGGGGGGTTAGAGCGATGAATAGCAAGTTAA	1	bc
GATGCTCAGC	GAAACACCGGTTTACGTTGCATCGGTTAGAGCTAGAAATAGCAAGTTAAC	1	bc
ATAACATATA	GAAACACCGGTAACTATATTCATGCGATATCGCCGTATAGGGTTAGAGCT	1	bc
TCGATCGTGC	GAAACACCGGTTATATTTGTAGGGGAGTGGGGTTAGAGCTAGAAATACCA	1	bc
AGAATTATAT	GAAACACCGGTAACTATATTCATGCGATATCGCCGTATCAGTGGGGTTAG	1	bc
CTAGTCCGAA	GAAACACCGGTTCCTTTGTTGATGCTGGGGGCTTTTTTTCATGCAGGGGC	1	bc
GGGCCCCTCG	GAAACACCGGTAAATTTGAGGCTCCGGCATGCAGGAGGCCGTGGGGTTAG	1	bc
ATGCTTCGTC	GAAACACCGGTTTACGTTGCATCGGTGTGGGGTTAGAGCTAGAAATAGCA	1	bc
CATTGCCAGA	GAAACACCGGTCGGGGCCACTCAGTGGTGGGGGTAGAGCTAGAAATAGCT	1	bc
GAAATTCGGT	GAAACACCGGTCGATTCATATCGAAACCTTCCCGTGACAAGTGGGGTTAG	1	bc
AATGTTGGCT	GAAACACCGGTGGGGTTAGAGCTAGAAATAGCAAGTTAACCTAAGGCTAG	1	bc
ACCTTTCCTG	GAAACACCGGTCGGGGCCACTCAGTGGTGGGGTTAGAGCTAGAAATAGCA	1	bc
GAGCACCGCC	GAAACACCGGTCGGCGGCAAATGGGGTTAGAGGGAGAAAGAGCAAGTTAA	1	bc
ACTCGTAGTC	GAAACACCGGTGTACGTATTGACTGAACCAGGGTGTGCAAGTGGGGTTAG	1	bc
GCGGCCCCGC	GAAACACCGGTCGGCGGCTCGGTGGGGTTAGAGCTAGAAATAGCAAGTTA	1	bc
GGTCTGGATA	GAAACACCGGTACGTAGGAGGCCAGGGTGGCATGTACCAGTGGGGCTAGG	1	bc
TACGTACTAC	GAAACACCGGTGCCCTTACTCTCACCTGATTACTTAATCCGTGGGGTTAG	1	bc
AAGAACACCC	GAAACACCGGTTTGAACTACCTAGTAGCAAGTTAACCTAAGGCTAGTCCG	1	bc
GCCGACACGC	GAAACACCGGTCGGCGGGGTGGGGTTAGAGCTAGAAATAGCAAGTTAACC	1	bc
ACCTACGCCC	GAAACACCGGTTTAGAGCTAGAGATAGCTAGTTAACCTAAGGCTAGTCCG	1	bc
GACTACACGC	GAAACCCCGTTCGGCGGCAATCGTGGTTGGGGTTAGAGCTAGAAATAGCA	1	bc
CCGTTAACGT	GCAACACCGGTCGGGGCCACTCAGTGGTGGGGTTAGAGCTAGAAATAGCA	1	bc
AGAATGCCTT	GAAACACCGGTCCGTAGGAGACCCGTGTGGCATGTACCTGTGGGGTTAGA	1	bc
TAGTCCAACA	GAAACACCGGTTAAGCCGAGGAGTTAGAGCTAGTAATAGCAAGTTAACCT	1	bc
CATAAGCCTC	GAAACACCGGTCCGTAGGAGCCCCGTGTGGCGTGAAACTGTGGAGTTAGA	1	bc
CAGGACCTAC	GAAACACCGGTGCCCTTACTCTCACCTGATTACTTAATCCGTGGGGATAG	1	bc
GAGTCGGCCT	GAAACACCGGTCCGTAGGAGACCCGTGTGGCATGTACCTGTGGGGTTAGA	1	bc
CACGAGTTAT	GAAACACCGGTCTCGAGTGAGGCGTTCAGGGTGGGGTTAGAGCTAGAAAT	1	bc
ACGAATAGTT	GAAACACCGGTCTCGAGTGAGGTGTTCAGGGTGGGGTTAGAGCTAGAAAT	1	bc
AAAGGCCATA	GAAACACCGGTCGGCGGCGAGCTAGAAATAGCAAGTTAACCTAAGGCTAG	1	bc
AGAAGACGCG	GAAACACCGGTCGGCGGCGGTGGGGTTAGAGCTAGAAATAGCAAGTTAAC	1	bc
GAGAAGACTC	GAAACACCGGTTCCCGTCCAGTGGGGTTAGAGCTAGAAATAGCAAGTTAA	1	bc
TGCAACTTTA	GAAACACCGGTAAATTTGAGGCTCCGGCATGCAGGAGGCCGTGGGGTTAG	1	bc
GACGAGGCTC	GAAACACCGGTTCCCGTCCAGTGGAGATAGAGCTAGAAATAGCAAGTTAA	1	bc
AATTGGCGAT	GAAACACCGGTTACATTGAGGGTTAGAGCTAGAAATAGCAAGTTAACCTA	1	bc
AGACACGAGC	GAAACACCGGTGCATTCGAAAGTCCGGTCGTAGTGTGGACGTGGGGTTAG	1	bc
TGCGCCTGGA	GAAACACCGGTAAATTTGAGGCTCCGGCATGCAGGAGGCCGTGGGGTTAG	1	bc
TACACAATCA	GAAACACCGGTAAATTTGAGGCTCCGGCATGCAGGAGGCCGTGGGGTTAG	1	bc
CGACGCGGCA	GAAACACCGGTACCTTTGTTGATGCTGGGTGGAAGGAGCTAGAGATAGCA	1	bc
AAGAGTCCCT	GAAACACCGGTCTCGAGTGAGGTGTTCAGGGTGGGGTTAGAGCTAGAAAT	1	bc
ATACTGTGTA	GAAACACCGGTACCTTTGTTGATGCTGGGTGGAAGGAATGGGGTTAGAGC	1	bc
AACGCCACAA	GCTCTCACCTGATTACTTAATCCGTGGGGTTAGAGCTAGAAATAGCAAGT	1	bc
AAGATCCTCG	GAAACTCCGGTGCATTCGAAAGTCCGGTCGTAGTGTGGACGTGGGGTTAG	1	bc
AAACGGCCTA	GAAACACCGGTGCCCTTACTCTCACCTGATTACTTAATCCGTGGGGTTAG	1	bc
AGCATGCATA	GAAACACCGGTCCGTGGGAGACCCGTGTGGCATGTACCTGTGGGGTTAGA	1	bc
GGGCTCAGCC	GAAACACCGGTGTGGGTGACAGCCTACGATTTATGTTGCTGAAGGGGTAC	1	bc
GTGTTGCGTC	GAAACACCGGTACCCGGCCATTGGGCTTAGACCTAGCCTGAGCTCGTGCC	1	bc
GTACTTCTAC	GAAACACCGGTAACTATATTCATGCGATATCGCCGTATCAGTGGGGATAG	1	bc
TAGACACTCG	GAAACACCGGTGCATTCGAAAGTCCGGTCGTAGTGTGGACGTGGGGTTAG	1	bc
ACTACTCAGC	GAAACACCGGTACCTTTGTTGATGCTGGGTGGAAGGTGGGGTTAGAGCTA	1	bc
GGAAACCTTC	GAAACACCGGTGTGGCTGAGAGTCCGGCAATGGTGTGGCTGTGGGGTTAG	1	bc
AGCCTGATTC	GAAACACCGGTCCGTTGGAGGCGCGGGGGGTATGTACCTAGGGGGGTAAA	1	bc
ATCAGCTATG	GAAACACCGGTTACATTGAGATTGGGGTTAGAGCTAGAAATAGCAAGTTA	1	bc
TAAAACGACC	GAAACACCGGTTTGAACTAGAAATAGCAAGTTAACCTAAGGCTAGTCCGT	1	bc
ACCTTTGCCG	GAAACACCGGTCGGGGCCACTCAGTGGTGGGGTTAGAGCTAGAAATAGCA	1	bc
CGCGAATCCT	GAAACACCGGTCTCGAGTGAGGTGTTCAGGGTGGGGTTAGAGCTAGAAAT	1	bc
AAACAACGAC	GGGTTAGAGCTAGAAATAGCAAGTTAACCTAAGGCTAGTCCGTTATCAAC	1	bc
ATGACTTATA	GAAACACCGGTAACTATATTCATGCGATATCGCCGTATCAGTGGGGTTAG	1	bc
GGGGGGGCTC	GAAACACCGGTTCCCGTCCAGTGGGGTTAGAGCTAGAAATAGCAAGTTAA	1	bc
AAGACTGCAT	GAAACACCGGTCCGTAGGAGACCCGTGTGGCATGTACCTGTGGGGTTAGA	1	bc
TGAATACCCG	GAAACACCGGTCGGCGGCAATCGTGGGTGGGGTTAGAGCTAGAAATAGCA	1	bc
CATAGCTTAT	GAAACACCGGTAACTATATTCATGCGATATCGCCGTATCAGTGGGGTTAG	1	bc
AAGACCATCG	GAAACACCGGTGCATTCGAAAGTCCGGTCGTAGTGTGGACGTGGGGTTAG	1	bc
AGAGCTACGT	GAAACACCGGTTACATTGAGTGGGGTTAGAGCTAGAAATAGCAAGTTAAC	1	bc
AACAACGCAA	GAAACACCGGTTTGAACTAGAAATAGCAAGTTAACCTAAGGCTAGTCCGT	1	bc
GGATCATGCC	GAAACACCGGTAAATTTGAGGCTCCGGCATGCAGGAGGCCGTGGGGTTAG	1	bc
GGAGACGTGC	GAAACACCGGTCGGGGGGTTAGAGCTAGAAACAGCGAGTTAACCTAAGGC	1	bc
AAGACGATAC	GAAACACCGGTGCCCTTACTCTCACCTGATTACTTAATCCGTGGGGTTAG	1	bc
CGCGATTTCT	GAAACACCGGTGACGTGGGGTTAGAGCTAGAAATAGCAAGTTAACCTAAG	1	bc
TCTCTTAGAC	GAAACACCGGTAACTATATTCATGCGATATCGCCGTATCAGTGGGGTTAG	1	bc
AACGCCTAAA	GAAACACCGGTACATTTAAGGCCACGTCATTCCTTAATCCGTGGGGTTAG	1	bc
AATGGTTAGC	GAAACACCGGTTTACGTTGCATCGGTGTGGGGTTAGAGCTAGAAATAGCA	1	bc
GGAAGACTTG	GAAACACCGGTGGGGTTAGAGCTAGAAATAGCAAGTTAACCTAAGGCTAG	1	bc
TCATTTACCG	GAAACACCGGTCGGGGCCACTCAGTGGTGGGGTTAGAGCTAGAAATAGCA	1	bc
AGACTCACCC	GAAACACCGGTTTATGCGGAAGTCAGAGCGAAAAGTGGCCAGTTAACTAG	1	bc
ACCTTCGGAC	GAAACACCGGTCGCTTCATATCGAAACCTTCCCGTGACAGGGGGGTTAGA	1	bc
TAAGCCCTTC	GAAACACCGGTGCCCTTACTCTCACCTGATTACTTAATCCGTGGGGTTAG	1	bc
ATAACTGATA	GAAACACCGGTAACTATATTCATGCGATATCGCCGTATCAGTGGGGTTAG	1	bc
GAGAACCGGC	GAAACACCGGTCGGCGGCAATTAGTTAGAGCTAGAAATAGCAAGTTAACC	1	bc
AAGACCCACG	GAAACACCGGTGCATTCGAAAGTCCGGTCGTAGTGTGGACGTGGGGTTAG	1	bc
AGTGTTCGCT	GCCTCCACGGCCACTAGTCTAAGGCTAGTCCGTTATCAACTTGAAAAAGG	1	bc
TGTGTTGTAC	GAAACACCGGTGACATTGGGTGGGGTTAGAGCTAGAAATAGCAAGTTAAC	1	bc
AGACACAGGC	GAAACACCGGTAGCAAGTGCGAGACGTGTTTGTGGGGTTAGAGCTAGAAA	1	bc
CTGCACAGCA	GAAACACCGGTTTACGTTGCATCGGTGTGGGGTTAGAGCTAGAAGTAGCA	1	bc
GGATCCTACT	GAAACACCGGTAAATTTGAGGCTCCGGCATGCAGGAGGCCGTGGGGTTAG	1	bc
AAAGGCATAT	GAAACACCGGTGCCCTTACTCTCACCTGATTACTTAATCCGTGGGGTTAG	1	bc
TAATGTCTAA	GAAACACCGGTAACTATATTCATGCGATATCGCCGTATCAGTGGGGTTAG	1	bc
AGTGGAGGCT	GAAACACCGGTTCCCGTCCAGTGGGGTTAGAGCTAGAAATAGCAAGTTAA	1	bc
CTGAAGACCC	GAAACACCGGTGCTAGAAATAGCAAGTTAACCTAAGGCTAGTCCGTTATC	1	bc
ATTGTGCATA	GAAACACCGGTTAAGCCGAGTGGGGTTAGAGCTAGAAATAGCAAGTTAAC	1	bc
ACAGAACGCA	GAAACACCGGTTTGAACTAGAAATAGCAAGTTAACCTAAGGCTAGTCCGT	1	bc
GCGATAGCGG	GAAACACCGGTTATATTTGTAAGTGTTTGTGGGGTTAGAGCTAGAAATAG	1	bc
CTACCCTTAA	GAAACACCGGTGTGGCTGAGAGTCCGGCAATGGTGTGGCTGTGGGGTTAG	1	bc
TCCTCGTCGT	GAAACACCGGTGTACGTATGGACTGAACCAGGGTGTGCAAGTGGGGTTAG	1	bc
TATAATCCTT	GAAACACCGGTTAAGCCGAGTGGGGTTAGAGCTAGAAATAGCAAGTTAAC	1	bc
GGAGTCCGGC	GAAACACCGGTCGGCGGCAATCGTGGGTGGGGTTAGAGCTAGAAATAGCA	1	bc
AACAAGGCAC	GCTAGAAATAGCAAGTTAACCTAAGGCTAGTCCGTTATCAACTTGAAAAA	1	bc
TATTGTCCGC	GAAACACCGGTCGGGGCCACTCAGTGGTGGGGTTAGAGCTAGAAATAGCA	1	bc
AAGACCATAG	GAAACACCGGTGCATTCGAAAGTCCGGTCGTAGTGTGGACGTGGGGTTAG	1	bc
GTCCTCGCGC	GAAACACCGGTGTGGCTGGGAGTCCGGCAATGGTGTGGCTGTGGGGTTAG	1	bc
GAACTACTTT	GAAACACCGGTCTCGAGTGAGGTGTTCAGGGTGGGGTTAGAGCTAGAAAT	1	bc
GACATAGATT	GAAACACCGGTAGCAAAGTGGGGTTAGAGCTAGAAATAGCAAGTTAACCT	1	bc
ACGTGTTGGC	GAAACAAGGCTAGTCCGTTATCAACTTGAAAAAGTGGCACCGAGTCGGTG	1	bc
ACGCATCCTT	GAAACACCGGTCTTGAAAAAGTGGCACCGAGTCGGTGCTTTTTTTCCTGC	1	bc
AGGCCCATAC	GAAACACCGGTAAATTTGAGGCTCCGGCATGCAGGAGGCCGTGGGGTTAG	1	bc
AAAGAGGCCC	GAAACACCGGTTTGAACTACCTAGTTCAAACCGGTGGGGTTAGAGCTAGG	1	bc
GGAATCAATT	GAAACACCGGTCTCGAGTGAGGTGTTCAGGGTGGGGTTAGAGCTAGAAAT	1	bc
ACCTATGGTT	GACTAGTCCGTTATCAACTTGAAAAAGTGGCACCGAGTCGGTGCTTTTTT	1	bc
TTGCGGCTCA	GAAACACCGGTTAAGCCGAGTGGGGTTAGAGCTAGAAATAGCAAGTTAAC	1	bc
AAAGCGTCGT	GAAACACCGGTGTACGTATGGACTGAACCAGGGTGTGCAAGTGGGGTTAG	1	bc
GGACGCTCAA	GAAACACCGGTAAATTTGAGGCTCCGGCATGCAGGAGGCCGTGGGGTTAG	1	bc
TAGTCTGCCA	GAAACACCGGTCCGTAGGAGACCCGTGTGGCATGTACCTGTGGGGTTAGA	1	bc
GTAACACCTT	GAAACACCGGTGTCGTTAGAGCTAGAAATAGCAAGCTAAGCTAAAGCTAG	1	bc
GAGGAACGGC	GAAACACCGGTCGGCGGCAATCGTGGGTGGGGTTAGAGCTAGAAATAGCA	1	bc
GTCTATTGAG	GAAACACCGGTGGGGTTAGAGCTAGAAATAGCAAGTTAACCTAAGGCTAG	1	bc
CTGAGTACAA	GAAACACCGGTTAAGCCGAGTGGGGTCAGAGCTAGAAATAGCAAGTTAAC	1	bc
GAACAACGCC	GAAACACCGGTTTGAACTACCTAGTTCAAACCGGTGGGGTTAGAGCTAGA	1	bc
AAGTATGCCT	GAAACACCGGTCCGTAGGAGACCCGTGTGGCATGTACCTGTGGGGTTAGA	1	bc
TTGAGCCTCC	GAAACACCGGTTAAGCCGAGGAGTTAGAGCTAGAAATAGCAAGTTAACCT	1	bc
TTCGCTGTGC	GAAACACCGGTTACATTGAGGGGTTAGAGCTAGAAATAGCAAGTTAACCT	1	bc
GAGTCGGGTA	GAAACACCGGTTCCCGTACAGTGGGGTTAGAGCTAGAAATAGCAAGTTAA	1	bc
TCGCCCTGGA	GAAACACCGGTGCATTCGAAAGTCCGGTCGTAGTGTGGACGTGGGGTTAG	1	bc
GAAGAAGCGG	GAAACACCGGTCGGCGGCCGGTTAGAGCTAGAAATAGCAAGTTAACCTAA	1	bc
AAGAGCATAT	GAAACACCGGTTAAGCAGAGGGGTTAGAGCTAGAAATAGCAAGTTAACCT	1	bc
AGATACAGAT	GAAACACCGGTAGCAAGTGCGGGGTTAGAGCTAGAAATAGCAAGTTAACC	1	bc
CTTCTCGCGG	GAAACACCGGTTATATTTGTAAGTGTGTGGGGTTAGAGCTAGAAATAGCA	1	bc
ACGTGTTGTA	GAAACATCGGTGAGTGGGGTTAGAGCTAGAAATAGCAAGTTAACCTAAGG	1	bc
AGTCGCCCCT	GAAACACCGGTCCGTAGCCGACCCGGGTGGCATGTACCTGTGGGGTTAGA	1	bc
GCCGCCATAC	GAAACACCGGTGCCCTTACTCTCACCTGAGTACTTAATCCGTGGGGTTAG	1	bc
TCATACGGGT	GAAACACCGGTCAATAACTATTCAAAGTTTCGCTAGACCTAGAAATTGCA	1	bc
AGATTTGTCT	GAAACACCGGTGACATTGGGTACGAGCTAGAAATAGCAAGTTAACCTAAG	1	bc
GAGACAGAAC	GAAACACCGGTAGCAAGTGCGGGGTTAGAGCTAGAAATAGCAAGTTAACC	1	bc
ACGAAGCCTT	GAAACACCGGTCTCGAGTGAGGTGTTCAGGGTGGGGTTAGAGCTAGAAAT	1	bc
GGGTTACAGG	GAAACACCGGTTGGGGCAACTCAGTGGGGTTAGATCTAGAAATAGCAAGT	1	bc
GAGACGGGCC	GAAACACCGGTAGCAAGTGCGAGACGTGTTTGTGGGGTTAGAGCTAGAAC	1	bc
ATCTTAGGTC	GAAACACCGGTCGTGTCATATCGGTACGTTGTCATAGCTAGGAAGAGCGA	1	bc
CGGCTGAGCT	GAAACACCGGTTTACGTTGCATCGGTGTGGGGTTAGAGCTAGAAATAGCA	1	bc
CGAGCGATGT	GAAACACCGGATTGGGGTTAGAGCTAGAAATAGCAAGTTAACCTAAGGCT	1	bc
ATGGCACTAC	GAAACACCGGTGCCCTTACTCTCACCTGATTACTTAATCCGTGGGGTTAG	1	bc
CCAAACGCCA	GAAACACCGGTTTGAACTACCTAGTTCAAGCCGGTGGGGGTAGAGGTAGT	1	bc
CACGCATTAC	GAAACACCGGTGCCCTTACTCTCACCTGATTACTTAATCCGTGGGGTTAG	1	bc
ATACTAGGCT	GAAACACCGGTACCTTTGTTGATGCTGGGTGGAAGTAGAAATAGCAAGTT	1	bc
TCGCATCCTT	GAAACACCGGTCTCGAGTGAGGTGTTCAGGGTGGGGTCAGAGCTAGAAAT	1	bc
GATAGAGTGG	GAAACACCGGTTATATTTGTAAGTGTTGTGGGGTTAGAGCTAGAAATAGC	1	bc
GCGACGCTCG	GAAACACCGGTGCATTCGAAAGTCCGGTCGTAGTGTGGACGTGGGGTTAG	1	bc
GGGACACTAC	GAAACACCGGTGTGGCTGAGAGTCCGGCAATGGTGTGGCTGTGGGGTTAG	1	bc
ATGGGCATAC	GAAACACCGGTTACGCCACGGGGATAGAGCTAGAAATAGCAAGTTAACAT	1	bc
CACAAAGTAC	GAAACACCGGTTTGAACTACCTAGTTCAAACCGGTGAGGTTAGAGCTAGA	1	bc
AATAGTGTTC	GAAACACCGGTGTACGTATGGACTGAGCCAGGGAGTGCAAGTGGGGTTAG	1	bc
GCTACTCTGC	GAAACACCGGTACCTTTGTTGATGCTGGGTGGAAGGAAGGTGGGGTTAGA	1	bc
AAGTTACCGC	GAAACACCGGTCGGAGCCACTCAGTGGTGGGGTTAGAGCTAGAAATAGCA	1	bc
TAACGCCTTA	GAAACACCGGTGCCCTTACTCTCACCTGATTACTTAATCCGTGGGGTTAG	1	bc
AAGTCACTAC	GAAACACCGGTGCCGTTACTCCGGCGTGGGGATAGAGTCAGAAGTAGTAA	1	bc
CTTCTCGACT	GAGACACCGGTACCTTTGTTGATGCTGGGTGGAAGGAAGGTGGGGTTAGA	1	bc
TAAGCTCTAC	GAAACACCGGTTACATTTGAGTGATAGAGCTAGAAATAGCAAGTTAACCT	1	bc
ATGCGTCTCT	GAAACACCGGTTAGAAATAGCAAGTTAACCTAAGGCTAGTCCGTTATCAA	1	bc
GGAGCGTGGT	GGAACACCGGTGTACGTATGGACTGAACCAGGGTGTGCAAGTGGGGTTAG	1	bc
ACGAATACTT	GAAACACCGGTCTCGAGTGAGGTGTTCAGGGGTGGGGTTAGAGCTAGAAA	1	bc
CACCACACGC	GAAACACCGGTTTGAACTACCTAGTTCAAACCGGTGGTGTTAGAACTAGA	1	bc
TGACAAAGAC	GAAACACCGGTAGCAAGTGCGAGACGTGGGGTTAGAGCTAGAAATAGCAA	1	bc
AGTGCATGCT	GAAACACCGGTGACATTGGGTACAGGGTGGGGTTAGAGCTAGAAATAGCA	1	bc
AGCGACCTCC	GAAACACCGGTGTGGCTGAGAGTCCGGCAATGGTGTGGCTGTGGGGTTAG	1	bc
CCATTAGCTC	GAAACACCGGTCGGGGCCACTCAGTGGTGGGGTTAGAGCTAGAAATAGCA	1	bc
AGGAATCCTT	GAAACACCGGTCTCGAGTGAGGTGTTCAGGTGGGGTTAGAGCTAGAAATA	1	bc
CCACGACGTC	GAAACACCGGTGTACGTATGGACTGAACCAGGGCGTGCAAGTGGGGTTAG	1	bc
CTACGCCACG	GAAACACCGGTACCTTTGGTGATTCTGGGGGGATGGAGTTTTGTGGGGTT	1	bc
AGTAGCCCTT	GAAACACCGGTCTCGAGTGAGGGGTTCAGGTTGTGGGGTTAGAGCTAGAA	1	bc
AATTTATCGC	GAAACACCGGTCGGGGCCACTCAGTGGTGGGGTTAGAGCTAGAAATAGCA	1	bc
TTCGCTCTTA	GAAACACCGGTTACATTGAGATCTCTTTTGTGGGGTTAGAGCTAGAAATA	1	bc
TCTATTGCGT	GAAACACCGGTTATATTTGTAAGTGTTGTGGGGTTAGAGCTAGAAATAGC	1	bc
GCAGAACAGC	GAAACACCGGTCGGCGGCAATCTAGGGTTAGAGCTAGAAATAGCAAGTTA	1	bc
AAGACCCTAG	GAAACACCGGTGCATTCGAAAGTCCGGTCGTAGTGTGGACGTGGGGTTAG	1	bc
ACCCTTACCG	GAAACACCGGTCGGGGCCACTCAGTGGTGGGGTTAGAGCTAGAAATAGCA	1	bc
ATACTTAGAC	GAAACACCGGTTTACGTTGCATCGGTGTGGGGTTAGAGCTAGAAATAGCA	1	bc
GAGGATACGT	GAAACACCGGTCGGCGGCGGTGGGGTTAGAGCTAGAAATAGCAAGTTAAC	1	bc
TCGAGGTGTA	GGTGGGGCTAGAGCTAGAAATAGCAAGTTAACCTAAGGCTAGTCCGTTAT	1	bc
CATCGGCACA	GAAACACCGGTTAATTTGAGGCTCCGGTGTGCTTAAAGCTAGAAATATCA	1	bc
AGACACCCTC	GAAACACCGGTGTGGCTGAGAGTCCGGCAATGGTGTGGCTGTGGGGTTAG	1	bc
AACGATCTAA	GAAACACCGGTGCCCTTACTCTCACCTGATTACTTAATCCGTGGGGTTAG	1	bc
ATTCTCTATT	GAAACACCGGTTACATTGAGGGTTAGAGCTAGAAATAGCAAGTTAACCTA	1	bc
CTCACTGCCG	GAAACACCGGTGTGGCTGAGAGTCCGGCAATGGTGTGGCTGTGGGGTTAG	1	bc
ACCGTCATTT	GAAACACCGGTGCCCTTATGCACACCTGTTTACGTGATACAGCGAGGTAG	1	bc
GTGCGTCGTC	GAAACACCGGTGTACGTATGGACTGAACCAGGGTGTGCAAGTGGGGTTAG	1	bc
ACACAATGCC	GCTAGAAATAGCAAGTTAACCTAAGGCTAGTCCGTTATCAACTTGAAAAA	1	bc
GTAGCTTATA	GAAACACCGGTAACTATATTCATGCGATATCGCCGTATCAGTGGGGTTAG	1	bc
TAGGCCCGAC	GAAACACCGGTGCCTTTACCCTCCTCTGATTACTTAATCGGGCTGGAAAT	1	bc
TGGCGCATCA	GAAACACCGGTTAAGCCGAGTGGGGTTAGAGCTAGAAATAGCAAGTTAAC	1	bc
GTACCAATCA	GAAACACCGGTAGCAAGTGCGAGACGTGTTAAATAGCAAGTTAACCTAAG	1	bc
TAAGCTATTC	ATTGGGGTTAGAGCTAGAAATAGCAAGTTAACCTAAGGCTAGTCCGTTAT	1	bc
GGGACACTAC	GAAACACCGGTGTGGCTGAGAGTCCGGCAATGGTGTGGCTGGGGGGTTAG	1	bc
GGGATAGGCA	GAAACACCGGTAGCAAGTGCGAGACGTTTTTGTGGGGTTAGAGCTAGAAA	1	bc
ACTACGCGGA	GAAACACCGGTACCTTTGTTGATGCTGGGTGGAAGGAATTTTGTGGGGTT	1	bc
GGTGCCTCCC	GAAACACCGGTAAATTTGAGGCTCCGGCATGCAGGAGGCCGTGGGGTTAG	1	bc
TCGCTACCTC	GAAACACCGGTCCGTAGGAGACCCGGGTTGCATGGACCTGTGGGGATAGA	1	bc
AACGTAACCG	GAAACACCGGTCGGGGCCACTCAGTGGTGGGGGTAGAGCTAGAAATAGCA	1	bc
GCAGCGTAGT	GAAACACCGGTGTACGTATGGACTGAACCAGGGTGTGCAAGTGGGTTAGA	1	bc
AACGCAGCAC	GAAACACCGGTGCCCTTACTCTCACCTGATTACTTAATCCGTGGGGTTAG	1	bc
GCATCGTAGT	GAAACACCGGTGTACGTATGGACTGAACCAGGGCGTGCAAGTGGGGTTAG	1	bc
GGAAGAAGCG	GAAACACCGGTCGGCGGCAATAGAAATAGCAGGTTAACCTAAGGCTAGTC	1	bc
ACACTCGACG	GAAACACCGGTACCTTTGTTGATGCTGGGGGGATGGAGTTTGAGGGGTTA	1	bc
GAGTTCTGCC	GAAACACCGGTACCTTTGTTGATGCTGGGTGGGGTTAGAGCTAGAAATAG	1	bc
CGGCGTGGTC	GAAACACTGGTGTACGTATGGACTGAACCAGGGTGTGCAAGTGGGGTTAG	1	bc
TACCATATCC	GAAACACCGGTAACTATATTCATGCGAATAGCAAGTTAACCTAAGGCTAG	1	bc
AATTCTTAGC	GAAACACCGGTTTACGTTGCATCGGTGTGGGGTTAGAGCTAGAAATAGCA	1	bc
AACATCGTCG	GAAACACCGGTGTACGTATGGACTGAACCAGGGTGTGCAAGTGGGGTTAG	1	bc
ACACCTTTGT	GAAACACCGGTTTCAGTGTGGGGTTAGAGCTAGAAATAGCAAGTTAACCT	1	bc
TATTGACGGC	GAAACACCGGTGGACGCATGGACTGAAACAGAGTGTGCAGGTGGGGTTAG	1	bc
GGTACTATCC	GAAACACCGGTGTGGCTGAGAGTCCGGCAATGGTGTGGCTATGGGGTTAG	1	bc
AATACTCGGT	GAAACACCGGTACCTTTGTTGATGCTGGGTGGAAGGAATGGTGGGGTTAG	1	bc
GCACACCGCC	GCTAGAAATAGCAAGTTAACCTAAGGCTAGTCCGTTATCAACTTGAAAAA	1	bc
CTGATCGCTC	GAAACACCGGTTTGCACTAGAAATAGCTAGTTAGCCTAATGCTAGGCCAG	1	bc
AGAAGGCGCG	GAAACACCGGTCGGCGGCAATCGTGGGGTGGGGTTAGAGCTAGAAATAGC	1	bc
GCATTCGGCA	GAAACACCGGTCGCTTCAGCGCGACGTCTTTGTGGGGCTAGAGCTAGAAA	1	bc
GAGCGCATAA	GAAACACCGGTTAAGCCGAGGAGTTAGAGCTAGAAATTACAAGTTGACAT	1	bc
ACAGACGGTC	GAAACACCGGTCGATTCATATCGAAACCTTCCCGTGACAGAGGGGTTAGA	1	bc
GGCCCTTAAC	GAAACACCGGTAATTTGAGGCTCCGGCATGCAGGAGGCCGTGGGGTTAGA	1	bc
AAACCCCGAG	GAAACACCGGTGCCCTTCCTCTCACCTGATTACTTAATCCGTGAGGATAG	1	bc
TTGTGCAGAG	GAAACACCGGTTAAGCCGAGGTGGGGTTAGAGCTAGAAATAGCAAGTTAA	1	bc
CTCCCCGTCA	GAAACACCGGTGTGGCTGAGAGTCCGGCAATGGTGTGGCTGTGGGGTTAG	1	bc
TACGCCGCCT	GAAACACCGGTTTGAACTAGAAATAGCAAGTTAACCTAAGGCTAGTCCGT	1	bc
GGGCGCCTCC	GAAACACCGGTAAATTTGAGGCTCCGGCATGCAGGAGGCGTGGGGTTAGA	1	bc
AGGAACCATC	GAAACACCGGTGTGGCTGAGAGTCCGGCAATGGTGTGGCTGTGGGGTTAG	1	bc
GGGAACCTTC	GAAACACCGGTGTGGCTGAGAGTCCGGCAATGGTGTGGCTGTGGGGTTAG	1	bc
ACACGACGCG	GAAACACCGGTTTGAACTACCTAGAAATAGCAAGTTAACCTAAGGCTAGT	1	bc
ACGGGTTGTA	GAAACACCGGTGACATTGGGGAAAATAGCAAGTTAACCTAAGGCTAGTCC	1	bc
ATGAGCATTC	GAAACACCGGTTAAGCCGAGGAGTTAGAGCTAGAAATAGCAAGTTAACCT	1	bc
GGTTTACTCC	GAAACACCGGTCTGGGCCACTCAGTGGCGGGGTTAGAGCTAGAAATAGCA	1	bc
AAACGCCATA	GAAACACCGGTGCCCTTACTCTCACCTGATTACTTAATCCGTGGGGTTAG	1	bc
AGGCAAGCGC	GAAACACCGGTGCATTCGAAAGTCCGGTCGTAGTGTGGACGTGGGGTTAG	1	bc
GATAGCGGCC	GAAACACCGGTGTGGCTGAGAGTCCGGCAATGGTGTGGCTGAGGGGTTAG	1	bc
CGGGCTGGCT	GAAACACCGGTGACATTGGGTACTAGAAATAGCAAGTTAACCTAAGGCTA	1	bc
AAAAATAGGC	GAAACACCGGTACCTTTGTTGATGCTGGGTGCTTTTTTTCCTGCAGGGGC	1	bc
ATAACCTATA	GAAACACCGGTAACTATATTCATGCGATATCGCCGTATCAGTGGGGTTAG	1	bc
ACCCGACCGC	GAAACACCGGTGCATTCGAAAGTCCGGTCGTAGTGTGGACGTGGGGTTAG	1	bc
TAGCTTTGTC	GAAACACCGGTTACATTGAGGGTTAGAGCTAGAAATAGCAAGTTAACCTA	1	bc
TTAATCCGTT	GAAACACCGGTCGATTCATGACGAACCCGTCCCGTGACAGTGGGGTTAGA	1	bc
ATAATACTTT	GAAACACCGGTCTCGAGTGAGGTGTTCAGGGTGGGGTTAGAGCTAGAAAT	1	bc
AGTCTGCACA	GAAACACCGGTCCGTAGGAGACCCGTGTGGCATGTACCTGTGGGGTTAGA	1	bc
ATACACGGTC	GAAACACCGGTACCTTTGTTGATGCTGGGTGGGGTTAGAGCTAGAAATAG	1	bc
AGAAGGCCTC	GAAACACCGGTCCGTAGGAGACCCGTGTGGCATGTACCTGTGGGGTTAGA	1	bc
AGAGGAGCGC	GAAACACCGGTGCATTCGAAAGTCCGGTCGTAGTGTGGACGTGGGGTTAG	1	bc
CCAACACTCG	GAAACACCGGTGGGGATAAGATTCGGGGAGTGGGGTGAGTGCGAGGTTTA	1	bc
ACTCGTAGTC	GAAACACCGGTGTACGTATGGACTGAACCAGGGTGTGCAAGTGGGGTTAG	1	bc
GCCTTGACCG	GAAACACCGGTCGGGGCCACTCAGTGGTGGGGTTAGAGCTAGAAATAGCA	1	bc
CACACTGTGT	GCTAGAAATACCAAGTTATCCTGAGGCTAGTCCGTTATCAACTTGAAAAA	1	bc
CGGGTGCTCT	GAAACACCGGTTCCCGTCCAGGGGGGTTAGAGCTAGAAATAGCAAGTTAA	1	bc
GCCTCACCGC	GAAACACCGGTGTGGCTGAGAGTCCGGCAATGGTGTGGCTGTTGGGATAG	1	bc
GAATTAGGTA	GAAACACCGGTCGATTGATATCGAAACCTTCCCGTGACAGTGGGGTTAGA	1	bc
GACACCAACC	GAAACACCGGTAGCAAGTGCGAGACGTGTTTGTGGGGTTAGAGCTAGAAA	1	bc
GTCGCTACGT	GAAACACCGGTTACGTTGCGGCTAGAGCTAGAAATAGCAAGTTAACCTAA	1	bc
GCCTGACGGT	GAAACACCGGTCGGGGCCACACTGTGGTGGGGTTAGAGCTAGAAATAGCA	1	bc
AAGTGATGCC	GAAACACCGGTTCCCGTCCAGTGGGGTTAGAGCTAGAAATAGCAAGTTAA	1	bc
AGGCACCCTG	GAAACACCGGTGTGGCTGAGAGTCCGGCAATGGTGTGGCTGTGGGGTTAG	1	bc
ACTTAACAGG	GGAACACCGGTCGGGGCCACTCAGTGGTTTGGTTAGAGCTTGAAATAGAA	1	bc
GGAGCCTATA	GAAACACCGGTAAATTTGAGGCTCCGGCATGCAGGAGGCCGTGGGGTTAG	1	bc
ATTAGATATG	GAAACACCGGTTACATCTCTGAGGGTTAGAGCTAGAAATAGCAAGTTAAC	1	bc
GTGGTCTCGC	GAAACACCGGTCGGTGGCGGTGGGGAGAGAGCTAGAAATAGCAAGTTAAA	1	bc
CAATTACCAC	GAAACACCGGTCGGGGCCACTCAGTGGTGGGGTTAGAGCTAGAAATAGCA	1	bc
AGGCCCACGA	GAAACACCGGTGCATTCGAAAGACCGGTCGTTGTATGGACGGGGGGATAG	1	bc
TAACTGCAAC	GAAAAACCGGTAACTATATTCATGCGATATCGCCGTATCAGTGGGGTTAG	1	bc
CGCGGTTCCC	GAAACACCGGTGACATTGAGTACAGGGGGTGGGGTTAGAGCTAGAAATAG	1	bc
AAACTTAGAT	GAAACACCGGCAACTATATTCATGCGATATCGCGGTATCGGTGGGGTTAG	1	bc
AGAAACGCGC	GAAACACCGGTGCATTCGACAGAGCGGTAGTAGTGTGGACGAGAGGTTAG	1	bc
AGCATCCATT	GAAACACCGGTCTCGAGTGAGGTGTTCAGGGTGGGGTTAGAGCTAGAAAT	1	bc
ATAAGCGAAC	GAAACACCGGTGCATTCGAAAGTCCGGTCGTAGTGTGGACGTGGGGTTAG	1	bc
ATGAGTAGTA	GAAAACCCGGTTTACGTTGCATCGGTGTGGGGTTAGAGCTAGAATTAGCA	1	bc
GGTGGTGTAG	GAAACACCGGTGACATTGGGTCAGGGGTTAGAGCTAGAAATAGCAAGTTA	1	bc
GGAACAGATA	GAGACACCGGTAGCAAGTGCGTGGGGTTAGAGCTAGAAATAGCAAGTTAA	1	bc
CGTCTGGATC	GAAACACCGGTACGAAGAAGACACGTGTGGCATGTACTTGTGGGGGTAAA	1	bc
AAGGTCTTAA	GAAACACCGGTGCCCTTACTCTCACCTGATTACTTAATCCGTGGGGTTAG	1	bc
TGTGTTATTT	GAAACACCGGTGACATTGGGTACAGGGGGGTGGTTAGGTCTAGAAATAGC	1	bc
ACATCGTCGG	GAAACACCGGTGTACGTATGGACTGAACCAGGGTGTGCAAGTGGGGTTAG	1	bc
TGGCACAGAC	GAAACACCGGTAGCAAGTGCGAGAGAAGTAGCAAGTTAACCTAAGGCTAG	1	bc
ACGTTACCGT	GAAACACCGGTCGGGGCCACTCAGTGGTGGGGTTAGAGCTAGAAATAGCA	1	bc
AAACGGCGAT	GAAACACCGGTAACTATATTCATGCGATATCGCCGTATCAGTGGATACAG	1	bc
GTGGATGCGC	GAAACACCGGTTCCCGTCCAGTGGGGTTAGAGCTAGAAATAGCAAGTTAA	1	bc
CGCAACGAGC	GAAACACCGGTTTGAACTAGAAATAGCAAGTTAACCTAAGGCTAGTCCGT	1	bc
AGGCGCTCGA	GAAACACCGGTGCATTCGAAAGTCCGGTCGTAGTGTGGACGTGGGGTTAG	1	bc
CTGCACATAA	GAAACACCGGTTAAGCCGAGTGGGGTTAGAGCTAGAAATAGCAAGTTAAC	1	bc
AGAAGCCCAA	GAAACACCGGTCTCGAGTGAGGTGTTCAGGTGGGGTTAGAGCTAGAAATA	1	bc
GGAACGGCCC	GAAACACCGGTGTGGCTGAGAGTCCGGCAATGGTGTGGCTGTGGGGGTAC	1	bc
ATGTTGAGTT	GAAACACCGGTTTACGTTGCATCGGTGTGGGGTTAGAGCTAGAAATAGCA	1	bc
ACGAACCCCT	GAAACACCGGTCTCGAGTGAGGTATTCAGGGTGGGGTTAGAGCTAGAAAT	1	bc
CATGAACTGC	GAAACACCGGTCGGCGGCGAGCTAGAAATAGCAAGTTAACCTAAGGCTAG	1	bc
AATCGTGGTA	GAAACACCGGTGTACGTATGGACTGAACCAGGGGGTGCAAAAAGTGGGGT	1	bc
AGAGCAACGA	GAAACACCGGTTATATTGAGGGGGTAGAGCTAGAAATAGCAAGTTAACCT	1	bc
TGAAGACGCG	GAAACACCGGTCGGCGGCGGTGGGGTTAGAGCTAGAAATAGCAAGTTAAC	1	bc
GAAGATCAAC	GAAACACCGGTCGGCGGCCGGCTAGAGCTAGAAATAGCAAGTTAACATAA	1	bc
AAAGCCGTCC	GAAACACCGGTGCCCTTACTCTCACCTGATTACTTAATCCGTGGGGTTAG	1	bc
ACTGGTTAGC	GAAACACCGGTTTACGTTGTATCGGGGTGGGGTTAGGGTTTAAAAAGGCA	1	bc
AAAATTATTC	GAAACACCGGTAACTATATTCATGCGATATCGCCGTATCAGTGGGGTTAG	1	bc
CAACACGCAT	GGAACACCGGTTTGAACTACCTAGAAATAGCAAGTTAACCTAAGGCTAGT	1	bc
GTGGCTACTC	GAAACACCGGGTTACAGCTAGAAATAGCAAGTTAACCTAAAGCTAGTCAG	1	bc
ACGGGACTAA	GAAACACCGGTGCCCTTACTCTCACCTGATTACTTAATCCGTGGGGTTAG	1	bc
TACTCCGACT	GAAACACCGGTGTGGCTGAGAGTCCGGCAATGGTGTGGCTGTGGGGATAG	1	bc
CCACAAGGAC	GAAACACCGGTACCTTTGTTGATGCTGGGTGGAAGGTGGGGTTAGAGCTA	1	bc
CGAAGCGTGT	GAAACACCGGTCTCGAGTGAGGTGTTCAGGGTGGGGTTAGAGCTAGAAAT	1	bc
AGACACAGAT	GAAACACCGGTAGCAAGTGCGAGACGTGTTTGTGGGGTTAGAGCTAGAAA	1	bc
AGCAGCCTTT	GAAACACCGGTCTCGAGCGAGGTGTTCGGGGTGGGGTTAGAGCTAGAAAT	1	bc
GAGAAGCATC	GAAACACCGGTTCCCGTCCAGTGGGGTTAGTGCTAGAAATAGCAAGTTAA	1	bc
CGGCTGTCTC	GAAACACCGGTCCGTAGGAGACCCGTGTGGCATGTACCTGTGGGGTTAGA	1	bc
AAAAAAAGCC	GAAACACCGGTTTGAACTACCTAGTTCAAACCGGTGGGGTTAGAGCTAGA	1	bc
ATGCTTATAC	GAAACACCGGTAACTATATTCATGCGATATCGCCGTATCAGGGGGGATAA	1	bc
TACAGCATAC	GAAACACCGGTTACGTCACGTGCACCTGATTATTTAATTAGCGGGGTTAG	1	bc
GACAACAACC	GAAACACCGGTTTGAACTACCTAGTTCAAACCGGTGGGGTTAGAGCTAGA	1	bc
ACATTTACAA	GAAACACCGGTCGGGGCCACTCAGTGGTGGGGTTAGAGCTAGAAATAGCA	1	bc
AAGAAATTAT	GAAACACCGGTAACTATGTTCATGCGATATCGCCGTATCAGTGGGGTTAG	1	bc
AATCACTGTA	GAAACACCGGTGCCCTTACTCTCACCTGATTACTTAATCCGTGGGGATAG	1	bc
ACCTTTATCG	GAAACACCGGTCGGGGCCTGGGGTTAGAGCTAGAAATAGCAAGTTAACCT	1	bc
CATATACCTC	GAAACACCGGTTTGAGCTACTTAGTTGAAACCGTGGGGTTAGAGCTAGAA	1	bc
GACATCCCGC	GAAACACCGGTGGGGTTAGAGCTAGAAATAGCAAGTTAACCTAAGGCTAG	1	bc
GGAAGAGGTT	GAAACACCGGTCGATTCATATCGAAACCTTCCCGTGACAGTGGGGGTAGA	1	bc
TCGTTACCGA	GAAACACCGGTCGGGGCCACTCAGTGGTGGGGTTAGAGCTAGAAATAGCA	1	bc
AATGAATAGA	GAAACACCGGTTTACGTTGGAAATAGCAAGTTAACCTAAGGCTAGTCCGT	1	bc
AAGAATCCTT	GAAACACCGGTCTCGAGTGAGGTGTTCAGGGGTGGGGTTAGAGCTAGAAA	1	bc
CTGAGCTGAA	GAAACACCGGTTAAGCCGAGGAGTTAGAGCTAGAAATAGCAAGTTAACCT	1	bc
TAGCAATGTC	GAAACACCGGCCGGGGCCACTCAGTGTCGGGTGTAGAGCTAGAAATAGAT	1	bc
CTTGTCGTCC	GAAACACCGGTGACATTGGGTACAGGGTGGGGTTAGAGCTAGAAATAGCA	1	bc
AAGTCGCTAA	GAAACACCGGTCCCATTGCTCTCACCTGATTACTTAATCCGTGGAGATAG	1	bc
AGGATGCCTA	GAAACACCGGTCCGTAGGAGACCCGTGTGGCATGTACCTGTGGGGTTAGA	1	bc
CGAACCTCCC	GAAACACGGGTTAATGCGAGAAATAGCAAGTTAACCTAAGGCTAGGCCGT	1	bc
ACTTTTCCTC	GAAACACCGGTCGGGGCCACTCAGTGGTGGGGTTAGAGCTAGAAATAGCA	1	bc
TTATCTGGCT	GAAACACCGGTTACATTCAGGGTTAGAGCTAGATATAGCAAGTTAACCTA	1	bc
GAGGAGGATA	GAAACGCCGGTTCCCGTCCAGTGGGGTTAGAGCTAGAAATAGCAAGATAA	1	bc
AGCACCGTAA	GAAACACCGGCGTGGCTGAGAGTCCGGCAATGGTGTGGCTGTGGGGTTAG	1	bc
ACGGGTGCTT	GAAACACCGGTCTCGAGTGAGGTGTTCAGGGGTGGGGTTAGAGCTAGAAA	1	bc
GGCGCCATGC	GAAACACCGGTGTGGCTGAGAGTCCGGCAATGGTGTGGCTGAGGGGATAG	1	bc
GTTACACTCC	GAAACACCGGTGTGGGTGAGGGTCGGGCAATGGCGTGGCTGTGTGGTAAG	1	bc
AGAGACGCGC	GAAACACCGGTGGGGTTAGAGCTAGAAATAGCAAGTTAACCTAAGGCTAG	1	bc
AGTCTGTCCA	GAAACACCGGTCCGTAGGAGACCCGTGTGGCATATGTGGGGTTAGAGCTA	1	bc
TGCAGCGTAC	GAAACACCGGTTAAGCCGAGGGATAAAGCTAGAGATAGCAAGTTAACCTA	1	bc
GGCATACGTC	GAAACACCGGTGTGGCTGAGAGTCCGGCAATGGTGTGGCTGTGGGGTTAG	1	bc
ACTCGACGTT	GAAACACCGGTGTACGTATGGACTGAACCAGGGTGTGCAAGTGGGGATAG	1	bc
AGAAGAACCG	GAAACACCGGTCGGCGGCAATCGTGGGTTGGGGTTAGAGCTAGAAATAGC	1	bc
GTGGGGATAC	GAAACACCGGTTCACGCCCGGAGTTAGTACTAGTAATAGTAACATAACAT	1	bc
ACGATGAGTC	GAAACACCGGTTTACGTTGCATCGGTTGTGGGGTTAGAGCTAGAAATAGC	1	bc
TAGAGTCTCG	GAAACACCGGTGCATTCGAAAGTCCGGTCGTAGTGTGGACGTGGGGTTAG	1	bc
AGACATAGAC	GAAACACCGGTAGCAAGTGCGGGGTTAGAGCTAGAAATAGCAAGTTAACC	1	bc
GAGTACTCGG	GAAACACCGGTACCTTTGTTGATGCTGGGTGGAAGGAATGTGGGGTTAGA	1	bc
TGTGTGCCTT	GAAACACTCGGTGCGTTTTTTCCTGCAGGGAGGCAGACTTAATTCTGGCC	1	bc
AGAGTGCTTC	GAAACACCGGTCTCGAGTGGAGCTAGAAATAGCAAGTTAACCTAAGGCTA	1	bc
ATCAATCGAG	GAAACACCGGTTATATTTGTAAGTGTGTGGGGTTAGAGCTAGAAATAGCA	1	bc
AGATCGTAGT	GAAACACCGGTGTACGTATGGACTGAACCAGGGTGTGCAAGTGGGGTTAG	1	bc
CGTGGTGGCC	GAAACACCGGTGACATTGGGTACAGGGGAGGGGTTACAGCTAGAAATAGC	1	bc
CACTCAGAAA	GAAACACCGGTAGCAAGTGGGGTTAGAGCTAGAAATAGCAAGTTATCCTA	1	bc
ATACCAGACC	GAAACACCGGTACCTTGTGGGGTTAGAGCTAGAAATAGCAAGTTAACCTA	1	bc
CGGCTTCGCT	GAAAAACCGGTTTACGGTGCATCGGTGTGGGGTTAGAGCTAGAAATAGCA	1	bc
ACACGTCTAC	GAAACACCGGTAACTATATTCATGCGATATCGCCGTATCAGTGGGGTTAG	1	bc
TTGCGATGGT	GAAACACCGGTAACTTTGGTGTTGCTGGGTGGAAGGTACCGGTGGGGTTA	1	bc
TGACACCGAC	GAAACACCGGTAGCAAGTGCGAGACGTGTTAAATAGCAAGTTAACCTAAG	1	bc
GGTGGAGACT	GAAACACCGGTTCCCGTCCAGTGGGGTTAGAGCTAGAAATAGCAAGTTAA	1	bc
CCTATCCTGT	GAAACACCGGTCGCGGCCACTCAGTGGAGGGGTTAGAGATAGATATAGCT	1	bc
AAATCGGCCT	GAAACACCGGTCCGTAGGAGACCCGTGTGGCATGTACCTGTGGGGTTAGA	1	bc
TAAGCTACGA	GAAACACCGGTTACATTGAGGGGTTAGAGCTAGAAATAGCAAGTTAACCT	1	bc
TAAATAACAC	GAAACACCGGTAACTATATTCATGCGATATCGCCGTATCAGTGGGGTTAG	1	bc
AAATTGTGGT	GAAACACCGGTCGATTCATATCGAAACCTTCCCGTGACAGTGGGGTTAGA	1	bc
CGTGATGGCC	GAAACACCGGTGAGTGGGGTTAGAGCTAGAAATAGCAAGTTAACCTAAGG	1	bc
AATTGACCGC	GAAACACCGGTCGGGGCCACTCAGTGGTGGGGTTAGAACTAGAAATAGCA	1	bc
CTCCAAGGCC	GAAACACCGGTACCTTTGTTGATGCTGGGTGGAAGGAATTTGTGGGGTTA	1	bc
GGCTACATCC	GAAACACCGGTGTGGCTGAGAGTCCGGCAATGTTGTGGCTGTGGGATTAG	1	bc
CTTGTGACTT	GAAACACCGGTCCGTAGGAGACCCGTGTGGCATGTACCTGTGGGGATAGA	1	bc
GCGAATCCTC	GAAACACCGGTTCCCTTCCAGTGGGGGTAGAGCTAGAGATAGCAAGATCA	1	bc
AACGCACTCG	GAAACACCGGTGCCCTTACTCTCACCTGATTACTTAATCCGTGGGGTTAG	1	bc
AACGAAGTAA	GAAACACCGGTGCCCTTACTCTCACCGGGTTACTTGATCCGTGGGGATAG	1	bc
GGCAGTCTCA	GAAACACCGGTGTGGCTGAGAGTCCGGCAATGGTGTGGCTGTGGGGTTAG	1	bc
GCCCGTCGAC	GAAACACCGGTAACTATATTCATGCGATATCGCTGTATCAGTGGGGTTAG	1	bc
TAAGAGATGT	GAAACACCGGTTACATTGAGGGGTTAGAGCTAGAAATAGCAAGTTAACCT	1	bc
GAACAAGCCA	GAAACACCGGTAGCAAGTGCGGGGTTAGAGCTAGAAATAGCAAGTTAACC	1	bc
ATGTATCGGT	GAAACACCGGTTATATTTGAGGGGTTCGGGCTGGGAATAGAACTTTAAAC	1	bc
GCCAGAGACC	GAAACACCGGTAGCAAGTGGGGTTAGAGCTAGAAATAGCAAGTTAACCTA	1	bc
GACGAAACGC	GAAACACCGGTCGGCGGCAATCGTGGGTGGGGTTAGAGCTAGAAATAGCA	1	bc
GCGAACCCTT	GAAACACCGGTCTCGAGTGAGGTGTTCAGGGTGGGGTTAGAGCTAGAAAT	1	bc
GAAGACGCTA	GAAACACCGGTCGGCGGCAATCGTGGGTGGGGTTAGAGCTAGAAATAGCA	1	bc
AGTGCGCATA	GAAACACCGGTTAAGCCGAGGAGTTAGAGCTAGAAATAGCAAGTTAACCT	1	bc
AATGGTTAGT	GAAACACCGGTTTACGTTGCATCGGGGTGGGGTTAGAGCTAGAAATAGCA	1	bc
CATTGGATAA	GAAACACCGGTTAAGCAGAGTGGGGGTAGAGCTAGAAATAGCAAGTTAAC	1	bc
TCCTCTCGTT	GAAACACCGGTTATATTTGTAAGTGTGTGGGGTTAGAGCTAGAAATAGCA	1	bc
ATATTCTCGC	GGAACACCGGTGCATTCGAAAGTCCGGGCGTAGAGCTGACATTGGGTTAG	1	bc
ACGTGTTGCA	GAAACACCGGTGACATGGTGGGGTTAGAGCTAGAAATAGCAAGTTAACCT	1	bc
ATTTACCGCC	GAAACACCGGTCGGGGCCACTCAGTGGTGGGGTTAGAGCTAGAAATAGCA	1	bc
AGAAGACACG	GAAACACCGGTCGGCGGCAATAGAAATAGCAAGTTAACCTAAGGCTAGTC	1	bc
AACCATGCCC	GAAACACCGGTTTGAACTAGAAATAGCAAGTTAACCTAAGGCTAGTCCGT	1	bc
CTAAGAATAA	GAAACACCGGTTCAGGCAAGCAGGTCGGGCTCGAGATAGTAAGTTGATCT	1	bc
CGTGATGGCA	GAAACACCGGTGACATTGGTGGTGGGGTTAGAGCTAGGAATAGCAAGTTA	1	bc
AAGACCTCCC	GAAACACCGGTTTGAACTACCTAGTTCAAACACCGGTTTGAACTACCTAG	1	bc
CCCAACGTCA	GAAACACGGGTTATAGCTAGAAATAGCAATTTAACCTAAGGCTAGTCCGT	1	bc
AATACTCGGC	GAAACACCGGTACCTTTGTTGATGCTGGGTGGGGTTAGAGCTAGGAATAG	1	bc
ATGCTGACTT	GAAACACCGGTCCGTAGGAGACCCGTGTGGCATGTACCTGTGGGGTTAGA	1	bc
GGAATCGGTT	GAAACACCGGTCTCGAGTGAGGTGTTCAGGGTGGGGTTAGAGCTAGAAAT	1	bc
TCGAGCCTTA	GAAACACCGGTTACGCCGAGGTGGGGTTAGAGCTAGAAATAGCAAGTTAA	1	bc
CGCATCGTTC	GAAACACCGGTCTCGGGTGAGGTGTTCAGGGTGGGGTTAGAGCTAGAAAT	1	bc
AGGGCTGTCT	GAAACACCGGTGACATTGGGTACAGAAATAGCGAGTTAACCTAAGGCTAG	1	bc
ACATCAGCCT	GAAACACCGGTCGATTCATATCGAAACCTTCCCGTGACAGTGGGGTTAGA	1	bc
ACTAATCGGC	GAAACACCGGTACCTTTGTTGATGCTGGGTGGATGGTGGGGTTAGAGCTA	1	bc
ACGAGTCCTT	GAAACACCGGTCTCGAGTGAGGTGTTCAGGGTGGGGTTAGAGCTAGAAAT	1	bc
GGACCCATGA	GAAACACCGGTAAATTTGAGGCTACGGCATGCAGGAGGCCGTGGGGTTAG	1	bc
GGGACGGGGT	GAAACACCGGTGTGGCTGAGAGTCCGGCAATGGTGTGGCTGTGGGGTTAA	1	bc
TAGCGACGTC	GAAACACCGGTGTACGTATGGACTGAACCAGGGTGTGCAAGTGGGGTTAG	1	bc
ATGATAGGCC	GAAACACCGGTACCTTTGTTGATGCTGGGTGGAAGGAATTTTGGGGTTAG	1	bc
ATATCTATTT	GGGTTAGAGCTAGAAATAGCAAGTTAACCTAAGGCTAGTCCGTGATCAAC	1	bc
AATGCCTAGC	GAAACACCGGTTTACGTTGCATCGGTGTGGGGTTAGAGCTAGAAACAGCA	1	bc
CACACTGCAC	GAAACACCGGTTTGCACTGGTGGGGTTAGAGCTAGAAATAGCAAGTTAAA	1	bc
AAACACAGGC	GAAACACCGGTAACTTTGTTGATGGTGGGGGGATGGGTTTGGGGTTAGAG	1	bc
GCGAGTCCTT	GAAACACCGGTCTCGAGTGAGGTGTTCAGGGGTGGGGTTAGAGCTAGAAA	1	bc
GGCACATAAA	GAAACACCGGTAAATTTGAGGCTCCGGCATGCAGGAGGCCGTGGGGTTAG	1	bc
GAGAATCCTT	GAAACACCGGTCTCGAGTGAGGTGTTCAGGGTGGGGTTAGAGCTAGAAAT	1	bc
GAAATCTGAA	GAAACACCGGTAAATTTGAGGCTCCGGCATGCAGGAGGCCGTGGGGTTAG	1	bc
ATAATCGGTC	GAAACACCGGTACCTTTGTTGATGCTGGGTGGAAGGTGGGGTTAGAGCTA	1	bc
ATGCTCGGCA	GAAACACCGGTACCTTTGTTGATGCTGGGTGGAAGGGATAGCAAGGAGGG	1	bc
ACGTGTTGCC	GAAACACCGGTGACATTGGGTACGGGGTTAGAGCTAGAAATAGCAAGTTA	1	bc
AACAATCGGT	GAAACACCGGTCGATTCATATCGAAACCTTCCCGTGACAGTGGGGTTAGA	1	bc
TTCTTTACAG	GAAACACCGGTCGGGGCCACTCAGTGGTGGGGTTAGAGCTAGAAATAGCA	1	bc
AGAGTCAGGC	GAAACACCGGTCCGTAGGAGACCCGTGTGGCATGTACCTGTGGGGTTAGA	1	bc
GAGTGGAGGC	GAAACACCGGTTCCCGTCCAGTGGTGGTGGAGCTAGAAATAGCAAGTTAA	1	bc
GTACTACGCC	GCTAGAAATAGCAAGTTAACCTAAGGCTAGTCCGTTATCAACTTGAAAAA	1	bc
AGAATCATTA	GAAACACCGGTCTCGAGTGAGGTGTTCAGGGTGGGGTTAGAGCTAGAAAT	1	bc
GTCCTTTATC	GAAACACCGGTCGGGGCCACTCAGTGGTGGGGTTAGAGCTAGAAATAGCA	1	bc
ACACAACGAC	GCTAGAAATAGCAAGTTAACCTAAGGCTAGTCCGTTATCAACTTGAAAAA	1	bc
TCCGTGTGTT	GAAACACCGGTGACATTGGGGTTAGAGCTAGAAATAGCAAGTTAACCTAA	1	bc
CCTAACGCGC	GAAACACCGGTTTGAACTGGAAATAGCAAGTTAACCTAAGGCTAGTCCGT	1	bc
CCAATCTTTG	GAAACACCGGTCTCGAGAGAGGTGGTCGGGGGGGGGTTAGGGCTGGAAAT	1	bc
TGCTCCCGCA	GAAACACCGGTAAATTTGAGGCTCCGGCATGCAGGAGGCCGTGGGGTTAG	1	bc
GAACCAGTGG	GAAACACCGGTAGCAAGTGGGGGTAGAGCTAGAAATAGCAAGTTAACCCA	1	bc
TGTGGAGGCT	GAAACACCGGTTCCCGTCCAGTGGGGTTAGAGCTAGAAATAGCAAGTTAA	1	bc
ACTCCCTGTT	GACGGAACCCCGGGTAAATTTTAGGCAGCGATGGGCGGGTTAGAGCGGGA	1	bc
GAGTCAGCCT	GAAACACCGGTCCGTAGGAGACCCGTGTGGCATGTACCTGTGGGGTTAGA	1	bc
GTGCCCGACA	GAAACACCGGTAGCAAGTGCGAGACGTGTTTGTGGGGTTAGAGCTAGAAA	1	bc
ACGAATCATT	GAAACACCGGTCTCGAGTGAGGTGTTCAGGGTGGGGTTAGAGCTAGAAAT	1	bc
TCACACTTGT	GAAACACCGGTTACATTGAGGGTTAGAGCTAGAAATAGCAAGTTAACCTA	1	bc
GATGGATAGC	GAAACACCGGTTTACGTTGCATCGGTGTGGGGTTAGAGCTAGAAATAGCA	1	bc
AAGTCCCTCC	GAAACACCGGTACCCTGACTCTCACCTGATTACTTAATCCGTGGGGATAG	1	bc
CGCGAATTCT	GAAACACCGGTCTCGAGTGAGGTGTTCAGGGGTGGGGTTAGAGCTAGAAA	1	bc
ACATCCGCGC	GAAACACCGGTGCATTCGAAAGTCCGGTCGTAGTGTGGACGTGGGGTTAG	1	bc
GAAGGCCAAC	GAAACACCGGTCGGCGGCAAAATGGGGTTAGAGCTAGAAATAGCAAGTTA	1	bc
TTAACGATGA	GAAACACCGGTTACATTGAGGGGTTAGAGCTAGAAATAGCAAGTTAACCT	1	bc
ACTTCCCTAC	GAAACACCGGTGCCCTTACTCTCACCTGATTACTTAATCCGTGGGGTTAG	1	bc
ACAACGTCGT	GAAACACCGGTGTACGTACGGACTGAACCAGGGTGTGCAAGTGGGGTTAG	1	bc
AACGAATCAT	GAAACACCGGTCTCGAGTGAGGTGTTCAGGGTGGGGTTAGAGCTAGAAAT	1	bc
ACCTTAGATT	GAAACACCGGTCGATTCATATCGAAACCTTCCCGTGGGGTTAGAGCTAGA	1	bc
CCGTTAACAC	GAAACACCGGTCGGGGCCACTCAGTGGTGGGGTTAGAGCTAGAAATAGCA	1	bc
ACGACTCCTT	GAAACACCGGTCTCGAGTGAGGTGTTCAGGGTGGGGTTAGAGCTAGAAAT	1	bc
CGCGATGCCT	GAAACACCGGTGTGAACTACCTAGTGCAAACCGGTGGGGTTAGAGCTAGA	1	bc
GGTATCCCTT	GAAACACCGGTCTCGAGTGAGGTGTTCAGGGTGGGGTTAGAGCTAGAAAT	1	bc
ACTACCGATG	GAAACACCGGTTATATTTGTAAGTGTGTGGGGTTAGAGCTAGAAATAGCA	1	bc
AATGCACCGC	GAAACACCGGTATACAAAGATACGAGTACAAATAGGTTAGTGCTATAAAT	1	bc
CGACTATCCG	GAAACACCGGTCCGTAGGAGACCCGTGTGGCATGGACATGGGGAGTTAGA	1	bc
AGAGACATCA	GAAACACCGGTAGCAAGTGCGAGACGTGTTAAATAGCAAGTTAACCTAAG	1	bc
ACACCACGCC	GCTAGAAATAGCAAGTTAACCTAAGGCTAGTCCGTTATCAACTTGAAAAA	1	bc
ACAGTACTAC	GAAACACCGGTGCCCTTACTCTCACCTCATTACTTAATCCGTGGGGATAG	1	bc
CCATTAGGGC	GAAACACCGGTCGGGGCCACTCAGTGGTGGGGTTAGAGCTAGAAATGGCA	1	bc
ATGACCATAT	GAAACACCGGTTAAGAGCTAGAAATAGCAAGTTAACCTAAGGCTAGTCCG	1	bc
ACGGGTTGTC	GAAACACCGGTGACATTGGGTACAGGGGTGGGGTTAGAGCTAGAAATAGC	1	bc
GACAAAGAAC	GAAACACCGGTAGCAAGTGCGAGCAAGTTAACCTAAGGCTAGTCCGTTAT	1	bc
ATATCGTCGT	GAAATACCGGTGTACGTATGGACTGAACCAGGGTGTGCAAGTGGGGTTAG	1	bc
CAAAGCCCTT	GAAACACCGGTCTCGAGTGAGGTGTTCAGGGGTGGGGTTAGAGCTAGAAA	1	bc
TAAGCTCTTG	GAAACACCGGTTACATTGAGGGGTTAGAGCTAGAAATAGCAAGTTAACCT	1	bc
CCTAAAGCCC	GCTAGAAATAGCAAGTTAACCTAAGGCTAGTCCGTTATCAACTTGAAAAA	1	bc
GATACGCGGC	GAAACACCGGTACCTTTGTGGGGTTAGAGCTAGAAATAGCAAGTTAACCT	1	bc
CACGAATCCT	GAAACACCGGTCTCGAGTGAGGTGTTCAGGTGGGGTTAGAGCTAGAAATA	1	bc
TATAGCACAA	GAAACACCGGTTAAGCCGAGTGGGGTTAGAGCCAGAAATAGCAAGTTAAC	1	bc
AAAAACGGTC	GAAACACCGGTTTGAACTACCTAGAAATAGCAAGTTAACCTAGGGCTAGT	1	bc
TCTACGCGGC	GAAACACCGGTACCTTTGTTGATGCTGGGTGGAAGGAATTCTAGAAATAG	1	bc
AGTGCTGACT	CTAGTCCGTTATCAACTTGAAAGAGTGGCACCGAGTCGGTGCTTTTTTTA	1	bc
TCGAGCACAC	GAAACACCGGTTAAGCCGAGTGGGGTTAGAGCTAGAAATAGCAAGTTAAC	1	bc
AGACTCCGCC	GAAACACCGGTGTGGCTGAGAGTCCGGCAGTGGTGTGGCTGTGGGGTTAG	1	bc
GTAGCGCTCC	GAAACACCGGTTCCCGTCCAGTGGGGTTAGAGCTAGAAATAGCAAGTTAA	1	bc
GTACACAGGG	GAAGCACCGGTACCTTTGTTGATGCTGGGTGGAAGGAGGGGTTAGAGCTA	1	bc
AAATCTGGGT	GAAACACCGGTTACATTGAGGGTTAGAGCTAGAAATAGCAAGTTAACCTA	1	bc
CGCCTTCTTT	GAAACACCGGTCTCGAGTGAGGTGTTCAGGGTGGGGTTAGAGCTAGAAAT	1	bc
TCTACTTGAA	GAAACACCGGTAAATTTGAGGCTCCGGCATGCAGGAGGCCGTGGGGTTAG	1	bc
GTCACAATCA	GAAACACCGGTGTGGCTGAGAGTCCGGCAATGGTGTGGCTGTGGGGTTAG	1	bc
ATTGCGCATA	GAAACACCGGTTAAGCCGAGGAGTTTCGTTAGAGCTAGAAATAGCAAGTT	1	bc
ACATTTCCCG	GAAACACCGGTCGGGGCCACTCAGTGGTGGGGTTAGAGCTAGAAATAGAA	1	bc
AGAAACAGAC	GAAACACCGGTAGCAAGTGCGAGACGTGTTTGTGGGGTTAGAGCTAGAAA	1	bc
CGATGCTTAG	GAAACACCGGTTTACGTTGCATCGGTGTGGGGTTAGAGCTAGAAATAGCA	1	bc
TTGCGCTTAC	GAAACACCGGTTAAGCCGGTGGGGTTAGAGCTAGAAATAGCAAGTTAACC	1	bc
CATCACTCGC	GAAACACCGGTCCGTAGGAGACCCGTGTGGCATGTACCTGTGGGGTTAGA	1	bc
CATTGAGCAT	GAAACACCGGTTAAGCCGAGTGGGGTTAGAGCTAGAAATAGCAAGTTAAC	1	bc
AGTGGAGACT	GAAACACCGGTTCCCGTCCAGTGGGGGTAGAGCTAGAAATAGCAGGTTAA	1	bc
AAACTGACAC	GAAACACCGGTACCTATATTCATGCGATATCGCCGAATCGGTGGGGTTAG	1	bc
CTCGCGATGT	GGAACACCGGTTACATTGAGGGGTTAGAGCTAGAAATAGCAAGTTAACCT	1	bc
ACTGACCTTC	GAAACACCGGTGCCCTTACTCTCACCTGATAACCTGGGGTTAGAGCTAGA	1	bc
AACCTTCGGT	GAAACACCGGTCGATTCATATCGAAACCTTCCCGTGACAGTGGGGTTAGA	1	bc
CGACCCGCCA	GAAACACCGGTAAATCTGTCGCACCGGCATGTAGGGGTACGTGGGGTTAG	1	bc
TTACTTACGC	GAAACACCGGTAACTATATTCATGCGATATCGCCGTATCAGTGGGGTTAG	1	bc
GTGACCTTGC	GAAACACCGGTGTGGCTGAGAGTCCGGCAATGGTGTGGCTGGGGGGATAA	1	bc
ATAACTTATG	GAAACACCGGTTACTATGTTCATGCGATATCGTCGTATCTGTGGGGATAG	1	bc
GCCTTTAGCT	GAAACACCGGTCGGGGCCACTCAGTGGTGGGGTTAGAGCTAGAAATAGCA	1	bc
TATATTGGGG	GAAACACCGGTTATATTTGTAAGTGTTGTGGGGTTAGAGCTAGAAATAGC	1	bc
ATGGAGCGCC	GAAACACCGGTTTACGTTGCATCGGTGTGGGGTTAGAGCTAGAAATAGCA	1	bc
GGCTGCGTCC	GAAACACCGGTGTGGCTGAGAGTCCGGCAATGGTGTGGCTGTGGGGTTAG	1	bc
ATACCCTGTA	GAAACACCGGTGCATTCGAAAGTCCGGTCGTAGTGTGGACGTGGGGTTAG	1	bc
AAACGAGGTC	GAAACACCGGTGTACGTATGGACTGAACCAGGGTGTGCAAGAGGGGTTAG	1	bc
CTAAGCATGA	GAAACACCGGTTAAATTGAGGGTTAGAGCTAGAAATAGCAAGTTAACCTA	1	bc
ATGATATTAA	GAAACACCGGTTAAGCCGAGGATGGGGTTAGAGCTAGAAATAGCAAGTTA	1	bc
GTAGAGGCTA	GAAACACCGGTTCCCGTCCAGTGGGGCTAGTGATAGAATTAGTAAGTTAA	1	bc
AATCGCAGTC	GAAACACCGGTGTACGTATGGACTGAACCAGGGTGTGCAAGTGGGGTTAG	1	bc
AACTTCGCAC	GAAACACCGGTTTGAACTAGAAATAGCAAGTTAACCTAAGGCTAGTCCGT	1	bc
TACAGCGTAC	GAAACACCGGTTAAGGCGAGGAGTTAGAGCTAGAAATAGCAAGTTAACCT	1	bc
AGTGGTGCAT	GAAACACCGGTTCCCGTCCAGTGGGGTTAGAGCTAGAAATAGCAAGTTAA	1	bc
CGGGTTGGTT	GAAACACCGGTGACCATAGGGTTAGAGCTAGAAATAGCAAGTTAACCTAA	1	bc
AGTGCCGTGT	GAAACACCGGTGCCAATTAGAGTTAGAGCTAGGAATAGCAGGGTAACCTA	1	bc
AAAGACATAC	GAAACACCGGTGCCCTTACTCTCACCTGATTACTTAATCCGTGGGGTTAG	1	bc
CAAATCGCAA	GCTAGAAAAAGCAAGTTAACCTAAGGCTAGTCCGTTATCAACTAGAAAAA	1	bc
TTTGTCGGGC	GAAACACCGGTTATATTTGTAAGTGTGTGGGGTTAGAGCTAGAAATAGCA	1	bc
CAACCCCGCG	GAAACACCGGTTTGAACTACCTAGTTCAAACCGGTGGGGTTAGAGCTAGA	1	bc
AAGTGAGCCT	GAAACACCGGTCCGTAGGAGACCCGTGTGGCATGTACCTGTGGGGTTAGA	1	bc
TCTAGCTATC	GAAACACCGGTTATATTTGTAAGTGTTGTGGGGTTAGAGCTAGAAATAGC	1	bc
AGGACCCTAC	GAAACACCGGTAAATTTGAGGCTCCGGCATGCAGGAGGCCGTGGGGTTAG	1	bc
CACGTCCTGC	GAAACACCGGTGCCCTTACTCTCACCTGATTACTTAATCCGTGGGGTTAG	1	bc
ATAATCCCTC	GAAACACCGGTCTCGAGTGAGGTGTTCAGGTGGGGTTAGAGCTAGAAATA	1	bc
ACACTACGCC	GAAACACCGGTTTGAACTACCTAGTTCAAACCGGTGGGGTTAGAGCTAGA	1	bc
AGGCCCGGGC	GAAAAACCGGTGCATTCGAAAGTCCGGTCGTGGTGTGGACGTGGGGTTAG	1	bc
AATTTGCGTC	GAAACACCGGTCCGTAGGAGAACCGTGTGGCATGTACTGGGGTTAGAGCT	1	bc
GACAGCGATA	GAAACACCGGTAGCAAGTGCGAGACGTGTTTGTGGGGTTAGAGCTAGAAA	1	bc
TGAAGCCCCG	GAAACACCGGTCGGCGGCCGGTTAGAGCTAGAAATAGCAAGTTAACCTAA	1	bc
ACGCTGTCTC	GAAACACCGGTCCGTAGGAGACCCGTGTGGCATGTACCTGTGGGGTTAGA	1	bc
CGCGTTGTTC	GAAACACCGGTGATATTGGGTACAGGGGGGTGGGGTTAGAGCTAGAGATA	1	bc
CGATACTCGC	GAAACACCGGTGCATTCGAAAGTCCGGTCGTAGTGTGGACGTGGGGTTAG	1	bc
GACCCCGAAA	GAAACACCGGTAGCAAGTGCGAGACGTGTTTGTGGGGTTAGAGCTAGAAA	1	bc
AAGGCGGTAC	GAAACACCGGTGCCCTTACTCTCACCTGATTACTTAATCCGTGGGGTTAG	1	bc
ACCGCTCTAA	GAAACACCGGTGCCCTTACTCTCACCTGATTACTTAATCCGTGGGGTTAG	1	bc
GCACTTCTAC	GAAACACCGGTAACTATATTCATGCGATATCGCCGTATCAGTGGGGTTAG	1	bc
GCGCGTGGTC	GAAACACCGGTGTACGTATGGACTGAACCAGGGTGTGCAAGTGGGGTTAG	1	bc
GCAGACCCTA	GAAACACCGGTCGGCGGCAATCGTGGGTGGGGTTAGAGCTAGAAATAGCA	1	bc
GTCATCCTAA	GAAACACCGGTGTGGCTGAGAGTCCGGCAATGGTGTGGCTGTGGGGGTAG	1	bc
ATACGAACTT	GAAAAACCGGTCGATTCATAACGAAACCTTCCCGTGACAGTGGGGTTAGA	1	bc
AGGGTTAGCC	GAAACACCGGTTTACGTTGCATCGGTTGTGGGGTTAGAGCTAGAAATAGC	1	bc
ATCGCTCTTC	GAAACACCGGTTCCCTTACTCTCACCTGATTACTTAATCCGTGGGGTTAG	1	bc
TCACTGACAC	GAAACACCGGTAACTATATTCATGCGATATCGCCGTATCAGTGGGGTTAG	1	bc
ACCATAGGTT	GAAACACCGGTCGATTCATATCGAAACCTTCCCGTGACAGTGGGGTTAGA	1	bc
AGTTTGCTGC	GAAACACCGGTCCGTAGGAGACCCGTGCGGCATGGTCCTGTGGGGTTTGG	1	bc
TGGAGCATCC	GAAACACCGGTTAAGCCGAGTGGGGTTAGAGCTAGAAATAGTAAGTTAAC	1	bc
AGACTTATAA	GAAACACCGGTAACTATATTCATGCGATATCGCCGTATCAGTGGGGTTAG	1	bc
GAGAAGCTCG	GAAACACCGGTGCATTCGAAAGTCCGGTCGTAGTGTGGACGTGGGGTTAG	1	bc
ATGTGTATCC	GAAACACCGGTTAAGCCGAGGAGTTAGAGCTAGAAATAGCAAGTTAACCT	1	bc
CTGTGACAGA	GAAACACCGGTCGGGGCCACTCAGTGGTGGGGTTAGAGCGAGAAATAGCT	1	bc
AAGCTTTTCT	GAAACACCGGTTTACGTTGCATCGGGGTTAGAGCTAGTAATAGCAAGTTA	1	bc
ACGAGTCCTT	GAAACGCCGGTCTCGAGTGAGGTGTTCAGGGTGGGGTTAGAGCTAGAAAT	1	bc
CACTTAGCGC	GAAACACCGGTCGGGGCCAGCTAGAAATAGCAAGTTAACCTAAGGCTAGT	1	bc
GACATAGCTC	GAAACACCGGTTTGAACTAGAAATAGCAAGTTAACCTAAGGCTAGTCCGT	1	bc
ACAGCCATAC	GAAACACCGGTGCCCTTACTCTCACCTGATTACTTAATCCGTGGGGTTAG	1	bc
AATGTTTAGT	GAAACACCGGTTTACGTTGCATCGGTTGTGGGGTTAGAGCTAGAAATAGC	1	bc
AATGTTTAGC	GAAACACCGGTTTACGTTGCATCGGTTTGTGGGGTTAGAGCTAGAAATAG	1	bc
GCAACGGATA	GAAACACCGGAGGGGTTAGAGCTAGAGATAGCAAGGTAACCTAAGGCTAG	1	bc
GAAAACGCCA	GGGTTAGAGCTAGAAATAGCAAGTTAACCTAAGGCTAGTCCGTTATCAAC	1	bc
AATTTCCCGT	GAAACACCAGTCGGAGCCACTCAGTGGTGGGGTTAGAGCTAGAAATAGCA	1	bc
ATACTGGGCA	GAAACACCGGTACCTTTGTTGATGCTGGGTGGAAGGAATTTTGTGGGGTT	1	bc
ACGTGTTGAA	GAAACACCGGTGACATTGGGTACAGGGTGGGGTTAGAGCTAGAAATAGCA	1	bc
GGCAACCACA	GAAACACCGGTAAATTTGAGGCTCCGGCATGCAGGAGGCCGTGGGGTTAG	1	bc
AGTGAGCATA	GAAACACCGGTTAAGCCGAGGAGTTAGAGCTAGAAATAGCAAGTTAACCT	1	bc
TACATTCGGC	GAAACACCGGTCGATTCATATCGAAACCTTCCCGTGACAGTGGGGTTAGA	1	bc
AACGTCCATC	GAAACACCGGTTCCCTTACTCTCACCTGATTACTTAATTCGGGGGGTTAG	1	bc
ACACAACGTT	GAAACACCGGTTTGAACTACCTAGTTCAAACCGGTGGGGTTAGAGCTAGA	1	bc
CACACCTCTA	GAAACACCGGTTTGAACTACCTAGTTCAAACCGGTGGGGTTAGAGCTAGA	1	bc
AGTGCGCTTC	GAAACACCGGTTTACGTTGCATCGCCGGGTGGTTAAAGCTAGGAAGAGCA	1	bc
ACATCGTGGT	GAAACACCGGTGTACGTATGGACTGAACCAGGGTGTGCAAGTGGGGCTAG	1	bc
ACTACACGGC	GAAACACCGGTACCTTTGTTGATGCTGGGTGGAAGGATGCTGGGTGGGGT	1	bc
AGTGCAGCCT	GAAACACCGGTCCGTGTGAAGCCCGGGTAGCGTTAGACTGAGGAAGTAGA	1	bc
TCGAAGGCCA	GAAACACCGGTTTGAACTAGAAATAGCAAGTTAACCTAAGGCTAGTCCGT	1	bc
GGGCATAGAC	GAAACACCGGTAGCAAGTGCGAGACGTGTTAAATAGCGAGTTAACCTAAG	1	bc
ACTATCGGGT	GAAACACCGGTCGATTCATATCGAAACCTTCCCGTGACAGTGGGGTTAGA	1	bc
TCACAACGAC	GAAACACCGGTTTGAACGCGGTGGGGTTAGAGCTAGAAATAGCAAGTTAA	1	bc
TAGTTACCGC	GAAACACCGGTCGGGGCCACTCAGTGGTGGGGTTAGAGCTAGAAATAGCA	1	bc
TTGCTTCTAC	GAAACACCGGTAACTATATTCATGCGATATCGCCGTATCAGTGGGGTTAG	1	bc
TACTGTCGAA	GAAACACCGGTAACTATATTCATAAGATATAACCGTTGGGATATAGATAG	1	bc
GAACAACGAC	GAAACACCGGTTTGAACTACCTAGAGCTAGAAATAGCAAGTTAACCTAAG	1	bc
TTATATCGAG	GAAACACCGGTTATATTTGTAAGTGTGTGGGGTTAGAGCTAGAAATAGCA	1	bc
CATAGTAGTA	GAAACACCGGTGTACGTATGGACTGAACCAGGGTGTGCAAGTGGGGTTAG	1	bc
GAAATCGAGC	GAAACACCGGTCGGCGGCAATCGTGGGTGGGGTTAGAGCTAGAAATAGCA	1	bc
TCACATATCC	GAAACACCGGTAACTATATTCATGCGATATCGCCGTATCAGTGGGGTTAG	1	bc
TCTATCTATT	GAAACACCGGTTATATTTGTAGGGGTTAGAGCTAGAATTAGCAAGGTAAT	1	bc
TAACAATGCC	GAAACACCGGTTTGAACTACCTAGTTCAAACCGGTGGGGTTAGAGCTAGA	1	bc
GCAGAGGCGC	GAAACACCGGTCGGCGGCAATCGTGGGTGGGGTTAGAGCTAGAAATAGCA	1	bc
TTGTGGTGTC	GAAGCACCGGTGACATTGGGTAGGGGTTAGAGCTAGAAATAGCAAGTTAA	1	bc
AATTTCGGAT	GAAACACCGGTCGATTCATATCGAAACCTTCCCGTGACAGTGGGGTTAGA	1	bc
GAGGAGACTG	GAAACACCGGTTCCCGTCCAGTGGGGTTAGAGCTAGAAATAGCACGTTAA	1	bc
TATGCATAGC	GAAACACCGGTTTACGTTGTATCGGGGTTAGAGCTAGAAATAGCAAGTTA	1	bc
CCTTGACGTC	GAAACACCGGTGTACGTATGGACTGAACCAGGGTGTGCAAGTGGGGTTAG	1	bc
GGGACTGCCT	GAAACACCGGTCCGTAGGAGACCCGTGTGGCATGTACCTGTGGGGTTAGA	1	bc
AGAAACCGTT	GAAACACCGGTCTCGAGTGAGGTGTTCAGGGCGGGGTTAGAGCTAGAAAT	1	bc
GCCAGCGGCA	GAAACACCGGTTGCCAGTGCGTTACGTGGTTCTTAGAGTAGAGCTGGTAG	1	bc
TTGGGGATGC	GAAACACCGGTTATATTGAGTGGGGTTAGAGCTAGAAATAGCAAGTTAAC	1	bc
AACGGACTAA	GAAACACCGGTGCCCTTACTCTCACCTGATTACTTAATCCGTGGGGTTAG	1	bc
GCTTGTGGAT	GAAACACCGGTCGATTCATATCGAAACCTTCCCGTGACAGTGGGGTTAGA	1	bc
TCTGTCGCTG	GAAACACCGGTTATATTTGTAAGTGTGTGGGGTTAGAGCTAGAAATAGCA	1	bc
AGCTATCGAG	GAAACACCGGTTATATTTGTAAAGTGGGGTTAGAGCTAGAAATAGCAAGT	1	bc
AACAATAGAG	GAAACACCGGTTATAGGGTTAGAGCTAGAAATAGCAAGTTAACCTAGGGC	1	bc
AACAACGGGC	GCTAGAAATAGCAAGTTAACCTAAGGCTAGTCCGTTATCAACTTGAAAAA	1	bc
GAAAATCTTT	GAAACACCGGTCTCGAGTGAGGTGTTCAGGGTGGGGTTAGAGCTAGAAAT	1	bc
GGCCCATAAC	GAAACACCGGTAAATTTGAGGTTCCGGCATGCAGGTGGCCGGGGGGTTAG	1	bc
GAAGAAATGC	GAAACACCGGTCGGCGGCAATCGTGGGTGGGGTTAGAGCTAGAAATAGCA	1	bc
AGGAGCAGAC	GAAACACCGGTTAAGCCGAGAAGTTAGAGCTAGAAATAGCAAGTTAACCT	1	bc
AATATGCGTC	GAAACACCGGTCCGTAGGAGACCCGTGTGGCATGTACCTGTGGGGTTAGA	1	bc
GGTCAGACTC	GAAACACCGGTCCGTCGGCGAACCGTGTGGCATGTGCCTGTGGTGGTAGA	1	bc
AAGCAACGGC	GAAACACCGGTTTGAACTAAGTGGGGTTAGAGCTAGAAATAGCAAGTTAA	1	bc
CGGGACACTC	GAAACACCGGTGTGGCTGTGAGTCAGGCGCTGATGTGGCTGTGGGGTTAG	1	bc
CAAAAAGCTC	GAAACACCGGTTTGAACTAGAAATAGCAAGTTAACCTAAGGCTAGTCCGT	1	bc
CTGCACTTCA	GAAACACCGGTACCTTTGTTGATGCTGGGTGGAAGGAATGGGTGGGGGTA	1	bc
GACATCGACT	GAAACACCGGTAGCAAGTGCGGGGTTAGAGCTAGAAATAGCAAGTTAACC	1	bc
AACCTGGGTC	GAAACACCGGTAGCAAGTGCGAGACGTGTTTGTGGGGTTAGAGCTAGAAA	1	bc
AGAGGACCCT	GAAACACCGGTCGGCGGCAATCGGGGGTGGGGTTAGAGCTAGAAATAGCA	1	bc
ACGAGTTGTC	GAAACACCGGTGACATTGGGGGTTAGAGCTAGAAATAGCAAGTTAACCTA	1	bc
GATAGTCGTA	GAAACACCGGTGTACGTATGGACTGAACCAGGGTGTGCAAGTGGGGTTAG	1	bc
AAGTCTGCAT	GAAACACCGGTCCGTAGGAGACCCGTGTGGCATATGTGGGGTTAGAGCTA	1	bc
TTTAGCTCTG	GAAACACCGGTTACATTGAGGGGTTAGAGCTAGAAATAGCAAGTTAACCT	1	bc
TCAGTTGTGG	GAAACACCGGTTATATTTGTAAGTGTTTTTTGGGGTTAGAGCTAGACCTA	1	bc
TCTAGAGTGG	GAAACACCGGTTATATTTGTAAGTGTTGTGGGGTTAGAGCTAGAAATAGC	1	bc
ACACGCCGTC	GAAACACCGATGTACGCATATACTGAACTAGGGGGTGCAGGGGGGGTTGA	1	bc
TGACAGCGAC	GAAACACCGGTAGCAAGTGCGGGGTTAGAGCTAGAAATAGCAAGTTAACC	1	bc
TCTGGTCGTT	GAAACACCGGTGTACGTATGGACTGAACCAGGGTGTGCAAGTGGGGTTAG	1	bc
AATAGGCGTC	GAAACACCGGTGTACGTATGGACTGAACCAGGGTGTGCAAGTGGGGTTAG	1	bc
AGCCAACCCG	GAAACACCGGTCGTCTGCACTACAGAAATAGCATGTTAATAGAAGGAGCA	1	bc
TAATGCCCTA	GCTCTCACCTGATTACTTAATCCGTGGGGTTAGAGCTAGAAATAGCAAGT	1	bc
ACATCGTCGG	GAAACACCGGTGTACGCATGGACTGAACCAGGGTGTGCAAGTGGGGTTAG	1	bc
ACGGCCCGCC	GAAACACCGGTGCCCGTACTCTCACCTGATTACTTAATCCGTGGGGTTAG	1	bc
AATATGCGGA	GAAACACCGGTACCTTTGTTGATGCTGGGTGGAAGGTACCGGTGGGGTTA	1	bc
GCTACTAGGC	GAAACACCGGTACCTTTGTTGATGCTGGGTGGAAGGAATTTTGTGGGGTT	1	bc
AAGACCCTAG	GAAACACCGGTGCATTCGAAAGTCCGGTCGCAGTGTGGACGTGGGGTTAG	1	bc
ACGTGTTGTA	GAAACACCGGTGACATTGGGTACAGGGTGGGGTTAGAGCTAGAAATAGCA	1	bc
AGCCCATACC	GAAACACCGGTAAATTTGAGGCTCCGGCATGCAGGAGGCCGTGGGGTTAG	1	bc
GATAGCCATT	GAAACACCGGTGCCCTTACTCTCACCTGATTACTTAATCCGTGGGGATAG	1	bc
GGGGAACCTT	GAAACACCGGTTCCCGTCCAGTGGGGTTAGAGCTAGAAATAGCAAGTTAA	1	bc
TGCCTAGCCG	GAAACACCGGTCGGCGGCAATCTAGAAATAGCAAGTTAACCTAAGGCTAG	1	bc
CGGATTGTAC	GAAACACCGGTCTCGAGTGAGGTGTTCAGGGGGGGGTTAGAGCTAGAACT	1	bc
TGAGCCGTGA	GAAACACCGGTAAATTTGAGGGGCTAGAGTTCGGAATAGCGAGTTAACCT	1	bc
GAACCCAACC	GAAACACCGGTAAATTTGAGGCTCCGGTATCCAGGAGGCCGTGGGGTTAG	1	bc
ATGCGTATAT	GAAACACCGGTTTACGTTGCATCGGTGTGGGGTTAGAGCTAGAAATAGCA	1	bc
AAAATGAGGT	GAAACACCGGTCGATTCATATCGAAACCTTCCCGTGACAGTGGGGTTAGA	1	bc
GGAAGTCCCG	GAAACACCGGTCGGCGGCGGTGGGGTTAGAGCTAGAAATAGCAAGTTAAC	1	bc
GTATACACGC	GAAACACCGGTCGGCGGCAATCGTGGGTGGGGTTAGAGCTAGAAATAGCA	1	bc
ACAAGCTCGC	GAAACACCGGTGCATTCGAAAGTCCGGTCGTAGTGTGGACGTGGGGTTAG	1	bc
GACTATGCCC	GAAACACGGGTTAGAGCTAGAAATAGCAAGTTAACCTTAGACCAGTCCGT	1	bc
AAGAATGGCT	GAAACACCGGTTTACATTACATCGGGGTTAGGGCTAGGCATAAAAAGTTA	1	bc
GGTAACTACA	GAAACACCGGTAAATTTGAGGCTCCGGCATGCAGGAGGCCGTGGGGTTAG	1	bc
TTGGCTTCGG	GAAACACCGGTTACATTGAGATTGGGGTTAGAGCTAGAAATAGCAAGTTA	1	bc
GCGAATCATT	GAAACACCGGTCTCGAGTGAGGTGTTCAGGGTGGGGTTAGAGCTAGAAAT	1	bc
TTAGGAAGGT	GAACGGGGTTAGAGCTAGAAATAGCAAGTTAACCTAAGGCTAGACCGTTA	1	bc
ATGTCTACGT	GAAACACCGGTTACATTGAGGGGTTAGAGCTAGAAATAGCAAGTTAAGCT	1	bc
GTGGGCATAC	GAAACACCGGTTAAGCCGAGGAGTTTCGTTAGAGCTAGAAATAGCAAGTT	1	bc
GCAGCCAGTC	GAAACACCGGTCGGCGGCAATAGAGCAGGTTAACCTAAGGGTAGGCCGTT	1	bc
AGCCTCCCTG	GAAACACCGGTTCCCGTCCAGTGGGGTTAGAGCTAGAAATAGCAAGATAA	1	bc
GCAAAAGCCC	GAAACACCGGGTTGAACTACCTAGGGGGTAGTTCAAACCGGGGTTAGAGC	1	bc
ATGGCTATTT	GAAACACCGGTTACATTGGGGTTAGAGCTAGAAATAGCAAAGTAACCTAT	1	bc
TCGATCCACG	GAAAAACCGGTTATATTTGTAAGTGTGTGGGGTTAGAGCTAGAAATAGCA	1	bc
AAGACCCTGG	GAAACACCGGTGCATTCGAAAGTCCGGTCGTAGTGTGGACGTGGGGTTAG	1	bc
ACACAACGCA	GAAACACCGGTTTGAACTAGAAATAGCAAGTTAACCTAAGGCTAGTCCGT	1	bc
ACTATCCCGC	GAAACACCGGTTAGATTTGTTAGTGGGGTTAGAGCTAGAAATAGCAAGTT	1	bc
TAACAACGCC	GAAACACCGGTTTGAACTACCTAGTTCAAACCGGTGGGGTTAGAGCTAGA	1	bc
TCGCCCTGCA	GAAACACCGGTGTGGCTGAGAGTCCGGCAATGGTGTGGCTGTGGGGTTAG	1	bc
TAAGGGCCGC	GAAACACCGGTCGGCGGCAACGTGGGTTAGAGCTAGAAATAGCAAGTTAA	1	bc
CGCCCCCCGC	GAAACACCGGTGCGTCTGAGAGTCCGGCAATGGTGTGGCTGTGGGGTTAG	1	bc
ACGTTGCGTT	GAAACACCGGTTCCCGTCCAGTGGGGTTAGAGCTAGAAATAGCAAGTTAA	1	bc
GACACCGTAA	GAAACACCGGTAGCAAGAGTGAGACGTGTTTGTGGGGTTAGAGGTAGAAA	1	bc
TTAGCTCGTC	GAAACACCGGTGTACGTATGGACTGAAACCTGGAGTGCAAGTGGGGATAG	1	bc
AGTATAGATC	GAAACACCGGTCCGTAGGAGACCCGTGTGGCATGTACCTGTGGGGTTAGA	1	bc
AAACAACGCC	GAAACACCGGTTTGAACTACCTAGTTCAAACCGGTGGGGTTAGAGCTAGA	1	bc
CCTGCAACGC	GAAACACCGGTCGGGGCCACTCAGTGGTGGGGTTAGAGCTAGAAATAGCA	1	bc
AAAAGCCCTA	GAAACACCGGTGCCCTTACTCTCGCCTGATTACTTAATCCGTGGGGTTAG	1	bc
TCTCACGAAG	GAAACACCGGTTATATTTGTAAGTGTGTGGGGCTATAGCTAGAAATAGCA	1	bc
CACATGGCTC	GAAACACCGGTTTGAACTAGTAATAGCAAGTTATCCTGATGCTAGTACGT	1	bc
GTCTACTCGG	GAAACACCGGTACCTTTGTTGATGCTGGGTGGAAGGTACCGGTGGGGTTA	1	bc
GAGACTGCAG	GAAACACCGGTCCGTAGGAGACCCGTGTGGCATGTACCTGTGGGGTTAGA	1	bc
CTAGTTGTGT	GAAACACCGGTGACATTGGGGATAGGCCGTGGGGTTAGAGCTAGAAATAG	1	bc
CCCACAGCCC	GAAACACCGGTTTGAACCGGTGGGGTTAGAGCCAGAAATAGCAAGTTAAC	1	bc
ATATCGTGGT	GAAACACCGGTGTACGTATGGACTGAACCAGGGTGTGCAACAAGTGGGGT	1	bc
GGACGCTACG	GAAACACCGGTAAATTTGAGGCTCCGGCATGCAGGAGGCCGTGGGGTTAG	1	bc
GCGAAGGCTC	GAAACACCGGTTCCCGTCCAGTGGGGTCAGAGCTAGAAATAGCAAGTTAA	1	bc
AGAGTCTGCC	GAAACACCGGTCCGTAGGAGACCCGTGTGGCATGTACCTGTGGGGTTAGA	1	bc
CGACTGCTTC	GAAACACCGGTCCGTAGGAAACCCGTGTGGCATGTACCATGGGTGGATAT	1	bc
CGGACCCGTA	GAAACACCGGTCGCGGGAGCGGTGTTCAGGGTGGGGTTAGAGCTAGAAAT	1	bc
AAGCGTCGCT	GAAACACCGGTTTACGTCGCATAGGAGTGGGGTTAGAGCTAGGAATAGCA	1	bc
AAACGTCCTA	GAAACACCGGTGCCCTTACTCTCACCTGATTACTTAATCCGTGGGGTTAG	1	bc
TAGTGTTGTC	GAAACACCGGTGACATTGGGTAAAATAGCAAGTTAACCTAAGGCTAGTCC	1	bc
GCTCAACGCC	GAAACACCGGTTTGAACTACCTAGTTCAAACCGGTGGGGTTAGAGCTAGA	1	bc
GGAGAACTCC	GAAACACCGGTGTGGCTGAGAGTCCGGCAATGGTGTGGCTGTGGGGTTAG	1	bc
AAACAACGCC	GAAACACCGGTTTGAACTACCTAGTTCAAACCGGTGGGGTTAGGGCTAGA	1	bc
ACGAAGCATT	GAAACACCGGTCTCGAGTGAGGTGTTCAGGGTGGGGTTAGAGCTAGAAAT	1	bc
GGCGGCGGCC	GAAACACCGGTGGGGTTAGAGCTAGAAATAGCAAGTTAACCTAAGGCTAG	1	bc
GAGACGCTCG	GAAACATCGGTGCATTCGAAAGTCCGGTCGTAGTGTGGACGTGGGGTTAG	1	bc
CCAAGCCGTT	GAAACACCGGTCTCGAGTGAGGTGTTCAGGGTGGGGTTAGAGCTAGAAAT	1	bc
ACATTCAGAA	GAAACACCGGTCGATTCATATCGAAACCTTCCCGTGACAGTGGGGTTAGA	1	bc
GTGCCTCCCC	GAAACACCGGTTTACGTTAGAGCTAGAAATAGCAAGTTAACCTAAGGCTA	1	bc
CGGACCCCTA	GAAACACCGGTCTCGAGTGAGGTGTTCAGGGGTGGGGTTAGAGCTAGAAA	1	bc
GGTCGTCTTC	GAAACACCGGTGTACGTATGGACTGAACCAGGGTGTGCAAAAGTGGGGTT	1	bc
GCGTGGTGTC	GAAACACCGGTGACATTGGGTACAGGGTTAGAGCTAGAAATAGCAAGTTA	1	bc
AAGAAGGCCC	GAAGCACCGGTCGGCGGCAATCGTGGGTGGGGTTAGAGCTAGAAATAGCA	1	bc
GATGTACTAC	GAAACACCGGTGCCCTTACTCTCACCTGATTACTTAATCCGGGTGGTTAG	1	bc
GGTCCCTTCC	GAAACACCGGTGAGGCTGAGAGTCAGGCAATGGTGTAGCTGGGGAGTTAG	1	bc
CGAACACTAT	GAAACACCGGTCTCGTGTGAGGTGTTGAGGGTGGGGTTAGAGCTAGAAAT	1	bc
GGCGGACAAG	GAAACACCGGTTCCCTTACTCTCACCTGATTACTTGCGCATAGAGCTAGA	1	bc
GGCCTCGTCC	GAAACACCGGTGTGGCTGAGCGTCCGGCAATGGTGTGGCAGTGGGGTTAG	1	bc
ATGTCTAGGT	GAAACACCGGTTTACGTTGCTTCGGTTGTGGGGTTAGAGCTAGAAATAGC	1	bc
ACTCTGTGTT	GAAACACCGGTTTACGTTGCATCGGTGTGGGGTTAGAGCTAGAAATAGCA	1	bc
TAGGCTTTGC	GAAACACCGGTTACATTGAGGGTTAGAGCTAGAAATAGCAAGTTAACCTA	1	bc
TGATTTTAAG	GAAACACCGGTCGGGGCCACTCAGTGGTGTTAGAGCTAGCAATAGCACGT	1	bc
ATGCTTCGAC	GAAACACCGGTTTACGTTGCATCGGTGTGGGGTTAGAGCTAGAAATAGCA	1	bc
AGAAGCTAGA	GAAACACCGGTGCATTCGAAAGTCCGGTCGTAGTGTGGACGTGGGGTTAG	1	bc
ATTAGATATG	GAAACACCGGTTACATTGAGGGTTAGAGCTAGAAATAGCAAGTTAACCTA	1	bc
ACCTTAACGC	GAAACACCGGTCGGGGCCACGGGTTAGAGCTAGAAATAGCAAGTTAACCT	1	bc
ACCAAAGCCC	GAAACACCGGTTTGAACTAGAAATAGCAAGTTAACCTAAGGCTAGTCCGT	1	bc
AACGCGTTAA	GAAACACCGGTGCCCTTACTCTCACCTGATTACTTAATCCGTGGGGTTAG	1	bc
AGGCGCCCGC	GAAACACCGGTGCATTCGAAAGTCCGGTCGTAGTGTGGACGTGGGGTTAG	1	bc
TCGAATCATT	GAAACACCGGTCTCGAGCGAGGTGTTCATGGTGGGGTTAGAGCTAGAAAT	1	bc
GAACAACGCC	ATAGAAATAGCAAGTTAACCTAAGGCTAGTCCGTTATCAACTTGAAAAAG	1	bc
AGAATCTCTT	GAAACACCGGTGCATTCGAAAGTCCGGTCGTAGTGTGGACGTGGGGTTAG	1	bc
GGGACTCCCC	GAAACACCGGTGTGGCTGAGAGTCCGGCAGTGGTGTGGCTGTGGGGGTAG	1	bc
AGATTCCCGC	GAAACACCGGTCGGGGCCACTCAGTGGTGGGGTTGGAGCTAGAAATAGCA	1	bc
CCACTAGGTC	GAAACACCGGTAAATTTGTTGATGCTGAGAAGACGGAATTTTGTGGAGAT	1	bc
AGAAGGACCG	GAAACACCGGTCGGCGGCAATCTGGGGTTAGAGCTAGAAATAGCAAGTTA	1	bc
GTCCCCGTCT	GACCGAACCACCGTTGTGGCTGATAGTCCGGCAATTATGTGGCTATCGGG	1	bc
AGTGGATGCT	GAAACACCGGTTCCCGTCCAGTGGGGTTAGAGCTAGAAATAGCAAGTTAA	1	bc
ATATCCGGGT	GAAACACCGGTCGATTCATATCGAAACCTTCCCGGTTAGAGCTAGAAATA	1	bc
ATTAGTTATG	GAACACGAGGGATTAGAGCTAGAAATAGCAAGTTAACCTAAGGCTAGTCC	1	bc
AACCGCACCA	GAAACACCGGTGCCCTTACTCTCACCTGATTACTTAATCCGTGGGGTTAG	1	bc
GTGATCATCC	GAAACACCGGTTAAGCCGAGGAGGTTCGTTAGAGCTAGAAATAGAAAGTT	1	bc
AAAGAACTAA	GAAACACCGGTGCCCTTACTCTCACCTGATTACTTAATCCGTGGGGTTAG	1	bc
GGGGGAGCCT	CTAAACACCGGTTCCCGTCCAGTGGGGTTAGAGCTAGAAATAGCAAGTTA	1	bc
AGACCCAGAC	GAAACACCGGTAGCAAGTGCGAGACGTGTTTGTGGGGTTAGAGCTAGAAA	1	bc
AAAAAAGCCC	GAAACACCGGTTTGAACTAGAAATAGCAAGTTAACCTAAGGCTAGTCCGT	1	bc
TGAAGACGCG	GAAACACCGGTCGGCGGCAATCGTGGGTGGGGTTAGAGCTAGAAATAGCA	1	bc
GCTACCCCCA	GAAACACCGGTCGGAAACGCTCAGAGGTGGGGTTAGAGCTAGAAATAGCA	1	bc
AGTTTCGTCT	GCAACACCGGTGACATTGGTGGGGTTAGAGCTAGAAATAGCAAGTTAACC	1	bc
TACCTGATAA	GAAACACCGGTAACTATATTCATGCGATATCGCCGTATCAGTGGGGTTAG	1	bc
ACGTGGTGTC	GAAACACCGGTGACATTGGGTTAGAGCTAGAAATAGCAAGTTAACCTAAG	1	bc
AGGATACTCT	GAAACACCGGTATCGAGTGAGGCGTTCAGGGCGGGGTTAGAGCTAGAAAT	1	bc
TAGAGCTTAT	GAAACACCGGTTAAGCCGAGTGGGGTTAGAGCTAGAAATAGCAAGATAAC	1	bc
CATAGCAGTC	GAAACACCGGTGTACGTATGGACTGAACCAGGGTGTGCAAGTGGGGTTAG	1	bc
AAGATCCTAG	GAAACACCGGTGCATTCGAAAGTCCGGTCGTAGTGTGGACGTGGGGTTAG	1	bc
TGACTCATTC	GAAACACCGGTCTCGAGAGAGGTGTTCAGGGTGGGGATAGAGCTAGAAAT	1	bc
AGGCACCGTC	GAAACACCGGCGTGGCTGAGAGTCCGGCAATGGTGTGGCTGTGGGGTTAG	1	bc
AAGAGCCTCG	GAAACACCGGTGCATTCGAAAGTCCGGTCGTAGTGTGGACGTGGGGTTAG	1	bc
AGACGTCTTC	GAAACACCGGTGCATTCGAAAGTCCGGTCGTAGTGTGGACGTGGGGCTAG	1	bc
AAACGACCTG	GAAACACCGGTGCCCTTACTCTCACCTGATTACTTAATCCGTGGGGTTAG	1	bc
ATAATTTATA	GAAACACCGGTAACTATATTCATGCGATATCGCCGTATCAGTGGGGTTAG	1	bc
TAGACCGAGA	GAAACACCGGTTATATTTGTAAGCGAGTGGGGTTAGAGCTAGAAATAGCA	1	bc
TCTAAAGATG	GAAACACCGGTTATATTTGTAAGTGTGTGGGGTTAGAGCTAGAAATAGCA	1	bc
ACGAATCGAG	GAAACACCGGTTTCGAGCGAGATGTTCAGGGTGGGGCTAGAGCTAGACCT	1	bc
ATACCCAATC	GAAACACCGGTTCATGCAAAATGCGGGTCGGGGTAGGGCCAGGGGTAGCG	1	bc
ACGTAGCGTG	GAAACACTGGTGTGGCTGAGAGTCCGGCAATGGTGTGGCTGTGGGGTTAG	1	bc
GGAACGCTCT	GAAACACCGGTGTGGCTGAGAGTCCGGCAATGGTGTGGCTGTGGGGTTAG	1	bc
AAGTCTCTAC	GAAACACCGGTGCCCTTACTCTCACCTGATTACTTAATCCGTGGGGTTAG	1	bc
AGGATCCTAC	GAAACACCGGTAAATTTGAGGCTCCGGCATGCAGGAGGCCGTGGGGTTAG	1	bc
GTAACTTGTA	GAAACACCGGTAACTATATTCATGCGATATCGCCGTATCAGTGGGGTTAG	1	bc
AAGGTTGTCT	GAAACACCGGTGGTTAGAGCTAGAAATAGCAAGTTAACCTAAGGCTAGTC	1	bc
GAGACAGCAA	GAAACACCGGTAGCAAGTGCGAGACGTGTTTGTGGGGTTAGAGCTAGAAA	1	bc
AGGGCACACT	GAAACACCGGTGTGGCTGAGAGTCCGGCAAGGGTGTGGCTGTGGGGTTAG	1	bc
GGGCCATATA	GAAACACCGGTAAATTTGAGGCTCCGGCATGCAGGAGGCCGTGGGGTTAG	1	bc
AGAAGATCGC	GAAACACCGGTGCATTCGAAAGCCCGGTCGTAGTGTGGACGTGGGGTTAG	1	bc
AAACGCACTA	GAAACACCGGTGCCCTTACTCTCACCTGATTGCTTAATCCGTGGGGTTAG	1	bc
TACCTTCGAC	GAAACACCGGTAACTATATTCATGCGATATCGCCGTATCAGTGGGGTTAG	1	bc
TGACAACGCC	GAAACACCGGTTTGAACTAGAAATAGCAAGTTAACCTAAGGCTAGTCCGT	1	bc
AGACGATAGC	GAAACACCGGTGCATTCGAAAGTCCGGTCGTAGTGTGGACGTGGGGTTAG	1	bc
CCCAAATACC	GAAACACCGGTTTGAACTAGAAATAGCAAGCTAACCTAAGGCTAGTCCGT	1	bc
TCACAAAGTC	GAAACACCGGTTTGAACTAGAAATAGCAAGTTAACCTAAGGCTAGTCCGT	1	bc
AACATGCGGT	GAAACACCGGTCGATTCATATCGAAACCTTCCCGTGACAGTGGGGTTAGA	1	bc
TCGAATTCTT	GAAACACCGGTCTCGAGTGAGGTGTTCAGGGTGGGGTTAGAGCTAGAAAT	1	bc
GAGCGGTGTA	GAAACACCGGTGCCCTTACTCTCACCTGATTACTTAATCCGTGGGGTTAG	1	bc
GTTGAGCGTA	GAAACACCGGTTAAGCCGAGTGGGGTTAGAGCTAGAAATAGCAAGTTAAC	1	bc
ATAAGTTATA	GAAACACCGGTAACTATATTCATGCGATATCGCCGTATCAAGTGGGGTTA	1	bc
CGTGGTTTCA	GAAACACCGGTGACATTGGGTACGGGGTTAGAGCTAGAAATAGCAAGTTA	1	bc
GGTACAGATA	GAAACACCGGTAGCAAGTGCGGGGTTAGAGCTAGAAATAGCAAGTTAACC	1	bc
ATGCTGAGAA	GAAACACTGGTTTACGTTGCATCGGTGTGGGGTTAGAGCTAGAAATAGCA	1	bc
AGGCATCTAC	GAAACACCGGTAAATTTGAGGCTCCGGCATGCAGGAGGCCGTGGGGTTAG	1	bc
GGCACATTAC	GAAACACCGGTGTGGCTGAGAGTCCGGCAATGGTGTGGCTGTGGGGTTAG	1	bc
CGACTCGTGT	GAAACACCGGTCTCGCGTGAGGTGTTCAGCGTGGGGTTAGAGCTAGAAAT	1	bc
ACCATAGAGG	GAAACACCGGTTTTCTTTGTACGGGTTGTGGGGTTAGAGCTAGAAATAGC	1	bc
GTGAGCAGTA	GAAACACCGGTTAAGGCGAGGAGTTAGAGCTAGAAATAGCAAGTTAACCT	1	bc
GGCACCACAC	GAAACACCGGTGTGGCTGAGAGTCCGGCAATGGTGTGGCTGTGGGGTTAG	1	bc
GGGACCCGGG	GAAACACCGGTGTGGCTGAGAGTCCGGCAATGGGGTGGATGGGGGGATAG	1	bc
AACACAGGGG	GAAACACCGGTAGCACTTTGTGGGGTTAGAGCTAGAAATAGCAAGTTAAC	1	bc
GGAGTTGTCG	GAAACACCGGTGACATTGGGTACAGGGGTGGGGTTAGAGCTAGAAATAGC	1	bc
AGGGTTGTAT	GAAACACCGGTGACATTGGGTTAGAGCTAGAAATAGCAAGTTAACCTAAG	1	bc
GTCTTTAGAG	GAAACACCGGTTATATTTGTGGGGTTAGAGCTAGAAATAGCAAGTTAACC	1	bc
AACTACCAAT	GAAACACCGGTGCCCTTACTCTCACCTGGTTTCTTAATCCATGTAGTTAG	1	bc
CGGATCCCTC	GAAACACCGGTCTCTAGAGAGGTGTTCAGGGTGGGGTTAGAGCTAGAAAT	1	bc
GGTGCGCCTC	GAAACACCGGTTCCCGTCCAGTGGGGTTAGAGCTAGAAATAGCAAGTTAA	1	bc
GAGCAGCCCC	GAAACACCGGTTCCCGTCCAGTGGGGTTAGAGCTAGAAATAGCAAGTTAA	1	bc
GCACAAGGCC	GAAACACGGGTTAGAGCTAGAAATAGCAAGTTAACCTAAGGCTAGTCCGT	1	bc
TAGGAACGTC	GAAACACCGGTTCCCGTCCAGTCGGGTTAGAGCTAGAAATAGCAAGTTAA	1	bc
GCATTACAGC	GAAACACCGGTCGGGGCCACTCAGTGGTGGGGTTAGAGCTAGAAATAGCA	1	bc
AGCTTCCGCT	GAAACACCGGTCGGTTCATATGGACAGCTTCGGGTTGCCGTGGGGGTAGA	1	bc
AGATCCTGTA	GAAACACCGGTAAATTTGTGTCTCCGGCTTGCAGGAGGCCGTGGGGTAAG	1	bc
AACGACTTCC	GAAACACCGGTGCCCTTACTCTCACCTGATTACTTAATCCGTGGGGTTAG	1	bc
GGGCCGCACA	GAAACACCGGTAAATTTGAGGATCCGGCACGCAGGAGGACCGTGGGGTTA	1	bc
TGTGGAGACT	GAAACACCGGTTCCCGTCCAGTGGGGTTAGAGCTAGAAATAGCAAGTTAA	1	bc
GAGGAACGGA	GAAACACCGGTCGGCGGCAATCGTGGGTGGGGTTAGAGCTAGAAATAGCA	1	bc
AGGTGATCGT	GAAACACCGGTGCATTCGAAAGTCCGGTCGGAGTGTGGACGGGGAGTTAG	1	bc
GGGACCCGAC	GAAACACCGGTGTGGCTGAGAGTCCGGCAATGGTGTGGCTGTGGGGTTAG	1	bc
AATGCGTAGC	GAAACACCGGTTTACGTTGCATCGGTGTGGGGTTAGAGCTAGAAATAGCA	1	bc
TTGCGCATTT	GAAACACCGGTTAAGCCGAGTGGGGTTAGAGCTAGAAATAGCAAGTTAAC	1	bc
AGAGCAGCGC	GAAACACCGGTGCATTCGAAAGTCCGGTCGTAGTGTGGACGTGGGGTTAG	1	bc
ACATAACGCT	GAAACACCGGTTTGAACTAGAAATAGCAAGTTAACCTAAGGCTAGTCCGT	1	bc
AGAACATTGT	GAAACACCGGTGCATTCGAAAGTCCGGTCGTAGTGTGGACGTGGGGTTAG	1	bc
ACAAACCCTC	GAAACACCGGTCGGCGGCAATCGAGGGTGGGGTTAGAGCTAGGAATAGCA	1	bc
GCCACCGACC	GAAACACCGGTGTGGCTGAGAGTCAGGCATTGGTGTAGCTGTGTGGCCTG	1	bc
ACTATCTACA	GAAACACCGGTAAATTTGAGGCTCAGGCATGCAGGAGGCCGTGGGGTTAG	1	bc
TACCAACGCC	GAAACACCGGTTTGAACTAGGAATAGCAAGTTAACCTAAGGCTAGTCCGT	1	bc
ATAGCTACGC	GAAACACCGGTTACATTGAGTGGGGTTAGAGCTAGAAATAGCAAGTTAAC	1	bc
CACCTCGCTT	GAAACACCGGTTTGAACTAGAAATATCCTGTTAACCTAAGGCTTGGCCGT	1	bc
AGAGACCTTT	GAAACACCGGTCTCGAGTGAGGTGTTCAGGGTGGGGTTAGAGCTAGAAAT	1	bc
ATAACCTAGC	GAAACACCGGTGCATTCGAAAGTCCGGTCGTAGTGTGGACGTGGGGTTAG	1	bc
CAGCGTCTTA	GAAACACCGGTGTACGTATGGACTGAACCAGGGTGTGCAGCTAGAAATAG	1	bc
CGATGCATGT	GAAACACCGGTCTCGAGTGAGGTGTTCAGGGGGGGGTTAGAGCTAGAAAT	1	bc
GTTTGAGCCT	GAAACACCGGTTAAGCCGAGTGGGGTTAGAGCTAGAAATAGCAAGTTAAC	1	bc
ATACTCCCCC	GAAACACCGGTTTACGTTGCAGAAATAGCAAGTTAACCTAAGGCTAGTCC	1	bc
TATCTCGTGG	GAAACACCGGTTATATTTGTAAGTGTGTGGGGTTAGAGCTAGAAATAGCA	1	bc
GAGGCCCCTC	GAAACACCGGTCGGCGGCAATCGTGGGGTGGGGTTAGAGCTAGAAATAGC	1	bc
AGGTCATTAC	GAAACACCGGTAAATTTGAGGCTCCGGCATGCAGGAGGCCGTGGGGTTAG	1	bc
AGTGCGCCCC	GAAACACCGGTCCGCAGCAATCGCGTGTGGGGTTTGCGCTAGAAATAACA	1	bc
GCAGGCCCGA	GAAACACCGGTCGGCGGCAATCGTGGGTGGGGTTAGAGCTAGAAATAGCA	1	bc
ATAGAGCATA	GAAACACCGGTTAAGCCGAGTGGGGTTAGAGCTAGAAATAGCAAGTTAAC	1	bc
AACGCCCGGA	GAAACACCGGTGCCCTTACTCTCACCTGATTACTTAATCCGTGGGGTTAG	1	bc
GACCTCGACC	GAAACACCGGTAAATTTGAGGCTCCGGCATGCAGGAGGCCGTGGGGTTAG	1	bc
ATGTCTAGGT	GAAACACCGGTGCCCTTACTCTCATCTGATTACTAAATCTGTGGGGATAG	1	bc
ACGAATTCTT	GAAACACCGGTCTCGAGTGAGGTGTTCAGGGTGGGGTTAGAGCTAGAAAT	1	bc
AGGCAACATC	GAAACACCGGTGTGGCTGAGAGTCCGGCAATGGTGTGGCTGTGGGGTTAG	1	bc
AGAGAGCCTC	GAAACACCGGTCGGCGGCAATAGAGATAGCAATTTAACCTAAGGCTAGTC	1	bc
ATGCCTATGT	GAAACACCGGTTTACGTTGCATCGGGGTGGGGTTAGAGCTAGATATAGCA	1	bc
GGAAGAGTAC	GAAACACCGGTGTGGCTGAGAGTCCGGCAATGGTGTGGCTGGGGGGATAG	1	bc
TAAATTATGA	GAAACACCGGTAACTATATTGATGCGATATCGCAGTATCAGGGGGGTTAG	1	bc
ATTGAGCGTA	GAAACACCGGTTAAGCCGAGGGGTTAGAGCTAGAAATAGCAAGTTAACCT	1	bc
CTCCCATGCA	GAAACACCGGTGTGGCTGAGAGTCCGGCGATGGTGTGGCTGTGGGGTTAG	1	bc
AAATGCCCTA	GAAACACCGGTGCCCTTACTCTCACCTGATTACTTAATCCGTGGGGTTAG	1	bc
CTAGGCGTCC	GAAACACCAATTTCACCGGTGGGGTTAGAGCTAGAAATAGCAAGTTAACC	1	bc
AAGATAGCCC	GAGACACCGGTTTGAACTACCTAGTTCAAACCGGTGGGGTTAGAGCTAGA	1	bc
GGCAGCAGAA	GAAACACCGGTGTGGCTGAGAGTCCGGCGATGGTGTGGCTGTGGGGTTAG	1	bc
ACGTGTTGTA	GAAACACCGGTGACATTGGGTACGGGGTTAGAGCTAGAAATAGCAAGTTA	1	bc
GCACTTCCGC	GAAACACCGGTAACTATATTCATGAGATATCGCCGTATCAGTGGGGTTAG	1	bc
GAACCAGCCA	GAAACACCGGTAGCAAGTGGGGTTAGAGCTAGAAATAGCAAGTTAACCTA	1	bc
GCACGCACTA	GAAACACCGGTGCCCTTACTCTCACCTGATTACTTAATCCGTGGGGTTAG	1	bc
CGCCCCTCGT	GAAACACCGGTGCATTCGAAAGTCCGGTCGTAGTGGGGACGGGGGGTTAG	1	bc
ATGAATAGAT	GAAACACCGGTTTACGGTGTTAGTGCGTGGGGTTAGAGCTAGAAATAGCA	1	bc
GAACTTCAAC	GAAACACCGGTAACTATATTCATGCGATATCGCCGTATCAGTGGGGTTAG	1	bc
ATTGGGAATA	GAAACACCGGTTAAGCCGAGTGGGGTTAGAGCTAGAAATAGCAAGTTAAC	1	bc
GCTGCCCTAC	GAAACACCGGTGCCCTTACTCTCACCTGATTACTTAATCCGTGGGGTTAG	1	bc
AGTGGGCTGC	GAAACACCGGTCCGGAGGAGACCCGTGTGGCATGTACTAGTGGGGGTAAA	1	bc
CGAAGTCGTT	GAAACACCGGTCTAGGGATGGACTGTCCGAGTGGGGGTAGGTCTGGATAT	1	bc
AGGATCATCT	GAAACACCGGTTTACGCTGCGTCGGTGTGGGGGTAGAGCGAGATATAGAA	1	bc
TTAAGTATGC	GAAACACCGGTTACATTGAGGGTTAGAGCTAGAAATAGCAAGTTAACCTA	1	bc
CTAATTCTGT	GAAACACCGGTTACATTGAGGGTTATAGCTAGAAATAGCAAGTTAACATA	1	bc
CCAGACGGCC	GAAACACCGGTACCTTTGTTGATGCTGGGTGGAAGGAATTTGTGGGGTTA	1	bc
CTGAGCGTCA	GAAACACCGGTTCCGTTGTGTACGCTTAGAGCTAGATGGAGTAAAGTTAT	1	bc
AGACTGCTTT	GAAACACCGGTCTCGAGTGAGGTGTTCAGGCGGGGTTAGAGCTAGAAATA	1	bc
GTGCGTCTCT	GAAACACCGGCTTACGTTGCATCGGTGTGGGGTTAGAGCTAGAAGTAGCA	1	bc
AACCTTACCG	GAAACACCGGTCGGGGCCAGCTAGAGATAGCAAGTTAACCTAAGGCTAGT	1	bc
AAAGCTATAC	GAAACACCGGTGCCCTTACTCTCACCTGATTACTTAATCCGTGGGGTTAG	1	bc
TGCTTTACCG	GAAACACCGGTCGGGGCCACTCAGTGGTGGGGTTAGAGCTAGAAATAGCA	1	bc
AGTCGCTCGT	GAAACACCGGTGCATTCGAAAGTCCGGTCGTAGTGTGGACGTGGGGTTAG	1	bc
AGAAGGCTTT	GAAACACCGGTCTCGAGTGAGGGGGGTTAGAGCTAGAAATAGCAAGTTAA	1	bc
AAACAACGCC	GAAACACCGGTTTGAATCGGTGGGGTTAGAGCTAGAAATAGCAAGTTAAC	1	bc
GGCTCCGACC	GAAACACCGGTAAATTTGAGGCTCCGGCATGCAGGAGGCCGTGGGGTTAG	1	bc
AAGACACTCG	GAAACACCGGTGCATTCGAAAGTCCGGTCGTGGTGTGGACGTGGGGTTAG	1	bc
AACCTCGCCC	GAAACACCGGTTTGAACAAGAAATAGCAGGTTAACCTAAGGCTAGTACGT	1	bc
GCCGCAGCCC	GAAACACCGGTAGCAAGTGCGAGACGTGTTAAATAGCAATTTAACCTAAG	1	bc
TCGTGCGTTT	GAAACACCGGTTGAGCCATATCTAAAGCTTCACGTAACAAGTTGATTTGA	1	bc
AAACTAGGAT	GAAACACCGGTACCTTTGTTGATGCTGGGTGGAAGGTGGGGTTAGAGCTA	1	bc
AACACCGCGC	GAAACACCGGTTTGAACTAGAAATAGCAAGTTAACCTAAGGCTTGTCCGT	1	bc
TCTGCCCTAC	GAAACACCGGTGCCCTTACTCTCACCTGATTACTTAATCCGTGGGGTTAG	1	bc
GCGACGGGGG	GAAACACCGGTTATATTTGTAAGTGTGTGGGGTTAGAGCTAGAAATAGCA	1	bc
GAAACTATCA	GAAACACCGGTTCCATTGAGGGGCTAGAGCGGGAAGTAGCAAGTTAACCT	1	bc
CATCTCTTGC	GAAACACCGGTGCCGTCGAAAGTCCTGTCGTAGTGTGGATAGGGAGAGAG	1	bc
AGACCCAGAC	GAAACACCGGTAGCAAGTGCGAGCAAGTTAGAGCTAGAAATAGCAAGTTA	1	bc
TACCCTCAAC	GAAACACCGGTGACTATGTTCGTGCGGTGGCGCCAGAGCAGTGGGGGGAT	1	bc
GGAATCAGAC	GAAACACCGGTAGCAAGTGGGGTTAGAGCTAGAAATAGCAAGTTAACCCA	1	bc
AGGACCGCGC	GAAACACCGGTGCATTCGACAGTCCGGTCGTAGTGTGGACGTGGGGTTAG	1	bc
ACGACCATCG	GAAACACCGGTGCATTCGAAAGTCCGGTCGTAGTGTGGACGTGGGGTTAG	1	bc
CTGAGCAGAC	GAAACACCGGTTAAGCCGGTGGGGTTAGAGCTAGAAATAGCAAGTTAACC	1	bc
AGATCAGTGT	GAAACACCGGTGCATTTAAAAACTCGGTCGGGTTAGAGCTGGGGATAGCG	1	bc
GACAGAGTAA	GAAACACCGGTAGCAAGTGCGAGACGTGTTTGTGGGGTTAGAGCTAGAAA	1	bc
GCTGAGCGCC	GAAACACCGGTGCCAATGCGGTTGGGCTATGGCGAGATATAGCTAGAAAT	1	bc
CTAGCCCTGT	GAAACACCGGTTACATGAGGGTTAGAGCTAGAAATAGCAAGTTAACCTAA	1	bc
AAATCTGCCT	GAAACACCGGTCCGTAGGAGACCCGTGTGGCATGTACCTCTGTGGGGTTA	1	bc
GATGAACCGA	GAAACACCGGTCGGCGGCAATCGTGGGTGGGGTTAGAGCTAGAAATAGCA	1	bc
CTCCCCTGCA	GAAACACAGGTGTGGCTGAGAGTCCGGCAATGGTGTGGCTGTGGGGTTAG	1	bc
CCCACAGGCG	GAAACACCGGTAGCAAGTGCGAGACGTGTGTGGGGTTAGAGCTGGAAATA	1	bc
TAGAAACTCG	GAAACACCGGTGCATTCGAAAGTCCGGTCGTAGTGTGGACGTGGGGTTAG	1	bc
GTATCGATGT	GAAACACCGGTTACATTGAGGGTTAGAGCTAGAAATAGCAAGTTAACCTA	1	bc
AGACTCGGCA	GAAACACCGGTACCTTTGTTGATGCTGGGTGGAAGGAATGGGGTTAGAGC	1	bc
GAGCACTCCC	GAAACACCGGTTTGAACCGGTGGGGTTAGAGCTAGAAATAGCAAGTTAAC	1	bc
GAGTATCCTC	GAAACACCGGTTCCCGTCCAGTGGGGTTAGAGCTAGAAATAGCAAGTTAA	1	bc
AGACAGAGAC	GAAACACCGGTAGCAAGTGCGGGGTTAGAGCTAGAAATAGCAAGTTAACC	1	bc
CTGGCGACTC	GAAACACCGGTTCCCGTCCAGTGGGGTTAGAGCTAGAAATAGCAAGTTAA	1	bc
GCGTGGTGTC	GAAACACCGGTGACATTGGGTACAGGGTGGGGTTAGAGCTAGAAATAGCA	1	bc
CACGCGTTGT	GAAACACCGGTGACATTGTGGGGTTAGAGCTAGAAATAGCAAGTTAACCT	1	bc
TCGAATACTT	GAAACACCGGTCTCGAGTGAGGTGTTCAGGTTCAGGGTGGGGTTAGAGCT	1	bc
GTAGCTAGGG	GAAACACCGGTTACATTGAGGGTTAGAGCTAGAAATAGCAAGTTAACCTA	1	bc
GGTACCGAGG	GAAACACCGGTTATTTTTATACTCCGGCATGCATGGAGCCGTGGGGATCG	1	bc
TCTAGCATCA	GAAACACCGGTTAAGCCGAGGAGTTAGAGCTAGAAATAGCAAGTTAACAT	1	bc
ACCGTTACCG	GAAACACCGGTCGGGGCCACTCAGTGGTGGGGTTAGAGCTAGAAATAGCA	1	bc
CGATCCGCGC	GAAACACCGGTGCATTCGAAAGTCCGGTCGTAGTGTGGACGTGGGGTTAG	1	bc
AGCAGACCCG	GAAACACCGGTCGGCGGGGTTAGAACTAGAAATTGCAAGTTAACCTAAGG	1	bc
TGACCTAGAC	GAAACACCGGTAAGTATATTCATGCGATGTCGCCGTATCAGTGGGGTTAG	1	bc
AGGCGGAGCC	GAAACACCGGTTCCCGTCCAGTGGGGTTAGAGCTAGAAATAGCAAGTTAA	1	bc
AAGGCTGCCT	GAAACACCGGTCCGTAGGAGACCCGTGTGGCATGTACCTGTGGGGTTAGA	1	bc
TCAGAGACTC	GAAACACCGGTTCCCGTCACCTGAGGTTCTAGCTTGGGATAGCAGGCTAG	1	bc
AGTATCGCGC	GAAACACCGGTTATATTTGTAAGCGTGTGGGGTTAGAGCTAGAAATAGCA	1	bc
GAGTCGGCTA	GAAACACCGGTTCCCGTCCAGCGGGGTTAGTGCTAGAAATAGCAAGTTAA	1	bc
ACGGATCCTT	GAAACACCGGTCTCGAGTGAGGTGTTCAGGGTGGGGTTAGAGCTAGAAAT	1	bc
GGGGATGCCT	GCCTCCACGGCCACTAGTCTAAGGCTAGTCCGTTATCAAATTGAGAAAGT	1	bc
CCTCTTCGTT	GAAACACCGGTGTACGTATGGACTGAACCAGGGTGTGCAAGTGGGGTTAG	1	bc
TCAACAGCGC	GAAACACCGGTAGCAAGTGCGAGACGTGTTAAATAGCAAGTTAACCTAAG	1	bc
CGAGATGCAA	GAAACGCCGGTTCCCGTCCAGTGGGGTTAGAGCTAGAAATAGCAAGTTAA	1	bc
TGACACAGGC	GAAACACCGGTAGCAGGTGCGAAAAAGTGGGGTTAGAGCTAGAAATAGCA	1	bc
CGTAGAAGAC	GAAACACCGGTGTACGTATGGAGCTAGAAGTAGTAAGTTAAGCTAAGGCT	1	bc
ATCTATCGCG	GAAACACCGGTTATATTTGTAAGTGGGGTTAGAGCTAGAAATAGCAAGTT	1	bc
CCGATCGTGG	GAAACACCGGTTATATTTGTAAGTGTGTGGGGTTAGAGCTAGAAATAGCA	1	bc
ACATCACTAA	GAAACACCGGTGCCCTTACTCTCACCTGATTACTTAATCCCGTGGGGTTA	1	bc
CTCGCCATAC	GAAACACCGGTGCCCTTACTCTCACCTGATTACTTAATCCGTGGATATAG	1	bc
CCACTACTTT	GAAACACCGGTCTCGAGTGAGGTGTTCAGGGTGGGGTTAGAGCTAGAAAT	1	bc
TAATCGGGGT	GAAACACCGGTGTACGTATGGACTGAACCAGGGTGTGCAAGTGGGGTTAG	1	bc
AGGCCGCTAC	GAAACACCGGTAAATTTGAGGCTCCGGCATGCAGGAGGCCGTGGGGTTAG	1	bc
ACGAATCATT	GAAACACCGGTCTCGAGTGAGGTGTTCAGGGTGGGGTCAGAGCTAGAAAT	1	bc
TGGCTGAGAT	GAAACACCGGTTTACGTTGCATCGGTGTGGGGTTAGAGCTAGAAATAGCA	1	bc
ACAGAACGCG	GAGACACCGGTTTGAACAGAGCTAGAAATAGCAAGTTAACCTAAGGCTAG	1	bc
GAATAGTCGT	GAAACACCGGTGTACGTATGGACTGAACCAGGGTGTGCAAGTGGGGTTAG	1	bc
ACTACGCGGC	GAAACACCGGTACCTTTGTTGATGCTGGGTGGGGTTAGAGCTAGAAATAG	1	bc
TCGCTTATCA	GAAACACCGGTAACTATATTCATGCGATATCGCCGTATCAAGTGGGGTTA	1	bc
GTGGCGAATC	GAAGCACCGGTTCCCGTCCAGTGGGGTTAGAGCTAGAAATAGCAAGTTAA	1	bc
ATAACTCATA	GAAACACCGGTAACTATATTCATGCGATATCGCCGTATCAGTGGGGTTAG	1	bc
TTTTTACTGC	GAAACACCGGTCGGGGCCACTCAGGGGTGAGGTTAGTGCTAGAAATAGCA	1	bc
ACTGTCGGCC	GAAACACCGGTACCTTTGTTGATGCTGGGTGGAAGGAATTTGTGGGGTTA	1	bc
CACATTGTCC	GCTAGAAATAGCAAGTTAACCTAAGGCTAGCTCGTTATCAACTTGTAACA	1	bc
GTAACGCTCA	GAAACACCGGTGTGGATGAGGGTGCCCCACTGACGTGATTGTGGGGTTAG	1	bc
CTTGTGATGT	GAAACACCGGTGTGGAGGAGAGCCGTGTGGCGTTTAGGTTTGGGGGTAGA	1	bc
AAGAATGCTT	GAAACACCGGTCTCGAGTGAGGTATTCAGGGTGGGGTTAGAGCTAGAAAT	1	bc
AGATCCGTGC	GAAACACCGGTGCATTCGAAAGTCCGGTCGTAGTGTGGACGTGGGGTTAG	1	bc
GTCTAGAGAG	GAAACACCGGTTATATTTGTCAGTGTGTGGGGTTAAAGCTAGAAATAGCA	1	bc
GACCTTCGGT	GAAACACCGGTCGATTCATATCGAAACCTTTCCGTGACAGTGGGGTTAGA	1	bc
GATCGTTGTA	GAAACACCGGTGTACGTATGGACTGAACCAGGGTGTGCAAGTGGGGTTAG	1	bc
ACGAGTAGAA	GAAACACCGGTTAAGCCGAGGAGTTTCGTTAGAGCTAGAAATAGCAAGTT	1	bc
AAGCTTATCC	GAAACACCGGTTTACGTTGCATCGGTGTGGGGTTAGAGCTAGAAATAGCA	1	bc
TCATGACTCG	GAAACACCGGTCGGGGCCACTCAGTGGTGGGGTTAGAGCTAGAAATAGCA	1	bc
AACGTTGGGT	GAAACACCGGTCGATTCATATCGAAACCTTCCCGTGACAGTGGGGTTAGA	1	bc
GACGCACCGA	GAAACACCGGTCGGCGGCAATCGTGGGTGGGGTTAGAGCTAGAAATAGCA	1	bc
ATAGTTAGGT	GAAACACCGGTTACATTGGGGTTAGAGCTAGAAATAGCAAGTTAACCTAA	1	bc
CCTATCACGT	GAAACACCGGTCGGGGCCACTAAGTGGGTGGGGTTAGAGCTAGAAATAGC	1	bc
CTGGTTAGTT	GAAACACCGGTTTACGTTGCATCGGTGTGGGGTTAGAGCTAGAAATAGCA	1	bc
ACGATTCCTT	GAAACACCGGTCTCGTGTGAGGTGTTCAGGGTGGGGTTAGAGCTAGAAAT	1	bc
TCGTTTCTTC	GAAACACCGGTTCCCGTCCAGTGAGGTTAGAGCTAGAAATAGCAAGTTAA	1	bc
ATCTACAGAG	GAAACACCGGTTATATTTGTAAGTGTGTGGGGTTAGAGCTAGAAATAGCA	1	bc
TATCATCTAC	GAAACACCGGTAACTATATTCATGCGATATCGCCGTATCAGTGGGGTTAG	1	bc
ATGGACACGC	GAAACACCGGTCGGCGGGGCTAGAGCTAGGAATTGCAAGTTAAACTAAGG	1	bc
ATCAGCAGCT	GAAACACCGGTTTACGTTGCATCGGTGTGGGGTTAGAGCTAGAAATAGCA	1	bc
AACCATCGGT	GAAACACCGGTCGATTCATATCGAAACCTTCCCGTGACAGTGGGGTTAGA	1	bc
TCTATCATAG	GAAACACCGGTTATATTTGTAAGTGTTTGTGGGGTTAGAGCTAGAAATAG	1	bc
TATTTTGAGG	GAAACACCGGTTATATTTGTAAGTGTGTGGGTTTAGAGCTAGAAATAGCA	1	bc
CCTCGTTGTT	GAAACACCGGTGTACGTATGGACTGAACCAGGGTGTGCAAGTGGGGTTAG	1	bc
GTCCCCGTCC	GAAACACCGGTACGTCTGTTGGTGCTGCAAGGGAGGGGGGGTTAGGGTTG	1	bc
AAACGCACTA	GAAACACCGGTGACCTTACTCTCACCTGATTACTTAATCCGTGGGGTTAG	1	bc
CGAAACCTCC	GAAACACCGGTCTCGAGTGAGGTGGTTAGGGCTGGGATAGAGCTAGAAAT	1	bc
AGACGATGGC	GAAACACCGGTGCATTCGAAAGTCCGGTCGTGGTATGGCTGTAAGTATCG	1	bc
TGGCCCCCAC	GAAACACCGGTAAATTTGAGGCTCCGGCATGCAGGAGGCCGTGGGGTTAG	1	bc
AAGAACGCTC	GAAACACCGGTTTGAACTAGAAATAGCAAGTTAACCTAAGGCTAGTCCGT	1	bc
AAGCATACCT	GAAACACCGGTTTGAACTACCTAGTTCAAACCGGTGGGGTTAGAGCTAGA	1	bc
ATGGTGAGAT	GAAACACCGGTTTACGTTGCATCGGTTAGAGCTAGAAATAGCAAGTTAAC	1	bc
CAGACACAGA	GAAACACCGGTAGCAAGTGCGTGGGGTTAGAGCTAGAAATAGCAAGTTAA	1	bc
GAGGGCACGC	GAAACACCGGTCGGCGGCGAGCTAGAAATAGCAGGTTAACCTAAGGCTAG	1	bc
TTAGCCCAGT	GAAACACCGGTTACACTGAGGGGTTAGAGCTAGAAATAGCAAGTTAACCT	1	bc
AACGTAGTAC	GAAACACCGGTGCCCTTACTCTCACCTGATTACTTAATCCGTGGGGTTAG	1	bc
ACGATTAGAC	GAAACACCGGTTTACGTTGCTTCGGTTGTGGGGTTAGAGTTAGAATTAGC	1	bc
GACGACCCAA	GAAACACCGGTCGGCGGCAATCGTGGGTGGGGTTAGAGCTAGAAATAGCA	1	bc
CTGTTCGGCA	GAAACACCGGTACTTCTGTTGGTGCTGGGGGGAAGGAGATAGAGACAGCG	1	bc
ACTCTGACGC	GAAACACCGGTCGGGGCGGGGGTAGAGCGTGAAATAACAAGTTAAACTAA	1	bc
GTGGACGCGA	GAAACACCGGTCGGCGGCAATCGTGGGTGGGGTTAGAGCTAGAAATAGCA	1	bc
AGGACTTCCT	GAAACACCGGTAAATTTGACGCCCTGTCGTGCGGGGGTCGGGGTAGATAT	1	bc
GCTGGTCGTC	GAAACACCGGTGTACGTATGGACTGAACCAGGGTGTGCAAGTGGGGTTAG	1	bc
GGGCCGTATC	GAAACACCGGTTCCCGTCCAGTGGGGTTAGAGCTAGAAATAGCAAGTTAG	1	bc
ACCTATGGTC	GAAACACCGGTCGATTCATGTCGAAACCTTCCCGTGACAAGTGGGGTTAG	1	bc
TAGATCGATG	GAAACACCGGTTCTGTTTGTTAGTGTGTGGGGTTAGAGCTAGAAATAGCA	1	bc
TTGCTATTGA	GAAACACCGGTTACATTGAGGGTTGGAGCTAGAAATAGCAAGTTAACCTA	1	bc
GCCTTTTGCG	GAAACACCGGTCGGGGCCACTCAGTGGTGGGGTTAGAGCTAGAAATAGCA	1	bc
GACAGCCGTC	GAAACACCGGTGTGGCTGAGAGTCCGGCAATGGTGTGGCTGTGGGGTTAG	1	bc
TACCAATGCA	GAAACACCGGTAAATTTGAGGCTCCGGCATGCAGGAGGCCGTGGGGTTAG	1	bc
TCTTGCCATC	GAAACACCGGTGTACGTATGGACTGAACCAGGGTGTGCAAGTGGGGTTAG	1	bc
AGCCCCCCTC	GAAACACCGGTGTGGCTGAGAGTCCGGCAATGGTGTGGCTGTGGGGTTAG	1	bc
ACGTGTTGAC	GAAACACCAATGTCACCGGTGGGGTTAGAGCTAGAAATAGCAAGTTAACC	1	bc
GAGAAAGCCC	GAAACACCGGTTTGAACTAGAAATAGCAAGTTAACCTAAGGCTAGTCCGT	1	bc
ATCTCACTAC	GAAACACCGGTGCCCTTACTCTCACCTGATTACTTAATCCGTGGGGTTAG	1	bc
TAGTGTTGTC	GAAACACCGGTGACATTGAGTGGGGTTAGAGCTAGAAATAGCAAGTTAAC	1	bc
AGGGACTCGC	GAAACACCGGTGCATTCGAAAGTCTGGTCGTAGTGTGGAAGTGGGGTTAG	1	bc
GATAGGACTC	GAAACACCGGTCCGTAGGAGACCCGTGTGGCATGTACCTGTGGGGTTAGA	1	bc
ATGAGATTAA	GAAACACCGGTTAAGCCGTGGAGTTAGATCTAGAAATAGCAAGTTAACCT	1	bc
AGAAGTCATA	GAAACACCGGTGCCCTTACTCTCACCTGATTACTTAATCCGTGGGGCTAG	1	bc
GGAACACGCC	GAAACACCGGTGTGGCTGAGAGTCCGGCAATGGTGTGGCTGTGGGGTTAG	1	bc
ATAAGCTATG	GAAACACCGGTACAGGGTTAGAGCTAGAAATAGCAAGTTAACCTAAGGCT	1	bc
AAGACATTCG	GAAACACCGGTGCATTCGAAAGTCCGGTCGTAGTGTGGACGTGGGGTTAG	1	bc
AGGGCACTAC	GAAACACCGGTGCCCTTACTCTCACCTGATTACTTAATCCGTGGGGTTAG	1	bc
ATCTATAGAG	GAAGCACCGGTTATATTTGTAAGTGTGTGGGGTTAGAGCTAGAAATAGCA	1	bc
TCGAGCGAGA	GAAACACCGGTTATATTTGTAAGCGTGCGGGGTTAGAGCTAGAAATAGCA	1	bc
AACCAACGCC	GAAACACCGGTTTGAACTACCTAGTAGCAAGTTAACCTAAGGCTAGTCCG	1	bc
GATGCGATCG	GAAACACCGGTGCATTCGAAAGTCCGGTCGTAGTGTGGACGGGGGGTTAG	1	bc
GGCACCACAC	GAAACACCGGTAAATTCGAGGCTCCGGCATGCAGGAGGCCGTGGGGTTAG	1	bc
AAGGAACTAT	GAAACACCGGTGCCCTTGCTTTCACCTGATTACTTAATCCGTGGGGTTAG	1	bc
CAACAAGTCA	GAAACACCGGTACCTTTGTTGATGCTGGGTAGAAGGTACACCGGTAACTT	1	bc
ATAGTGTTGT	GAAACACCGGTGACATTGGGTTAGAGCTAGAAATAGCAAGTTAACCTAAG	1	bc
GCGTCTGCCT	GAAACACCGGTCCGTAGGAGACCCGTGTGGCATGTACCTGCGGGGTTAGA	1	bc
GAGACAGCGA	GAAAAACCGGTAGCACGTGCGTGGGGTTAGAGCTAGAAATAGCAAGATAA	1	bc
GTAACCGGCC	GAAACACCGGTGTGGCTGAGAGTCCGGCAATGGAGTGGCTGTGGGGTTAG	1	bc
GCATTCGACA	GAAACACCGGTAGCAGGTGCGAGACGTGTTTGTGGGGGTAGAGCTAGAAA	1	bc
TTTAGCCGAC	GAAACACCGGTGAACGTATGGACTTAGCCCTAGAAATCACATGTTGATCG	1	bc
CATAGGTGTC	GAAACACCGGTGTACGTATGGACTGAACCAGGGTGTGCAAGTGGGGTTAG	1	bc
AATATGGGTT	GAAACACCGGTCGATTCATATCGAAACCTTCCCGTGACAGTGGGGTTAGA	1	bc
ACACCCCGCG	GAAACACGGGTTAGAGCTAGAAATAGCAAGTTAACCTAAGGCTAGTCCGT	1	bc
AAATCAGGTT	GAAACACCGGTCGATTCATATCGAAACCTTCCCGAGACAGTGGGGTTAGA	1	bc
ACTAACTTTT	GAAACACCGGTTATATTTGTAAGTGTTGTGGGGTTAGAGCTAGAAATAGC	1	bc
AAACGACCTA	GAAACACCGGTGCCCTTGCTCTCACCTGATAACCTGGGGTTAGAGCTAGA	1	bc
TCATCGCCGT	GAAACACCGGTGTACGTATGGACTGAACCAGGGTGTGCAAGTGGGGTTAG	1	bc
ACAAAAGGCC	GAAACACCGGTTTAGAGCTAGAAATAGCAAGTTAACCTAAGGCTAGTCCG	1	bc
CGACCTGCGC	GAAACACCGGTGACCACCGGGGTAGAGCTGGAGATAGCAAGTTAACCTAG	1	bc
GGAACTCTAC	GAAACACCGGTGTGGCTGAGAGTCCGGCAATGGTGTGGCTGTGGGGTTAG	1	bc
ACCTGTTGTC	GAAACACCGGTGACATTGGGTACAGGGTGGGGTTAGAGCTAGAAATAGCA	1	bc
GCCTATTGCG	GAAACACCGGTCGGGGCCACTCAGTGGGTGGGGTTAGAGCTAGAAATAGC	1	bc
GCGCATCCTT	GAAACACCGGTCTCGAGTGAGGTGTTCAGGGTGGGGTTAGGGCTAGAAAT	1	bc
AGAACTGCGC	GTAACACCGGTGCATTCGAAAGTCCGGTCGTAGTGTGGACGTGGGGTTAG	1	bc
GAAGAATCTC	GAAACACTGGTCGGCGGCAATCGTGGGTGGGGTTAGAGCTAGAAATAGCA	1	bc
CAGCGTAGGC	GAAACACCGGTGTACGTATGGACTGAACCAGGGTGTGCAAGTGGGGTTAG	1	bc
GAGGCCCCAC	GAAACACCGGTGCCCTTACTCTCACCTGATTACTTAATCCGTGGGGTTAG	1	bc
TGGGTTGTAT	GAAACACCGGTGACATTGGGTACGGGGTTAGAGCTAGAAATAGCAAGTTA	1	bc
AGTGGCGTCT	GAAACACCGGTCCCGTCCAGTGGGGTTAGAGCTAGAAAAAGCAAGTTAAA	1	bc
CCTAGACGCC	GAAACACCGGTGTACGTATGGACTGAACCAGGGTGTGCAAGTGGGGTTAG	1	bc
GGGCACATAT	GAAACACCGGTAAATTTGAGGCTCCGGCATGCAGGAGGCCGTGGGGTTAG	1	bc
GCACAACGCA	GAAACACCGGTTTGAACTACCTAGTTCAAACACCGGTTTGAACTACCTAG	1	bc
TCCTTTATCG	GAACCTAAGGCTAGTCCGTTACAACTTGAAAAAGTGGCACCGAGTCGGTG	1	bc
TATGCTTCGC	GAAACACCGGTTTACGTTGCATCGGTTGGGGGGGTAGAGCTGGAAGTAGC	1	bc
ATGCACCCTC	GAAACACCGGTGTGGCTGAGAGTCCGGCAATGGTGTGGCTGTGGGGTTAG	1	bc
CCTACAGCGC	GAAACACCGGTTTGAACTAGAAATAGCAAGTTAACCTACTGCTAGTCCGT	1	bc
GGGGATGCTT	GAAACACCGGTTACAGTGGGGACAGGGTTAAACTTGGAATAACCAGGTAA	1	bc
TCCTACGCCC	GGGCTAGAGCGAGAAATAGCAAGATAACTTATAACTAGTCCTTTATCAAC	1	bc
TGATTTCATT	GAAACATCGGTCTCGAGTGAGGTGTTCAGGGTGGGGTTAGAGCTAGAAAT	1	bc
AAGTGTTGTC	GAAACACCGGTGACATTGGGTACAGGGTTAGAGCTAGAAATAGCAAGTTA	1	bc
AGGTCTACCA	GAAACACCGGTTTACGTTGCATCGGGTTAGAGCTAGAAATAGAAAGTTAA	1	bc
AATCTGATAC	GAAACACCGGTAACTATATTCATGCGATATCGCCGTATCAGTGGGGTTAG	1	bc
GCATCGAAGT	GAAACACCGGTGTACGTATGGACTGAACCAGGGTGTGCAAGAGGGGTTAG	1	bc
GAATGCTTAG	GAAACACCGGTTTACGTTGCATCGGGGTTAGAGCTAGAAATAGCAAGTTA	1	bc
AAAGCCATAA	GAAACACCGGTGCCCTTACTCTCACCTGATTACTTAATCCGTGGGGTTAG	1	bc
TCATCGACGC	GAAACACCGGTGTACGTATGGACTGAACCAGGGTGTGCAAGTGGGGTTAG	1	bc
GCCAGTGGCT	GAAACACCGGTTACCTTGGGAATAATAGCAAGTTAACCTAAGGCTAGTCC	1	bc
AAACGCGATA	GAAACACCGGTGCCCTTACTCTCACCTGATTACTTAATCCGTGGGGTTAG	1	bc
ACGCTTACAT	GAAACACCGGTTTACGTTGCATCGGTTGTGGGGTTAGAGCTAGAAATAGC	1	bc
GACACTGTGA	GAAACACCGGTAGCAAGTGCGAGACGTTTTTGTGGGGTTAGAGCTAGAAA	1	bc
GAGGAACCCA	GAAACACCGGTTCCCGTCCAGTGGGGTTAGAGCTAGAAATAGCAAGTTAA	1	bc
CGGGACTTGC	GAAACACCGGTGCATTCGAAAGTCCGGTCGTAGTGTGGACGTGGGGTTGG	1	bc
GCGAAGCCTT	GAAACACCGGTCTCGAGTGAGGTGTTCAGGGTGGGGTTAGAGCTAGAAAT	1	bc
TCATTTATGC	GAAACACCGGTCGGGGCCACTCAGTGGTGGGGTTAGAGCTAGAAATAGCA	1	bc
TAGCTGATTC	GAAACACCGGTAACTATATTCATGCGATATCGCCGTATCAGTGGGGTTAG	1	bc
GAGACGGCCT	GAAACACCGGTCCGTAGGAGACCCGTGTGGCATGTACCTGTGGGGTTAGA	1	bc
AGATGACCCG	GAAACACCGGTCGGCGGCAATATAGCAAGTTAACCTAAGGCTAGTCCGTT	1	bc
GAGGACGAGA	GAAACACCGGTGGGTTAGAGCTAGAAATAGCAAGTTAACCTAAGGCTAGT	1	bc
CTAATTGTTT	GAAACACCGGTCTCGAGTGAGGTGTTCAGGGGGGGGTTAGAGCTAGAAAT	1	bc
GAACGCACAA	GAAACACCGGTGCCCTTACTCTCACCTGATTACTTAATCCGTGGGGTTAG	1	bc
ATCTATAGAG	GAAACACCGGTTATATTTGTAAGTGTGTGGGGTTAGAGCTAGAAATAGCA	1	bc
GTAGACCCTA	GAAACACCGGTCGGCGGAAGTTAACCTAAGGCTAGTCCGTTATCAACTTG	1	bc
TCTGTGGCGC	GAAACACCGGTTATATTTGTAAGTGTGTGGGGTTAGAGCTAGAAATAGCA	1	bc
AAAGATCGGC	GAAACACCGGTAAACGGCAAACGAGGAACGAAATATAGCAAGTTAACCAG	1	bc
ACTGCACTTC	GAAACACCGGTGCCCTTACTCTCACCTGATTACTTAATCCGTGGGGTTAG	1	bc
AAGCGTAGAT	GAAACACCGGTTTACGTTGCATCGGTGTGGGGTTAGAGCTAGAAATAGCA	1	bc
AGGGACCCTC	GAAACACCGGTGTGGCTGAGAGTCCGACAATGGTGTGGCTGTGGGGTTAG	1	bc
CAACTTCTTC	GAAACACCGGTCTCGATATTGATGTTCAGGCGGCGTATAGAGCGAGAAAT	1	bc
TACAACGACA	GAAACACCGGTTTAGAGCTAGAAATAGCAAGTTAACCTAAGGCTAGCCCG	1	bc
GAACGAGCTA	GAAACACCGGTGCCCTTACTCTCACCTGATTACTTAATCCGTGGGGTTAG	1	bc
GAAACAAGAT	GTCGAATTCGGGCCCATTGGTATGGCAGATCGGAAGAGCACACGTCTGAA	1	bc
TCTCTACGCC	GAAACACGGGTTAGAGCTAGAAATAGCAAGTTAACCTAAGGCTAGTCCGT	1	bc
GGAGCTCTCT	GAAACACCGGTGTGGCTGAGAGTCCGGCAATGGTGTGGCTGTGGGGTTAG	1	bc
ACGAGTTGTC	GAAACACCGGTGACATTGGGTACAGGGGTGGGGTCAGAGCTAGAAATAGC	1	bc
AAACAGCCGC	GAAACACCGGTCGGCGGCCGGTTAGAGCTAGAAATAGCAAGTTAACCTAA	1	bc
AATAGACGTC	GAAACACCGGTGTACGTATGGACTGAACCAGGGGTGGGGTTAGAGCTAGA	1	bc
AACATCGCAC	GCTAGAAATAGCAAGTTAACCTAAGGCTAGTCCGTTATCAACTTGAAAAA	1	bc
GGACACTAAA	GAAACACCGGTAAATTTGAGGCTCCGGCATGCAGGAGGCCCGTGGGGTTA	1	bc
AGCTTCTATA	GAAACACCGGTAGATTTGAGGCTCCGGCATGCAGGAGGCCGTGGGGTTAG	1	bc
GACAAAGAAC	GAAACACCGGTAGCAAGTGCGGGGTTAGAGCTAGAAATAGCAAGTTAACC	1	bc
AGGAGGCCTC	GAAACACCGGTCCGTCGGAGACCCGTGTGGCATGTACCTGTGGGGTTAGA	1	bc
GGGGGGCCTT	GAAACCCCGGTTCCCGTCCAGTGGGGTTATCGCTAGAGATAGCAAGTTAA	1	bc
GAGGAGAATC	GAAACACCGGTTCCCGTCCAGTGGGGTTAGAGCTAGAAATAGCAAGTTAA	1	bc
GAGGCCGTCG	GAAACACCGGTGCATTCGAAAGTCCGGTCGTAGTGTGGCCGTGGGGTTAG	1	bc
AAGTGTCGTC	GAAACACCGGTGTACGTATGGACTGAACCAGGGTGTGCAAGTGGGGTTAG	1	bc
CGTCGGCCGC	GAAACACCGGTCCGTAGGAGACCCGTGTGGCATGTACCTGTGGGGTTAGA	1	bc
GAGCAAGAAA	GAAACACCGGTAGCAAGTGCGAGCATTTTGTGGGGTTAGAGCTAGAAATA	1	bc
AGATGACCAG	GAACCACCGGTCGGCGGCAATCGTGGGTGGGGTTAGAGCTAGAAATAGCA	1	bc
TAGACACTCG	GAAACACCGGTGCATTCGAAAGTTCGGTCGTAGTGTGGACGTGGGGTTAG	1	bc
GGGATGCTTC	GAAACACCGGTCCCGAGTGAGGGGTTCAGGGTGTGGTTAGAGCTAGAAAT	1	bc
ACGCATAGAC	GCAACACCGGTTTACGTTGCATCGGTGTGGGGTTAGAGCTAGAAATAGCA	1	bc
GAGATCCGCG	GAAACACCGGTGCATTCGAAAGTCCGGTCGTAGTGTGGACGTGGGGTTGG	1	bc
AGATCGTTCC	GAAACACCGGTGCATTCGAAAGTCCGGTCGTGGTGTGGACATGGGGATAG	1	bc
TGTGTAGTCC	GAAACTAGAGCTAGACATAGCAGGTTAACCTAAGGCTAGGCCGGTATCAG	1	bc
GCCAGCTGCC	GAAACACCGGTAAATTTGAGGCTCCGGCATGCAGGAGGCCGTGGGGTTAG	1	bc
AAGAAAGCCC	GAAACACCGGTTTGCACTACCTAGTTCAAACCGGTGGGGTTAGAGCTACA	1	bc
AGAAGACTTT	GAAACACCGGTCTCGAGTGAGGTGTTCAGGGTGGGGTTAGAGCTAGAAAT	1	bc
ATCTCTCGAG	GAAACACCGGTTATATTTGTAAGTGTGTGGGGTTAGAGCTAGAAATAGCA	1	bc
GAGAAGGCTC	GAAACACCGGTTCCCGTCCAGTGGGGTTAGAGCTAGAAATAGCAAGTTAA	1	bc
ACTCTTACGC	GAAACACCGGTCGAGGCCGCTCCGTGGTGGGGTTAGAGCTAGAAATAGCA	1	bc
CTCATAGGGC	GAAACACCGGTTATATTTGTACGTGTGTGGGTTTAGAGCTAGAAATAGCA	1	bc
CCATCAGGGC	GAAACACCGGTCGGGGCCACTCAGTGGCGGGGCTAGAGCTAGAAATAGCA	1	bc
AAAGGCCTTT	GAAACACCGGTGCCCTTACTCTCACCTGATTACTTAATCCGTGGGGTTAG	1	bc
GATGCCACGC	GAAACACCGGTCGGCGGCCGATTAGAGCTAGAAATAGCAAGTTAACCTAA	1	bc
GGACAGTACA	GAAACACCGGTACATTTGAGGCTCCGGCATGCAGGAGGCCGTGGGGTTAG	1	bc
GGCACCGGCT	GAAACACCGGTGTGGCTGAGAGTCCGGCAATGGTGTGGCTGTGGGGTTAG	1	bc
AGCGTGCTAC	GAAACACCGGTTCCCTTACTCTCACCTGATTACTTAATCCGTGGGGTTAG	1	bc
GTAGAGAGTC	GAAACACCGGTTCCCGTCCAGTGGGGTTAGAGCTAGAAATAGCAAGTTAA	1	bc
ATTAGCAGAA	GAAACACCGGTTAAGCCGAGTGGGGTTAGAGCTAGAAATAGCAAGTTAAC	1	bc
CGACAGCCTC	GAAACACCGGTCCGTAGGAGACCCGTGTGGCATGTACCTGGGGGGTTAGA	1	bc
GCACAAAGAA	GCTAGAAATAGCAAGTTAACCTAAGGCTAGTCCGTTATCAACTTGAAAAA	1	bc
AGGCACACTA	GAAACACCGGTGTGGCTGAGAGTCCGGCAATGGTGTGGCTGTGGGGTTAG	1	bc
AAGATTAGCA	GAAACACCGGTTTACGTTGTATCGGCTGTGGGGTTAGACCTAGAAATAGC	1	bc
ATCTCTCGAG	GAAACACCGGTTATATTTGTAAGTGTTTTGTGGGGTTAGAGCTAGAAATA	1	bc
AATAATCGGC	GAAACACCGGTACCTTTGTTGATGCTGGGTGGGGTTAGAGCTAGAAATAG	1	bc
GTCTATCGCG	GAAACACCGGTGGGGTTAGAGCTAGAAATAGCAAGTTAACCTAAGGCTAG	1	bc
TAGACGATCG	GAAACACCGGTGCATTCGAAAGTCCGGTCGTAGTGTGGACGTGGGGTTAG	1	bc
GGTCGACCTA	GAAACACCCGTCCGTAGGAGACCCGTGTGGCATGTACCTGTGGGGTTAGA	1	bc
AGACTCCGTT	GAAACACCGGTCTCGAGTGAGGTGTTCAGGGTGGGGTTAGAGCTAGAAAT	1	bc
TCCCATATCC	GAAACACCGGTGTGGCTGAGAGTCCGGCAATGGTGTGGCTGGGGGGTTAG	1	bc
CTCCCCTGCA	GAAACACCGGTGTGGCTGAGAGTCCGGCAATGGTGTGGCTGCGGGGTTAG	1	bc
GAACAACGCA	GAAACACCGGTTTGAACTAGAAATAGCAAGTTAACCTAAGGCTAGTCCGT	1	bc
AGTGTTGCCC	GAGACACCGGTGACATTGGGTACAGGGGTGGGGTTAGAGCTAGAAATAGC	1	bc
ATAACTACAA	GAAACACCGGTTACATAGAGGGGTTAGAGCTAGAAATAGCAAGTTAACCT	1	bc
TTGACTGTCA	GAAACACCGGTAGCATGTGCGGGGATAGAGCTAGAAATAGCAATTTAACC	1	bc
TGAGACAGAC	GAAACACCGGTAGCAAGTGCGAGACGTGTTTGTGGGGTTAGAGCTAGAAA	1	bc
GCGAAGCGTT	GAAACACCGGTCTCGAGTGAGGTGTTCAGGGTGGGGTTAGAGCTAGAAAT	1	bc
GTAAGTCAGT	GAAACACCGGTTACATCTCTGAGGGTTAGAGCTAGAAATAGCAAGTTAAC	1	bc
CTGGGGGAAC	GAAACACCGGTTAAACCGCGGAGGTTCGTTATAGCTAGAAATAGCAAGTT	1	bc
GGAGCGGCTC	GAAACACCGGTGCATTCGAAAGTCCGGTCGTAGTGTGGACGTGGGGTTAG	1	bc
AAGCATACCT	GAAACACCGGTTTACGTTGCATCGGTGTGGAGTTAGAGCTAGAAATAGCA	1	bc
AATGAGCATA	GAAACACCGGTTAAGCCGAGGAGTTAGAGCTATAAATAGCAAGTTAACCT	1	bc
TTAACCATAT	GAAACACCGGTTATTGGGGTTAGAGCTAGAAATAGCAAGTTAACCTAAGG	1	bc
ACTGCTAGGC	GAAACACCGGTACCTTTGTTGATGCTGGGTGGAAGGATGCTGGGTGGGGT	1	bc
TAGAGCGTAC	GAAACACCGGTTAAAGAGCTAGAAATAGCAAGTTAACCTAAGGCTAGTCC	1	bc
GCCAACAGCC	GAAACACCGGTGTGGCTGAGAGTCCGGCAATGGTGTGGCTGTGGGGTTAG	1	bc
CTGCTAAGGC	GAAACACCGGTTTACGCTGCATCGGTGTGGGGTTAGAGCTAGAAATAGCG	1	bc
ATCGAGCATA	GAAACACCGGTTAAGCCGAGGATGGGGTTAGAGCTAGAAGTAGCAAGTTA	1	bc
ATTAGCGGTG	GAAACACCGGTTACATTGAGGGTTAGAGCTAGAAATAGCAAGTTAACCTA	1	bc
TTCGCCCTGC	GAAACACCGGTGCCCTTACTCTCACCTGATTACTTAATCCGTGAGGATAG	1	bc
AAACGTCGTA	GAAACGCCGGTGTACGTATGGACTGAACCAGGGTGTGCAAAAGTGGGGTT	1	bc
AAACGGTCGC	GAAACACCGGTGCATTCGAAAGTCCGGTCGTAGTGTGGACGTGGGGTTAG	1	bc
TACCAACTAC	GAAACACCGGTAACTATATTCATGCGATATCGCCGTATCAGTGGGGTTAG	1	bc
ACATTTACCG	GAGCTAGAAATAGCAAGTTAACCTAAGGCTAGTCCGTTACAACTTGAAAA	1	bc
ATGTCTTTGA	GAAACACCGGTTGAATTTGGGGCTTAGAGCGAGTAGAAGTAGGAATAGCA	1	bc
TACATTTGGT	GAAACACCGGTCGATTCATATCGAAACCTTCCCGTGACAGTGGGGTTAGA	1	bc
TGGGCGCCTC	GAAACACCGGTTCCCGTCCAGTGGGGTTAGAGCTAGAAATAGCAAGTTAA	1	bc
GAGAACGACA	GAAACACCGGTAGCAAGTGCGAGACGTGTTGGTGGGGTTAGAGCTAGAGA	1	bc
AGTATCCATT	GAAACACCGGTCTCGAGTGAGGTGTTCAGGGTCAGGGTGGGGTTAGAGCT	1	bc
GTTTTGCGCC	GAAACACCGGTACATTTGAGGATCCGGCGTGCAGGGGACCGTGGGGTTGG	1	bc
TCACCGTTGT	GAAACACCGGTAAATTTGAGGCTCCGGCATGCAGGAGGCCGTGGGGTTAG	1	bc
ACCTTTAACG	GAAACACCGGTCGGGGCCACTCAGTGGTGGGGTTAGAGCTAGAAATAGCA	1	bc
GAACTCATCA	GAAACACCGGTAACTATATTCATGCGATATCGCCGTATCAGTGGGGTTAG	1	bc
AGTCCCTCCT	GAAACACCAGTGCATTCGAAAGTCCGGTCGTAGTGTGGCCGTGGGGTTAG	1	bc
ACTACACGGC	GAAACACCGGTACCTTTGTTGATGCTGGGTGGAAGGTGGGGTTAGAGCTA	1	bc
GAGTGTTGTC	GAAACACCGGTGACATTGGGTACAAAATAGCAAGTTAACCTAAGGCTAGT	1	bc
ACTATAACGC	GAAACACCGGTCGGGGCCACCCAGTGGTGGGGTTAGAGCTAGAAATAGCA	1	bc
CTGATTAGCC	GAAACACCGGTTTACGTTGCATCGGTTGTGGGGTTAGAGCTAGAAATAGC	1	bc
AAGCGTCGTA	GAAACACCGGTGTACGTATGGACTGAACCAGGGTGTGCAAGTGGGGTTAG	1	bc
GGCCGTTAAA	GAAACACCGGTAAATTTGAGGCTCCGGCATGCAGGAGGCCGTGGGGTTAG	1	bc
AAGACCAGCG	GAAACACCGGTGCATTCGAAAGTCCGGTCGTAGTGTGGACGTGGGGTTAG	1	bc
AGCAACAGAC	GAAACACCGGTAGCAAGTGGGGTTAGAGCTAGAAATAGCAAGTTAACCTA	1	bc
ATGGCTATTT	GAAACACCGGTTACAATTGGGGTTAGAGCTAGAAATAGCAAGTTAACCTA	1	bc
AGACTCATTT	GAAACACCGGTCTCGAGTGAGGTGTTCAGGGTGGGGTTAGAGCTAGACAT	1	bc
GATGATTCTC	GAAACACCGGTTTACGTTGCATCGGTTGTGGGGTTAGAGCTAGAAATAGC	1	bc
TCGACGGCGG	GAAACACCGGTTTTATTTGGAAGCGTGTGGGGGTAGAGCTAGATATAGCA	1	bc
CATTTACGGA	GAAACACCGGTCGGGGCCACTCAGTGGTGGGGTTAGAGCTAGAAATAGCA	1	bc
AGAAGCCCCG	GAAACACCGGTCGGCGGCAATCGTGGGTGGGGTTAGAGCTAGAAATAGCA	1	bc
CTGCTTGGAC	GAAACACCGGTTTACGTTGCATCGGTTGTGGGGTTAGAGCTAGAAATAGC	1	bc
GGACAGAGAC	GAAACACCGGTAGCAAGTGCGTTTTGGTGGGGTTAGAGCTAGAAATAGCA	1	bc
GTCAAAGACC	GAAACACCGGTGTGGCTGAGAGTCCGGCAATGGTGTGGCTGTGGGGTTAG	1	bc
TAAAGTATCC	GAAACACCGGTAACTATATTCATGCGATATCGCCGTATCAGTGGGGTTAG	1	bc
GCTGAGCATC	GAAACACCGGTTCCCGTCCAGTGGGGTTAGAGCTAGAAATAGCAAGTTAA	1	bc
CGACCGTCGA	GAAACACCGGTGCATTCGAAAGTCCGGTCGTAGTGTGGACGTGGGGTTAG	1	bc
CATCGCAGAA	GAAACGCCGGTGTACGTATGGACTGAACCAGGGTGTGCAAGTGGGGTTAG	1	bc
GACGAACGGC	GAAACACCGGTCGGCGGCAATCGTGGGTGGGGTTAGAGCTAGAAATAGCA	1	bc
GGGGAGGTCT	GAAACACCGGTGGGTGGGGTTAGAGCTAGAAATAGCAAGTTAACCTAAGG	1	bc
CACATGGTGG	GAAACACCGGTGTACGTATGGACTGAACCAGGGTGCGCAAAAGTGGGGTT	1	bc
GTAACAGCCA	GAAACACCGGTAGCAAGTGCGGGGTTAGAGCTAGAAATAGCAAGTTAACC	1	bc
GAGGACGCGA	GAAACACCGGTCGGCGGCAATCGTGGGGTGGGGTTAGAGCTAGAAATAGC	1	bc
CTCCCTTGGA	GAAACACCGGTGTGGCTGAGAGTCCGGCAATGGTGTGGCTGTGGGGTTAG	1	bc
GACGAGGCGA	GAAACACCGGTCGGCGGCAATCGTGGGTGGGGTTAGAGCTGGAAATAGCA	1	bc
GCGCCTGGCT	GAAACACCGGTCCGTAGGAGACCCGTGTGGCATGTACCTGTGGGGATAGA	1	bc
ACCACAGACT	GAAACACCGGTAGCAAGTGCGAGACGTTTTTGTGGGGTTAGAGCTAGAAA	1	bc
ACAAAAATCC	GAAACACCGGTTTGAACTACCTAGTTCAAACCGGTGGGGTTAGAGCTAGA	1	bc
AAAGACCCAA	GAAACACCGGTGCCCTTACTCTCACCTGATTACTTAATCCGTGGGGTTAG	1	bc
TCATGTAAAC	GAAACACCGGTAACTATATTCATGCGATATCGCCGTATCAGTGGGGTTAG	1	bc
AGGCACTCTC	GAAACACCGGTTTGGCTGAGAGTCCGGCAATGGTGTGGCTGTGGGGTTAG	1	bc
AAACAATGCT	GAAACACCGGTTTGACCCGGTGGGGTTAGAGCTAGAAATAGCAAGTTAAT	1	bc
ATGCTTGGAC	GAAACACCGGTTTACGTTGCATAGGCGTAGGGGTCGAGCTAGAAATAGAA	1	bc
TAACGTCGTT	GAAACACCGGTTAACGTAACCACTGAAACAGGGTGGGCACGTGGGGCTAG	1	bc
ACGTGTGGTC	GAAACACCGGTTCCATTGATTACCAGGGCGGAGTTAGAACGAGGAATAAC	1	bc
GTAACTCATC	GAAACACCGGTGTGGCTGAGAGTCCGGCAATGGTGTGGCTGTGGGGTTAG	1	bc
TAAGGCCTCC	GAAACACCGGTGCCCTTACTCTCACCTGATTACTTAATCCGTGGGGTTAG	1	bc
AGTCTTACTA	GAAACACCGGTCCGTAGGAGACCCGTGTGGCATGTACCTGTGGGGTTAGA	1	bc
AGATTGGCTT	GAAACACCCGGTGCTTTTTTGCCTGCAGGGAGGCAGACTGAACTCGAGCC	1	bc
GAGCAACCGC	GAAACACCGGTCGGCGGCAATCGTGGTATGAGCCACGTGGGGTTAGATCG	1	bc
ATTGGCGATG	GAAACACCGGTTACATTGAGGGGTTAGAGCTAGAAATAGCAAGTTAACCT	1	bc
AAGACACGCG	GAAACACCGGTGCATTCGAAAGTCCGGTCGTAGTGTGGACGTGGGGTTAG	1	bc
CTGATTACCT	GAAACACCGGTTTACGTTGCATCGGTGTGGGGTTAGAGCTAGAAATAGCA	1	bc
GAATAATAGG	GGCAAGTTAACCTAAGGCTAGTCCGTTATCAACTTGAAAAAGTGGCACCG	1	bc
AGGCACTCGA	GAAACACCGGTGCATTCGAAAGTCCGGTCGTAGTGTGGACGTGGGGTTAG	1	bc
AGGTTCCTTT	GAAACACCGGTCTCGAGTGAGGTGTTCAGGGTGGGGTTAGAGCTAGAAAT	1	bc
ACTACCCGGC	GAAACACCGGTACCTTTGTTGATGCTGGGTGGAAGGAATGGTGGGGTTAG	1	bc
ACACTCCCGC	GAAACACCGGTGCATTCGAAAGTCCGGTCGTAGTGTGGACGTGGGGTTAG	1	bc
TTGACGGCTG	GAAACACCGGTTATATTTGAAGGGGTTAGAGCTAGAAATAGCAAGTTAAC	1	bc
AAACGCTCTA	GAAACACCGGTGCCCTTACTCTCACCTGATTACTTAATCCGTGGGGTTAG	1	bc
GGCGACCTAC	GAAACACCGGTGTGGCTGAGAGTCCGGCAATGGTGTGGCTGTGGGGTTAG	1	bc
TCCGATGCGC	GAAACATTGGGGTTAAAGCTAGACATATCAAGTTAACCTAAGGCTAGTCG	1	bc
AATACTCGGC	GAAACACCGGTACCTTTGTTGATGCTGGGTGGAAGGAAATAGCAAGTTAA	1	bc
CGCTTACTTC	GAAACACCGGTGTGGCTGAGAGTCCGGCAATGGTGTGGCTGTGGGGTTAG	1	bc
CTCCCCTGCG	GAAACACCGGTGTGGCTGAGAGTCCGGCAATGGTGTGGCTGTGGGGTTAG	1	bc
TAGGATATGT	GAAGCACCGGTTACATTGAGGGGTTAGAGCTAGAAATAGCAAGTTAACCT	1	bc
CACAGCGGGG	GAAACACCGGTTTGAACTACCTAGTAGCAAGTTAACCTAAGGCTAGTCCG	1	bc
CCTGGTGGCT	GAAACACCGGTGACATTGGGTACAGGGTGGGGTTAGAGCTAGAAATAGCA	1	bc
ATCTAAGCGG	GAAACTGGGGTTAGAGCTAGAAATAGCAAGATAACCAAAGGCTAGGCCGT	1	bc
GTAGACACGA	GAAACACCGGTCGGCGGCAATCGTGGGTGGGGTTAGAGCTAGAAATAGCA	1	bc
CTAGTTGGCT	GAAACACCGGTACCTTTGTTGATGCTGGGGGGAATAGATTTAGAGGGATA	1	bc
AATACTCGGA	GAAACACCGGTACCTTTGTTGATGCTGGTGGGGTTAGAGCTAGAAATAGC	1	bc
GGCACAACGA	GAAACACCGGTGGGGCCGACTGTACAGCAGTGGTATGGCTGGAGAGATAA	1	bc
AAAAACGCTA	GAAACACCGGTTTGAACTACCTAGTTCAAACCGGTGGGGTTAGAGCTAGA	1	bc
GGGCAGCTTC	GAAACACCGGTTCGCGTCCAGTGGAGTTAGACATGGGACTGGCAGGTTAA	1	bc
CTCGAATTGA	GAAACACCGGTGCCGTTACTTTCACCTGATGGTTTAATCTGGGGGGATCG	1	bc
CGATCCACGC	GAAACACCGGTGCATTCGAAAGTCCGGTCGTAGTGTGGACGTGGGGTTAG	1	bc
GACACATAAC	GAAACACCGGTAGGAAGTGCGAGCGAGTTAACATAAGGCTAGAACGTTAT	1	bc
TATCCCTAGC	GAAACACCGGTTTACGTTGCATCGGTGTGGGGTTAGAGCTAGAAATAGCA	1	bc
TAATTTGGTC	GAAACACTGGTCGATTCATATCGAAACCTTCCCGTGACAGTGGGGTTAGA	1	bc
ATACATTATT	GAAACACCGGTAAAGGCTAGTCCGTTATCAACTTGAAAAAGTGGCACCGA	1	bc
TCTAGAGACG	GAAACACCGGTTATATTTGCAAGAGTTTGTGGGGTTAGCGCTAGAAATAG	1	bc
TAAGTGCTCT	GAAACACCGGTGCACTTACTCTCACCTGATTACTTAATCCGTGGGGTTAG	1	bc
ACCTTTATCG	GAAACACCGGTCGGGGCCACTCAGTGGTGGGGTTAGAGCTAGAAATAGCA	1	bc
CATTTCCCTC	GAAACACCGGTCGGGGCCACTCAGTGGTGGGGTTAGCGCTAGAAATAGCA	1	bc
TGACTACTTT	GAAACACCGGTCTCGAGAGAGGTGTTCAGGGTGGGGTTAGAGCTAGAAAT	1	bc
CTATTAGGGC	GAAACACCGGTACCTTTGTTGATGCTGGGTGGAGGGAGCTGGTGGGGTTA	1	bc
CTCCTCTGCA	GAAACACCGGTGTGGCTGAGAGTCCGGCAATGGTGTGGCTGTGGGGTTAG	1	bc
GCACAGACTT	GAAACACCGGTTCACGGCTAGATGTTGTAAATCTAGATAGAGCAAGAAAA	1	bc
GCCCACCTCC	GAAACACCGGTGTGGCTGCGTGTCCGGCAATGGGGGGGATGTGGGGATAG	1	bc
AGACAGAGCC	GAAGCACCGGTAGCAAGTGCGAGACGTGTTTGTGGGGTTAGAGCTAGAAA	1	bc
TAAGAAACGC	GAAACACCGGTCGGCGGCCGGTTAGAGCTAGAAATAGCAAGTTAACCTAA	1	bc
ACATCGTAGT	GAAACACCGGTGTACGTATGGACTGAACCAGGGTGTGCAATAGTGGGGTT	1	bc
CTCCCCTGCA	GAAACACCGGTGCGGCTGAGAGTCCGGCAATGGTGTGGCTGGCGGGTTAG	1	bc
AGACCTGCGA	GAAACACCGGTGCATTCGAAAGTCCGGTCGTAGTGTGGACGTGGGGTTAG	1	bc
TAGAGAATAC	GAAACACCGGTTAAGCCGAGTGGGGTTAGAGCTAGAAATAGCAAGTTAAC	1	bc
CTCAAAGGCC	GAAACACCGGTACCTTTGTTGATGCTGGTTAGAGCTAGAAATAGCAAGTT	1	bc
GGGGAGCTTA	GAAACACCGGTTCCCGTCCAGTGGGGTTAGAGCTAGAAATAGCAAGTTAA	1	bc
AAGGCTCGCG	GAAACACCGGTGCATTCGAAAGTCCGGTCGTAGAGTGGACGTGGGGTTAG	1	bc
ATTGAGCCTA	GAAACACCGGTTAAGCCGAGGTTAGAGCTAGAAATAGCAAGTTAACCTAA	1	bc
CTACCCGCGC	GAAACACCGGTGCATTCGAAAGGCCGGTCGGGTTATGGCTATAGGGATCG	1	bc
GATACCCCTG	GAAACACCGGTAAATTTGAGGCTCCGGCATGCAGGAGGCCGTGGGGTTAG	1	bc
TGTGCCTGGT	GAAACACCGGTGACCTTAGTCTCACCTGAGTACTAAATCCGTGGGGATAG	1	bc
CGTCGAGCCA	GAAACACCGGTAGCAAGTGGGGTTAGAGCTAGAAATAGCAAGTTAACCTA	1	bc
GGCAAACTAC	GAAACACCGGTGTGGCTGAGAGTCCGGCAATGGTGTGGCTGTGGGGTTAG	1	bc
CTCCCCTGCA	GAAACACCGGTGTGACTGAGAGTCCGGCAATGGTGTGGCTGTGGGGTTAG	1	bc
ATCTCTCGAG	GAAACACCGGTTATATTTGTGATGGGGTTAGAGCTAGAAATAGCAAGTTA	1	bc
CGTGTAGCGC	GAAACACCGGTGACATTGGGTAGGGTTAGAGCTAGAAATAGCAAGTTAAC	1	bc
TAAGGGCGGA	GAAACACCGGTGCCCTTACTCTCACCTGATTACTTAATCCGTGGGGTTAG	1	bc
AGGTTACTGG	GAAACACCGGTCTCGACTGAGGTGATCAGGGTGGTGCTAGAGCTAGAAAT	1	bc
GAACGCACCA	GAAACACCGGTGCCCTTACTCTCACCTGATTACTTAATCCGTGGGGTTAG	1	bc
AGCGGAGACT	GAAACACCGGTTCCCGTCCAGTGGGGTTAGAGCTAGAAATAGCAAGTTAA	1	bc
TTAAGTATAT	GAAACACCGGTTACATTGAGGGGTTAGAGCTAGAAATAGCAAGTTAACCT	1	bc
