CTCCCCTGCA	GAAACACCGGTGTGGCTGAGAGTCCGGCAATGGTGTGGCTGTGGGGTTAG	6	bc
CACCCAATGT	GAAACACCGGTGACATTGGGTGGAATTCGGGCCCATTGGTATGGCAGATC	5	bc
TGGTGATGGT	GAAACACCGGTCAAACCTGGATAGAAGTGGGGTTAGAGCTAGAAATAGCA	3	bc
AATGCTGAGC	GAAACACCGGTTTACGTTGCATCGGTGTGGGGTTAGAGCTAGAAATAGCA	2	bc
ATTGAGCGTA	GAAACACCGGTTAAGCCGAGGAGTTAGAGCTAGAAATAGCAAGTTAACCT	2	bc
ACCTCGTCGT	GAAACACCGGTGTACGTATGGACTGAACCAGGGTGTGCAAGTGGGGTTAG	2	bc
ATAAGCTAGG	GAAACACCGGTTACATTGAGGGTTAGAGCTAGAAATAGCAAGTTAACCTA	1	bc
GAGGAGTATG	GAAACACCGGTTCCCGTCCAGTGGGGTTAGAGCTAGAAATAGCAAGTTAA	1	bc
GGCGCCCAAC	GAAACACCGGTAAATTTGAGGCTCCGGCATGCAGGAGGCCGTGGGGTTAG	1	bc
AAGATCCTCG	GAAACACCGGTGCATTCGAAAGTCCGGTCGTAGTGTGGACGTGGGGTTAG	1	bc
AAATCGCGTC	GAAACACCGGTGCCCTTAATCTCACCTGATTGCTTAATCCGTGGGGTTAG	1	bc
TTGTGCACTC	GAAACACCGGTTCAGCCGAGGTGTTAGAGCTAGTAATAGCAAGTTAACCT	1	bc
CCCACCGACC	GAAACACCGGTTTGAGCTAGAAATAGCAAGTTAACCTAAGGCTAGTCCGT	1	bc
TTTTTCCCGC	GAAACACTGGTCGGGGCCACTCAGTGGTGGGGTTAGAGCTAGAAATAGCA	1	bc
GTAAGTTATA	GAAACACCGGTAACTATATTCATGCGATATCGCCGTATCAGTGGGGTTAG	1	bc
AAGACATCGC	GAAACACCGGTGCATTCGAAAGTCCGGTCGTAGTGTGGACGTGGGGTTAG	1	bc
AAGGCTGCCT	GAAACACCGGTCCGTAGGAGACCCGTGTGGCATGTACCTGTGGGGTTAGA	1	bc
ACGAATCATT	GAAACACCGGTCTCGAGTGAGGTGTTCAGGGTGGGGTTAGAGCTAGAAAT	1	bc
ATGAGTCTAA	GAAACACCGGTTAAGCCGAGGAGTTAGAGCTAGAAATAGCAAGTTAACCT	1	bc
AAGTGTTGTC	GAAACACCGGTATTGGGGTTAGAGCTAGAAATAGCAAGTTAACCTAAGGC	1	bc
ACGAATCCTC	GAAACACCGGTCTCGAGTGAGGTGTTCAGGGTGGGGTTAGAGCTAGAAAT	1	bc
GACGCACTTC	GAAACACCGGTGCCCTTACTCTCACCTGATTACTTAATCCGTGGGGTTAG	1	bc
AACAACGCAA	GAAACACGTGGGGTTAGAGCTAGAAATAGCAAGTTAACCTAAGGCTAGTC	1	bc
TCAGTCGCAC	GAAACACCGGTCAGTGCCAATCGAGAGCTAGAAATAGCAAGTTAACCTAA	1	bc
CTTGGCGTCC	GAAACACCGGTGTACGTATGGACTGAACCAGGGTGTGCAAGTGGGGTTAG	1	bc
AACACAACGC	GAAACACCGGTTAGTGGTGGGGTTAGAGCTAGAAATAGCAAGTTAACCTA	1	bc
ACGTCGTCGT	GAAACACCGGTGTACGTATGGACTGAACCAGGGTGTGCAAGTGGGGTTAG	1	bc
ACCTCGTCTA	GAAACACCGGTGTACGTATGGAATGAACCAGGGTGTGCAAGTGGGGTTAG	1	bc
AGTCAGTTTC	GAAACACCGGTCCGTAGGAGACCCGTGTGGCATGTACCTGTGGGGTTAGA	1	bc
ATCTCTCAAG	GAAACACCGGTTATATTTGTAGGGGTAGAAATAGCAAGTTAACCTAAGGC	1	bc
TTGCGAAGGT	GAAACACCGGTTTACGTTGCATCGGAGTGGGGTTAGAGCTAGAAATAGCA	1	bc
ACATCCCGAT	GAAACACCGGTCGATTCATATCGAAACCTTCCCGTGACAGAGGGGTTAGA	1	bc
AACAGCGCTC	GAAACACCGGTTTGAACTAGAAATAGCGTGGTAACCTAAGGGTAGGCCGT	1	bc
CGGATGCGCC	GAAACACCGGTTTACGTTGCATCGGTTAGAGCTAGAAATAGCAAGTTAAC	1	bc
GCAGAGCCGA	GAAACACCGGTCGGAGCTAGAAATAGCAAGTTAACCTAAGGCTAGTCCGT	1	bc
GGGACCCAAC	GAAACACCGGTGTGGCTGAGAGTCCGGCAATGGTGTGGCCGTGGGGTTAG	1	bc
AAAGGGCATA	GAAACACCGGTCCGTAGGAGACCCGTGTGGCATGTACCTCTGTGGGGTTA	1	bc
CCTTCCTGCT	GAAACACCGGTTTGAGAAACAGATAGCAGGTTTACGTTAGAGCAATTAAA	1	bc
AGTGGTGCCC	GAAACACCGGTGACATTGGGATAGAGCTAGAAATAGCAAGTTAACCTAAG	1	bc
ATAAATAGGC	GAAACACCGGTTTCATCTACCTATATAGCTAGAAATAGCAAGTTAACCTA	1	bc
GCGTGTTGAC	GAAACACCGGTGACATTGGGTACAGGGGTGTGTTTAGAGCTAGAAATAGC	1	bc
AGACTGAATC	GAAACACCGGTCAGTAGGAGACCCGTGTGGCATGTACCTTAGGGATTAGA	1	bc
ACACAAAGCG	GAAACACCGGTTTGAACTACCTAGCAAGTTAACCTAAGGCTAGTCCGTTA	1	bc
GCTATCCCCC	GAAACACCGGTGTGGCTGAGAGTCCGGCAATGGTGTGGCTGTGGGGTTAG	1	bc
ACGAATGCTT	GAAACACCGGTCTCGAGTGAGGTGTTCAGGGGTGGGGTTAGAGCTAGAAA	1	bc
GCGACAGTCA	GAAACACCGGTAGCAAGTGCGAGACGTGTTTGTGGGGTTAGAGCTAGAAA	1	bc
GAGAGTAGTC	GAAACACCGGTGTACGTATGGACTGAACCAGGGTGTGCAAGTGGGGTTAG	1	bc
CCCAAAGCCA	GAAACACCGGTTTGAACTAGAAATAGCAAGTTAACCTAAGGCTAGTCCGT	1	bc
GGCAAGGCCC	GAAACACCGGTTAGTGGTGGGGTTAGAGCTAGAAATAGCAAGTTAACCTA	1	bc
CAATGCTTAG	GAAACACCGGTTTACGTTGCATCGGGTTAGAGCTAGAAATAGCAAGTTAA	1	bc
TAGGAGTGCC	GAAACACCGGTTCCCGTCCCGACCTATTGGAGCTGGAAATAGCTAGTTAT	1	bc
TGCAGACGCG	GAAACACCGGTTGGCGGGTGGGGATAGAGCTAGGAATAGCAAGTTAAACT	1	bc
AACGGACCAC	GAAACACCGGTGCCCTTACTCTCACCTGATTACTTAATCCGTGGGGTTAG	1	bc
GCTATAGCGG	GAAACACCGGTTCTATTTGGAAGTGTGTGGGGTTAGGGCTAGGAATAAGA	1	bc
ATACTCTAGA	GAAACACCGGTGCATTCGAAAGTCCGGTCGTAGTGTGGACGTGGGGTTAG	1	bc
AAAGGCACTA	GAAACACCGGTGCCCTTACTCTCACCTGATTACTTAATCCGTGGGGTTAG	1	bc
ACGATAGGGG	GAAACACCGGTTATATTTGTAAGTGTGTGGGGTTAGAGCTAGAAATAGCA	1	bc
AAAGACGTAC	GAAACACCGGTGCACTTACTCTCGACTGATTACTTAATACGTGGGGTTAG	1	bc
ATGTCATCGA	GAAACACCGGTAGACCCTGTTGCTTCGTGGGGTTAGAGCTAGAAATAGCA	1	bc
AGAAGCCCCG	GAAACACCGGTCGGCGGCAATCGTAGAGCTAGAAATAGCAAGTTAACCTA	1	bc
CGACTGATAC	GAAACACCGGTAACTATATTCATGCGATATCGCCGTATCAGTGGGGTTAG	1	bc
AGAAGACACG	GAAACACCGGTCGGCGGCAATCGTGGGTGGGGATTGAGCTAGAAATAGAA	1	bc
GGGCCGCCTC	GAAACACCGGTCAGTAGGAGACCCGTGTGGCATGTACCTTGTGGGGGTAG	1	bc
GTTGAGCATG	GAAACACCGGTTAAGCCGAGGAGTTAGAGCTAGAAATAGCAAGTTAACCT	1	bc
AACAATGCAA	GAAACACCGGTTTGAACTAGAAATAGCAAGTTAACCTAAGGCTAGTCCGT	1	bc
CTCCCAGGCC	GAAACACCGGTACCTTTGTTGATGCTGGGTGGAAGGATTTTTGTGGGGTT	1	bc
AAACGCACTA	GAAACACCGGTGCCCTTACTCTCACCTGATTACTTAATCCGTGGGGTTAG	1	bc
ATGCCCGGCC	GAAACACCGGTACCTTTGTTGATGCTGGGTGGAAGGAGGTGGGGTTAGAG	1	bc
ACAGAACGCC	ATGTGGGGTTAGAGCTAGAAATAGCAAGTTAACCTAAGGCTAGTCCGTTA	1	bc
TTTGGTCGGT	GAAACACCGGTTACATTGTGGGCTAGACCTAGAAGTAGCAAGTTAACCTA	1	bc
AGACTCGCCC	GAAACACCGGTACCTTTGTTGATGCTGGGAGGAAGGAATTTTGTGGGGTT	1	bc
ACGAAGCCTT	GAAACACCGGTCTCGAGTGAGGTGTTCAGGGTGGGGTTAGAGCTAGAAAT	1	bc
CGCGGTGTCC	GAAACACCGGTGACATTGGGTGGGGTTAGAGCTAGAAATAGCAAGTTAAC	1	bc
ATCGCCATGC	GAAACACCGGTGACATTACTCTCACCTGCTTACTTAATCAGTTGAGCTAG	1	bc
CAACAAACCC	GAAACACCGGTTTGCACTGGATATAGCAAGTTAAACTACGACTAATCCGT	1	bc
ACTATTCGGC	GAAACACCGGTACCTTTGTTGATGCTGGGTGGAAGGAATTTTGTGTGGGG	1	bc
AAATCGTCGT	GAAACACCGGTGTACGTATGGACTGAACCAGGGTGTGCAAGTGGGGTTAG	1	bc
ACTAATCCTT	GAAACACCGGTCTCGAGTGAGGTGTTCAGGGTGGGGTTAGAGCTAGAAAT	1	bc
TCTATGGATC	GAAACACCGGTTATATTTGTAAGTGTTTTTGTAAGTGTTAAGGGTTAGAG	1	bc
GCGCAATCTC	GAAACACCGGTTGCAGTAGGATGGGGTTAGAGCGAGAAATAGCAAGTAAA	1	bc
GCAGCAGCGC	GAAACACCGGTCGGCGGCCGGGGTTAGAGCTAGAAAAAGCAAGTTAACCT	1	bc
GCGTATCCTT	GAAACACCGGTCTCGAGTGAGGTGTTCAGGGTGGGGTTAGAGCTAGAAAT	1	bc
TGGCACCCTT	GAAACACCGGTGTGGCTGAGAGTCTGGCAATGGTGTGGCTGTGGGGTTAG	1	bc
CGCCCATGCA	GAAACACCGGTGTGGCTGAGAGTCCGGCAATGGTGTGGCTGTGGGGGTAG	1	bc
ATGCTCGGCA	GAAACACCGGTACCTTTGTTGATGCTGGGTGGAAGGAATTTTGTGGGGTT	1	bc
ATCCGCTCGC	GAAACACCGGTGCATTCGAAAGTCCGGTCATCGTGTGGACGTGGGGTTAG	1	bc
ATACCAGACC	GAAACACCGGTAGCAAGCTAGAAATAGCAAGGTAACCTAAGGCTAGTCCG	1	bc
AGAGGAGACT	GAAACACCGGTTCCCGTCCAGTGGGGTTAGAGCTAGAAATAGCAAGTTAA	1	bc
AGACACAGTC	GAAACACCGGTAGCAAGTGCGAGACGTGTTTGTGGGGTTAGAGCTAGAAA	1	bc
ATTCGCACGG	GAAACACCGGTTACATTGAGGGTTAGAGCTAGAAATAGCAAGTTAACCTA	1	bc
AGGCACCATA	GAAACGCCGGTGAGGCTGAGAGTCCGGCAATGGTGTGGCTGTGGGGTTAG	1	bc
AACCACTCCC	GAAACACCGGTTAGTAGTGGGGTTAGAGCTAGAAATAGCAAGTTAACCTA	1	bc
CACGCACTAA	GAAACACCGGTGGCCTTACTCTCACCTGATTACTTAATCCGTGGGGTTAG	1	bc
GAGGCTTCAC	GAAACACCGGTCGGCGGCATTCGCGTTTGGGGCTATAGCTAGAAATAGAA	1	bc
TCAATCACTC	GAAACACCGGTTATATTTGTAAGTGTGTGGGGTTAGAGCTAGAAATAGAT	1	bc
CTGTTAACGC	GAAACACCGGTCGGGGCCACTCAGTGGTGGGGTTAGAGCTAGAAATAGCA	1	bc
TCCTTGACGT	GAAACACCGGTGTACGTATGGACTGAACCAGGGTGTGCAAGTGGGGTTAG	1	bc
AGACCCAGAC	GAAACACCGGTAGCAAGTGCGAAACACCGGTAGCAAGTGCGAGACGTGGG	1	bc
AACCCACTTC	GAAACACCGGTGCCCTTACTCTCACCTGATTACTTAATACGTGGGGTTAG	1	bc
AAGGTACGCC	GAAACACCGGTGCCCTTACTCTCACCTGATTACTTAATCCGTGGGGTTAG	1	bc
TTGAGAGCAA	GAAACACCGGTTAAGCCGAGTGGGGTTAGAGCTAGAAATAGCAAGTTAAC	1	bc
GGGCCCCGCC	GAAACACCGGTGTGGCTGAGAGTCCGGCAATGGTGTGGCTGGGGGGTTCG	1	bc
TTGAGCACGC	GAAACACCGGTTAAGCCGTGGGGTTAGAGCTAGAAATAGCAAGTTAACCT	1	bc
GAAACGGCCA	GAAACACCGGTAGCAAGTGCGAGACGTGTTAGAGCTAGAAATAGCACCGT	1	bc
AGAAGACCGG	GAAACACCGGTCGGGGTTAGAGCTAGAAATAGCAAGTTAACCTAAGGCTA	1	bc
AGGCACCCAC	GAAACACCGGTGTGGCTGAGAGTCCGGCAATGGTGTGGCTGTGGGGTTAG	1	bc
AAGCTTACAT	GAAACACCGGTTACTAAATTCATGCGATATCGCCGTATCAGTGGGGTTAG	1	bc
CTGAGTGTCT	GAAACACCGGTTAAGTCGAGTAGATAGAGGTAGAAATAGCAGAATAACCA	1	bc
ATTGTCGTCC	GAAACACCGGTGTACGTATGGACTGAACCAGGGTGTGCAAGTGGGGTTAG	1	bc
TCTGGCAGTT	GAAACACCGGTCGCTTCATATCGAAACCTTCCCGTGACAGTGGGGTTAGA	1	bc
CGGATAGCCC	GAAACACCGGTATGCACTAGAAATACCAAGTTAACCTCAGGCTACTCCGT	1	bc
ACAGGACAGT	GAAACACCGGTGTACGTATGGACTGAACCAGGGTATGCAAGTGGGGATAG	1	bc
AGTCGGTATC	GAAACACCGGTCCGTAGGAGACCCGTGTGGCATGTACCTGTGGGGTTAGA	1	bc
TCCGACCCGC	GAAACACCGGTCGGCGGCAATCGTGGGTGGGGTTAGAGCTAGAAATAGCA	1	bc
TTTAACATCC	GAAACACCGGTTAAGCCGAGTGGGGTTAGAGCTAGAAATAGCAAGTTAAC	1	bc
CGTGTCCGGA	GAAACACCGGTCGCGGCCACACCATGGGCTGTTTAGAGATAGATATAGAA	1	bc
CCGTTCGGGT	GAAACACCGGTCGATTCATATCGAAACCTTCCCGTGAAGGTTTCGTGGGG	1	bc
AGCCGCGCGC	GAAACACCGGTTAATACCAAAGTCCGGTCCTACTGGGGACGTGGGGTTAG	1	bc
CACCTCGGAC	GAAACACCGGTACCTTTGTTGATGCCGGGTGGAAGGAATTTGTGGGGTTA	1	bc
TCTTACCCTT	GAAACACCGGTCGGCGGCAAGCGGGGGCGGGTGGAGAGAGAGCTAGAGCT	1	bc
ACTTGACCGA	GAAACACCGGTCGGGGCCACTCAGTGGTGGGGTTAGAGCTAGAAATAGCA	1	bc
TCAGTTAGGT	GAAACACCGGTTACATTGAGGGGTTAGAGCTAGAAATAGCAAGTTAACCT	1	bc
AGGCACCTAC	GAAACACCGGTAAATTTGAGGCTCCGGCATGCAGGAGGCCGTGGGGTTAG	1	bc
ATGGCTAGGT	GAAACACCGGTTTACTTGACAACGTCGTGGGGGTATAGATCGAGAAAGCA	1	bc
AATATCGAGA	GAAACACCGGTTATATTTGTAAGTGTGTGGGGTTAGAGCTAGAAATAGCA	1	bc
GCTGACGCGC	GAAACACCGGTCGGCGGCAATCGGGGGGTGGGGTTAGAGCTAGCAATAGC	1	bc
CCGTTATCGA	GAAACACCGGTCGGGGCCACTCAGTGGTGGGGTTAGAGCTAGAAATAGCA	1	bc
GACGGCCGCT	GAAACACCGGTGCCCTTACTCTCACCTGATTACTTAATCCGTGGGGTTAG	1	bc
CTTCTGGCTC	GAAACACCGGTCCGTAGGAGACCCGTGTGGCATGTACCTGTGGGGTTAGA	1	bc
ATTACCTATT	GAAACACCGGTTACATTAAGGTTTAGAGCTAGAAATAGCAAGTTAACCTA	1	bc
GAAGCTATGG	GAAACACCGGTTACATGAGGGATAGAGCTAGAAATAGCAAGTTAACCTAA	1	bc
AGAGACCTGC	GAAACACCGGTCGGCGGCAACGTGGGGTTAGAGCTAGAAATAGCAAGTTA	1	bc
GCAGATCCTC	GAAACACCGGTCGGCGGCAATCGTAGGGGTGGTAATAGCAAGTTAACCTA	1	bc
AGTTTGACCC	GAACCACCGGTCCGTAGGAGACCCGTGTGGCATGTACCTGTGGGGTTAGA	1	bc
GGCTGCCCCC	GAAACACCGGTGTGGCTGAGAGTCCGGCAATGGTGTGGCTGTGGGGTTAG	1	bc
TTGAGCCTCC	GAAACACCGGTTAAGCCGTGGGGTTAGAGCTAGAAATAGCAAGTTAACCT	1	bc
TCGTGTCGTC	GAAACACCGGTGACATGTGGGGTTAGAGCTAGAAATAGCAAGTTAACCTA	1	bc
TGGCACTCTC	GAAACACCGGTCTCGAGTGAGGTGTTCAGGGTGGGGTTAGAGCTAGAAAT	1	bc
CGGCGTCCCT	GAAACACCGGTGTACGTATGGACTGAACCAGGGTGTGCAAGTGGGGTTAG	1	bc
AAGTATGCCT	GAAACACCGGTCCGTAGGAGACCCGTGTGGCATGTACCTGTGGGGTTAGA	1	bc
AGTTTTGGCT	GAAACACCGGTCGATTCATATCGAAACCTTCCCGTGACAGTGGGGTTAGA	1	bc
GGTGCTGACT	GAAACACCGGTGACATTGGGGACTTGAGATATTGTCACCGAATCGGTGCT	1	bc
ACATGAGGTA	GAAACACCGGTCGATTCATATCGAAACCTTCCCGAGACAGTGGGGTTAGA	1	bc
GTCCCACTCA	GAAACACCGGTGTGGCTGAGAGTCCGGCAATGGTGTGGCTGTGGGGTTAG	1	bc
GCAGACGGCC	GAAACACCGGTCGGCGGCAATCGTGGGTGGGGTTAGAGCTAGAAATAGCA	1	bc
GGAAACATTT	GAAACACCGGTCTCGAGTGAGGTGTTCAGGGTGGGGTTAGAGCTAGAAAT	1	bc
ACGAATCATT	GGAACACCGGTCTCGAGTGAGGTGTTCAGGGTGGGGTTAGAGCTAGAAGT	1	bc
ACATCCGCCC	GAAACACCGGTGCATTCGAAAGTCCGGTCGTAGTGTGGATGTGGGGATAG	1	bc
AGAAGACACG	GAAACACCGGTCGGTGGGGTTAGAGCTAGAAATAGCAAGTTAACCTAAGG	1	bc
GCGCTCACTC	GAAACACCGGTTCCCGTCCGGAGGTTTTAGAGCTAGAAATAGCAAGATAA	1	bc
GAACTGCCTC	GAAACACCGGTCGGCGGCTAACGCTAGTGGTATCAAGCTAACCTGATGCT	1	bc
GCACACCGCC	GAAACACCGGTTTGAACTAGAAATAGCAAGTTAACCTAAGGCTAGTCCGT	1	bc
ACCACCTGTA	GAAACACCGGTAGATTTGAGGCTCCGGCATGCAGGAGGCCGTGGGGTTAG	1	bc
ATGACTAGAT	GAAACACCGGTTTACGTTGCATCGGTGTGGGGTTAGAGCTAGAAATAGCA	1	bc
ATTAGATATG	GAAACACCGGTTACATTTGAGGGTTAGAGCTAGAAATAGCAAGTTAACCT	1	bc
TTAGCCGGGT	GAAACACCGGTTACATTGTGGGGTTAGAGCTAGAAATAGCATGTTAATAT	1	bc
CTCCCCTGCA	GAAACACCGGTGTGGCTGAGAGTCCGGCAATGGTGCGGCTGTGGGGTTGG	1	bc
CGTGATATAT	GAAACACCGGTGACATTGGGTACTTGAAAAAGTGGCACCGAGTCGGTGCT	1	bc
ACGTGTTGAC	GAAACACCGGTGACATGGGGTTAGAGCTAGAAATAGCAAGTTAACCTAAG	1	bc
AGACACAGTC	GAAACACCGGTAGCAAGTGCGAGAAATAGCAAGTTAACCTAAGGCTAGTC	1	bc
AGTTCCGCGC	GAAACACCGGTGCATTCGAAAGTCCGGTCGTAGTGTGGACGTGGGGTTAG	1	bc
CATCGTCTAA	GAAACACCGGTGTACGTATGGACTGAACCAGGGTGTGAAGTGTGGTTAGA	1	bc
ATGCATAGAC	GAAACACCGGTTTACGTTGCATCGGTGTGGGGGTAGAGATAGATATAGCA	1	bc
AGGCCCTTAA	GAAACACCGGTAAATTTGAGGCTCCGGCATGCAGGAGGCCGTGGGGTTAG	1	bc
TAACGTAGTC	GAAACACCGGTGTACGTATGGACTGAACCAGGGTGTGCAAGCGGGGTTAG	1	bc
AGGCCCCCTC	GAAACACCGGTGTGGCTGAGAGTCCGGCAATGGTGTGGCTGTGGGGTTAG	1	bc
AGTACTCGGC	GAAACACCGGTACCTTTGTTGATGCTGGTGTGGGGTTAGAGCTAGAAATA	1	bc
GGAACCTACC	GAAACACCGGTAAATTTGAGGCTCCGGCATGCAGGAGGCCGTGGGGTTAG	1	bc
AGCCTCGCGC	GAAACACCGGTGCATTCGAAAGTCCGGTCGTAGTGTGGACGTGGGGTTAG	1	bc
GTATCTGACA	GAAACACCAGTAGCAAGTGCGAAACACCGGTAGCAAGTGCGAGACGTGGG	1	bc
AAACGTCGGC	GAAACACCGGTGTACGTATGGACTGAACCAGGGTGTGCAAGTGGGGTTAG	1	bc
GACATTCAGA	GAAACACCGGTCGATTCATATCGAAACCTTCCCGTGACAGTGGGGTTAGA	1	bc
ACCGCCGGAC	GAAACACCGGTGCCCTTACTCTCACCTGATTACTTAATCCGTGGGGTTAG	1	bc
AGAAGAGCCG	GAAACACCGGTCGGCGGCTAGAAATAGCAAGTTAACCTAAGGCTAGTCCG	1	bc
GGAGCCATGC	GAAACACCGGTGTGGCTGAGAGTCCGGCAATGGTGTGGCTGGGGGGAGAG	1	bc
TTGAAGAAAA	GAAACACCGGTTAAGCCGAGTGGGGTTAGAGCTAGAAATAGCAAGTTAAC	1	bc
TAGCATGTAC	GAAACACCGGTAACTATATTCATGCGATATCGCCGTATCAGTGGGGTTAG	1	bc
AGGCACCATC	GAAACACCGGTGTGGCTGAGAGTCCGGCAATGGTGTGGCTGTGGGGTTAG	1	bc
TAATTTATCA	GAAACACCGGTAACTATATTCATGCGATATCGCCGTATCAGTGGGGTTAG	1	bc
ACAGCCATAC	GAAACACCGGTGCCCTTACTCTCACCTGATTACTTAAGACATGGGGTTAG	1	bc
GACACCGAAC	GAAACACCGGTAGCAAGTGCGAGACGTGTTTGTGGGGTTAGAGCTAGAAA	1	bc
CAGAACGCTA	GAAACACCGGTTTGCACTAGAACTAGCAAGTTAACCTAAGGCTAGACCGT	1	bc
GATCTTGAAA	GAAACAACGGTAGCAAGTGCGAGACGTGTTTGTGGGGTTAGAGCTAGAAA	1	bc
TAACGCTCTA	GAAACACCGGTGCCCTTACTCTCACCTGATTACTTAATCCGTGGGGATAG	1	bc
TGTCTCGCGC	GAAACACCGGTTCATTCGAAAGTCCGTACGAAGCGAGGTGGGGGGGTGAG	1	bc
CGCCTCATTT	GAAACACCGGTCTCGAGTGAGGTGTTCAGGGTGGGGTTAGAGCTAGAAAT	1	bc
GGCAGACGCC	GAAACACCGGTGTGGCTGAGAGTCCGGCAATGGTGTGGCTGTGAGGATAG	1	bc
GACGCTGACT	GAAACACCGGTAGCAAGTGCGAGACGTGTTTGTGGTGGTAGAGCTAGCAA	1	bc
ACAAGTGGCA	GAAACACCGGTAGCAGGATCGACAGAACGAGGGAGTACAAGAGGGGTTAG	1	bc
ATGTGTTGTC	GAAACACCGGTGACATTGGGTACTTGAAAAAGTGGCACCGAGTCGGTGCT	1	bc
GCACACCGCC	GAAACACCGGTTTGAACTAGAAATAGCAAGTTAACCTAAGGCTAGCCCGT	1	bc
AATGCCCAGT	GAAACACCGGTTTACGTTGCATCGGTTAGAGCTAGAAATAGCAAGTTAAC	1	bc
GAGGTCGCCC	GAAACACCGGTCGGCGGCACTCTTGAATAAGTTTCACCGTAGCGATAGCT	1	bc
ATCTCTAGAG	GAAACACCGGTTATATTTGTAAGTGGGGTTAGAGCTAGAAATAGCAAGTT	1	bc
TCGAGAATGC	GAAACACCGGTTAAGCCGAGGAGTTAGAGCTAGAAATAGCAAGTTAGCCT	1	bc
ACAGCGCCGG	GAAACACCGGTGTACGAATGGACTGAACCAGGGTGTGCAAGTGGGGTTAG	1	bc
ATCTAGCGAG	GAAACACCGGTTATATTTGTAAGTGTTGTGGGGTTAGAGCTAGAAATAGC	1	bc
TTGTGTATAG	GAAACACCGGTTAAGCCGAGTGGTGATAGAGCTAGAAATAGCAAATTACC	1	bc
AGGTGGCCTC	GAAACACCGGTTCGGACGACACCCGTGTGGCTTGTACCTGTGGGGTTAGA	1	bc
ACAAAACGCC	GAAACACCGGTTAGTAGTGGGGTTAGAGCTAGAAATAGCAAGTTGACCTA	1	bc
GAGTAGCCTT	GAAACACCGGTTCCCGTCCGGTGGGGTTAGAGCTAGAAATAGCAAGTTAA	1	bc
ACTATCGTAG	GAAACACCGGTTATATTTGTAAGTGTGTGGGGTTAGAGCTAGAAAGAGCA	1	bc
GAAGGCCCTA	GAAACACCGGTGCCCTTACTCTCACCTGATTACTTAATCCGTGGGGTTAG	1	bc
GACGACACAT	GAAACACCGGTCGGCGGCAATCTTGAAAAAGTGGCACCGAGTCGGTGCTT	1	bc
AAAGATAGGT	GAAACACCGGTTACATTGATGTGTAGAGCGAGATCTATCAGGGTAACTTA	1	bc
TCTCTCGATT	GAAACACCGGTTATATTTGTAGGTGGTTGTGGGGGTAGAGCTAGAAATAG	1	bc
GCGTAGCATC	GAAACACCGGTTCCCGTCCAGTGGGGTTAGAGTTAGAAATAGCAAGTTAA	1	bc
ATCCCCTGCA	GAAACACCGGTGTGGCTGAGAGTCCGGCAATGGTGTGGCTGTGGGGTTAG	1	bc
ATTAGATATG	GAAACACCGGTTACATTGAGGGTTAGAGCTAGAAATAGCAAGTTACCCTA	1	bc
GACACTGCCT	GAAACACCGGTAGCAAGGGCGAAATGTGTTTTTGGGGTTAGAGCTAGAAA	1	bc
GACGCCGCCA	GAAACACCGGTACCGAGAGCTCGAAATAGCAAGTTAACCTAAGGCGAGTC	1	bc
CGATTGGTCC	GAAACACCGGTGACATTGGGTTAGAGCTAGAAATAGCAAGTTAACCTAAG	1	bc
ATCTATAGAG	GAAACACCGGTTATATTTGTAAGTGTGTGGGGTTAGAGCTAGAAATAGCA	1	bc
ACACTACGCC	GAAACACCGGTTTGAACTAGAAATAGCAAGTTAACCTAAGGCTAGTCCGT	1	bc
CTGCTTCGGT	GAAACACCGGTTTACGTTGCATCGGTTTGTGGGGTTAGAGCTAGAAATCG	1	bc
CGGGATGGCT	GAAACACCGGTGACATTGGGTACTTGTAAAAGTGGCACCGAGTCGGTGCT	1	bc
CTGATTGGCT	GAAACACCGGTTTACGTTGCATCGGTGTGGGGTTAGAGCTAGAAATAGCA	1	bc
GGCACAAGCC	GAAACACCGGTGTGGCTGAGAGTCCGGCAATGGTGTGGCTGTGGGGTTAG	1	bc
ATTGCGCATA	GAAACACCGGTTAAGCCGTGGGGTTAGAGCTAGAAATAGCAAGTTAACCT	1	bc
AATCTGGACC	GAAACACCGGTACGTAGGAGACCCGTGTGTCATGTACCTCTGTGGGGTTA	1	bc
CAGAATCGTG	GAAACACCGGTGCACGTATTGAATGAACGGGGGTGTACACAGAGGTATAG	1	bc
AAGGCCCTCG	GAAACACCGGTGCATTCGAAAGTCCGGTCGTAGTGTGGACGTGGGGTTAG	1	bc
AAACAACGGA	ATGGGGGGTTAAAGCTAGAAATAGCAAGTTAACCTAAGGCTAGTCCGTTA	1	bc
GTATAGCATA	GAAACACCGGCTAAGCCGAGGAGTTAGAGCTAGAAATAGCAAGATAACCT	1	bc
TAGTGCATAC	GAAACACCGGTTAAGCCGAGTGGGGTTAGAGCTAGAAATAGCAAGTTAAC	1	bc
GCATCGTGGA	GAAACACCGGTGTACGTATGGACTGAACCAGGGTGTGGGGTTAGAGCTAG	1	bc
GAGGAGCGTG	GAAACACCGGTTCCAAACCATTGGACGTAGAGCTAGAGCTAGCAAGTTAA	1	bc
TTGATTCGCT	GAAAAACCGGTTTACGTTGCATCGGTGTGGGGTTAGAGCTAGAAATAGCA	1	bc
GGAGTCACGC	GAAACACCGGTCGGCGGCAATCTTGAAAAAGTGGCACCGAGTCGGTGCTT	1	bc
ATTTGAGGAT	GAAACACCGGTTAAGCCGAGGAGTTAGAGCTAGAAATAGCAAGTCAACCT	1	bc
AGGAACCCCC	GAAACACCGGTGTGGCTGAGAGTCCGGCCGTAGTGTGGCTGTGGGGTTAG	1	bc
G	GAAACACCGGTTTACGTTGCATCGGGTTAGAGCTAGAAATAGCAAGTTAA	1	bc
GATAGTAGCT	GAAACACCGGTTTACAGTGCATCGGTGTGGTGTTAGAGCTGGGGGTATCA	1	bc
GCAGACGCGA	GACGAAACACCGGTCGGCGGCAATCGTTAATCGGTTAATCGTGGGGTTAG	1	bc
AATCTGCTTT	GAAACACCGGTCCGTAGGAGACCCGTGTGGCATGTACCTTGTGGGGTTAG	1	bc
GGCATAGTTT	GAAACACCGGTCGCGAGTGCGAGACGCGTGTGGGGGGTTAAAGCTAGAAA	1	bc
CCACCTCTGT	GAAAAACCGGTTATATTTGTAAGTGTGTGGGGTTAGAGCTAGAAATAGCA	1	bc
ACCTTTAAAG	GAAACACCGGTCGGGGCCACTCAGTGGTGGGGTTAGAGCTAGAAATAGCA	1	bc
ACGCGCAGTA	GAAACACCGGTTAAGCCGAGGGGTTAGAGCTAGAAATAGCAAGTTAACCT	1	bc
ACACCACGCC	GAAACACCGGTTTGAATAGCAAGTTAACCTAAGGCTAGTCCGTTATCAAC	1	bc
ATCTCTCGAG	GAAACACCGGTTATATTTGTAAGTGTTGTGGGGTTAGAGCTAGAAATAGC	1	bc
ATTGAGAATA	GAAACACCGGTTAAGCCGAGGAGTTAGAGCTAGAAATAGCAAGTTAACCT	1	bc
TGGCTCCCTC	GAAACACCGGTGTGGCTGAGAGTCCGGCAATGGTGTGGCTGTGGGGTTAG	1	bc
ATGGGTATCC	GAAACACCGGTTTACGTTGCATCGGTGTGGGGTTGGAGCTGGAGATAGCA	1	bc
GCAATCGAGC	GAAACACCGGTTATATTTGTAAGTTTAGAGCTAGAAATAGCAAGTTAACC	1	bc
ATGGGTAGGT	GAAACACCGGTTTCGTTAGAGCTAGAAATAGCAGGTTAACCTAAGGCTAG	1	bc
ATCTCTCGAG	GAAACACCGGTTATATTTGTAAGTGTTTTGTGGTGGTAGAGCTAGAAATA	1	bc
TCACGACGTT	GAAACACCGGTTTGAATAGCAAGTTAACCTAAGGCTAGTCCGTTATCAAC	1	bc
ACAACCCCGC	GAAACGCCGGTCGGCGGCGATTTTGAAAGAGTGTCACCGAGTCGGTACTT	1	bc
AGATGACCCG	GAAACACCGGTCGGCGGCAATCGTTAATCGGTTAATCGTGGGGTTAGAGC	1	bc
GGTGTTGGCC	GAAACACCGGTGACATTGGGTGGGGTTAGAGCTAGAAATAGCAAGTTAAC	1	bc
TGGTGATGGT	GAAACACCGGTCATACCTGGATAGAAGTGGGGTTAGAGCTAGAAATAGCA	1	bc
GACTCAGCCC	GAAACACCGGTAGCAAGTGCGAGACGTGTTTGTGGGGTTAGAGCTAGAAC	1	bc
ATGCATGGTG	GAAACACCGGTTTACGTTGCATCGGTGTGGGGTTAGAGCTAGAAATAGCA	1	bc
TTGAGGCTAC	GAAACACCGGTTAAGCCGAGGAGTTAGAGCTAGAAATAGCAAGTTAACCT	1	bc
TCGCCCTGCA	GAAACACCGGTGCATTCGAAAGTCCGGTCGTAGTGTGGACGTGGGGTTAG	1	bc
AAACTGAGAC	GAAACACCGGTAACTATATTCATGCGATATCGCTGTATCAGTGGGGTTAG	1	bc
CCTTTTGCGA	GAAACACCGGTCGGGGCCACTCAGTGGAGGGGTTAGAGCTAGAAATAGCA	1	bc
AGAAGACTTT	GAAACACCGGTCTCGAGTGAGGTGTTCAGGGTGGGGTTAGAGCTAGAAAT	1	bc
AAACTCTGTC	GAAACACCGGTCTAGTCACATTGAATCCTTGGCTAGACCTAGAGATAACA	1	bc
ACGTGATGTC	GAAACACCGGTGACATTGGGTACTTGAAAAAGTGGCACCGAGTCGGTGCT	1	bc
AAACCAATGT	GAAACACCGGTTACATGAGGGTTAGAGCTAGAATTAGCATGGAAACCGAA	1	bc
AGTATGCTCC	GAAACACCGGTCGGTAGGAGACCCGTGTGGCATGTACCTGTGGGGTTAGA	1	bc
TTGCGCCTAC	GAAGCACCGGTTAGGCCGATCAGCGGTAGAGCTAGAAATAGCAAGTTAAC	1	bc
AAGTGTTGTC	GAAACACCGGTGACATTGGGTACAGGGGTGGGGTTAGAGCTAGAAATAGC	1	bc
TCTCGCGGTC	GAAACACCGGTTATAGTTGGAAGTGTGTTGGGTTAGAGCTAGAGATAGAG	1	bc
AAGCGTAGTA	GAAACACCGGTGTACGTATGGACTGAATCAGGGTGTGCATAGGGAGTTAG	1	bc
AAATACCTGC	GAAACACCGGTCGGCGGCAATCGTGGGTGGGGTTAGAGCTAGAAATAGCA	1	bc
ACCTTTAGCG	GAAACACCGGTCGGGGCCACTCAGTGGTGGGGTTAGAGCTAGAAATAGCA	1	bc
ACCTTTATCG	GAAACACCGGTCGGGGCCACTCAGTGGTGGGGTTAGAGCTAGAAATAGCA	1	bc
TAGAGAGTAA	GAAACACCGGTTAAGCCGTGGGGTTAGAGCTAGAAATAGCAAGTTAACCT	1	bc
CGAGGCCTCT	GAAACACCGGTCTCGAGTGAGGTGTTCAGGTGGGGTTAGAGCTAGAAATA	1	bc
GCGGAGTCCC	GAAACACCGGTTCCCGTCCAGTGGGGTTAGAGCTAGAAATAGCAAGTTAA	1	bc
GGCTTATACC	GAAACACCGGTAAATTTGAGGCTCCGGCATGCAGGAGGCCGTGGGGTTAG	1	bc
AATGCTGAGC	GAAACACCGGTTTACGTTGCATCGGTTGTGGGGTTAGAGCTAGAAATAGC	1	bc
GATGGTCGTG	GAAACACCGGTGTACGTATGGACTGAACCAGGGTGTGCAAGTGGGGTTAG	1	bc
TAACTCGGAC	GAAACACCGGCACCTTCGTTGATGCTAGGTGGGGTTAGCGGTAGAAATAG	1	bc
TGTGGGGCCT	GAAACACCGGTTCCCGTCCAGTGGGGTTAGAGCTAGAAATAGCAAGTTAA	1	bc
TGAACTATGC	GAAACACCGGTTACATGGAGGGGTAGAGCTAGAAATAGCTAGTTAACCTA	1	bc
AACAGTGCCC	GAAACACCGGTTTGAACTAGAAATAGCAAGTTAACCTAAGGCTAGTCCGT	1	bc
AACTATCGAG	GAAACACCGGTTATATTTGCAAGAGAGTGGGGTTAGAGCTAGAAATAGCA	1	bc
AAGTCAGCCT	GAAACACCGGTCCGTAGGAGACCCGTGTGGCATGTACCTGTGGGGTTAGA	1	bc
ACAACCCTCG	GAAACACCGGTGCATTCGAAAGTCCGGTCGTAGTGTGGACGTGGGGTTAG	1	bc
ATGGCCGGCC	GAAACACCGGTGTGGCCGATAGTCCTGCAATGTTGGGGCTGTGGTGGTAA	1	bc
ACCGCTTAGC	GAAACACCGGTTTACGTTGCATCGGTGTGGGGTTAGAGCTAGAAATAGCA	1	bc
GAGGGCCTAC	GAAACACCGGTTCCCTTACTCTCACCTGATTACTTAATCCGTGGGGTTAG	1	bc
AATGTTTAGC	GAAACACCGGTTTACGTTGCATCGGTTGTGGGGTTAGAGCTAGAAATAGC	1	bc
CGACTCCATA	GAAACACCGGTCTCGAGTGAGGTGTTCAGGGTGGGGTTAGAGCTAGAAAT	1	bc
GCTAATCGGC	GAAACACCGGTACCTTTGTTGATGCTGGGTGGAAGGAATTTTGTGGGGTT	1	bc
AAGCGACGTC	GAAACACCGGTGTACGTATGGACTGAACCAGGGTGTGCAAGTGGGGTTAG	1	bc
GATCTGCCGC	GAAACACCGGTCCGCAGCAGACCCGGGTGGCGTTAGACTGAGAAATTGCA	1	bc
ATACACGGAC	GAAACACCGGTACCTTTGTTGATGCTGGGTGGGGTTAGAGCTAGAAATAG	1	bc
AAGAAGGCAC	GAAACACCGGTTGTTGGTATGTTTTTATGGGGATATAGCAAGTTAAGCAA	1	bc
AGTACTCGGC	GAAACACCGGTACCTTTGTTGATGCTGGGTGGAAGGAATTTTGTGGGGTT	1	bc
TACTTTACCG	GAAACACCGGTCGGGGCCACTCAGTGGTGGGGTTAGAGCTAGAAATAGCA	1	bc
ACAGCACTAC	GAAACACCGGTGCCCTTACTCTCACCTGATTACTTAATCCGTGGGGTTAG	1	bc
GGAAAGCTCC	GAAACACCGGTGTGGCTGCGGGTCCGGCAATGGTGTGGCTGTGGGGGTAG	1	bc
AACCGCACTC	GAAACACCGGTGCCCTTACTCTCACCTGATTACTTAATCCGTGGGGTTAG	1	bc
GCCTCGTCGT	GAAACACCGGTGTACGTATGGACTGAACCAGGGTGTGCAAGTGGGGTTAG	1	bc
GGCACTGCCC	GAAACACCGGTGTGGCTGAGAGTCCGGCAATGGTGTGGCTGTGGGGTTAG	1	bc
TATGTGCCTC	GAAACACCGGTCCGTAGGAGACCCGTGTGGCATGTACCTGTGGGGGTAGA	1	bc
GGCTACACTC	GAAACACCGGTCGGTGGGGTTAGAGCTAGAAATAGCAAGTTAACCTAAGG	1	bc
ACAATCCTTC	GAAACACCGGTCTCGAGTGAGGTGTTCAGGGTGGGGTTAGAGCTAGAAAT	1	bc
ATACGTAGTG	GAAACACCGGTGACCGGATGGGCTAAAAGAGGAAGTGCAAGTGGGGTTAG	1	bc
TTACTTCTTC	GAAACACCGGTAACTATATTCATGCGATATCGCCGTATCAGGGGGGTTAG	1	bc
ACAAACTCGC	GAAACACCGGTGCATTCGAAAGTCCGGTCGTAGTGTGGACGTGGGGTTAG	1	bc
ATGACTACAT	GAAACACCGGTTTACGTTGCATCGGGCGTGGGGGTAGAGCTAGAAATAGC	1	bc
CATCGGCTCC	GAAACACCGGTGTACGTATGGACTGAACCAGGGTGTGCAGGTGGGGTTAG	1	bc
CAGAGCAGAC	GAAACACCGGTGTACGTATGGACTGAACCAGGGTGTGCAAGCGGGGTTAG	1	bc
AACGATGTAC	GAAACACCGGTGCCCTTACTCTCACCTGATTACTTAATCCGTGGGGTTAG	1	bc
TCGTGTCGTC	GAAACACCGGTGACATTGGGTACTTGAAAAAGTGGCACCGAGTCGGTGCT	1	bc
AAATGTCGTC	GAAACACCGGTGTACGTATGGACTGAACCAGGGTGTGCAAGTGGGGTTAG	1	bc
AGAGCTGTGT	GAAACACCGGTTACATTGAGGGATAGAGCTAGAAATATCAAGTTAACCTA	1	bc
TAACGCCGTA	GAAACACCGGTGCCCTTACTCTCACCTGATTACTTAATCCGTGGGGTTAG	1	bc
TCGATCGGCA	GAAACACCGGTTATATTTGTAAGTGTGTGGGGGTAGATCTAGCAATAGCA	1	bc
ACCTATCGAG	GTTGTGGGGTTAGAGCTAGAAATAGCAAGTTAACCTAAGGCTAGTCCGTT	1	bc
GCTCTACGCC	GAAACACCGGTAGCAAGTGCGAGACGTGTTTGTGGGGTAAGAGCTAGAAT	1	bc
AGAACCGCGA	GAAACACCGGTGCATTCGACAGGCCGGTCGGAGGGGGGACGTGGGGATAG	1	bc
AACGCTTCGC	GAAACACCGGTTTACGTTGCATCGGTGTGGGGTTAGAGCTAGAAATAGCA	1	bc
GGGTTTCTTT	GAAACACCGGTCTCGAGTGAGGTGTTCAGGGTGGGGTTAGAGCTGGAAAT	1	bc
ACCGGCCTAA	GAAACACCGGTGCCCTTACTCTCACCTGATTACTTAAGCCGTGGGGTTAG	1	bc
AACATTAGGG	GAAACACCGGTCGATTCATATCGAAACCTTCCCGTGACAGTGGGGTTAGA	1	bc
AGACCCTTCT	GAAACACCGGTAAATTTGAGGCTCCGGCATGCAGGAGGCTGTGGGGTTAG	1	bc
CAAAAAGCTC	GAAACACCGGTTTGAACTAGAAATAGCAAGTTAACCTAAGGCTAGTCCGT	1	bc
AGACGATAGC	GAAACACCGGTGCATTCGAAAGTCCGGTCGTAGTGTGGACGTGGGGTTAG	1	bc
TCAGTCGGGA	GAAACACCGGTCGATTCATATCGAAACCTTCCCGTGACAGTGGGGTTAGA	1	bc
CACTAAGCGC	GAAACACCGTGGGGTTAGAGCTAGAAATAGCAAGTTAACCTAAGGCTAGT	1	bc
CGTGCTGTAG	GAAACACCGGTGCCACCTAAGGATAGTCCGTTATCAACTTGAAAAAAGCA	1	bc
TGAGCCATTT	GAAACACCGGTTACGTTGGGGGGAGAGCTAGAAATAGCAAGTTAACCTAA	1	bc
GCTCTACGTC	GAAACACCGGTTTGAACTAGAAATAGCAAGTTAACCTAAGGCTAGTCCGT	1	bc
TAGACCCGCG	GAAACACCGGTGCATTCGAAAGTCCGGTCGTAGTGTGGACGTGGGGTTAG	1	bc
AAACAACGCC	GAAACACCGGTTTGAACTACCTAGTTCAAACCGGTGGGGTTAGAGCTAGA	1	bc
GGCCTCCTTC	GAAACACCGGTGTGGCTGAGAGTCCGGCAATGGTGTGGCTGTGGGGTTAG	1	bc
ATCCTGACTT	GAAACACCGGTCCGTAGGAGACCCTTGTGGCATGTACCTGTGGGGTTAGA	1	bc
CGATTTCTCT	GAAACACCGGTGACATTGGGGACAGGGTGGGGTTAGGGCTAGAAATAGCA	1	bc
TGAGTTGTGT	GAAACACCGGTGACATTGGGTACAGGGGGAGGGGTTAGAGCTAGAAATAG	1	bc
AGGCACCATC	GAAACACCGGTGTGGCTGAGAGTCCGGCAATGGTGTGGCTGTGGGGCTAG	1	bc
GCCACCTACT	GAAACACCGGTAAATTTGAGGCTCCGGCATGCAGGAGGCCGTGGGGTTAG	1	bc
CTGGACGGTC	GAAACACCGGTTCCTTTGTTGTTGCTTTAGAGCTAGAAGTAGCAATAGAG	1	bc
AAAGGAGCTA	GAAACACCGGTGCCCTTACTCTCACCTGATTACTTAATCCGTGGGGTTAG	1	bc
GGCAAGATCC	GAAACACCGGTGTGGCTGAGAGTCCGGCAATGGTGTGGCTGTGGGGTTAG	1	bc
AAAATTCGGT	GGAACACCGGTCGATTCATATCGAAACCTTCCCGTGACAGTGGGGTTAGA	1	bc
AGGCTTACCC	GAAACACCGGTTTATGTTGAGGGCGGGTCGAGCTGGGGATAGGGAGTTAA	1	bc
ACTACTAGGA	GAAACACCGGTACCTTTGTTGATGCTGGGTGGAAGGAATTTGTGGGGTTA	1	bc
ACAGCTGGAC	GAAACACCGGTTCCCTTACTCTCACCTGATTACTTAATCCGTGGGGTTAG	1	bc
GGTCGCTATA	GAAACACCGGTAAATTTGAGGCTCCGGCATGCAGGAGGCCGTGGGGTTAG	1	bc
GATCTAGCGC	GAAACACCGGTAGCAAGTGCAAAACTCCGGGAGTAAGGGCGGGACGTGGA	1	bc
CCGCGTTGTC	GAAACACCGGTGCACGTATGGACTAAACCAGGTTGGGCATGGGGGTATAG	1	bc
GGGCACAGAC	GAAACACCGGTAGCAAGTGCGAGACGTGGTTGTGGGGTTAGAGCTAGAAA	1	bc
GAGACCCCCA	GAAACACCGGTTCCCGTTGTGGGCGGGTGGGGCTAGAAATAGCAAGTTAA	1	bc
CAGCGTAGCC	GAAACACCGGTGTACGTATGGACTGAACCAGGGTGGGCAAGTGGGGTTAG	1	bc
ACACAACGCA	ATGTGGGGTTAGAGCTAGAAATAGCAAGTTAACCTAAGGCTAGTCCGTTA	1	bc
TCACACCGCC	GAAACACCGGTTAGTAGTGGGGTTAGAGCTAGAAATAGCAAGTTAACCTA	1	bc
ACTACTAGGC	GAAACACCGGTACCTTTGTTGATGCTGGGTGGGGTTAGAGCTAGAAATAG	1	bc
CATAGGAGTC	GAAACACCGGTGTACGTATGGACTGAACCAGAGTGTGCAAGTGGGTTAGA	1	bc
CATATCAGTC	GAAACACCGGTGGACGGCTGGACTGAACCAGGGTATACATGGAGGGATAG	1	bc
CGGTTCGTTT	GAAACACCGGTGACATTGGGTACAATTGTGGTTAGAGCTAGAAATAGCAT	1	bc
CATTAGCTAT	GAAACACCGGTTACATGAGGGGTTAGAGCTAGAAATAGCAAGTTAACCTA	1	bc
GGTAACATCC	GAAACACCGGTGTGGCTGAGAGTCCGGCAATGGTGTGGCTGTGGGGTTAG	1	bc
TTGGGGCCTA	GAAACACCGGTTCCCGTGAAGTGGGGTTAGAGTTCGAAATAGCATGTTAA	1	bc
CAGCGTCGCT	GAAACACCGGTGTACGTATGGACTGAACCAGGGTGTGCAAGTGGGGTTAG	1	bc
GAAGAGATGC	GAAACACCGGTCGGCGGCAATCGTGGGTGGGGTTAGAGCTTGAAATAGCA	1	bc
GAGCCAGCCA	GAAACACCGGTAGCAAGTGCGAGACGTGGTGTTGGGGTTAGAGCTAGAAA	1	bc
CACATCGGGC	GAAACACCGGTCGATTCATATCGAAACCTTCCCGTGACAGTGGGGTTAGA	1	bc
TTCTATTGAG	GAAACACCGGTTATATTTGTAAGTGTTTGTGGGGTTAGAGCTAGAAATAG	1	bc
GGAGCCTTCC	GAAACACCGGTGGGGCGCAGGGTCCGGCAATGGTGTGGCTGTGGGGTTAG	1	bc
ATGACTTGAA	GAAACACCGGTAACTATATTCATGCGATATCGCCGTATCAGTGGGGTTAG	1	bc
TAGAGAGTAA	GAAACACCGGTTACGCGGAGGAGTTAGGGCTAGAAGTAGCAAGTTAACGA	1	bc
AGTGGAGACT	GAAACACCGGTTCCCGTCCAGTGGGGTTAGAGCTAGAAATAGCAAGTTAA	1	bc
ATATTTATCG	GAAACACCGGTCGGGGCCACTCAGTGGTGGGGTTAGAGCTAGAAATAGCA	1	bc
CTACTAGCGC	GAAACACCGGTACCTTTGTTGATGCTGGGTGGAAGGAATTTTATGGGGTT	1	bc
GGACACTAAA	GAAACACCGGTAAATTTGAGGCTCCGACATGCAGGAGGCCGTGGGGTTAG	1	bc
CGTCTTGCCA	GAAACACCGGTGACAGGGGTTAGAGCTAGAAATAGCAAGTTAACCTAAGG	1	bc
GAGGATCCGT	GAGACACCGGTCGGCGGCAATTGTGGTATGAGCGACGTGGGGTTAGATCG	1	bc
CGTGGTGGCC	GAAACACCGGTGACCCCAAGGACTAGTCCGTTATCAACTTGAAAAAGTGG	1	bc
AGTATGTCTT	GAAACACCGGTCCGAAGGAGAACCGTGTGGTGTGTGCCTGGGGGGTTAGA	1	bc
GATACTCGGC	GAAACACCGGTACCTTTGTTGATGCTGGGTGGGGTGGGGTTAGAGCTAGA	1	bc
AGGGTGGTTC	GAAACACCGGTGACAGAGCTAGAAATAGCAAGTTAACCTAAGGCTAGTCC	1	bc
