TAAACTCAAG	GAAACACCGGTAGTTCGCCCACTATCCATCGTGGGGTAGAGCTAGAAATA	5	bc
CAACAACGGC	GAAACACCGGTGCCTGTCAATTGATCGCAAGTGGGGTTAGAGCTAGAAAT	5	bc
TATGTCATGC	GAAACACCGGTAATACGTTCCGTGGTACTAGTGGGGTTAGAGCTAGAAAT	4	bc
AAAGCGTGAG	GAAACACCGGTTCGTCCCCGATGAGTAAGCTGATGCCAAAGTGGGGTAGA	3	bc
ACGCGACTTC	GAAACACCGGTACTCCTTCAAGTCTACATCGTGGGGTTAGAGCTAGAAAT	3	bc
CTCCACAGAA	GAAACACCGGTTAATCGAGACGCAGTTCAGTGTGTGGGTGTGGGGTTAGA	3	bc
CCCAATCCAT	GAAACACCGGTCTTGATGCCCGAGGAGGGTGTGGGGTTAGAGCTAGAAAT	3	bc
CCACACGACA	GAAACACCGGTGTGGGTGTTGTTCCTGAAGAGACCGACGGGTGGGGTTAG	3	bc
TCAATACACT	GAAACACCGGTTTAGAGGTTCTGGGGATATGGGAGTAGGGGTGGGGTTAG	3	bc
TGTCCAAGCG	GAAACACCGGTCCGGGGTAATTCGTATATAGTGGGGTTAGAGCTAGAAAT	3	bc
GCCGAAATCA	GAAACACCGGTGAAAGACGATGGCAGGTGGGGTTAGAGCTAGAAATAGCA	3	bc
CCAGCTAAAG	GAAACACCGGTTGGAAGGGACAGCGGGCCGCACGGCCTTTGTGGGGTTAG	2	bc
TCAACACACT	CAAAACACCGGTTTAGAGGTTCTGGGGATATGGGAGTAGGGGTGGGGTTA	2	bc
GCCAGCCGCT	GAAACACCGGTTAGCAGCCAATTGCGTGGCTCCTAGAGGTGTGGGGTTAG	2	bc
CGGCCATACC	GAAACACCGGTAGTTATTAGCTCGACCATTGTGGGGTTAGAGCTAGAAAT	2	bc
GGCCACCCCC	GAAACACCGGTCCCGGTAGAACCAAAGGCTGTGGGGTTAGAGCTAGAAAT	1	bc
GCTCTACGCC	GAAACACCGGTGCCAATGTGGTTGCGTCATGTGGGGTTAGAGCTAGAAAT	1	bc
TGGCGACTGC	GAAACACCGGTCCCGGTAGAACCAAAGGCTGTGGGGTTAGAGCTAGAAAT	1	bc
ATATAATTAT	CGTGGGGTTGGAACCAAAAACAGCAGGCTAACCTAGGGCTATACCGTCCT	1	bc
CCCCACTCAG	GAAACACCGGTAGAGGACTGGTGAACACTAGTGGGGTTAGAGCCAGAAAT	1	bc
GCCATCGGCC	GAAACACCGGTGCGTAGAGGTGTGCAGCCAGGTGACCTCTGGGGGGATCG	1	bc
TCCTATACCT	GAAACACCGGTAACCAGCGCATGCTCCAAAGTGGGGTTAAAGCTCAGAAT	1	bc
TCAATACACC	GAAACACCGGTTTAGAGGTTCTGGGGATATGGGAGTAGGGGTGGGGTTAG	1	bc
TCCTCAGCAC	GAAACACCGGTGTGAAAGCTTTCGAAGTGCGGGTGGATAGAGCTAGAAAT	1	bc
AGGAGAACCC	GAAACACCGGTAGCCCGTGATTCTGCAGGGGCGTATCCTGAATTCGGGCC	1	bc
GAAGACCCGC	GAAACACCGGTCGGCAGCAATCGTGGGTGAGGTTAGAGCTAGAAATAGCA	1	bc
GATACTTAAC	GGAACACCGGTACCATACTTAAGAGGGAGCTTAAGGGGCAGTGGGGTTAG	1	bc
TACTCTTCCA	GAAACACCGGTGGGCAGGTGGGAATCACATTGGGGTATATGGGTAGAAAT	1	bc
CAACAACTGC	GAAACACCGGTGCCTGTCAATTGATCGCAAGTGGGGTTAGAGCTAGAAAT	1	bc
TTGCTTGTAC	GAAACACCGGTCGTCACTTTATCATTGTGGGGTTAGACTAGAAATAGCAA	1	bc
GTGTCAGCTG	GAAACACCGGTAAAGGGAGACTACACTATCGTGGGGTTAGAGCTAGAAAT	1	bc
TTACCATACC	GAAACACCGGTAGCTATTAGGTCGACCTATTTAGGTTTTTAGCTGGATAG	1	bc
GATACCCCCA	GAAACACCGGTCCAAAATGTCGCCACGTGGGGTTAGAGCTAGAAATAGCA	1	bc
GAACATTAGA	GAAACACCGGTAATAAGTGGTTCTTAGTGGGGTCAGAGCTAGAAATAGCA	1	bc
CAACAATGGC	GAAACACCGGTGCCTGTCAATTGATCGCATGTGGGGTTAGAGCTAGAAAT	1	bc
TAAGAAACCC	GAAACACCGGTCCTGTCGCCACGGGTGTGGGGTTAGAGCTAGAAATAGCA	1	bc
ATGTAAGCTG	GAAACACCGGTGTAGAGGCCTAAAGTGACAGTGGGGTTAGAGCTAGAAAT	1	bc
CCCAGTCCAT	GAAACACCGGTCTTGATGCCCGTGGAGGGGGTGGGGTTAGAGCTAGAAAT	1	bc
GAATACCCCA	GAAACACCGGTAACGCGCCTATATGCCTAGTGACCGCAGAGTGGGGTTAG	1	bc
ACGGCGCGAC	GAAACACCGGTAGAACATGTTCGACTTATAGTGGAGTTAAAGCTAGGAAT	1	bc
CCGTGCCATA	GAAACACCGGTTCGTATCACGCCATTGCACTGGGGGATAGTGCTAGTAAT	1	bc
TTTGTGGCAT	GAAACACCGGTCGTTATCAACTCATGGAACGTGGGGTTAGAGCTAGAAAT	1	bc
GCCGGTCTTC	GAAACACCGGTTCTCCTGCAGCACTTCACGGGATTATAGAGCGAGGATAG	1	bc
TCCCAGGGAC	GAAACACCGGTCCCTCCGCATACAGCTGTCGTGGGGTTAGAGCTAGAAAT	1	bc
CACAACGCCC	GAAACACCGGTTTGAACTACCTAGTTGTGGGGTTAGAGCTAGAAATAGCA	1	bc
GCCCAAGGCC	GAAACACCGGTCCCGGTAGAACCAAATGCTATGGGGTTAGAGCTAGAAAT	1	bc
GATACTTAAC	GAAACACCGGTACCATACTTAAGAGTGAACTTAAGGGGCAGTGGGGTTAG	1	bc
CCCCACTCAG	GAAGCACCGGTAGAGGACTGGTGAACACTAGTGGGGTTAGAGCTAGAAAT	1	bc
AGTCTCCGAA	GAAACACCGGTAGAACGCTTGAAGCACTAGTTGTTCGGTGGTGGGGTTAG	1	bc
CAACAACGGC	GAAACACCGGTGCCTGTCAGTTGATCGCAAGTGGGGTTAGAGCTAGAAAT	1	bc
ACTTATAATA	GAAACACCGGTAACCAGCGCTTGCTCCAAAGTGGGGTTAGAGCTAGAAAT	1	bc
AGATCAAAGC	GAAACACCGGTTTCCCGTATGTGGGGTTAGAGCTAGAAATAGCAAGTTAA	1	bc
GACGGTTGGG	GAAACACCGGTGACACAAGTGAGGATGGACTGGCTGATGTGTGGGGTTAT	1	bc
ATTACACATA	GAAACACCGGTTACATCGCTACGGGAGTGGGGTTAGAGCTAGAAATAGCA	1	bc
GAAGAAGTCT	GAAACACCGGTACAACCGTCTCACTTGGTCGTGGGGTTAGAGCTAGAAAT	1	bc
AAGGCGGTGG	GAAACACCGGTACCACTCCCGTCGGGAGTAGTGGGGTTAGAGCTAGAAAT	1	bc
TCCCAGCTCG	GAAACACCGATAAAGGAAGCATACCCTATCGTGGCGCTAGAGCTAGATAT	1	bc
TCGATACACT	GAAACACCGGTTTAGAGGTTCTGGGGATATGGGAGTAGGGGTGGGGTTAG	1	bc
TTGAGCATAA	GAAACACCGGTTAAGCCGAGGAGTTAGTGGGGTTAGAGCTAGAAATAGCA	1	bc
CCCACCACTC	GAAACACCGGTCGTCTGCACTACGCAGAGGGGTTAGAGCTAGAAATAGCA	1	bc
GACTAGCCCA	GAAACACCGGTTCTCTTAGAACTAGAAATAGTAAGTTTACCTATGGCTAT	1	bc
AAGCCGCGCG	GAAATACCGGTGTAACTTAACACTGAGTGGGGTTAGAGCTAGAAATAGCA	1	bc
AGGTGGCTCC	GAAACACCGGCCTTGGTTCTAGGGAATTGGAGTGCGGGTAGAAATAGTAG	1	bc
GAATACTATA	GAAACACCGGTCACGCGCCTATATGCCTGGTGACCGAAGAGTGGGGATAG	1	bc
TATTTCATGC	GAAACACCGGTAATACGTTCCGTGGTACTAGTGGGGTTAGAGCTAGAAAT	1	bc
ACGCGCCTTC	GAAACACCGGTACTCCTTCAAGTCTACATCGTGGGGTTAGAGCTAGAAAT	1	bc
AACCGCTTGC	GAAACACCGGTGCAAAAGGGGTAGTGGACCGTGGGGTTAGAGCTAGAAAT	1	bc
GACCCGACCA	GAAACACCGGTGCTCTGTGTGGGGTTAGAGCTAGAAATAGCAAGTTAACC	1	bc
GGATTCTGGC	GAAACACCGGTGCATATAGGAGTGCAGCCAAGAGTCCTATGTGGGGTTAG	1	bc
CAATCGGCGT	GAAACACCGGTACGCTAATAAAAAGTGAGCAAGTGAACTAGTGGGGTTAG	1	bc
GAACCACGGC	GAAACACCGGTAGCCCGTGATTCTGCAGGGGCGTATCCTGAATTCGGGCC	1	bc
TACGCTGGAT	GAAACACCGGTACCACTCCCGTCGTGAGTAGAGTGCGTAGCGCTATAAAT	1	bc
AAATCAGGCT	GAAACACCGGTACAACCGTCTCACTTGGTCGTGGGGCTAGAGCTAGAAAT	1	bc
GACTACCTCA	GAAACACCGGTCCCGGTAGAACCAAAGGCTGTGGGGTTAGAGCTGGAAAT	1	bc
CCACGCGACA	GAAACACCGGTGTGGGTGTTGTTCCTGAAGAGACCGACGGGTGGGGTTAG	1	bc
AATAGCTGAA	GAAACACCGGTTAACAGGGACGCTATGAGTGTAACAACTTGTGGGTAAGA	1	bc
GAATCGCCCC	GAAACACCGGTGTCCGCGGCCAGCTCCATTGTGGGGTTAGAGCTAGAAAT	1	bc
AACGGGCATT	GAAACACCGGTACCTGTAGATTTGTTTATCGTGGGGTTAGAGCTAGAAAT	1	bc
ACGGCGCACC	GAAACACCGATATATAAAAATACGACCACTGTGGGGTTAGAGCTAGAAAT	1	bc
AACTCACCTC	GAAACACCGGTCGGATCTCCGGAGGAGTGGGGTTAGAGCAAGAATAAGCA	1	bc
TGGAGCTGGC	GAAACACCGGTCAAACCTGGCTAGACGAGGGGTTAGAGCTAGAAATAGCA	1	bc
TTAAAAAGAA	GAAAAAAAGGAGAGGAAAGGGGACATGAGGGTGGACCCGAGTGGGGTTAG	1	bc
GAAGGATACA	GAAACACCGGTTTCCACGGCGCACATGCGGGTATTAAGGCGTGGGGTTAG	1	bc
TAGGAAAAGC	GAAACACCGGTAGCCCGTGATTCTGCAGGGGCGTATCCTGAATTCGGGCC	1	bc
AGCAGGGGGT	GAAACACCGGTCTTGGTTCTAAGGAAGTAGGGTTAGAGCAGAAATAGCAA	1	bc
CCCCACTCAG	GAAACACCGGTAGAGGACTGGTGAACACTAGTGGGGTTAGAGCTAGAAAT	1	bc
TGGAACCACA	GAAACACCGGTTCTGCCGCTTTAAGTGTGGGGTTAGAGCTAGAAATAGCA	1	bc
AGGCCAGATA	GAAACACCGGTCCCTCCGCATACAGCTGTCGTGGGGTTAGAGCTAGAAAT	1	bc
CCCGCCAGCG	GAAACACCGGTGAAGGAAGACGGGAGGGCGACGTAAGGGGTGGGGTTAGA	1	bc
CGAGTAAGCC	GAAACACCGGTCATGTCAATGCGGGGTGGGGTTAGAGCTAGAAATAGCAA	1	bc
GTACATTAGA	GAAACACCGGTAATAAGTGGTTCAGAGTGGGGTCAGAGCTAGAAATAGCA	1	bc
ACGACACGTA	GAAACACCGGTAGAACAGGGTCGACATATAGTGGGGTTATAGCTAGAAAT	1	bc
TGTTGGCGGT	GAGACACCGGTCAAACCTGGATAGAAGTGGGGTTAGAGCTAGAAATAGCG	1	bc
AACTATCGGC	GAAACACCGGTAAAGGGCATATGAGGGAGGGAGTCGATGTGTGGGGTTAG	1	bc
GCACGCGCAA	GAAACACCGGTACCTGCAGATTTGTTTATCGTGGGGCTAGAGATAGAAAT	1	bc
AAAAATCATA	GAAACACCGGTAGGCGAGAGGTCAACGTAATCATTATGGGTGGGGTTAGA	1	bc
GCCGAAATCA	GAAACACCGATGAAAGACGATGGCAGGTGGGGTTAGAGCTAGAAATAGCA	1	bc
GACCTCTCCA	GAAACACCGGTTTGCACAGCGCGTACGCGGGGATTAAGGTGTAGGGATCG	1	bc
ACTCAGCGGC	GAAACACCGGTCCGGTTGGGGTTAGAGCTAGAAATAGCAAGTTAACCTAA	1	bc
ACGCAGCTGA	GAAACACCGGTAATCCGTCACTACCCCATCGTGGGGTTAGAGCTAGAAAT	1	bc
ACTCAACGAC	GAAACACCGGTCCTGCTAGAACTAGAAATAGCAAGTTAACCTCTGGCAAG	1	bc
GACCCGACCA	GAAACACCGGTGCTCTGGGTTTGTGTGTGGGGTTAGAGCTAGAAATAGCA	1	bc
CGCATGATGC	GAAACACCGGTTCGTTTCATGCTCACGACTTAATTGACATGTGGGGCTAG	1	bc
GCTACTATAG	GAAACACCGGTGTAGCGGACAAGTACAGCTTCACGAGCTGGTGGGGTTAG	1	bc
CACGAATTCA	GAAACACCGGTCCCGGTAGAACCAATGGCTGTGGAGATAGAGCTAGAGAT	1	bc
ATCAACTTTG	GAAACACCGGTTACCTGGGACGCTATCAGTGTAACAACTTGTGGGGTAGA	1	bc
ATCCGACGCG	GAAACACCGGTAGAACATGGTCGACATATAGTGGGGTTAGAGCTAGAAAT	1	bc
AAACGCTTAT	GAAACACCGGTCGAGACATAGGCACAGACATCGGGCGGCTGTGGGGTTAG	1	bc
ACGCGACCTC	GAAACACCGGTACTCCTTCAAGTCTACATCGTCGGGTTAGAGCTAGAAAT	1	bc
TAAACTCAAG	GAAACTCCGGTAGTTCGCCCACTATCCATCGTGGGGTAGAGCTAGAAATA	1	bc
TAAACTAAAG	GAAACACCGGTCTCGTATCCACGTACCATCGGTTAGAGCTAGTAATAGTA	1	bc
TTGCGTTGGT	GAAACACCGGTCAAACCTGGATAGAAGTGGGGTTAGAGCTAGAAATAGCA	1	bc
CCAGGGGCCC	GAAACACCGGTTTCCCAAAAGGAGCTGTGGGGTTAGAGCTAGAAATAGCA	1	bc
AAACGATTAA	GAAACACCGGTCGAGAAATAGGCACAGACATCGGACGGCTGTGGGGTTAG	1	bc
GGCGACTAGA	GAAACTCCGGTCACGTTAGAACCAAAGGCTATGAGGTTGGAGCTAGAAAT	1	bc
TAAACTCAAG	GAAACACCGGTAGTTCGCCCACTATCCATCGTGGGGTAGAGCTAGGAATA	1	bc
ACGCGACTTC	GAAACACCGGTACTCCTTCAAGTCTACATCGTCGGGGTATATCTAGAAAT	1	bc
ATTATCGTAC	GAAACACCGGTGGGTAGCTGGGTGCCCTACTGACCTAATTGTGGGGTTAG	1	bc
CGTTCGTTCC	GAAACACCGGTCTTGGTTATATGGTAGTGGGTTTAGTGCAGAAATAGCAA	1	bc
AGGCCATACC	GAAACACCGGTAGTTATTAGCTCGACCATTGTGGGGTTAGAGCTAGAAAT	1	bc
ACCTACCGCA	GAAACACCGGTCCCGGTAGATCCAAAGGCTGTGGGGTTAGAGCTAGAAAT	1	bc
TGCCCACAAA	GAAACACCGGTCCCTCCGCGTACAGCTGTCGTGGGGTTAGAGCTAGAAAT	1	bc
TGCACCGCTT	GAAACACCGGTGCAAAAGGGGTAGTGGACCGTGGGGTTAGAGCTAGAAAT	1	bc
CCCCCCGGCC	GAAACACCGGTGCGGCGAGGTCGTTCGTGGGGTTAGAGCTAGAAATAGCA	1	bc
TCCCCCCACC	GAAACACCGGTAAGTTTCTTTATCGGTTGAGGCGGTGATGGTGGGGTTAG	1	bc
TCGCGGGTAA	GAAACACCGGTACCTGTAGATTTGTTTACCGTGGGGTTAGAGCTAGAAGT	1	bc
ATATCAAAGC	GAAACACCGGTTTCCCGTATGTCTGGGGCTATAGCTAGAAATAGCAAGTT	1	bc
AACGCGAAGC	GAAACACCGGTGCAAGTCCCTTCTGGGTGGGGTTAGAGCTGGAAATAGCA	1	bc
TTACAACTTG	GAAACACCGGTAAAGGGAGACTACCCTATCGTGGGGTTAGAGCTAGAAAT	1	bc
TCAATACACT	GAAACACCGGTTTAGAGGTTCTGGGGATACGGGAGTAGGGGTGGGGTTAG	1	bc
GGAACCGCTC	GAAACACCGGTGCACGAGGATGAGTGGCTCGCGGTGTGGGGTCAAAGCTT	1	bc
AGACCCTCGC	GAAACACCGGTGCATTCGAAAGTCCGGTCGTAGTGTGGACGTGGGGTTAG	1	bc
CATACTTAAC	GAAACACCGGCAGACGTAATTCCCTTGTGGGGTTAGAGCTAGAAATAGCG	1	bc
ACCCCCCACC	GAAACACCGGTACGTTTCTTCATCCGTTACGTCGGCCCCGCGGGGGTTGA	1	bc
TTAGCGCTCT	GAAACACCGGTTTCCAAATAGGAGCTCTACCGATCTAACTAGGGAGATCG	1	bc
CTGCTATCGA	GAAACACTGGTTGTGTCACCTTCACAGTGGGGTTAGAGCTAGAAATAGCA	1	bc
AAAGCGTGAG	GAAACACCGGTTCGTCCCCGATGAGTAATCTGATGCCAAAGTGGGGTAGA	1	bc
CAACAACGGC	GAAACACCGGTGCCTGTCAATTGATCGCAAGTGGGGTTAGAGCTAGAAGT	1	bc
CCGGCCCCTA	GAAACACCGGTCCAAAGGCGTCGGACGTGGGGTTAGAGCTAGAAATAGCA	1	bc
GACCCGACCA	GAAACACCGGTGCTCTGGGTTTGTGTTGTGGGGTTAGAGCTAGAGATAGC	1	bc
ACTCAACGGC	GAAACACCGGTCCGGTTGAAGTGGGGTTAGAGCTAGAAATAACAAGTTAA	1	bc
CTATAGCTGA	GAAACACCGGTTACCTGGGACGCTATCAGTGTAACAACTTGTGGGGTAGA	1	bc
TTTGGCACAC	GAAACACCGGTAGCAGCGGCAGGCGTGATGGTGGGGTTAGAGCTAGAAAT	1	bc
CCCCCCTCCC	GAAACACCGGTCGGCCAGAGGTAATCACATGTGGGGTTAGAGCTAGAAAT	1	bc
CGTGGGCTGC	GAAACACCGGTCTTGGTTCTAGGGTAGTGGGGTTAGAGCAGAAATAGCAA	1	bc
GATACTTAAC	GAAACACCGGTACCATACTTAAGAGGGAACTTAAGGTGCAGTGGGGTTAG	1	bc
TTATCCTCCC	GAAACACCGGTGGGCAGCTGGGTGCCCTACTGACCTAATTGGGGGGTTAG	1	bc
AATGGGTTCC	GAAACACCGGTCTTGGTTCTAGGGTAGTGGGGTTAGAGCAGAAATAGCAG	1	bc
AAATCGCAGG	GAAACACCGGTGCAAAAGGGGTAGTGGACCGGGTAGATATAGCTAGAACA	1	bc
CATACTTAAC	GAAACACCGGTAGACGTAATTCCCTTGTGGGGTTAGAGCTAGAAATAGCA	1	bc
CTTACTACTT	GAAACACCGGTGCAGCGAACAAGTACGTCTTCACGAGCCAGTGGGGTTAG	1	bc
ACTCAACGGC	GAAACACCGGTCCGGTTGAAGTGGGGTTAGAGCTAGAAATAGCAAGTTAA	1	bc
CGCCGTAGCA	GAAACACCGGTGTGGTCGAAGGACGGGTCGTGTGTGGAGTGTGGGGTTAG	1	bc
TAAACTCAAG	GAAACACCGGTAGTTCGCCCACTATCCATCGTGGGGTAGAGCTAGAAATG	1	bc
ATGGTAGCTC	GAAACACCGGTCGTCGCTATATCATCGTGGGGTTAGACTAGAAATAGCAA	1	bc
TCCACACGCA	GAAACACCGGTGTAGCCTGTGTAGACCAATCGATAGCAGTGTGGGGATAG	1	bc
GGACGAAAAC	GAAACACCGGTGCATGTACCTTCTGGGTGGGGTTAGAGCTAGAAATAGCA	1	bc
CAATATAACT	GAAACACCGGTACAAACGTCTCACTTGGTCGTGGGGTTAGAGCTAGAAAT	1	bc
ACTCAACGGC	GAAACACCGGTACGGTTGCCGTGTCAGTGGGGTTAGAGATAGCTATAGTA	1	bc
GGGCTGGACC	GAAACACCGGTCCAAAGGCGTCGGACGTGGGGTTAGAGCTAGAAATAGCA	1	bc
AGCCCAAACC	GAAACACCGGTTAGCATCCTATTACGTCGTTAATTTGGTAGTGGGGTTAG	1	bc
GTGATCATAC	GAAACACCGGTAGTCCCTCCATAGGGTGTGTCTCGGTGGGGTTAGAGCTA	1	bc
CCCCACTCAG	GAAACACCTGTAGAGGACTGGTGAACACTAGTGGGGTTAGAGCTAGAAAT	1	bc
CAGGTACACT	GAAACACCGGTACCCCGTGATTCTGTTATCGTGGATCTAGAGTTCGAAAT	1	bc
TAACTGCCTC	GAAACACCGGTACTCACGTGTAGATGAACTTTGGGGGTTAGACTTAGAAA	1	bc
TCGCATAACT	GAAACACCGGTAACCAGCGCATGCTCCAAAGTGGGGTTAGAGCTAGAAAT	1	bc
AAAGCGCGAG	GAAACACCGGTTCGTCCCCGATGAGTAAGCTGATGCCAAAGTGGGGTAGA	1	bc
GACACTGTGA	GAAATACCGGTACCAAGGCGGCGGACGTGTGGGTAGATCTAGCAATAGCT	1	bc
TCATCCAAAC	GAAACACCGGTGAGAAACCTTTCTAAGTGGGGTTAGAGCTAGAAATAGCA	1	bc
ATCATCCGGC	GAAACACCGGTGAGAAACCTTTCTAAGTGGGGTTAGAGTTAGAAATAGCA	1	bc
AGCCCAAATC	GAAACACCGGTTGACACGCTAGGTGTTGAAAAACTTGTTGGTGGGGTTAG	1	bc
TATGTCACGC	GAAACACCGGTAATACGTTCTGTGGTACTAGTGGGGTTAGAGCTAGAAAT	1	bc
TAACCCGGCC	GAAACACCGGTGCATATAGGAGTGCAGCCAAGAGTCCTATGTGGGGTTAG	1	bc
TCAATACACT	GAAACACCGGTTTAGAGGTTCTGGGGATATGGGGGTAGGGGTGGGGTTAG	1	bc
CATAACTGAT	GAAACACCGGTTACCTGGGACGCTATCAGTGTAACAACTTGTGGGGTAGA	1	bc
TACTTTAATC	GAAACACCGGTGACGAGATCATGTAGAAATGGCGGGTTAGCCTTAGGCTT	1	bc
GATTTCACCA	GAAACACCGGTTTCACCGTCCCTCGTACTGGTAGTGTTACGTCTAGTTAG	1	bc
TCAATACACT	GAAACACCGGTTTAGAGGTTCTGGGGATATGGGAGTAGGGGTTAGAGCTA	1	bc
TCGTTACGGT	GAAACACCGGTCAAACCTGGATAGAAGTGGGGTTAGAGCTAGAAATAGCA	1	bc
TATATACCCC	GAAACACCGGTCTCGCGTCTCTGTATGTGGGGTTAGAGCTAGAAGTGGCG	1	bc
GCATCAACCT	GAAACACCGGTGTCCGCTACCAGCTCCAATGTGGGGTTAGAGCTAGAAAT	1	bc
TGGAATCATT	GAAACACCGGTTCGGCCTCTTTAAGAGTGGGGGTAGAGATAGAAATAGCA	1	bc
CCGAACTTAC	GAAACACAGGTAATTCTGCAAGAGATTCTGGTGGGGTTAGAGCTAGAAAT	1	bc
ATATAATGAT	GAGACACCGGTGCCCCAACCTGGGGTTAGAGCTAGAAATAGCAAGTTAAC	1	bc
TAATTACTGA	GAAACACCGGTTCTACAACAGTCGCATGTTCGCGGGTGGGGTTAGAGCTA	1	bc
AGTCCATTTT	GAAACACCGGTCTGGCGAATTGCTGAGTGGGGTTAGAGCTAGAAATAGCA	1	bc
CCCGGGAAAA	GAAACACCGGTACCTGTAGATTTGTTTATCGTGGGGTTAGAGCTAGAAAT	1	bc
GTCAGATACC	GAAACACCGGTAGTTCTCAGAGGAAGAGCCGTGGGGTTAGAGCTAGAAAT	1	bc
CCACCGCTCG	GAAACACCGGTGCAAGAAGAGAGGAGGGCGATGTAAGGGGTGGGGCTAGA	1	bc
ACTCAACGGC	GAAACACCGGTCCGGTTGAGCTAGAAATAGCAAGTTAACCTAAGGCTAGT	1	bc
ACATAATGAT	GTATGGCGTTAGAGCTAGAAATAGCAAGTTAACCTAAGGCTAATCCGTTA	1	bc
TAACTGTTAT	GAAACACCGGTACACCGCTGAAGGGTATACGACCGGAAAGGGGGGGAAAT	1	bc
AGGCGTTAAC	GAAACACCGGTAATATTTTCTGGAGGGAGGGGTAAGAGCTAGAAATAGCA	1	bc
CGTGTTGTCT	GAAACACCGGTGACATTGGGTACAGGGTGGGGTTAGAGCTAGAAATAGCA	1	bc
ACTTCACCAG	GAAACACCGGTGCAGCGAACAAGTACGTCTTCACGAGCAAGTGGGGTTAG	1	bc
ATATCACGAC	GAAACACCGGTCACGAGAGGGGCCCCCGCCGTAGTCCCGAGTGGGGTTAG	1	bc
GAACTGGGAC	GAAACACCGGTACAAGTATGGCAACAGACCGTCGGGACTGAGCTGGATAT	1	bc
ACTTCGCCTG	GAAACACCGGTTTCCTCTGCGAGCTCCATTGTGTAGTAAGAGCTAGAAAT	1	bc
GGGTGACACG	GAAACACCGGTTGGGGCAGCGGCAAGATACATCATGCGCAGTGGGGTTAG	1	bc
ATTTTCTCGA	GAAACACCGGTAGACCCTGTTGCTTCGTGGGGTTAGAGCTAGAGATAGCA	1	bc
GACCCGACCA	GAAACACCGGTAGAGGACTGGTGAACACTAGTGGGGTTAGAGCTAGAAAT	1	bc
AAGGGGTTCA	GAAACACCGGTAATAATTCCTGCCGGGGGGGGTTAGAGCTAGAAATATCA	1	bc
CATTTTATCA	GAAACACCGGTCTCGTAACCATGTATGTGGGGTTAGAGCTAGAAATAGCA	1	bc
ATTAGGTTCA	GAAACACCGGTCTTGGTTCTAGGGCAGTGGGGTTAGAGCAGCAAGAACAA	1	bc
GACGACGCAC	GAAACACCGGTCCCGGTAGAACCAAAGGCTGTGGGGTTAGAGCTAGAAAT	1	bc
AAGCTTGTGG	GAAACACCGGTCACATTAGCGCAACTAGCCGAAGTCGCATGTGGGGTTAG	1	bc
GCCAGTCGCT	GAAACACCGGTTAGCAGCCAATTGCGTGGCTCCTAGAGGTGTGGGGTTAG	1	bc
GCGAAGTCAT	GAAACACCGGTGACTCAATATACCAGTGTTCCATGGTGGGGCTAGAGCTA	1	bc
ATATATAATA	GAAACACCGGTTACCAGGGAGTGAATCATAGTAACAGCAGGTGAAGCAAA	1	bc
CCATTACCAT	GAAACACCGGTAAATTTAGCTTCGATGACAGGGTTGCGGTAGGGAGTTAG	1	bc
ACAGTACTTA	GAAACACCGGTACTCCGGAAGGCCAAGTGGGGTTAGAGCTAGAAATAGCA	1	bc
TACACTCAAG	GAAACACCGGTAGTTCGCCCCCTATCCATCGTGGGGTAAGACTAGAAATT	1	bc
CCCCCAACAA	GAAACACCGGTAGATGTCACGTACATGTGGACATACCTGGGTGGGGTTAG	1	bc
GAACTAATGT	GAAACACCGGTGAAAAAGGGGAAGTGGACCGAGGGCTTAGAGCTAGAAAT	1	bc
TATTCACAGG	GAAACACCGGTAGTTGGCCCAATAGCTAGAGTGGGGTAGAACTAAAAATA	1	bc
ACTTCACGAA	GAAACACCGGTATAACATGGTCTACATGTTGTGGGGTTAGAGCTAGAAAT	1	bc
ACTCCGGTGG	GAAACACCGGTTTGCAAGTCCCAAGTGTGGGGTTAGAGCTAGATATAGCA	1	bc
GCACTCAATG	GAAACACCGGTGTGGGGGTAGAGTAGAAGGATCAGGTTAACCTAAGACTA	1	bc
GAGCCATACC	CAAAACACCGGTGCATGTACCTTCTACGTTTGTTTAGATCTAGCAATAGC	1	bc
GGAACTGTGC	GAAACACCGGTCCAAAGGCGTCAGACGTGGGGTTAGAGCTAGATATAGCA	1	bc
GGAAACACTG	GAAACACCGGTGCAAAAGGGGTAGTGGACCGTGGGGTTAGAGCTAGAAAT	1	bc
ATGTCCTCCC	GAAACACCGGTAGACCCTGTTGCTTCGTGGGGTTAGAGCTAGAAATAGCA	1	bc
AGAGCACACC	GAAACACCGGTCCTGTCGCCACGGGTGTGGGGTTAGAGCTAGAAATAGCA	1	bc
TTTGGCCCAC	GAAACACCGGTAGCAGCGGCAGGCGTGATGGTGGGGTTAGAGCTAGAAAT	1	bc
CGTACTTCCC	GAAACACCGGTACTCCGGAAGGCCAAGTGGGGTTAGAGCTAGAAATAGCA	1	bc
AGGCCATCGC	GAAACACCGGTAGACCCTGTTGCTTCGTGGGGGTAGAGCTAGAAATAGCA	1	bc
GGCACCCTCC	GAAACACCGGTGTGGCTGAGAGTCCGGCAATGGTGTGGCTGTGGGGTTAG	1	bc
AAGGTATCCA	GAAACACCGGTATCCACGGCGCACATACGGGCATTACGGCGATGGGTTAG	1	bc
CGGATCCGCA	GAAACACCGGTACTCCGGAATTCCACGTGGGGGTAGACCTAGATCTAGCA	1	bc
TATCAGCTGC	GAAACACCGGTAAAGGGAGACTACCCTATCGTGGGGTCAGAGCTAGTAAT	1	bc
CTACTCGGCC	GAAACACCGGTACCTTTGTTGATGCTGGGTGGAAGGAATTGTGGGGTTAG	1	bc
AGTTTCCGAA	GAACCACCGGTAGAACGCTTGAAGCACTAGTTGTTCGGTGGTGGGGTTAG	1	bc
CATGCTTCCC	GAAACACCGGTGTCGAAGTCAAGCATGTGCGTGTGGTTAGAGCTATAAAT	1	bc
GAATATATTG	GAAACACCGGTCTCGTATCCATGTATGTAGGGTTAGAGCTAGAAATAGCA	1	bc
GTACATTAGA	GAAACACCGGTAATAAGTGGTTCTTAGTGGGGTCAGAGCTAGAAAAAGCA	1	bc
TTGCTGGTCT	GAAACACCGGTACACCGCGTAATGGTATACTACCGTAAAGGTGGGGTTAG	1	bc
GATCCCTCAA	GAAACACCGGTCACGCGCCTATATGCCTAGTGTCCGAGGTGTGGGGTGAG	1	bc
CAACAACGGC	GAAACACCGGTGCCCGTCAATTGATCGCAAGTGGGGTTAGAGCTAGAAAT	1	bc
GTACACAATT	GAAACACCGGTTATAGTAAATTGCGCCGGGGGTTAGAGCTAGAAATAGCA	1	bc
AATGGGGTCC	CAAAACACCGGTTTTGGTTCTAGGGCAGTGGGTTTAGGGCTGAAATAGCA	1	bc
AAGCCTCGCG	GAAACACCGGTGTAACTTAACACTGTGGGGGGTTAGAGCTAGAAATAGCA	1	bc
CCTCCCACCA	GAAACACCGGTGCAGCGAACAAGTACGTCTTCACGAGCAAGTGGGGTTAG	1	bc
CGGCGGTCAC	GAAACACCGGTCTTGGTTCTAGGGTAGTGGGGTTAGAGCAGAAATAGCAA	1	bc
ATGAAATTCC	GAAACACCGGTCGTCGCTATATCATTGTGGTGTTAGACTAGAAATTGCAA	1	bc
TCCCCAGCTA	GCACCACCGGTGCTACAGGGCTGAGAGTGGGGTTAGAGCTAGAAATAGCA	1	bc
ACAGGGGTTC	GAAACACCGGTTTTGGTTCTAGGGTAGTGGGGTTAGAGCAGAAATAGCAA	1	bc
CATACATCCA	GAAACACCGGTCTCGTACGAATGACTGTGGGGTTAGAGCTAGAAATAGCA	1	bc
CATACTTAAC	GACGAAACACCGGTAGACGTAATTCCCTTGTGGGGTTAGAGCTAGAAATA	1	bc
CATCCGGCTC	GAAGCACCGGTGCCAGAACGAATTACGACTCTATTAAGCGGGGGAGATAG	1	bc
TCCCGGGGAA	GAAACACCGGTACCTGTAGATTTGTTTATCGTGGGGTTAGAGCTAGAAAT	1	bc
ACTCAACGGC	GAAACACCGGTCCGGTTGAAGTGTCAGTGGGGTTAGAGCTAGAAATAGCA	1	bc
GCACAAGAGT	GAAACACCGGTAGCAGGGACCTTCGATAGAGTGGGGTAAGAGATAGAGCT	1	bc
ATGTTGATGG	GAAACACCGGTCAAACCTGGATAGAAGTGGGGTTAGAGCTAGAAATAGCA	1	bc
ACAGTGGATC	GAAACACCGGTATCACTCCCGTCGGGAGAAGTGGGGTTAGAGCTAGAAAT	1	bc
TCCCGCATCT	GAAACACCGGTAAAGCGAGACATGGTATCCACCTGTAAGGGGGGGGTAAG	1	bc
AAGCCACGGC	GAAACACCGGTAGAACATGGTTGATAACTAGTGGGGTTAGAGCTAGAAGT	1	bc
CCCCACTCAG	GAAGCACCGGTAGAGGACCGGTGAACACTAGTGGGGTTAGAGCTAGAAAT	1	bc
TGCCCAAGCG	GAAACACCGGTCCGGGGTAATTCGTATATAGTGGGGTTAGAGCTAGAAAT	1	bc
TGCCCGTTGT	GAAACACCGGTAAAGGGAGACTACCCTATCGTGGGGTTAGAGCTAGAAAT	1	bc
CAGTGCTGGC	GAAACACCGGTGACACAAGTGTGGATGGATTGGCTGACGTGTGGGGATAG	1	bc
TATTTCATGC	GAAACACCGGTGATACGTTCCGTGGTACTAGTGGGGTTAGAGCTAGAAAT	1	bc
CCGCGCGTCA	GAAACACCGGTACTCCTAAAGGCCAAGTGGGGTTAGAGCTAGAAATATCA	1	bc
GTTGAGCCTC	GAAACACCGGTTCCCGTCCCATAATCGTGCGGTTAGAGCTAGCTATAGCA	1	bc
CGAATCCTTT	GAAACACCGGTCTCGAGTGAGGTGTTCAGGGAGGGGTTTGAGCTAGAAAT	1	bc
TGGCCCATCA	GAAACACCGGTGAAACTTCCCAAACTCGCCAACGGGTGGGGTTAGAGCTA	1	bc
CCATCAACGC	GAAACACCGGTTTCTGGTATCATCGGTAAAGTGCTGGAAATACTAAGATT	1	bc
TGGCGATCTC	GAACCACCGGTCTCGGTAGCACCAAAGGCCGTGGGGTTGGAGCTAGAAGT	1	bc
GGGTCTGGCT	GAAACACCGGTCAAACCTTAATAATAGTGTGTTTAGAGCTAGATATAACT	1	bc
AAATTGGGTT	GAAACACCGGTACCACTCCCGTCGGGAGTAGTGGGGTTAGAGCTAGAAAT	1	bc
GACACTAACT	GAAACACCGGTAAGTTTAGCATCGCTGACAAGGTTGCGGAGTGGGGTTAG	1	bc
CTACGTCGTA	GAAACATCGGTGTGGAACGGGGCCCCAAGGGTGGCCCCGAGTGGGGTTAG	1	bc
ATCCTTTCAC	GAAACACCGGTAGTCCCTCCATAGGGGGGGTCTCAGTGGTGTTAGAGCTA	1	bc
TCCCCTTCAT	GAAACACCGGTCCATATCCGGCAGACGTGGGCTTACATCTGTGAGGATAG	1	bc
CCTAATTAAA	GAAACACCAGTAGACGAAATTCCCTTGTGGGGTTAGAGATAGAAGGAGCA	1	bc
CGAATCCTTT	GAAACACCGGTCTTGAGTGAGGTGTTCAGGGTGGGGTTAGAGCTAGAAAT	1	bc
GATACTTACC	GAAACACCGGTACCATACTTAAGAGGGAACTTAAGGGGCAGTGGGGTTAG	1	bc
GTCAAATTCT	GAAACACCGGTAGTTCTCAGAGGAAGCGCCGTGGGGTTAGAGCTAGAAAT	1	bc
CCCAATCCAT	GAAACACCGGTCTTGATGCCCGAGGAGGGGGTGGGGTTAGAGCTGGAAAT	1	bc
AGATCAAAGC	GAAACACCGGTTTCCCGTATGTCTGGGGTGTGGTTAGAGCTAGAAATAGC	1	bc
ATATAATGAT	GAAACACCGGTGCCCCAACCTTATAGAGCTAGAAATAGCAAGTTAACCTA	1	bc
CTCCGCAGCG	GAAACGCCGGTTAATCGAGACGCAGTTCAGTGTGTGGGTGTGGGGTTAGA	1	bc
ACTCCATTGT	GAAACACAGGTATAAGAATCGTAAGTCATCGTGGGGTTAGAGCTAGAAAT	1	bc
AGATAGCTGA	GAAACACCGGTTACCTGGGACGCTATCAGTGTAACAACTTGTGGGGTAGA	1	bc
GGCCCGGATA	GAAACACCGGTCCCTCCGCATACAGCTGTCGTGGGGTTAGAGCTAGAAAT	1	bc
GACATCAGTC	GAAACACCGGTGAGAAACCTTTCTAATTGGGGTTAGAGCTAGAAATAGCA	1	bc
CCTCCATCAC	GAAACGCCGGTACCCTTATTAACAAGGGACTTAGTACGTAGTGGGGTTAG	1	bc
