AAAGCGTGAG	GAAACACCGGTTCGTCCCCGATGAGTAAGCTGATGCCAAAGTGGGGTAGA	5	bc
CCCAATCCAT	GAAACACCGGTCTTGATGCCCGAGGAGGGTGTGGGGTTAGAGCTAGAAAT	5	bc
TAAACTCAAG	GAAACACCGGTAGTTCGCCCACTATCCATCGTGGGGTAGAGCTAGAAATA	4	bc
TATGTCATGC	GAAACACCGGTAATACGTTCCGTGGTACTAGTGGGGTTAGAGCTAGAAAT	4	bc
CCCCCCACAA	GAAACACCGGTAGATGTCACGTACATGTGGACATACATGGGTGGGGTTAG	4	bc
CCCCACTCAG	GAAACACCGGTAGAGGACTGGTGAACACTAGTGGGGTTAGAGCTAGAAAT	3	bc
ACGCGACTTC	GAAACACCGGTACTCCTTCAAGTCTACATCGTGGGGTTAGAGCTAGAAAT	3	bc
TCAATACACT	GAAACACCGGTTTAGAGGTTCTGGGGATATGGGAGTAGGGGTGGGGTTAG	3	bc
CAACAACGGC	GAAACACCGGTGCCTGTCAATTGATCGCAAGTGGGGTTAGAGCTAGAAAT	3	bc
AGATCAAAGC	GAAACACCGGTTTCCCGTATGTGGGGTTAGAGCTAGAAATAGCAAGTTAA	3	bc
TGGTTTCTTT	GAAACACCGGTCTGGCGAATTGCTGAGTGGGGTTAGAGCTAGAAATAGCA	2	bc
GAATCCACCC	GAAACACCGGTTAACAGCTGGATTGGTTGTTCGTGTGCGTGTGGGGTTAG	2	bc
ATATAATGAT	GAAACACCGGTGCCCCAACCTTATATGTGGGGTTAGAGCTAGAAATAGCA	2	bc
CAGCTTGTGG	GAAACACCGGCCACATTAGCGCAACTAGCCGAAGTCGCATGTGGGGTTAG	2	bc
TATTTCATGC	GAAACACCGGTAATACGTTCCGTGGTACTAGTGGGGTTAGAGCTAGAAAT	2	bc
CCCGCCAGCG	GAAACACCGGTGAAGGAAGACAGGAGGGCGACGTAAGGGGTGGGGTTAGA	2	bc
TAAGTGCCTC	GAAACACCGGTACTCACATGTAGACGAACTGTGGGGTTAGAGCTAGAAAT	2	bc
GATACTTAAC	GAAACACCGGTACCATACTTAAGAGGGAACTTAAGGGGCAGTGGGGTTAG	2	bc
TGTACAAGCG	GAAACACCGGTCCGGGGAACTTCGTATATAGTGGGGTTAGAGCTAGAAAT	1	bc
CCAGCTAAAG	GAAACACCGGTTGGAAGGTACAGCGGGCCCCGCGGCCTTTGTGGGGTTAG	1	bc
AACCGCCCGT	GAAACACCGGTGCCCTTACTCTCACCTGATTACTTAATCCGGGGGTTAGA	1	bc
CCACTGCCTC	GAAACACCGGTCCGTAGGAGACTCGTGTGGCATGTACCTGTGGGGTTAGA	1	bc
CACCGCTGCC	GAAACACCGGTGGTACATTAGAGGTATAAATTGGTTTAGAGGTAGATATA	1	bc
CCTTCCACCG	GAAACACCGGTGTAGGACGAAAGGAGGGCGATGTTGGGGGTGGGGTTAGA	1	bc
GTACATTAGA	GAAACGCCGGTAATAAGTGGTTCTTAGTGGGGTCAGAGCTAGAAATAGCA	1	bc
TATGGCACCA	GAAACACCGGTGGCAGCTACTGTCGTGATGGTGGGGTTAGAGCTAGAAAT	1	bc
GCAGCCATAC	GAAACACCGGTAGTTATTAGCTCGGCCATTGTGGGGTTAGAGCTAGAAAT	1	bc
AAACGATTAA	GAAACACCGGTCGAGAAATAGGCACAGACATCGGACGGCTGTGGGGTTAG	1	bc
GACCCGACCA	GAAACACCGGTGCTCTGGGTTTGAGCTAGAAATAGCAAGTTAACCTAAGG	1	bc
AAACGATTAC	GAAACACCGGTCGAGAAATAGGCACAGACATCGGACGGCTGTGGGGTTAG	1	bc
AGTAGTGCCA	GAAACACCGGTGGGAATTTAGATGGACAAGGTGGTTTAGAGCTAGAATTA	1	bc
AGTCTCTAGA	GAAACACCGGTTAATCTCTCGTGCCCTTTAACGCAAAATGTGGGGGAGAG	1	bc
ATCGTCGCAC	GAAACACCAGTAGCAGCGGCACGAGAGCCGCTGTCAACAGAGGTAGTTAT	1	bc
AAGCCCAGAT	GAAACACCGGTTGACACGCTAGGTGTTGAAAAACTTGTTGGTGGGGTCAG	1	bc
TGGCACCTTC	GAAACACCGGTTAGGTCACGTCGCTTGTGGGGTTAGAGCTAGAAATAGCA	1	bc
ATCGCTGCCC	GAAACACCGGTGTCTCGGTGGAACGTTCAGGTGGGGTTAGAGCTAGAAAT	1	bc
CCCCACTCAG	CAAAACACCGGTAGAGGACTGGTGAACACTAGTGTGGGGTTAGAGCTAGA	1	bc
CGACAATACT	GAAACACCGGTTCGTGTTTGCTCGACCGGCGTAAGATACTGTGGAGTTAG	1	bc
ATTTAGCATC	GAAACACCGGTTCCCGTCCAGTAATCGTGGGGTTAGAGCTAGAAATAGCA	1	bc
TGCCAGCTGA	GAAACACCGGTAAAGGGAGACTACCCTATCGTGGGGTTAGAGCTAGAAAT	1	bc
ACCCCCGGCA	GAAACACCGGTCGAAACATATCGAAACGTTGTGGGGATAGAGCGAGAAGA	1	bc
CGTGCAGACT	GAAACACCGGTGACAATGGGCACAGGCATGGGTTAGAGATAGAAATAACA	1	bc
CCCGCCAGCG	GAAACACCGGTGAAGGAAGACAGGAGGGCGACGTAAGGGGTGGGGGTAGA	1	bc
ATTCTGTTCC	GAAACACCGGTGAGGACTTGCGCAGTGCGAGTGGGGTTAGAGCTAGAAAT	1	bc
CAATCGCCCT	GAAACACCGGTGTGCAAGTAAAAGGTGAGCAAGTGAAGACGTGGGGTTAG	1	bc
TTGAGGCTTA	GAAACACCGGTGATGAGGCCTAGCGTGACAGTGGGGTTAGAGCTAGAAAT	1	bc
AGGATACGCC	GAAACACCGGTAGCACGTGCTTCTGCAGGGGCGTATCCTGAATTCGGGCT	1	bc
CCCCCCACAA	GAAACACCGGTAGATGTCACGTACATGTGGACATACATGGGTGGGTTAGA	1	bc
TTTTGCATGA	GAAACACCGGTTAAGCCGAGGAGTTAGTGGGGTTAGAGCTAGAAATAGCA	1	bc
AATACGCGAG	GAAACACCGGTGTAACTTAACACTGAGTGGGGTTAGAGATAGAAATAGCA	1	bc
GACCATAACC	GAAACACCGGTCGTCTGCACTACGCAGTGGGGTTAGAGCTAGAGATAGAA	1	bc
CCCTTAGTAC	GAAACACCGGTGTGGTCGAAGGTCGGGTCGTGGGTGGAGTGTGGGGTTAG	1	bc
ATTTCCCTCT	GAAACACCGGTATCTCGGTGATTCTTCGTGGGGGGTTAGGGTTAGGAAAT	1	bc
AACAACCCCG	GAAACACCGGTTTCTTCTGACTAATTGTGGGGCGAGATCTAGAGAGATCA	1	bc
TGATGGCTGT	GAAGAACAGGTTGAGGGGACCGCAGGGGATTGACTGGGATGTGGGGCTAG	1	bc
ATGCTCACGG	CAAAACACCGGTTGTGTCACCCTCACTGTGGGGTTAGAGCTAGAAATAGC	1	bc
GCGCGACTGC	GAAACACCGGTCCTCCTCCATCGCGACTGCGGTTAGTGCTAGATATAGCT	1	bc
TAATTACTGA	GAAACACCGGTTCTACAACAGTCGCATGTTCGCGGGTGGGGTTAGAGCTA	1	bc
ACTCGACTTC	GAAACACCGGTACTCCTTCAAGTCTACATCGTGGGGTTAGAGCTAGAAAT	1	bc
CGCAGACCCC	GAAACACCGGTGGTAATTTAGAGGTACAAAGTGGGTTAGTGCTAGAAATA	1	bc
CACCTTAGCA	GAAACTCCGGTGTGGCCGAGGGTCGGGTCGTGGGTGGAGCGTGGGGTTAG	1	bc
GACACATCCC	GAAACACCGGTAGTTCTCAGAGGGAGGACCGTGGGGTTAGAGCTAGAAAT	1	bc
AGATCAAAGC	GAAACACCGGTTTCTCGTATGTCTTGCTATTTCTAGCTCTAACCCCGCAT	1	bc
GCCTAAATCC	GAAACACCGGTGAAAGACGATGGGGTTAGAGCTAGAAATAGCAAGTTAAC	1	bc
AATTTAAAGA	GAAACACCGGTGCCCCCACCTTGCTTTTTTTCGTGCTGGATCCTAAAAAT	1	bc
TTATAGATAT	GAAACACCGGTTACATTTTGGACTTCGTGGGGTTAGAGCTAGAAATAGCA	1	bc
GGCCGCGTCA	GAAACACCGGTAATTTTGCGGCTCCAGCTTGCAGGGGGCCGGGGGGAAAG	1	bc
ACCGCAATCA	GAAACACCGGTGAAAGACGATGGCAGGTGGGGTTAGAGCTAGAAATAGCA	1	bc
CGCCCCCTGC	GAAACACCGGTGGGTTTAGAGCTAGAAATAGCAAGTCAACCTAGGGCTAG	1	bc
CCCAATCCAT	GAAACACCGGTCTTGATGCCCGAGGAGGGGGTGGGGTTAGAGCTAGAAAT	1	bc
ATATAATGAT	GAAACACCGGTGCCCCAACCGGTGGGGTTAGAGCTAGAAATAGCAAGTTA	1	bc
AGCTCTCGAA	GAAACACCGGTAGAACGCTTGAAGCACTAGTTGTTCGGTGGTGGGGTTAG	1	bc
AGAAGACCCA	GAAACACCGGTAGGCGGCAATCGTGGGTGGGGTTAGAGCTAGAAATAGCA	1	bc
GCGATTCCCT	GAAACACCGGTCTCGAGTGAGGGGTTCAGGGGGGGGTTAGAGTTAGAATT	1	bc
GGACCTCGAA	GAAACACCGGTGTACACAGAGACGACGACCCAGTATGTTCGGGGGGATGG	1	bc
GCAGAATGGC	GAAACACCGGTAGGAGGCACTCGAGGGTGGGGTTAGAGCTAGATATAGAA	1	bc
GCCGAAATCA	GAAACACCGGTGAATGACGATGGGGTTAGAGCTAGAAATAGCAAGTTAAC	1	bc
GACCCGACCA	GAAACACCGGTGCTCTGGGTTTGTGTTTGTGGGGTTAGAGCTAGAAATAG	1	bc
GAACACCTAC	GAAACACCGGTACCCTTACTCTCACCTGATTACTTAATCCTTGGGTTGAG	1	bc
AGATGTCGAC	GAAACACCGGTGTCTCGTTGGTACGTTCTGGTGGGGTTAGAGCTAGAAAT	1	bc
ACTTTGCGTC	GAAACACCGGTCCGTAGATAACGAGTGTGTCATGTGCCTGTGGGGTTAGA	1	bc
AAACATTCGT	GAAACACCGGTGGATGACATTTGCTTTTAGCTCGGGTTAGAGCTAGAAAT	1	bc
ACTCAACGGC	GAAACACCGGTCCGGTTGAAGTGTCAACAAGTGGGGTTAGAGCTAGAAAT	1	bc
AGCCACCGCA	GAAACACCGGTCCCTTTAGAGCCAAGGTCGGAGTGTGTACAGCTGGATAT	1	bc
GCCGAAATCA	GAAACACCGGTGAAAGACGATGGGGTTAGAGCTAGAAATAGCAAGTTAAC	1	bc
TACCCACATC	GAAACACCGGTTGACACGCTACTTTTTATAAAACTTTATAGCTAGATTAG	1	bc
CCAGCTAAAG	GAAACACCGGTTGGAAGGGACAGCGGGCCGCACGGCCTTTGTGGGGTTAG	1	bc
TCAATACACT	GAAACACCGGTTTAGAGGTACTGGGGATATGGGAGTGGGGGGGGGGTTAG	1	bc
ATTCTAGCTC	GAAACACCGGTTTACGTTGCATCGGTGTGGGGTTAGAGCTAGAAATAGCA	1	bc
CCACACGACA	GAGACACCGGTAGACGTAATTCCACTCCAGCGTGGGGTTAGAGCTAGAAA	1	bc
TCAATACACT	GAAACACCGGTTTAGAGGGTCTGGGGATATGGGAGTAGGGGTTAGAGCTA	1	bc
GCCGAAATCA	GAAACACCGGTGAAAGACGATGGTAGGGTGGGGTTAGAGCTAGAAATAGC	1	bc
CCCCACTCAG	GAGACACCGGTAGAGGACTGGTGAACACTAGTGGGGTTAGAGCTAGAAAT	1	bc
CAACGGATAC	GAAACACCGGTAACAATTTACAGGCAATAACTCGGTTACAGTGAGATATA	1	bc
CGACAATCTT	GAAACACCGGTTCGTGCATGCTCGACAGGCGCAAGAGACTGTGGGGTTAG	1	bc
GCGCCGGAGT	GAAACACCGGTAAGGGCGAAGGTCGGGGCGTTGGCGGTGGGAAGAGTTAG	1	bc
GACACCCCAT	GAAACACCGGTCCAAAATGTCGCCACGTGGGGTTAGAGCTAGAAATAGCA	1	bc
ACCGCCAGCG	GAAACACCGGTGAAGGAAGACAGGAGGGCGACGTAAGGGGTGGGGTTAGA	1	bc
AACCTTCGAT	GAAACACCGGTATACACAAAATCAGGTACCCAATCTGTGCGTGGGGTTAG	1	bc
ACGCCGGTGG	GAAACACCGGTATGAAAATCGGTAGTCTTGGTGTGGTTCTAGCTAGAAAT	1	bc
AATCCCCGTT	GAAACACCGGTATGAGAATCGGTAGTCATGGTGGGGTTAGAGCTAGAAAT	1	bc
ACCCACTCAG	GAAACACCGGTAGAGGACTGGTGAACACTAGTGGGGTTAGAGTTAGAAAT	1	bc
GAACCGCTGG	GAAACACCGGTGCAAAAGGGGTAGTGGACCGTGGGGTTAGAGCTAGAAAT	1	bc
CACCCCTGCC	GAAACACCGGTTTGCCAATCAGTGTGTGGATGACTGCATGTGGGGTTAGA	1	bc
CGCCGGCTAC	GAAACACCGGTACGATATTGGTTCTACTCTGGGGGGTAGTGTCTGGTTAG	1	bc
ACTCAACGGC	GAAACACCGGTCCGGGTGAAGTGGTATTGGAGCTCGAAATAGCAAGTTAA	1	bc
TGCCACCCGC	GAAACACCGGTTAGCAGCCAATTGCGTTGCTCCTAGAGGGGTGGGGTTAG	1	bc
GGACATACTC	GAAACACCGGTTAAAGAAAATCGCGAGCGGGGTTAGAGATAGATATAGCA	1	bc
ACAACCCCCC	GAAACACCGGTTTGAACTACCTAGTTGTGGGGTTAGAGCTAGAAATAGCG	1	bc
CACCCCTGCC	GAAACACCGGTTTGCCAATCAGTGTGTGGATGGCTGCATGTGGTGTTAGA	1	bc
AATGTCGCCT	GAAACACCGGTGCCTCGTTGGTACGTTCTGGTGGGGTTAGAGCTAGAAAT	1	bc
AACATAGGCA	GAAACACCGGTAGCAGGTGCGAGACGTGCACTGGGGATAGAGCTGGATAT	1	bc
GCCCACCACA	GAAACACCGGTAAGTTTCTTCATCGGTTGAGGCGGTGGTGGGGGGGGTCA	1	bc
GACCCCCCCC	GAAACACCGGTCGGCGGCAATCGTGGGTTGCGTTAGAGCTAGAAATAGCA	1	bc
CGTTTGGGAC	GAAACACCGGTAGCAGCGGCAGGCGTGATGGTGGGGTTAGAGCTAGAAAT	1	bc
CAAACCTTTT	GAAACACCGGTCTCGAGTGAGGTGTTCAGGGTGGGGTTAGAGCTAGAAAT	1	bc
GACAACCCAG	GAAACACCGGTAGAGGACGGGGGCACACTAGGGGGGTGCTAGAAATAACA	1	bc
CGTACTCCAC	GAAACACCGGTCACGCGCCTATATGCCTAGTGATAGAAGAGGAAGGAGCA	1	bc
CAATCGCACT	GAAACACCGGTGTGCAAGTAAAAGGTGAGCAAGTGAAGACGTGGGGTTAG	1	bc
GAGTTACACT	GAAACACCGGTTGGGGCAGCGGCAAGATACATCATGCGCAGTGGGGTTAG	1	bc
CGCTCGAGGT	GAAACACCGGTGACAGAAGCTGCGTGGTGGGGTTAGAGCTAGAAATAGCA	1	bc
ACACAACGAT	GAAACACCGGTGTCTTTAAGCATTAAGGAAATGCTTGGGTGTGGGGTTAG	1	bc
CAACGGCTTC	GAAACACCGGTTAATGGGACCGCAGGTACTTGACTGGGATGTGGGGCTAG	1	bc
ACTCGCCTTC	GAAACACCGGTACTCCTTCAAGTCTACATCGTGGGGTTAGAGCTAGAAAT	1	bc
ACCCCACATT	GAAACACCGGTTTACAGGCTATGTGTTTAAAGACTTATTGGTGGGGTTAG	1	bc
AAACGCTTAT	GAAACACCGGTCGAGACATATGCACAGACATCGGACGGCTGTGGGGTTAG	1	bc
GGGGAAAATC	GAAACACCGGTTGCCGTCCAGTCATGGTGGGGTTAGAGCTAGAAATAGCA	1	bc
TGCCAGCTGA	GAAACACCGGTAAAGGGAGATTACCCTATCGTGGGGTTAGAGCTAGAAAT	1	bc
CGATCAATAT	GAAACACCGGTTCTGGATGGCTCGACAGTCGCGAGGGTAGAGGGGGTAAT	1	bc
CCTTCACTTC	GAAACACCGGTGGAAGGTTGTATGTTGCTAGTGGGGTTAGAGCTAGAAAT	1	bc
ACCACGAAGC	GAAACACCGGTCTCTAGATAATTCGTTACGGGTTGGTGCGATTAGTGCTA	1	bc
CCGAGTCCTT	GAAACACCGGTCAAGAGCTAACGCGTAGTGGTGGGGTTAGAGCTAGAAAT	1	bc
CTGAGATTAC	GAAACACCGGTCAAGAGCTAACGCGTAGTGGTGGGGTTAGAGCTAGAAAT	1	bc
TTGCCCATCA	GAAACACCGGTGAAACTTCCCAAACTCGCTAACGGGTGGGGTTAGAGCTA	1	bc
ATATAATGAT	GAAACACCGGTGCCCCAACCTGGTGGGGTTAGAGCTAGAAGTAGCAGGTT	1	bc
TCAATACACT	GAAACACCGGTTTAGAGGTTCTGGGGATATGGGAGTAGGGGTTAGAGCTA	1	bc
TGGGAGCCGC	GAAACACCGGTTCCCGTCCAGTAATCGTGGGGTTAGAGCTAGAAATAGCA	1	bc
AATCGCCGCG	CAAAACACCGGTGTAATTTAACACTGATTGGGGTTAGAGCTAGAAATAGC	1	bc
ACCAAAAAAA	GAAACACCGGTTTACTGGATTAGTTCGTGGGGTTAGAGCTAGAAATAGCA	1	bc
AATAGTAGCC	GAAACACCGGTGGTAATTTCAATGCATATAGTGGAGTAGAGCTAGAAAGA	1	bc
GACCCGACCA	GAAACACCGGTGCTCTGGGGTTAGAGCTAGAAATAGCAAGTTAACCTAAG	1	bc
GACGCACAAA	GAAACACCGGTGCTATCGGATCATCAGTTGAGCTAGAGCTAGAAAGAGCA	1	bc
AACAAACCCA	GAAACACCGGTCGGATCTACGAAAGGGTGGGGTTAGAGCTAGAAATAGCA	1	bc
GACACGGAAC	GAAACACTGGTAGCAAGTGCGAGACGTGTTGTGGGGTTAGAGCTAGAAAT	1	bc
TACACCTGCA	GAAGCACCGGTAAATTTGAGGCTCCGGCATGCAGGAGGCCGTGGGGTTAG	1	bc
CACTTGATTC	GAAACACCGGTTAGTGGTAAGGGTAGAACTTGCATGTTATGTGGGGCTAG	1	bc
AGCAATCCAC	GAAACACCGGTTAATTGAAAATATACTTCGACGAAGATCTGTAGATTTAG	1	bc
CCCGCCAGCG	GAAACACCGGTGAAGGAAGACAGGAGGGCGACGGAAGGGGGGGGGTTAGA	1	bc
TAACCATTGC	GAAACACCGGTCGTTGTAGCAACCTATCGGGTGGGGTTAGAGCTAGAAAT	1	bc
AGCTCTCCGC	GAAACACCGGTACATTGCAAATTCGGGTCGTAGTGTGGACGTGGGGTTAG	1	bc
AAAGCGTGAG	GAAGCACCGGTTCGTCCCCGATGAGTAAGCTGATGCTAAAGTGGGGTAGA	1	bc
TTTTGATCAC	GAAACACCGGTAGCAGCGGCAGGCGTGATGGTGGGGTTAGAGCTAGAAAT	1	bc
TAAGCTCAAT	GAAACACCGGTAGTTCGCACACTTTCCATCGTGGGGTAGAGCTAGAAATA	1	bc
ACTATTGATG	GAAACACCGGTTATCTTTGACCCTCTGTGTGTTACAAGTTATGAATTACA	1	bc
GATACTTAAC	GAAGCACCGGTACCATACTTAAGAGGGAACTTAAGGGGCAGTGGGGTTAG	1	bc
AAACTTAGCC	GAAACACCGGTTAATGTATCATCGGTGTGGGGTTAGAGCTAGAAATATCA	1	bc
AAAGCAGCGC	GAAACACCGGTGTAACTTAACACTGAGTGGGGTTAGAGCTAGAAATAGCA	1	bc
AGTTCGATGC	GAAACACCGGTATCACGGTTGTCAAGGATTGTGGGGTTAGAGCTAGAAAT	1	bc
ACGTCGCGGA	GAAACACCGGTAGAACATGGTCGACATATAGTGGGGTTAGAGCTAGAAAT	1	bc
GGCCTTCGAC	GAAACACCGGTTGTCCCTCCATAGGGAGTGTCTCGGTGGGGTTAGAGCTA	1	bc
ACATAGGCCC	GAAACACCGGTTGGATCAGACTGCTGAGGCTCGGGGAATTGGGGGGTTAG	1	bc
AAGCTTGTGA	GAAACACCGGTCACATTAGCGGAACTAACCGAAGTCGCAGGTGGGGTTAG	1	bc
CGACCAACTC	GAAACACCGGTGAATTCAAAAGTGCGGTGGTAGTGTGGTAGAAGTATTAG	1	bc
ACTCCCCCTC	GAAACACCGGTCCGTAGGAGACCCGGGTCGCATGTACCTGTGGGGTTAGA	1	bc
ATTGAGCGTA	TCGTGAAAAGGAAGAAACACCGGTTAAGCAGAGGAGTTAGAGGGGTTAGA	1	bc
GATCCCTATT	GAAACACCGGTTTAATCGTGCAGGCAGAATGGAAGCTTCGTGGGGTTAGA	1	bc
CAATCGCACT	GAAACACCGGTAATAAGTGGTTCTTATTACCGGTGTTTCGTAAGTGGGGT	1	bc
TGCCCTACGC	GAAACACCGGTGCCAATGTGGTCGCGTCATGTGGGGTTAGAGCTAGAAAT	1	bc
CCCAATCCAT	GAAACACCGGTTTGGACTACCTAGGTGTGGGTGTAGATCTAGAAAGAACA	1	bc
ACTCCACGGA	GAAACACCGGTCCGGTGGGGTTAGAGCTAGAAATAGCAAGTTAACCTAAG	1	bc
CACCCCTGCC	GAAACACCGGTTTGCCAATCAGTGTGTGGATGGCTGCATGTGGGGATATA	1	bc
TATTCATGAC	GAAACACCGGTCGTTGAAGCAACCTATCGGGTGGGGTTAGAGCTAGAAAT	1	bc
TATTCCCAAG	GAAACACCGGTGGTTGGAACAGTAGCGATGGTGGGGTAGAGGTAGAAATA	1	bc
TAATTACGCT	GAAACACCGGTCGATCGGAGCTCGGAGACGTTGCTGGTAGGTGTGGCTAG	1	bc
TCAATGCACC	GAAACACCGGTTTGCCAATCAGTGTGTGGATGGCTGCATGTGGGGTTAGA	1	bc
GATACTTACC	GAAACACCGGTACCATACTTAAGAGGGAACTTAAGGGGCAGTGGGGTTAG	1	bc
ATATAAAGAT	GAAACACCGGCGCCCCAACCTACTTTGTGGGTAGAGCTATAAAAAGAACG	1	bc
CCACACGACA	GAAACACCGGTGTGGGTGTTGTTCCTGAAGAGACAGACGGGTGGGGTTAG	1	bc
CATCGGAGTA	GAAACACCGGTGTGGTCGAAGGTCGGGTCGGGGGTGGAGTGTGGGGTTAG	1	bc
ACATACGTCC	GAAACACCGGTTGGTTCAGACTGCCGAGGCTCAGGAAATTGTGGGGTTAG	1	bc
CTCCCGCCCC	GAAACACCGGTAGATGCTCGTGGGGTTGGCAGATGCGATGGTGGGGTTAG	1	bc
CAACAACGGC	GAAACACCGGCGCCTGTCAATTGATCGCAAGTGGGGTTAGAGCTAGAAAT	1	bc
CCTTGGAGTC	GAAACACCGGTGACAGAAGCTGCGTGGTGGGGTTAGAGTTAGAAATAGCA	1	bc
ACTCAAAGAC	GAAACACCGGTCCGGTGGGAGTGGGGTTAGAGCTAGATATAGCAAGTTAA	1	bc
TCATGTCACG	GAAACACCGGTTGGGGCAGCGACAGGATACATCATGCACGGTGGGGTTAG	1	bc
GAGATTGGAT	GAAACACCGGTAACAGAAGCTGCATGGTGGGGTTATAACAAGAAATAAAA	1	bc
CTAGTACGGC	GAAACACCGGTAACAAAAATGTGCATGCGGGTATAAAGTTAGAAAAGGCA	1	bc
GCCGAAATCA	GAAACACCGGTGAAAGACGATGGCAGGTGGGGTTAGAGCTAGAAATAGCA	1	bc
CAACAACGGC	GAAACACCGGTGCCTGTCAAATGATCGCAATTGGGGTTAGATGTAGTAAG	1	bc
ACTCAACGGC	GAAACACCGGTCCGGTTGAAGTGCTGACTGACCTTGGGGTTAGAGCTAGA	1	bc
CAGCGTTTCA	GAAACACCGGTCAAGTGCTAACGCGTAGTGGTTGTGTTAGAGCTAGAACT	1	bc
TACACCTGCA	GAAACACCGGTAAATTTGAGGCTCCGGCATGCAGGAGGCCGTGAGGTTAG	1	bc
ACCAAACTAC	GAAGCACCGGTTTACTGGCCTAGTTCGTTGGGTTAGAGCTAGAAATAGCA	1	bc
CCCCCTGAGA	GAAACACCGGTACCCGAACGGGTTAAGACTCCATTAAGCGGTGGGGTTAG	1	bc
GACACTAACC	GAAACACCGGTAGCAAGAGCGAGAAGTGTTGTGGGGTTAGAGCTAGAAAT	1	bc
CAGCGTGCGC	GAAACACCGGTCACATTAGCACACCTAATCGAGGTGTTATAGCGAGTTAT	1	bc
TAAGTGCCTC	GAAACACCGGTACCCACATGTAGACGAACTTGTGGGGTTAGAGCTAGAAA	1	bc
ATTCTATGCT	GAAACACCGGTATGAGAATCGGCAGTCATGGGGTGGATAGAGCTAGAAAT	1	bc
CTCTTATCGC	GAAACACCGGTAGTTCTCAGAGGAAGAGCCGTTTAGTTAGAGCTATAAAT	1	bc
TCAATACACT	GAACCACCGGTTTAGAGGTTCTGGGGATATGGGAGTAGGGGTGGGGTTAG	1	bc
CATACTTAAC	GAAACACCGGTAGACGTAATTCCCTTACGTCTACTGGGGTTAGAGCTAGA	1	bc
AGACTACGCC	GAAACACCGGTTCCACTGATGGTGCGTCATGTGGGGTTATAACTGGAAGT	1	bc
AAGATTAGGT	GAAACACCGGTTTACGTTGCATCGGTGTGGGGTTAGAGCTAGAAATAGCA	1	bc
TCTCACGCGG	GAAACACCGGTTGAGTTTGTATGAGTATTAGTGTAGAGCTAGCTATAGCA	1	bc
AACCCGACCA	GAAACACCGGTGCTCTTAGAGCTAGAAATAGCAAGTTAACCTAAGGCTAG	1	bc
TTAGCTACAC	GAAACACCGGTTTACCGGATTAGTTCGTGGGGTTAGAGCTAGAAATAGCA	1	bc
GCCCACGGCT	GAAACACCGGTTAGCATCCAATTGCGTGGCTCCTAGAGGGGTGTGGTTAT	1	bc
TGTCCAAGCG	GAAACACCCCGGACCGGTGGGGTTAGAGCTAGAAATAGCAAGTTAACCTA	1	bc
GCCCCCCCCC	GAAACACCGGTGTGGCTGAGAGTCCGGCAATGGTGTGGCTGTGGGGTTAG	1	bc
CAATCGCACT	GAAACACCGGTGTGCAAGTAGAAGGTGAGCAAGTGAAGACGTGGGGTTAG	1	bc
CCACCATCCG	GAAACACCGGTGGCAATAGGATGAGTGGAGTGGGGTTAGAGCTAGAAATA	1	bc
CTTTCGCTGG	GAAACACCGGTGCAGTCCATCAGTATTTCCATCATGAGATGTGGGGTTAG	1	bc
GCTGAGTCTC	GAAACACCGGTTCCCGTCCAGTAATCGTGGGGTTAGAGCTAGAAATAGCA	1	bc
CCACCACCCC	GAAACACCGGTCGTCTGCACTACGCAGTGGGGTTAGAGCTAGAAATAGCA	1	bc
TGGTGATGGT	GAAACACCGGTCAAACCTGGATAGAAGTGGGGTTAGAGCTAGAAATAGCA	1	bc
AATTAACCCC	GAAACACCGGTTTATCGTGATGGGTGGAGCCGCGGGTGGGAGTAGAGCTA	1	bc
GACCTGACCA	GAAACACCGGTGCTCTGGGTTTGTGGGGTTATAGCTAGACATAGCAAGTT	1	bc
ATAAGGAGAA	GAAACACCGGTTAAGCCGAGGAGTTAGTGGGGGTTAGAGCTAGAAATAGC	1	bc
GCAGACACAC	GAAACACCGGTCTGCTGCAATCGTGCGTGGGGTTAGAGCTAGAAATAGCA	1	bc
CACCCCTGCC	GAAACACCGGTTTGCCAATCAGTGTGTGGATGGCTGCATGTGGGGTTAGA	1	bc
TAAACGCACT	GAAACACCGGTGTGCAAGTAAAAGGTGAGCAAGTGCAGACGTGGGGTTAG	1	bc
CACGGGTAAT	GAAACACCGGTACCTGTAGATTTGTTTATCGTGGGGTTAGAGCTAGAAAT	1	bc
TCAGTACACT	GAAACACCGGTTTAGAGGTTCTGGGGATATGGGAGTAGGGGTGGGGTTAG	1	bc
CCCAAGCCAT	GAAACACCGGTCTTAATGCCAAAGTCGGCTGTGGGGTTAGAGCTAGAAAT	1	bc
GTCAATCCTC	GAAACACCGGTTCCCGTCCAGTAATCGTGGGTTTAGATCTAGCTATAGCA	1	bc
CAGCTTGTGC	GAAACACCGGTCACATTAGCGCAACTAGCCGAAGTCGCATGTGGGGTTAG	1	bc
AACCCGTCCT	GAAACACCGGTGAACAACGGCGATCCACGCCAATTAACGTGTGGGGTTAG	1	bc
CCACACGACA	GAAACGCCGGTGCGGGTGTTGTTCCTGAAGAGACCGACGGGTCGGGTTAG	1	bc
TGAATACCCG	GAAACACCGGTCGGCGGCAATCGTGGGTGGGGTTAGAGCTAGAAATAGCA	1	bc
AAATTACTCT	GAAACACCGGTTAACGGGACCGCAGGGACTTGACTAGGTAGTGGGGCTAG	1	bc
CGCGCTGCCT	GAAACACCGGTGACATTGGGTACAGGGTGGGGTTAGAGCTAGAAATAGCA	1	bc
AGGTGTTCAA	GAAACACCGGTAATAATTCCTGCCGGGTGGGGTTAGAGATAGAAGTAGCA	1	bc
CCACCCCCCC	GAAACACCGGTCTTCTGCACTACGCAGAGGGGTTAGAGATAGCAAGAGCA	1	bc
AGGCGTCACT	GAAACACCGGTTTAGGCAGCGTCAAGGTACATCATGCGCTGGGAGTATAG	1	bc
AAGCCTCTCC	GAAACACCGGTGTAACTTAACACTGAGTGGGGTTAGAGCTAGAAATAGCT	1	bc
TAAGTGACTC	GAAACACCGGTACTCACATGTAGACGCACTTGTGGGGTTAGAGCTAGAAA	1	bc
GTCCCCCTGC	GAAACACCGGTGTAGGGCCGGTGGGGTTAGAGCTAGAAATAGCAAGTCAA	1	bc
CTTTTTACTG	GAAACACCGGTGTAATCCAAAGCTATTAACATCATGAGTTGTGGGGTTAG	1	bc
AAAGCGCCAT	GAAACACCGGTTCGTCCCCGTTGAGTAAGCTGATGGCAGAGTGAGAGAGA	1	bc
GCGGATACTC	GAAACACCGGTTCTCGTCCAGTATCGTGGGGTTAGAGCTAGAAATAGCAA	1	bc
CAACAACGGC	GAAACACCGGTGCATGTCAATTGATCGCAAGTGGGGTTAGAGTTAGAAAT	1	bc
AACCCACCAC	GAAACACCGGTCGTCTGCACTACGCAGTGGGAGTATAGCTAGAAATAGAA	1	bc
AATAGGTTAA	GAAACACCGGTGAGGACTTGCGCAGTGCGAGTGGGGTTAGAGCTAGAAAT	1	bc
CAATCGCACT	GAAACACCGGTGTGCAAGTAAAAGGCGAGCAAGTGAAGACGTGGGGTTAG	1	bc
AGATCAAAGC	GAAACACCGGTTTCCCGTATGTCCCGTATAACTTGAAAAAGTGGCACCGA	1	bc
GTACATTAGA	GAAACACCGGTAATAAGTGGTTCTTAGTGGGGTCAGAGCTAGAAATAGCA	1	bc
ACGCGACTTC	GAAACACCGATACTCCTTCAAGTCTACATCGTGGGGTTAGAGCTAGAAAT	1	bc
CTAGACCCTC	GAAACACCGGTTCCCGTCCAGTAATCGTGGGGTTAGAGCTGGGAATAGCG	1	bc
ATGTCATCGA	GAAACACCGGTAGACTCTGTTGCTTCGTGGGGTTAGAGCTAGAAATAGCA	1	bc
AACTTAACGC	GAAACACCGGTCGGGGCCACTCAGTGGTGGGGTTAGAGCTAGAAATAGCA	1	bc
AGATCAAAGC	GAAACACCGGTTTCCCGTATGTCTGAGAGCTAGAAATAGCAAGTTAACCT	1	bc
CCCGCCAGCG	GAAACACCGGTGAAGGAAGATAGGAGGGCGACGTAAGGGGTGGGGTTAGA	1	bc
AATACTTAAC	GAAACACCGGTACCATACTTAAGAGGGAACTTAAGGGGCAGTGGGGTTAG	1	bc
CCCCACTCAG	GAAACACCGGTGTGCAAGTAAAAGGTGAGCAAGTGAAGACGTGGGGTTAG	1	bc
AACACCGTAA	GAAACACCGGTTCATGAAAAACATACTTAGACGACGGTCCGTGGGGTTAG	1	bc
GGCTTTACGC	GAAAAACCGGTCCAAATGTGGTTACTCATATTGGGGTTAGAGCTAGAAAT	1	bc
CGGTCTGTAC	GAAACACCGGTCCAAAGGCGTCGGACGTGGGGTTAGAGCTAGAAATAGCA	1	bc
CCCGCCCCTA	GAAACACCGGTGTCTCGTTGGAACGTTCCGGCGGGGGTAGAGCTAGTAAT	1	bc
CATTCTCGGC	GAAACACCGGTCTACCTATTGTCTGTTTCGGGGTGTGCATGTGGAGTTAG	1	bc
GGTGATACTA	GAAACACCGGTTCCCGTCCAGTAATCGTGGGGTTAGAGCTAGAAATAGCA	1	bc
GTCCACGACA	GAAACACCGGTATGTTCAAGGCTCCGCCATGCAGGAAGCCAGGGCGAGAG	1	bc
AAGAAGACCG	GAAACACCGGTTTAACTTATTACTTAGTGGGGTTAGAGCTAGAAATAGCA	1	bc
AGTACATCGT	GAAACACCGGTGGTAATTTAGAGGAACAAAGTGGGTTAGAGCTAGAAATA	1	bc
GAGCTCCGCT	GAAACACCGGTGTACACAGAATCGACTACCCAGTGTGTTCGTGGGGTTAT	1	bc
AACAAAACAA	GAAACACCGGTTAACTGGATTAGTTCGTGGGGTTAGAGCCAGAAATAGCA	1	bc
AAGCAAAGCA	GAAACACCGGTTTACGTTGCATCGGTGTGGGGTTAGAGCTAGAAATAGCA	1	bc
ATAATTGATG	GAAACACCGGTTACCTGGAACGCTATCAGTGTAACAACTTGTAGGATAGA	1	bc
GTCCCCCTGC	GAAACACCGAGCTAGAAATAGCAAGTCAACCTAAGGCTAGTCCGTTATCA	1	bc
GACCCGACCA	GAAACACCGGTGCTCTGGGTTTGTGTTTAGAGCTAGAAATAGCAAGTTAA	1	bc
TTAGCAAGGA	GAAACACCGGTCGTTGTAGCAACCTATCGGGTGGGGTTAGAGCTAGAAAT	1	bc
AGATCAAAGC	GAAGCACCGGTTTCCCGAAATAGCAAGTTAACCTAAGGCTAGTCCGTTAT	1	bc
ACGCGACTTC	GAAACACCGGTACTCCTTCAAGTCTACATCGTGGGGTTAGAGCTAGAAAA	1	bc
AAGTCATCAA	GAAACACCGGTCGATGACACTGCCTATTGGCTAGTGTGGGGTTAGGTCAA	1	bc
AAATCTCTAG	CTAAACACCGGTGCTCTCGGATCATCAGTGGGGTTAGAGCTAGAAATAGC	1	bc
ATATAATGAT	GAAACACCGGTGCCCCAACCTTATATTTTTGGGGTTATAGCTAGAAATAT	1	bc
CTACATATGG	GAAACACCGGTTACATTGAGAACTTCGTGGGGTTAGAGCTAGAAATAACA	1	bc
AACCCCTCTC	GAAACACCGGTAACACTGACAAGTAGTACGGGCTGTAGAGGTGGGGTTAG	1	bc
CGGCCATACC	GAAACACCGGTAGTTATTAGCTCGACCATTGTGGGGTTAGAGCTAGAAAT	1	bc
GCTGCTATGG	GAAACACCGGTTGTGCCACCTTCACAGTGGGGTTAGAGCTAGCAATAGCA	1	bc
ATGACTGCTC	GAAACACCGGTTAATGGGACCGCAGGTACTTGACTGGGATGTGGGGCTAG	1	bc
AATCCGTCTC	GAAACACCGGTCCGTAGGAGACCTGAGAGGCATGTACCTGTTGGGTTAGA	1	bc
CGCCGAAGAT	GAAACACCGGTGTGGTCGAAGTTCGGGTCGTGGGTGGAGTGTGGGGAAAT	1	bc
CTACTAGCCA	GAAACACCGGTTGTATCACCTTCACACGTGGGGTAGAGCTATAAATGGCA	1	bc
ATGGAGGGAC	GAAACACCGGTCGTCGCTATTTCATTTAGGGGTTAGATTAGACTAAGCAT	1	bc
ATAAGCATAC	GAAACACCGGTTAAGCCGAAGGGTTAGTGGGAGTAGGGCTGGGAGGAGAG	1	bc
AGGCTACGCC	GAAACACCGGTAGCCCGTGATTCTGCAGGGCCGTCTCCTGATTTCGGTCC	1	bc
CATTGCGCCC	GAAACACCGGTGTCTCGTTGGTACGTTCTGGTGGGGTTAGAGCTAGAAAT	1	bc
ACGCGACTTC	GAAACACCGGTACTCCTTCAATTCTACATCGTGGGGTTAGAGCTAGAAAT	1	bc
TCAATACACT	GAAACACCGGTTTAGAGGTTCTGGGGGTATGGGAGTAGGGGTTAGAGCTA	1	bc
ACGCTTCGCG	GAGACACCGGAGTAACTTAACATTGAGAGGGCATAGAGATAGAAATAGCA	1	bc
CACACCAGCG	GAAACACCGGTCAAGAATGTCACGACGTGGGCTTAGGGGTAGAAATTGCA	1	bc
ATGAGATATA	GAAACACCGGTCAAAAGCTAACGCGTAGTGGTGGGGTTATAGCTATAACT	1	bc
ATAGCAACTA	GAAACACCGGTGTTTCATTGCTACGCTCTGGCGGGGTTAGAGCTAGAAAT	1	bc
GCATTAGAGG	GAAACACCGGTGACAGAAGCTGCGTGGTGGGGTTAGAGCTAGAAATAGCA	1	bc
CGTATTTATC	GAAACACCGGTATAGGTAGTTGTCTTACGTCTACTGGTATTAGAGCAAAT	1	bc
AACACCAACA	GAAACACCGGTAGCAAGTGCGAGACGTGTTGTGGGGTTAGAGCTAGAAAT	1	bc
GCCGAAATCA	GAAACACCGGTGAAAGACGATGGCAGGGTGGGGTTAGAGCTAGAAATAGC	1	bc
TTGCTCATCA	GAAACACCGGTGAAACTTCCCAAACTCGCTAACGGGTGGGGTTAGAGCTA	1	bc
GAGGCTGGCA	GAAACACCGGTGGCTACATAAACATAGGTTGTGGGGTTAGAGCTAGAAAT	1	bc
AATCCCCGCA	GAAACACCGGTTCGTAGATTCCCCAAGACGCATTTGACATATGGGGTTAG	1	bc
CAATCGCACT	GAAACACCGGTGTGCAAGTAAAAGGTGAGCAAGTGAAGGCGTGGGGTTAG	1	bc
TTGCCCATCA	GAAACACCGGTAGAACGTTTCAAACACTCTTAACTGGGGGGGTGGGGGCT	1	bc
TTTCCTACGC	GAAACACCGGTTACATTGAGAACTTCGTGGGGTTAGAGCTAGAAATAGCA	1	bc
ATTTAGCCTC	GAAACACCGGTGCCCGTCCCGTAATCGAGGGGGTAGTGCTAGCTAGAGCA	1	bc
CAGCTTGTGG	GAAACGCCGGTCACATTAGCGCAACTAGCCGAAGTCGCATGTGGGGTTAG	1	bc
GGAAGAACCA	GAAACACCGGTCGGCGGCAATCGGGGGTGGGGTTAGAGCTAGAAATAGCA	1	bc
CTGAGTGTGG	GAAACACCGGTCAAGTTCTAACGCGTAGTGGTGGGCTCAGAGCTGGATAT	1	bc
AAACATTCGG	GAAACACCGGTCGATTCATATCGAAACCTTCCCGTGACAGTGGGGTTAGA	1	bc
TCGCAAAACA	GAAACACCGGATTAATGGATTAGTTCGTGGGGTTAGAGCTAGAAATAGCA	1	bc
CAATCGCCCT	GAAACACCGGTGTGCAAGTAAAAGGTGAGCAAGTGAAGACGTTGGGTTAG	1	bc
TCCCCAAAAA	GAAACACCGGTTTACTGGATTAGTTCGTGGGGTTAGAGCTAGAAATAGCA	1	bc
GTTAGCACCC	GAAACACCGGTAGCAACGGCAGGCGTGATGGTGGGGTTAGAGCTAGAAAT	1	bc
GACCCGAACA	GAAACACCGGTGCTCTGGCTTTGTGGGGTTAGAGCTAGAAATAGCAAGTT	1	bc
CAGTGGGTGG	GAAACACCGGTTACAGAAGCTGCGTGGTGGGGTTAGAGCTAGAAATAGCA	1	bc
AAACGATTAA	GAAACACCGGTCGAGAAATAGGCACAGGCATCGGACGGCTGTGGGGTTGG	1	bc
GAACCCCCCC	GAAACACCGGTGCATTCGAAAGTCCGGTCGTAGTGTGGACGTGGGGTTAG	1	bc
TCAATACACC	GAAACACCGGTTTAGAGGTTCTGGGGATATGGGAGTAGGGGTGGGGTTAG	1	bc
ACACTGCCCT	CTAAACACCGGTTAATAGCACTGCACGTATTTGGTTGTGGGGTTAGGCTA	1	bc
GAGTAGGGCC	GAAACACCGGTGGTAATTTAGAGGTACAAAGTGGGTTAGAGCTAGAAATA	1	bc
CCCCCTTCCC	GAAACACCGGTCAGGTCACGTCGTCTGTGGGGTTAGAGCTAGAAATAGCA	1	bc
TCAATACACT	GAAACACCGGCTTAGAGGTTCTGGGGATATGGGAGTAGGGGTGGGGTTAG	1	bc
CGCGGCCTTT	GAAACACCGGTCTCGAGTGAGGTGTTCAGGGGGGGGTTAGAGCTAGAAAT	1	bc
AGATAGTTTT	CAAAACACCGGTTCGTGCATGCTCGACAGTAGCAATAGCCTGTGGAGTTA	1	bc
CATACCCCAC	GAAACACCGGTCACGCGCCTATATGCCTAGTGACCGAAGAGTGGGGTTAG	1	bc
ACTCAACGGC	GAAACACCGGTCTGGTTGAAGTGGGGTTAGAGCTAGAAATAGCAAGTTAA	1	bc
TGCCAAAAAA	GAAACACCGGTTTACTGGATTAGTTCGTGGGGTTAGAGCTAGAAATAGCA	1	bc
CCGCGCCGTA	GAAACACCGGTGTGGACGACGGACGGGTCTTGGGTGGAGTGTGGGGTTAG	1	bc
TATGTCATGC	GAAACACCGGTAATACGTTCCGTGGTAGAGCTAGAAATAGCAAGTTAACC	1	bc
GCCGGAATCA	GAAACACCGGTGAAAGACGATGTCAGGTGGGGTTAGAGCTAGAAATAGCA	1	bc
TCATTGGGGA	GAAACACCGGTGACAGAAGCTGCGTGGTGGGGTTAGAGCTAGAAATAGCA	1	bc
ACGCGACTTC	GAAACACCGGTACTCCCTCAAGTCTACATCGTGGGGTTAGAGCTAGAAAT	1	bc
ACACGACTTC	GAAACACCGGTACTCCTTCACGTCTACATCGTGGGGTTAGAGCTAGAAAT	1	bc
AATCCATCTC	GAAACACCGGTTCGTATGAGACCCACGACTTATGTGCCTTGTGGGTTTAG	1	bc
TGTTCAAGCG	GAAACACCGGTCCCGGGAACTTCGTATATGGTGTAGATAGAGCAAGAACA	1	bc
TAGCGCTGCG	GAAACACCGGTCGTTGTAGCAACCTATCGGTTGGGGATAGAGCTAGAAAT	1	bc
GACAAGACCG	GAAACACCGGTCGATAGATAATTCGGTGCTGGTGTGTGGGGTTAGAGCTA	1	bc
TAAACTCCAG	GAAACACCGGTAGTTCGCCCACTATCCATCGTGGGGTAGAGCTAGAAATA	1	bc
GAGTCTGGCA	GAAACACCGGTTTAGAGGTTCTGGGGATATGGGAGTAGGGGTGGGGTTAG	1	bc
TGCCAAACCC	GCGGAACCCCCGTTTACTGGATTTTCTCGTATGGTTAGTTTTGGAATTGT	1	bc
GTACCCCTCC	GAAACACCGGTACCTTTGTTGATGCTGGTTGGAAGGCATTGTGGGGTTAG	1	bc
ACTGCCAGCG	GAAACACCGGTGAAGCAAGACAGGAGGGCGACGTAAGGGGTGGGGTTAGA	1	bc
GTACATTAGA	GAGACACCGGTAATAAGTGGTTCTTAGTGGGGTCAGAGCTAGAAATAGCA	1	bc
CCCAATCCAT	GAAACACCGGACTTGATGCCCGAGGAGGGTGTGGGGTTAGAGCTAGAAAT	1	bc
TCAATACACT	GAAACACCGGTTTAGAGGCTCTGGGGATATGGGAGTAGGGGTGGGGTTAG	1	bc
ACCCTCCCTC	GAAACACCGGTCCTTCTTTATCTCTTTCTCGTTGGTGCAGTGCTAGCAAT	1	bc
CCCTCCAGCT	GAAACACCGGTGAAGGAAGACAGGAGGACGCCGGAAGGGGTGGGGATAGA	1	bc
CCCAATCCAT	GAAACACCGGTCTTGATGCCCGAGGAGGGTGTGGGTTAGAGCTAGAAATA	1	bc
ATAGAGCATT	GAAACACCGGTGTCTCGTTGGTACGTTCTGGTGGGGTTAGAGCTAGAAAT	1	bc
GGCTTCCGAT	GAAACACCGGTGGACAGAGTGTAGCATAAGTTGTTTGTTGGTGGGGTTAG	1	bc
ACTCAACGGC	GGAACACCGGTCCGGTTGAAGTCGGGTTAGAGCTAGAAATAGCAAGTTAA	1	bc
CCCCCCCACT	GAAACACCGGTGGAAGGTTGTATGTTGCTAGTGGGGTTAGAGCTAGAAAT	1	bc
TTTTGCATGC	GAAACACCGGTTAAGCCGAGGAGTTAATTGGGTTAGAGCTAGAAATAGCA	1	bc
GTTGGATCAC	GAAACACCGGTAACGGCACCACGCGTGAGGGGTTAGATATAGATATAGCT	1	bc
AATTTCGGTA	GAAACACCGGTCTATTTATTTCGAAACTTTCGCGTTACTTTGGGGTTAGA	1	bc
GCCCAGATAC	GAAACACCGGTCCCTCCGCATACAGCTGTCGTGGGGTTAGAGCTAGGAAT	1	bc
GCGTATCTCC	GAAACACCGGTTTGTCGGTCATTGATAGATCGGGCGATTGGGGGGGATAG	1	bc
CCCAATCCAT	GAAACACCGGTCTTGATGCCCGAGGAGGGTGGGGGGTTAGAGCTAGAAAT	1	bc
CCCCTCCTCC	GAAACACCGGTCATCTGCACTACGCTATGGGGTTAGAGCTAGCACTAGCA	1	bc
CACCCCTGCC	GAAAAACCGGTTTGCCAATCAGTGTGCGGATGGCTGCATGTGGGGTTAGT	1	bc
CCACAGATGC	GAAGCACCGGTCCCTAGCTAATTCTCTGCTGGTGTGTGCGATTAGACCTA	1	bc
ATGCTTTGAC	GAAACACCGGTTTACGTTGCATCGGTGTGGGGTTAGAGCTCGAAATAGAA	1	bc
GCCCACCACA	GAAACACCAGTAAGTTTCTTCATCGGTTGAGGCGGTGATGGGGGGGGTAG	1	bc
AACCCGCCCT	GAAACACCGGTGAACAACAGCGATCCACGCCAATTAACCTGTGGGGTTAG	1	bc
GCACCATCCG	GAAACACCGGTTCCAATAGGGTGATCGGAGGGGTATTACTAGTAGTAGTA	1	bc
AATCCACGCC	GAAACACCGGTTTAACTTAACACTGAGTGGGGTTAGAGCTAGCAATAGCA	1	bc
GTACATCAGC	GAAACACCAGACGGAGGCAATCGAGGGTGAGCTTAGAGTAATAAATTGCA	1	bc
GTATGGCACA	GAAACACCGGTAGCAGCGGCAGGCGTGATGGTGGGGTTAGAGCTAGATAT	1	bc
TCAATACACT	GAAACACCGGTTTAGAGGTTCTGAGGATATGGGAGTAGGGGTGGGGTTAG	1	bc
