barcode	classification
ATGGAGGGAC	Fast
ATGTCATCGA	Fast
CTCGTAAGTC	Fast
TGGTGATGGT	Fast
AGCACACCCA	Intermediate
AGGTGTTCAA	Intermediate
CAAGGGCCCT	Intermediate
CACCTCGGAC	Intermediate
CATATATTCC	Intermediate
CCGTACTTCA	Intermediate
CGGGGGTTCC	Intermediate
GACCCTTCCT	Intermediate
GCGTCGCCCT	Intermediate
TACACAGATA	Intermediate
TACACCCCAC	Intermediate
TAGAACCATG	Intermediate
TCATCAGGCC	Intermediate
TCTTATAACC	Intermediate
ATGACCCACC	Slow
CCACCATCCG	Slow
CGGTCTGTAC	Slow
GACGAAGACA	Slow
GCCAACGAGC	Slow
GCCCAGATAC	Slow
GGCGACCGCA	Slow
TTATCGTTCA	Slow
TTGTGACATA	Slow
AAGGCGGATC	Inactive
ACAAATCCTG	Inactive
ACGTCGCGGA	Inactive
AGGATACGCC	Inactive
ATAGCTGATG	Inactive
CAATCCGACT	Inactive
CACGGGTAAT	Inactive
CACTTAATTC	Inactive
CATACCCCAC	Inactive
CCACTAACTT	Inactive
CCTACAACAG	Inactive
CCTTAAGCGC	Inactive
GAACCGCTGG	Inactive
GACGGTTCCA	Inactive
GACTCTGGCC	Inactive
GAGCGCTGGG	Inactive
GCCCACCACA	Inactive
GGCCTTTGAC	Inactive
GTATCCCGAG	Inactive
TCATACGGGC	Inactive
TCTCCGGGCA	Inactive
TGACGGTTCT	Inactive
TGCCAGCTGA	Inactive
TGGTTTCTTT	Inactive
TTACCACGAA	Inactive
