barcode	classification
CACAACGCCC	Fast
CACTCTCAAG	Fast
GTGGAGCCTC	Fast
TTAGCTATGT	Fast
TTGAGCATAA	Fast
AAGCCGCGCG	Intermediate
CATTGGAGGT	Intermediate
CCCAAAACAC	Intermediate
CGTAGGGCCC	Intermediate
CTACTCGGCC	Intermediate
CTGCTATCGA	Intermediate
GACACAGACA	Intermediate
GATACCCCCA	Intermediate
GTACACAATT	Intermediate
ACATTCGGTT	Slow
ACCACTGCTG	Slow
ACCCTGGGAC	Slow
ACTCCATGTT	Slow
AGTCTGCCTC	Slow
ATGCTTAGCT	Slow
ATGGCGCCTA	Slow
CATCGTCGTC	Slow
CCTTTACCGC	Slow
CGAATCCTTT	Slow
CGACAGTTAT	Slow
CGTGTTGTCT	Slow
CTGAGTTTTA	Slow
CTTTTGTCGG	Slow
GAAGACCCGC	Slow
GCCAAGATGG	Slow
GCTCTACGCC	Slow
GGCCCCTACA	Slow
GGGTGACACG	Slow
GTCAAATACC	Slow
TAACTTATAC	Slow
TAGCCATGCA	Slow
TCTATCGAGG	Slow
AAACCCCGGG	Inactive
AACGCCCTAC	Inactive
AACTATCGGC	Inactive
AACTCACCTA	Inactive
AAGACTTCAT	Inactive
ACTCGGTTAC	Inactive
AGACCCTCGC	Inactive
AGCACTGTAC	Inactive
AGCCCAAATC	Inactive
AGTTTCCGAA	Inactive
CCCATCACCC	Inactive
CCCCTCACTT	Inactive
CCTCACCCCA	Inactive
CGCATGATGC	Inactive
CGCCGTAGTA	Inactive
GACCTCCAAT	Inactive
GCCAGCCGCT	Inactive
GCCCCATTCC	Inactive
GCGAAGTCCC	Inactive
GGCACCCTCC	Inactive
TAACTGCTCT	Inactive
TCTCTAGATC	Inactive
TTTGGCACAC	Inactive
