processing genotypingSample-PB7 2020-12-07 16:50:25 
Converted TACACCTGCA to GGCCCCTACAbecause it is a known primer mishybridization result 
processing mutantSample-1-PB7 2020-12-07 16:50:25 
Converted TACACCTGCA to GGCCCCTACAbecause it is a known primer mishybridization result 
Combined ACATTCGGTT GAAACACCGGTCGATTCATATCGAAACCTTCCCGTGTGGTTAGAGCTAGA 4 into ACATTCGGTT GAAACACCGGTCGATTCATATCGAAACCTTCCCGTGGGGTTAGAGCTAGA 5	for max_spacer_dist
Combined AGACCCTCGC CAAAACACCGGTGCATTCGAAAGTCCGGTCGTAGTGTGGACGTGGGGTTA 4 into AGACCCTCGC GAAACACCGGTGCATTCGAAAGTCCGGTCGTAGTGTGGACGTGGGGTTAG 1874	for one base displacement
Combined ATGCTTAGCT CAAAACACCGGTTTACGTTGCATCGGTGTGGGGTTAGAGCTAGAAATAGC 3 into ATGCTTAGCT GAAACACCGGTTTACGTTGCATCGGTGTGGGGTTAGAGCTAGAAATAGCA 979	for one base displacement
Combined CATCGTCGTC CAAAACACCGGTGTACGTATGGACTGAACCAGGGTGTGCAAGTGGGGTTA 5 into CATCGTCGTC GAAACACCGGTGTACGTATGGACTGAACCAGGGTGTGCAAGTGGGGTTAG 1662	for one base displacement
Combined CCTTTACCGC CAAAACACCGGTCGGGGCCACTCAGTGGTGGGGTTAGAGCTAGAAATAGC 3 into CCTTTACCGC GAAACACCGGTCGGGGCCACTCAGTGGTGGGGTTAGAGCTAGAAATAGCA 1532	for one base displacement
Combined CGAATCCTTT CAAAACACCGGTCTCGAGTGAGGTGTTCAGGGTGGGGTTAGAGCTAGAAA 7 into CGAATCCTTT GAAACACCGGTCTCGAGTGAGGTGTTCAGGGTGGGGTTAGAGCTAGAAAT 1263	for one base displacement
Combined CGTGTTGTCT GAAACACCGGTGACATTGGGTACGGGGTTAGAGCTAGAAATAGCAAGTTA 4 into CGTGTTGTCT GAAACACCGGTGACATTGGGTATGGGGTTAGAGCTAGAAATAGCAAGTTA 5	for max_spacer_dist
Combined CGTGTTGTCT GAAACACCGGTGACATGGGTTAGAGCTAGAAATAGCAAGTTAACCTAAGG 5 into CGTGTTGTCT GAAACACCGGTGACAGGGGTTAGAGCTAGAAATAGCAAGTTAACCTAAGG 8	for max_spacer_dist
Combined CGTGTTGTCT CAAAACACCGGTGACATTGGGTACAGGGTGGGGTTAGAGCTAGAAATAGC 3 into CGTGTTGTCT GAAACACCGGTGACATTGGGTACAGGGTGGGGTTAGAGCTAGAAATAGCA 376	for one base displacement
Combined GAAGACCCGC GAAACACGGGTTAGAGCTAGAAATAGCAAGTTAACCTAAGGCTAGTCCGT 4 into GAAGACCCGC GAAACACCGGTTAGAGCTAGAAATAGCAAGTTAACCTAAGGCTAGTCCGT 20	for max_spacer_dist
Combined GAAGACCCGC GAAACACCGGTCGGCGGCAGTGGGGTTAGAGCTAGAAATAGCAAGTTAAC 5 into GAAGACCCGC GAAACACCGGTCGGCGGCAATGGGGTTAGAGCTAGAAATAGCAAGTTAAC 8	for max_spacer_dist
Combined GAAGACCCGC GAAACACCGGTCGGCGGTTAGAGCTAGAAATAGCAAGTTAACCTAAGGCT 13 into GAAGACCCGC GAAACACCGGTCGGGGGTTAGAGCTAGAAATAGCAAGTTAACCTAAGGCT 16	for max_spacer_dist
Combined GAAGACCCGC GAAACACCGGTCGGCGGCAATCGGGGTTAGAGCTAGAAATAGCAAGTTAA 21 into GAAGACCCGC GAAACACCGGTCGGCGGCAATCGTGGTTAGAGCTAGAAATAGCAAGTTAA 23	for max_spacer_dist
Combined GACACAGACA GAAACACCGGTAGCAAGTGCGAGCAAGTTGTGGGGTTAGAGCTAGAAATA 9 into GACACAGACA GAAACACCGGTAGCAAGTGCGAGCAAGTTTTGGGGTTAGAGCTAGAAATA 12	for max_spacer_dist
Combined GACACAGACA GAAACACCGGTAGCAAGTGCGGTTAGAGCTAGAAATAGCAAGTTAACCTA 38 into GACACAGACA GAAACACCGGTAGCAAGTGGGGTTAGAGCTAGAAATAGCAAGTTAACCTA 77	for max_spacer_dist
Combined GGCACCCTCC GAACACCGGTGTGGCTGAGAGTCCGGCAATGGTGTGGCTGTGGGGTTAGA 3 into GGCACCCTCC GAAACACCGGTGTGGCTGAGAGTCCGGCAATGGTGTGGCTGTGGGGTTAG 1092	for one base displacement
Combined TAACTTATAC GAAACACCGGTAACTATATTCATGCGATATAGCCGTATGGGGTTAGAGCT 3 into TAACTTATAC GAAACACCGGTAACTATATTCATGCGATATCGCCGTATGGGGTTAGAGCT 5	for max_spacer_dist
Combined TCTATCGAGG GAAACACCGGTTATATTTGTAAGTGTTAGAGCTAGAAATAGCAAGTTAAC 5 into TCTATCGAGG GAAACACCGGTTATATTTGTAAGGGTTAGAGCTAGAAATAGCAAGTTAAC 10	for max_spacer_dist
Combined TTAGCTATGT GAAATACCGGTTACATTGAGTGGGGTTAGAGCTAGAAATAGCAAGTTAAC 3 into TTAGCTATGT GAAACACCGGTTACATTGAGTGGGGTTAGAGCTAGAAATAGCAAGTTAAC 9	for max_spacer_dist
Combined TTAGCTATGT CAAAACACCGGTTACATTGAGGGGTTAGAGCTAGAAATAGCAAGTTAACC 3 into TTAGCTATGT GAAACACCGGTTACATTGAGGGGTTAGAGCTAGAAATAGCAAGTTAACCT 306	for one base displacement
Combined TTAGCTATGT GTGAGGGTTAGAGCTAGAAATAGCAAGTTAACCTAAGGCTAGTCCGTTAT 4 into TTAGCTATGT AGAGGGTTAGAGCTAGAAATAGCAAGTTAACCTAAGGCTAGTCCGTTATC 5	for one base displacement
Combined TTAGCTATGT ATTGAGGGTTAGAGCTAGAAATAGCAAGTTAACCTAAGGCTAGTCCGTTA 5 into TTAGCTATGT AGAGGGTTAGAGCTAGAAATAGCAAGTTAACCTAAGGCTAGTCCGTTATC 9	for one base displacement
processing mutantSample-2-PB7 2020-12-07 16:50:25 
Converted TACACCTGCA to GGCCCCTACAbecause it is a known primer mishybridization result 
Combined ACATTCGGTT CAAAACACCGGTCGATTCATATCGAAACCTTCCCGTGACAGTGGGGTTAG 3 into ACATTCGGTT GAAACACCGGTCGATTCATATCGAAACCTTCCCGTGACAGTGGGGTTAGA 1121	for one base displacement
Combined ATGCTTAGCT CAAAACACCGGTTTACGTTGCATCGGTGTGGGGTTAGAGCTAGAAATAGC 3 into ATGCTTAGCT GAAACACCGGTTTACGTTGCATCGGTGTGGGGTTAGAGCTAGAAATAGCA 1198	for one base displacement
Combined CACAACGCCC ATTGTGGGGTTAGAGCTAGAAATAGCAAGTTAACCTAAGGCTAGTCCGTT 5 into CACAACGCCC ATGTGGGGTTAGAGCTAGAAATAGCAAGTTAACCTAAGGCTAGTCCGTTA 12	for one base displacement
Combined CACAACGCCC GAACACGGGTTAGAGCTAGAAATAGCAAGTTAACCTAAGGCTAGTCCGTT 4 into CACAACGCCC GAAACACGGGTTAGAGCTAGAAATAGCAAGTTAACCTAAGGCTAGTCCGT 119	for one base displacement
Combined CACAACGCCC GAAATAGCAAGTTAACCTAAGGCTAGTCCGTTATCAACTTGAAAAAGTGG 3 into CACAACGCCC GCTAGAAATAGCAAGTTAACCTAAGGCTAGTCCGTTATCAACTTGAAAAA 253	for one base displacement
Combined CGAATCCTTT CAAAACACCGGTCTCGAGTGAGGTGTTCAGGGTGGGGTTAGAGCTAGAAA 3 into CGAATCCTTT GAAACACCGGTCTCGAGTGAGGTGTTCAGGGTGGGGTTAGAGCTAGAAAT 1412	for one base displacement
Combined CGTGTTGTCT GAAACACCGGTGACATTGGGTACAGGGGGGTGGGGTTAGAGCTAGAAATA 3 into CGTGTTGTCT GAAACACCGGTGACATTGGGTACAGGGGGATGGGGTTAGAGCTAGAAATA 3	for max_spacer_dist
Combined CGTGTTGTCT GAACCGGGGTTAGAGCTAGAAATAGCAAGTTAACCTAAGGCTAGTCCGTT 4 into CGTGTTGTCT GAAACGGGGTTAGAGCTAGAAATAGCAAGTTAACCTAAGGCTAGTCCGTT 5	for max_spacer_dist
Combined CGTGTTGTCT GAAACACCGGTGACATTGGGTACAAGAAATAGCAAGTTAACCTAAGGCTA 5 into CGTGTTGTCT GAAACACCGGTGACATTGGGTACTAGAAATAGCAAGTTAACCTAAGGCTA 15	for max_spacer_dist
Combined CGTGTTGTCT GAAACACCGTTGGGGTTAGAGCTAGAAATAGCAAGTTAACCTAAGGCTAG 6 into CGTGTTGTCT GAAACACCGGTGGGGTTAGAGCTAGAAATAGCAAGTTAACCTAAGGCTAG 7	for max_spacer_dist
Combined CGTGTTGTCT GAAACACCGGTGACATTGGGTACAGTTAGAGCTAGAAATAGCAAGTTAAC 6 into CGTGTTGTCT GAAACACCGGTGACATTGGGTACAATTAGAGCTAGAAATAGCAAGTTAAC 18	for max_spacer_dist
Combined CGTGTTGTCT GAAACACCGGTGACATTGGGTAGGGTTAGAGCTAGAAATAGCAAGTTAAC 7 into CGTGTTGTCT GAAACACCGGTGACATTGGGTGGGGTTAGAGCTAGAAATAGCAAGTTAAC 19	for max_spacer_dist
Combined CGTGTTGTCT GAAACACCGGTGACATTGGGTATGGGGTTAGAGCTAGAAATAGCAAGTTA 24 into CGTGTTGTCT GAAACACCGGTGACATTGGGTACGGGGTTAGAGCTAGAAATAGCAAGTTA 47	for max_spacer_dist
Combined CGTGTTGTCT GAAACACCGGTGACATTGGGTACAGGGTTAGAGCTAGAAATAGCAAGTTA 31 into CGTGTTGTCT GAAACACCGGTGACATTGGGTACGGGGTTAGAGCTAGAAATAGCAAGTTA 71	for max_spacer_dist
Combined CGTGTTGTCT GAAACGGGGTTAGAGCTAGAAATAGCAAGTTAACCTAAGGCTAGTCCGTT 9 into CGTGTTGTCT ACCGGGGTTAGAGCTAGAAATAGCAAGTTAACCTAAGGCTAGTCCGTTAT 18	for one base displacement
Combined CGTGTTGTCT GATTGGGGTTAGAGCTAGAAATAGCAAGTTAACCTAAGGCTAGTCCGTTA 15 into CGTGTTGTCT GGTGGGGTTAGAGCTAGAAATAGCAAGTTAACCTAAGGCTAGTCCGTTAT 19	for one base displacement
Combined CGTGTTGTCT GGGTTAGAGCTAGAAATAGCAAGTTAACCTAAGGCTAGTCCGTTATCAAC 12 into CGTGTTGTCT GGTGGGGTTAGAGCTAGAAATAGCAAGTTAACCTAAGGCTAGTCCGTTAT 34	for one base displacement
Combined CGTGTTGTCT ACCGGGGTTAGAGCTAGAAATAGCAAGTTAACCTAAGGCTAGTCCGTTAT 27 into CGTGTTGTCT GGTGGGGTTAGAGCTAGAAATAGCAAGTTAACCTAAGGCTAGTCCGTTAT 46	for one base displacement
Combined CTACTCGGCC GAAACACCGGTACCTTTGTTGATGCTGGGTGGAAGGAGGCTAGAAATAGC 3 into CTACTCGGCC GAAACACCGGTACCTTTGTTGATGCTGGGTGGAAGGAAGCTAGAAATAGC 5	for max_spacer_dist
Combined CTACTCGGCC GAAACACCGGTACCTTTGTTGATGCTGGGTGGAAGGAGTGGGGTTAGAGC 4 into CTACTCGGCC GAAACACCGGTACCTTTGTTGATGCTGGGTGGAAGGAATGGGGTTAGAGC 15	for max_spacer_dist
Combined CTACTCGGCC CAAAACACCGGTACCTTTGTTGATGCTGGTTGTGGGGTTAGAGCTAGAAA 4 into CTACTCGGCC GAAACACCGGTACCTTTGTTGATGCTGGTTGTGGGGTTAGAGCTAGAAAT 6	for one base displacement
Combined GAAGACCCGC GAAACACCGGTCGGCGGGTGGGGTTAGAGCTAGAAATAGCAAGTTAACCT 3 into GAAGACCCGC GAAACACCGGTCGGCGGCTGGGGTTAGAGCTAGAAATAGCAAGTTAACCT 3	for max_spacer_dist
Combined GAAGACCCGC GAAACACCGGTCGGCGGCTGGGGTTAGAGCTAGAAATAGCAAGTTAACCT 3 into GAAGACCCGC GAAACACCGGTCGGCGGCAGGGGTTAGAGCTAGAAATAGCAAGTTAACCT 5	for max_spacer_dist
Combined GAAGACCCGC GAAACACCGGTCGGCGGCGTGAGGTTAGAGCTAGAAATAGCAAGTTAACC 3 into GAAGACCCGC GAAACACCGGTCGGCGGCGTGGGGTTAGAGCTAGAAATAGCAAGTTAACC 4	for max_spacer_dist
Combined GAAGACCCGC GAAACACCGGTCGGCGGCATGGGGTTAGAGCTAGAAATAGCAAGTTAACC 3 into GAAGACCCGC GAAACACCGGTCGGCGGCGTGGGGTTAGAGCTAGAAATAGCAAGTTAACC 7	for max_spacer_dist
Combined GAAGACCCGC GAAACACCGGTCGGCGGCAATCGTGGAGCTAGAAATAGCAAGTTAACCTA 4 into GAAGACCCGC GAAACACCGGTCGGCGGCAATCGTGGGGCTAGAAATAGCAAGTTAACCTA 9	for max_spacer_dist
Combined GAAGACCCGC GAAACACCGGTCGGCGGTTAGAGCTAGAAATAGCAAGTTAACCTAAGGCT 7 into GAAGACCCGC GAAACACCGGTCGGCGGCTAGAGCTAGAAATAGCAAGTTAACCTAAGGCT 23	for max_spacer_dist
Combined GAAGACCCGC GAAACACCGGTCGGTGGGGTTAGAGCTAGAAATAGCAAGTTAACCTAAGG 12 into GAAGACCCGC GAAACACCGGTCGGCGGGGTTAGAGCTAGAAATAGCAAGTTAACCTAAGG 35	for max_spacer_dist
Combined GAAGACCCGC GAAACACCGGTCGTGGGGTTAGAGCTAGAAATAGCAAGTTAACCTAAGGC 16 into GAAGACCCGC GAAACACCGGTCGGGGGGTTAGAGCTAGAAATAGCAAGTTAACCTAAGGC 16	for max_spacer_dist
Combined GACACAGACA GAAACGTTAACCTAAGGCTAGTCCGTTATCAACTTGAAAAAGTGGCACCG 5 into GACACAGACA GAAACGTTAACCTAAAGCTAGTCCGTTATCAACTTGAAAAAGTGGCACCG 10	for max_spacer_dist
Combined GTGGAGCCTC CAAAACACCGGTTCCCGTCCAGTGGGGTTAGAGCTAGAAATAGCAAGTTA 5 into GTGGAGCCTC GAAACACCGGTTCCCGTCCAGTGGGGTTAGAGCTAGAAATAGCAAGTTAA 1822	for one base displacement
Combined TCTATCGAGG GGAACACCGGTTAGGGGTTAGAGCTAGAAATAGCAAGTTAACCTAAGGCT 5 into TCTATCGAGG GAAACACCGGTTAGGGGTTAGAGCTAGAAATAGCAAGTTAACCTAAGGCT 5	for max_spacer_dist
Combined TTAGCTATGT GAAACACCGGTTACGGGTTAGAGCTAGAAATAGCAAGTTAACCTAAGGCT 7 into TTAGCTATGT GAAACACCGGTTAAGGGTTAGAGCTAGAAATAGCAAGTTAACCTAAGGCT 8	for max_spacer_dist
Combined TTAGCTATGT ATTGGGGTTAGAGCTAGAAATAGCAAGTTAACCTAAGGCTAGTCCGTTAT 13 into TTAGCTATGT GGGTTAGAGCTAGAAATAGCAAGTTAACCTAAGGCTAGTCCGTTATCAAC 27	for one base displacement
Combined TTAGCTATGT GATAGAGCTAGAAATAGCAAGTTAACCTAAGGCTAGTCCGTTATCAACTT 8 into TTAGCTATGT GGGTTAGAGCTAGAAATAGCAAGTTAACCTAAGGCTAGTCCGTTATCAAC 40	for one base displacement
Combined TTGAGCATAA GAAACACCGGTTAAGCCGAGGTGGGGTTAGAGCTAGAAATAGCAAGTTAA 13 into TTGAGCATAA GAAACACCGGTTAAGCCGAGGAGGGGTTAGAGCTAGAAATAGCAAGTTAA 17	for max_spacer_dist
Combined TTGAGCATAA CAAAACACCGGTTAAGCCGAGGAGTTAGAGCTAGAAATAGCAAGTTAACC 3 into TTGAGCATAA GAAACACCGGTTAAGCCGAGGAGTTAGAGCTAGAAATAGCAAGTTAACCT 498	for one base displacement
processing mutantSample-3-PB7 2020-12-07 16:50:26 
Converted TACACCTGCA to GGCCCCTACAbecause it is a known primer mishybridization result 
Combined AGACCCTCGC CAAAACACCGGTGCATTCGAAAGTCCGGTCGTAGTGTGGACGTGGGGTTA 3 into AGACCCTCGC GAAACACCGGTGCATTCGAAAGTCCGGTCGTAGTGTGGACGTGGGGTTAG 1097	for one base displacement
Combined ATGCTTAGCT GAAACACCGGTTTACGTTGGGTTAGAGCTAGAAATAGCAAGTTAACCTAA 3 into ATGCTTAGCT GAAACACCGGTTTACGTGGGGTTAGAGCTAGAAATAGCAAGTTAACCTAA 4	for max_spacer_dist
Combined ATGCTTAGCT GAAACACCGGTTTACGTTGCATCGTTAGAGCTAGAAATAGCAAGTTAACC 3 into ATGCTTAGCT GAAACACCGGTTTACGTTGCATCGGTAGAGCTAGAAATAGCAAGTTAACC 5	for max_spacer_dist
Combined ATGCTTAGCT GAAACACCGGTTTACCTAGAAATAGCAAGTTAACCTAAGGCTAGTCCGTT 4 into ATGCTTAGCT GAAACACCGGTTTAGCTAGAAATAGCAAGTTAACCTAAGGCTAGTCCGTT 6	for max_spacer_dist
Combined CATCGTCGTC CAAAACACCGGTGTACGTATGGACTGAACCAGGGTGTGCAAGTGGGGTTA 3 into CATCGTCGTC GAAACACCGGTGTACGTATGGACTGAACCAGGGTGTGCAAGTGGGGTTAG 1149	for one base displacement
Combined CGAATCCTTT GAAACACCGGTCTCGAGTGAGGTTAGAGCTAGAAATAGCAAGTTAACCTA 12 into CGAATCCTTT GAAACACCGGTCTCGAGTGGGGTTAGAGCTAGAAATAGCAAGTTAACCTA 14	for max_spacer_dist
Combined CGTGTTGTCT GAAACACCGGTGACATTGGGTACGAAATAGCAAGTTAACCTAAGGCTAGT 4 into CGTGTTGTCT GAAACACCGGTGACATTGGGTACGGAATAGCAAGTTAACCTAAGGCTAGT 6	for max_spacer_dist
Combined CGTGTTGTCT GAAACACCGGTGACATTGGGTAGGGGGTTAGAGCTAGAAATAGCAAGTTA 5 into CGTGTTGTCT GAAACACCGGTGACATTGGGTATGGGGTTAGAGCTAGAAATAGCAAGTTA 8	for max_spacer_dist
Combined CGTGTTGTCT GAAACACCGGTGACATTGGGTATGGGGTTAGAGCTAGAAATAGCAAGTTA 8 into CGTGTTGTCT GAAACACCGGTGACATTGGGTGTGGGGTTAGAGCTAGAAATAGCAAGTTA 18	for max_spacer_dist
Combined CGTGTTGTCT GAAGGTGGGGTTAGAGCTAGAAATAGCAAGTTAACCTAAGGCTAGTCCGT 4 into CGTGTTGTCT GTGGGGTTAGAGCTAGAAATAGCAAGTTAACCTAAGGCTAGTCCGTTATC 18	for one base displacement
Combined CGTGTTGTCT CCGTGGGGTTAGAGCTAGAAATAGCAAGTTAACCTAAGGCTAGTCCGTTA 8 into CGTGTTGTCT GTGGGGTTAGAGCTAGAAATAGCAAGTTAACCTAAGGCTAGTCCGTTATC 22	for one base displacement
Combined CTACTCGGCC GACACCGGTACCTTTGTTGATGCTGGGGTGGGGTTAGAGCTAGAAATAGC 5 into CTACTCGGCC GAAACACCGGTACCTTTGTTGATGCTGGGGTGGGGTTAGAGCTAGAAATA 9	for one base displacement
Combined GAAGACCCGC GAAACACTTAGAGCTAGAAATAGCAAGTTAACCTAAGGCTAGTCCGTTAT 6 into GAAGACCCGC GAAACACCTAGAGCTAGAAATAGCAAGTTAACCTAAGGCTAGTCCGTTAT 7	for max_spacer_dist
Combined GAAGACCCGC GAAACACCGGTCGGCGGCAATCTTTAGAGCTAGAAATAGCAAGTTAACCT 6 into GAAGACCCGC GAAACACCGGTCGGCGGCAATCGTTAGAGCTAGAAATAGCAAGTTAACCT 20	for max_spacer_dist
Combined GAAGACCCGC GAAACACCGGTCGGCGGCAATGGGGTTAGAGCTAGAAATAGCAAGTTAAC 9 into GAAGACCCGC GAAACACCGGTCGGCGGCAGTGGGGTTAGAGCTAGAAATAGCAAGTTAAC 10	for max_spacer_dist
Combined GAAGACCCGC GAAACACCGGTCGGCGGGGTTAGAGCTAGAAATAGCAAGTTAACCTAAGG 21 into GAAGACCCGC GAAACACCGGTCGGTGGGGTTAGAGCTAGAAATAGCAAGTTAACCTAAGG 22	for max_spacer_dist
Combined TTAGCTATGT GATGAGGGTTAGAGCTAGAAATAGCAAGTTAACCTAAGGCTAGTCCGTTA 3 into TTAGCTATGT GTGAGGGTTAGAGCTAGAAATAGCAAGTTAACCTAAGGCTAGTCCGTTAT 10	for one base displacement
processing PB7-founder 2020-12-07 16:50:26 
Converted TACACCTGCA to GGCCCCTACAbecause it is a known primer mishybridization result 
Combined ACTCCATGTT CAAAACACCGGTATGAGAATCGGTAGTCATGGTGGGGTTAGAGCTAGAAA 3 into ACTCCATGTT GAAACACCGGTATGAGAATCGGTAGTCATGGTGGGGTTAGAGCTAGAAAT 526	for one base displacement
Combined CATCGTCGTC CAAAACACCGGTGTACGTATGGACTGAACCAGGGTGTGCAAGTGGGGTTA 3 into CATCGTCGTC GAAACACCGGTGTACGTATGGACTGAACCAGGGTGTGCAAGTGGGGTTAG 485	for one base displacement
Combined CATTGGAGGT CAAAACACCGGTGACAGAAGCTGCGTGGTGGGGTTAGAGCTAGAAATAGC 4 into CATTGGAGGT GAAACACCGGTGACAGAAGCTGCGTGGTGGGGTTAGAGCTAGAAATAGCA 800	for one base displacement
Combined CCCAAAACAC CAAAACACCGGTTTACTGGATTAGTTCGTGGGGTTAGAGCTAGAAATAGC 4 into CCCAAAACAC GAAACACCGGTTTACTGGATTAGTTCGTGGGGTTAGAGCTAGAAATAGCA 1540	for one base displacement
Combined CGTGTTGTCT GACGAAACACCGGTGACATTGGGTACAGGGTGGGGTTAGAGCTAGAAATA 4 into CGTGTTGTCT GAAACACCGGTGACATTGGGTACAGGGTGGGGTTAGAGCTAGAAATAGCA 557	for one base displacement
Combined CTGCTATCGA CAAAACACCGGTTGTGTCACCTTCACAGTGGGGTTAGAGCTAGAAATAGC 3 into CTGCTATCGA GAAACACCGGTTGTGTCACCTTCACAGTGGGGTTAGAGCTAGAAATAGCA 649	for one base displacement
Combined GACCTCCAAT CAAAACACCGGTGTACACAGAGTCGACTACCCAGTATGTTCGTGGGGTTA 7 into GACCTCCAAT GAAACACCGGTGTACACAGAGTCGACTACCCAGTATGTTCGTGGGGTTAG 606	for one base displacement
Combined GCCCCATTCC CAAAACACCGGTCAGGTCACGTCGTCTGTGGGGTTAGAGCTAGAAATAGC 4 into GCCCCATTCC GAAACACCGGTCAGGTCACGTCGTCTGTGGGGTTAGAGCTAGAAATAGCA 526	for one base displacement
Combined GTACACAATT CAAAACACCGGTTAAAGTAAATTGCGAGTGGGGTTAGAGCTAGAAATAGC 3 into GTACACAATT GAAACACCGGTTAAAGTAAATTGCGAGTGGGGTTAGAGCTAGAAATAGCA 322	for one base displacement
Combined GTGGAGCCTC CAAAACACCGGTTCCCGTCCAGTAATCGTGGGGTTAGAGCTAGAAATAGC 4 into GTGGAGCCTC GAAACACCGGTTCCCGTCCAGTAATCGTGGGGTTAGAGCTAGAAATAGCA 955	for one base displacement
Combined TAACTTATAC CAAAACACCGGTAACTATATTCATGCGATATCGCCGTATCAGTGGGGTTA 6 into TAACTTATAC GAAACACCGGTAACTATATTCATGCGATATCGCCGTATCAGTGGGGTTAG 920	for one base displacement
Combined TAGCCATGCA CAAAACACCGGTCGTTGTAGCAACCTATCGGGTGGGGTTAGAGCTAGAAA 3 into TAGCCATGCA GAAACACCGGTCGTTGTAGCAACCTATCGGGTGGGGTTAGAGCTAGAAAT 853	for one base displacement
Combined TTAGCTATGT CAAAACACCGGTTACATTGAGAACTTCGTGGGGTTAGAGCTAGAAATAGC 3 into TTAGCTATGT GAAACACCGGTTACATTGAGAACTTCGTGGGGTTAGAGCTAGAAATAGCA 597	for one base displacement
Combined TTGAGCATAA CAAAACACCGGTTAAGCCGAGGAGTTAGTGGGGTTAGAGCTAGAAATAGC 4 into TTGAGCATAA GAAACACCGGTTAAGCCGAGGAGTTAGTGGGGTTAGAGCTAGAAATAGCA 550	for one base displacement
Combined TTTGGCACAC CAAAACACCGGTAGCAGCGGCAGGCGTGATGGTGGGGTTAGAGCTAGAAA 3 into TTTGGCACAC GAAACACCGGTAGCAGCGGCAGGCGTGATGGTGGGGTTAGAGCTAGAAAT 742	for one base displacement
