processing PB7-founder 2020-09-23 11:05:10 
Converted TACACCTGCA to GGCCCCTACAbecause it is a known primer mishybridization result 
Combined ACTCCATGTT CAAAACACCGGTATGAGAATCGGTAGTCATGGTGGGGTTAGAGCTAGAAA 3 into ACTCCATGTT GAAACACCGGTATGAGAATCGGTAGTCATGGTGGGGTTAGAGCTAGAAAT 505	for one base displacement
Combined CATCGTCGTC CAAAACACCGGTGTACGTATGGACTGAACCAGGGTGTGCAAGTGGGGTTA 3 into CATCGTCGTC GAAACACCGGTGTACGTATGGACTGAACCAGGGTGTGCAAGTGGGGTTAG 461	for one base displacement
Combined CATTGGAGGT CAAAACACCGGTGACAGAAGCTGCGTGGTGGGGTTAGAGCTAGAAATAGC 4 into CATTGGAGGT GAAACACCGGTGACAGAAGCTGCGTGGTGGGGTTAGAGCTAGAAATAGCA 766	for one base displacement
Combined CCCAAAACAC CAAAACACCGGTTTACTGGATTAGTTCGTGGGGTTAGAGCTAGAAATAGC 4 into CCCAAAACAC GAAACACCGGTTTACTGGATTAGTTCGTGGGGTTAGAGCTAGAAATAGCA 1479	for one base displacement
Combined CGTGTTGTCT GACGAAACACCGGTGACATTGGGTACAGGGTGGGGTTAGAGCTAGAAATA 4 into CGTGTTGTCT GAAACACCGGTGACATTGGGTACAGGGTGGGGTTAGAGCTAGAAATAGCA 543	for one base displacement
Combined CTGCTATCGA CAAAACACCGGTTGTGTCACCTTCACAGTGGGGTTAGAGCTAGAAATAGC 3 into CTGCTATCGA GAAACACCGGTTGTGTCACCTTCACAGTGGGGTTAGAGCTAGAAATAGCA 618	for one base displacement
Combined GACCTCCAAT CAAAACACCGGTGTACACAGAGTCGACTACCCAGTATGTTCGTGGGGTTA 7 into GACCTCCAAT GAAACACCGGTGTACACAGAGTCGACTACCCAGTATGTTCGTGGGGTTAG 583	for one base displacement
Combined GCCCCATTCC CAAAACACCGGTCAGGTCACGTCGTCTGTGGGGTTAGAGCTAGAAATAGC 4 into GCCCCATTCC GAAACACCGGTCAGGTCACGTCGTCTGTGGGGTTAGAGCTAGAAATAGCA 504	for one base displacement
Combined GTACACAATT CAAAACACCGGTTAAAGTAAATTGCGAGTGGGGTTAGAGCTAGAAATAGC 3 into GTACACAATT GAAACACCGGTTAAAGTAAATTGCGAGTGGGGTTAGAGCTAGAAATAGCA 310	for one base displacement
Combined GTGGAGCCTC CAAAACACCGGTTCCCGTCCAGTAATCGTGGGGTTAGAGCTAGAAATAGC 4 into GTGGAGCCTC GAAACACCGGTTCCCGTCCAGTAATCGTGGGGTTAGAGCTAGAAATAGCA 925	for one base displacement
Combined TAACTTATAC CAAAACACCGGTAACTATATTCATGCGATATCGCCGTATCAGTGGGGTTA 6 into TAACTTATAC GAAACACCGGTAACTATATTCATGCGATATCGCCGTATCAGTGGGGTTAG 885	for one base displacement
Combined TAGCCATGCA CAAAACACCGGTCGTTGTAGCAACCTATCGGGTGGGGTTAGAGCTAGAAA 3 into TAGCCATGCA GAAACACCGGTCGTTGTAGCAACCTATCGGGTGGGGTTAGAGCTAGAAAT 825	for one base displacement
Combined TTAGCTATGT CAAAACACCGGTTACATTGAGAACTTCGTGGGGTTAGAGCTAGAAATAGC 3 into TTAGCTATGT GAAACACCGGTTACATTGAGAACTTCGTGGGGTTAGAGCTAGAAATAGCA 572	for one base displacement
Combined TTGAGCATAA CAAAACACCGGTTAAGCCGAGGAGTTAGTGGGGTTAGAGCTAGAAATAGC 4 into TTGAGCATAA GAAACACCGGTTAAGCCGAGGAGTTAGTGGGGTTAGAGCTAGAAATAGCA 530	for one base displacement
Combined TTTGGCACAC CAAAACACCGGTAGCAGCGGCAGGCGTGATGGTGGGGTTAGAGCTAGAAA 3 into TTTGGCACAC GAAACACCGGTAGCAGCGGCAGGCGTGATGGTGGGGTTAGAGCTAGAAAT 719	for one base displacement
processing genotypingSample-PB7 2020-09-23 11:05:11 
Converted TACACCTGCA to GGCCCCTACAbecause it is a known primer mishybridization result 
processing mutantSample-1-PB7 2020-09-23 11:05:11 
Converted TACACCTGCA to GGCCCCTACAbecause it is a known primer mishybridization result 
Combined ACATTCGGTT GAAACACCGGTCGATTCATATCGAAACCTTCCCGTGTGGTTAGAGCTAGA 4 into ACATTCGGTT GAAACACCGGTCGATTCATATCGAAACCTTCCCGTGGGGTTAGAGCTAGA 5	for max_spacer_dist
Combined AGACCCTCGC CAAAACACCGGTGCATTCGAAAGTCCGGTCGTAGTGTGGACGTGGGGTTA 4 into AGACCCTCGC GAAACACCGGTGCATTCGAAAGTCCGGTCGTAGTGTGGACGTGGGGTTAG 1835	for one base displacement
Combined ATGCTTAGCT CAAAACACCGGTTTACGTTGCATCGGTGTGGGGTTAGAGCTAGAAATAGC 3 into ATGCTTAGCT GAAACACCGGTTTACGTTGCATCGGTGTGGGGTTAGAGCTAGAAATAGCA 957	for one base displacement
Combined CATCGTCGTC CAAAACACCGGTGTACGTATGGACTGAACCAGGGTGTGCAAGTGGGGTTA 5 into CATCGTCGTC GAAACACCGGTGTACGTATGGACTGAACCAGGGTGTGCAAGTGGGGTTAG 1621	for one base displacement
Combined CCTTTACCGC CAAAACACCGGTCGGGGCCACTCAGTGGTGGGGTTAGAGCTAGAAATAGC 3 into CCTTTACCGC GAAACACCGGTCGGGGCCACTCAGTGGTGGGGTTAGAGCTAGAAATAGCA 1492	for one base displacement
Combined CGAATCCTTT CAAAACACCGGTCTCGAGTGAGGTGTTCAGGGTGGGGTTAGAGCTAGAAA 7 into CGAATCCTTT GAAACACCGGTCTCGAGTGAGGTGTTCAGGGTGGGGTTAGAGCTAGAAAT 1234	for one base displacement
Combined CGTGTTGTCT GAAACACCGGTGACATTGGGTACGGGGTTAGAGCTAGAAATAGCAAGTTA 4 into CGTGTTGTCT GAAACACCGGTGACATTGGGTATGGGGTTAGAGCTAGAAATAGCAAGTTA 5	for max_spacer_dist
Combined CGTGTTGTCT GAAACACCGGTGACATGGGTTAGAGCTAGAAATAGCAAGTTAACCTAAGG 5 into CGTGTTGTCT GAAACACCGGTGACAGGGGTTAGAGCTAGAAATAGCAAGTTAACCTAAGG 8	for max_spacer_dist
Combined CGTGTTGTCT CAAAACACCGGTGACATTGGGTACAGGGTGGGGTTAGAGCTAGAAATAGC 3 into CGTGTTGTCT GAAACACCGGTGACATTGGGTACAGGGTGGGGTTAGAGCTAGAAATAGCA 368	for one base displacement
Combined GAAGACCCGC GAAACACGGGTTAGAGCTAGAAATAGCAAGTTAACCTAAGGCTAGTCCGT 4 into GAAGACCCGC GAAACACCGGTTAGAGCTAGAAATAGCAAGTTAACCTAAGGCTAGTCCGT 20	for max_spacer_dist
Combined GAAGACCCGC GAAACACCGGTCGGCGGCAGTGGGGTTAGAGCTAGAAATAGCAAGTTAAC 4 into GAAGACCCGC GAAACACCGGTCGGCGGCAATGGGGTTAGAGCTAGAAATAGCAAGTTAAC 8	for max_spacer_dist
Combined GAAGACCCGC GAAACACCGGTCGGCGGTTAGAGCTAGAAATAGCAAGTTAACCTAAGGCT 13 into GAAGACCCGC GAAACACCGGTCGGGGGTTAGAGCTAGAAATAGCAAGTTAACCTAAGGCT 16	for max_spacer_dist
Combined GAAGACCCGC GAAACACCGGTCGGCGGCAATCGGGGTTAGAGCTAGAAATAGCAAGTTAA 20 into GAAGACCCGC GAAACACCGGTCGGCGGCAATCGTGGTTAGAGCTAGAAATAGCAAGTTAA 21	for max_spacer_dist
Combined GACACAGACA GAAACACCGGTAGCAAGTGCGAGCAAGTTGTGGGGTTAGAGCTAGAAATA 9 into GACACAGACA GAAACACCGGTAGCAAGTGCGAGCAAGTTTTGGGGTTAGAGCTAGAAATA 11	for max_spacer_dist
Combined GACACAGACA GAAACACCGGTAGCAAGTGCGGTTAGAGCTAGAAATAGCAAGTTAACCTA 37 into GACACAGACA GAAACACCGGTAGCAAGTGGGGTTAGAGCTAGAAATAGCAAGTTAACCTA 73	for max_spacer_dist
Combined GGCACCCTCC GAACACCGGTGTGGCTGAGAGTCCGGCAATGGTGTGGCTGTGGGGTTAGA 3 into GGCACCCTCC GAAACACCGGTGTGGCTGAGAGTCCGGCAATGGTGTGGCTGTGGGGTTAG 1069	for one base displacement
Combined TAACTTATAC GAAACACCGGTAACTATATTCATGCGATATAGCCGTATGGGGTTAGAGCT 3 into TAACTTATAC GAAACACCGGTAACTATATTCATGCGATATCGCCGTATGGGGTTAGAGCT 5	for max_spacer_dist
Combined TCTATCGAGG GAAACACCGGTTATATTTGTAAGTGTTAGAGCTAGAAATAGCAAGTTAAC 5 into TCTATCGAGG GAAACACCGGTTATATTTGTAAGGGTTAGAGCTAGAAATAGCAAGTTAAC 10	for max_spacer_dist
Combined TTAGCTATGT GAAATACCGGTTACATTGAGTGGGGTTAGAGCTAGAAATAGCAAGTTAAC 3 into TTAGCTATGT GAAACACCGGTTACATTGAGTGGGGTTAGAGCTAGAAATAGCAAGTTAAC 9	for max_spacer_dist
Combined TTAGCTATGT CAAAACACCGGTTACATTGAGGGGTTAGAGCTAGAAATAGCAAGTTAACC 3 into TTAGCTATGT GAAACACCGGTTACATTGAGGGGTTAGAGCTAGAAATAGCAAGTTAACCT 302	for one base displacement
Combined TTAGCTATGT GTGAGGGTTAGAGCTAGAAATAGCAAGTTAACCTAAGGCTAGTCCGTTAT 4 into TTAGCTATGT AGAGGGTTAGAGCTAGAAATAGCAAGTTAACCTAAGGCTAGTCCGTTATC 5	for one base displacement
Combined TTAGCTATGT ATTGAGGGTTAGAGCTAGAAATAGCAAGTTAACCTAAGGCTAGTCCGTTA 5 into TTAGCTATGT AGAGGGTTAGAGCTAGAAATAGCAAGTTAACCTAAGGCTAGTCCGTTATC 9	for one base displacement
processing mutantSample-2-PB7 2020-09-23 11:05:11 
Converted TACACCTGCA to GGCCCCTACAbecause it is a known primer mishybridization result 
Combined AACGCCCTAC CAAAACACCGGTGCCCTTACTCTCACCTGATTACTTAATCCGTGGGGTTA 4 into AACGCCCTAC GAAACACCGGTGCCCTTACTCTCACCTGATTACTTAATCCGTGGGGTTAG 2228	for one base displacement
Combined ACATTCGGTT CAAAACACCGGTCGATTCATATCGAAACCTTCCCGTGACAGTGGGGTTAG 4 into ACATTCGGTT GAAACACCGGTCGATTCATATCGAAACCTTCCCGTGACAGTGGGGTTAGA 1667	for one base displacement
Combined ATGCTTAGCT CAAAACACCGGTTTACGTTGCATCGGTGTGGGGTTAGAGCTAGAAATAGC 7 into ATGCTTAGCT GAAACACCGGTTTACGTTGCATCGGTGTGGGGTTAGAGCTAGAAATAGCA 1744	for one base displacement
Combined CACAACGCCC CAAAACACCGGTTTGAACTAGAAATAGCAAGTTAACCTAAGGCTAGTCCG 3 into CACAACGCCC GAAACACCGGTTTGAACTAGAAATAGCAAGTTAACCTAAGGCTAGTCCGT 804	for one base displacement
Combined CACAACGCCC AGGGCTAGAAATAGCAAGTTAACCTAAGGCTAGTCCGTTATCAACTTGAA 3 into CACAACGCCC GCTAGAAATAGCAAGTTAACCTAAGGCTAGTCCGTTATCAACTTGAAAAA 393	for one base displacement
Combined CACAACGCCC ATTGTGGGGTTAGAGCTAGAAATAGCAAGTTAACCTAAGGCTAGTCCGTT 11 into CACAACGCCC ATGTGGGGTTAGAGCTAGAAATAGCAAGTTAACCTAAGGCTAGTCCGTTA 14	for one base displacement
Combined CACAACGCCC GAACACGGGTTAGAGCTAGAAATAGCAAGTTAACCTAAGGCTAGTCCGTT 4 into CACAACGCCC GAAACACGGGTTAGAGCTAGAAATAGCAAGTTAACCTAAGGCTAGTCCGT 167	for one base displacement
Combined CACAACGCCC GAAATAGCAAGTTAACCTAAGGCTAGTCCGTTATCAACTTGAAAAAGTGG 5 into CACAACGCCC GCTAGAAATAGCAAGTTAACCTAAGGCTAGTCCGTTATCAACTTGAAAAA 396	for one base displacement
Combined CCTTTACCGC GAAACACCGGTCGGGGCCACTAGCAAGTTAACCTAAGGCTAGTCCGTTAC 3 into CCTTTACCGC GAAACACCGGTCGGGGCCACTAGCAAGTTAACCTAAGGCTATTCCGTTAC 4	for max_spacer_dist
Combined CGAATCCTTT GACGAAACACCGGTCTCGAGTGAGGTGTTCAGGGTGGGGTTAGAGCTAGA 3 into CGAATCCTTT GAAACACCGGTCTCGAGTGAGGTGTTCAGGGTGGGGTTAGAGCTAGAAAT 2088	for one base displacement
Combined CGAATCCTTT CAAAACACCGGTCTCGAGTGAGGTGTTCAGGGTGGGGTTAGAGCTAGAAA 5 into CGAATCCTTT GAAACACCGGTCTCGAGTGAGGTGTTCAGGGTGGGGTTAGAGCTAGAAAT 2091	for one base displacement
Combined CGTGTTGTCT GAAACACCGGTGACATTGGGTACAGGGGGATGGGGTTAGAGCTAGAAATA 3 into CGTGTTGTCT GAAACACCGGTGACATTGGGTACAGGGGGGTGGGGTTAGAGCTAGAAATA 7	for max_spacer_dist
Combined CGTGTTGTCT GAAACACCGGTATTGGGTTAGAGCTAGAAATAACAAGTTAACCTAAGGCT 5 into CGTGTTGTCT GAAACACCGGTATTGGGTTAGAGCTAGAAATAGCAAGTTAACCTAAGGCT 11	for max_spacer_dist
Combined CGTGTTGTCT GAACCGGGGTTAGAGCTAGAAATAGCAAGTTAACCTAAGGCTAGTCCGTT 7 into CGTGTTGTCT GAAACGGGGTTAGAGCTAGAAATAGCAAGTTAACCTAAGGCTAGTCCGTT 7	for max_spacer_dist
Combined CGTGTTGTCT GAAACACCGTTGGGGTTAGAGCTAGAAATAGCAAGTTAACCTAAGGCTAG 9 into CGTGTTGTCT GAAACACCGGTGGGGTTAGAGCTAGAAATAGCAAGTTAACCTAAGGCTAG 10	for max_spacer_dist
Combined CGTGTTGTCT GAAACACCGGTGACATTGGGTACAGTTAGAGCTAGAAATAGCAAGTTAAC 9 into CGTGTTGTCT GAAACACCGGTGACATTGGGTACAATTAGAGCTAGAAATAGCAAGTTAAC 25	for max_spacer_dist
Combined CGTGTTGTCT GAAACACCGGTGACATTGGGTACAAGAAATAGCAAGTTAACCTAAGGCTA 10 into CGTGTTGTCT GAAACACCGGTGACATTGGGTACTAGAAATAGCAAGTTAACCTAAGGCTA 26	for max_spacer_dist
Combined CGTGTTGTCT GAAACACCGGTGACGTGGGGTTAGAGCTAGAAATAGCAAGTTAACCTAAG 21 into CGTGTTGTCT GAAACACCGGTGACATGGGGTTAGAGCTAGAAATAGCAAGTTAACCTAAG 44	for max_spacer_dist
Combined CGTGTTGTCT GAAACACCGGTGACATTGGGTATGGGGTTAGAGCTAGAAATAGCAAGTTA 38 into CGTGTTGTCT GAAACACCGGTGACATTGGGTACGGGGTTAGAGCTAGAAATAGCAAGTTA 65	for max_spacer_dist
Combined CGTGTTGTCT GAAACACCGGTGACATTGGGTACAGGGTTAGAGCTAGAAATAGCAAGTTA 43 into CGTGTTGTCT GAAACACCGGTGACATTGGGTACGGGGTTAGAGCTAGAAATAGCAAGTTA 103	for max_spacer_dist
Combined CGTGTTGTCT GAAACACCGGTGACATGGGGTTAGAGCTAGAAATAGCAAGTTAACCTAAG 44 into CGTGTTGTCT GAAACACCGGTGACATTGGGTTAGAGCTAGAAATAGCAAGTTAACCTAAG 115	for max_spacer_dist
Combined CGTGTTGTCT GCTAGTCCGTTATCAACTTGAAAAAGTGGCACCGAGTCGGTGCTTTTTTT 4 into CGTGTTGTCT CTAGTCCGTTATCAACTTGAAAAAGTGGCACCGAGTCGGTGCTTTTTTTC 19	for one base displacement
Combined CGTGTTGTCT GAAACGGGGTTAGAGCTAGAAATAGCAAGTTAACCTAAGGCTAGTCCGTT 14 into CGTGTTGTCT ACCGGGGTTAGAGCTAGAAATAGCAAGTTAACCTAAGGCTAGTCCGTTAT 28	for one base displacement
Combined CGTGTTGTCT GATTGGGGTTAGAGCTAGAAATAGCAAGTTAACCTAAGGCTAGTCCGTTA 25 into CGTGTTGTCT GGTGGGGTTAGAGCTAGAAATAGCAAGTTAACCTAAGGCTAGTCCGTTAT 29	for one base displacement
Combined CGTGTTGTCT GGGTTAGAGCTAGAAATAGCAAGTTAACCTAAGGCTAGTCCGTTATCAAC 17 into CGTGTTGTCT GGTGGGGTTAGAGCTAGAAATAGCAAGTTAACCTAAGGCTAGTCCGTTAT 54	for one base displacement
Combined CGTGTTGTCT ACCGGGGTTAGAGCTAGAAATAGCAAGTTAACCTAAGGCTAGTCCGTTAT 42 into CGTGTTGTCT GGTGGGGTTAGAGCTAGAAATAGCAAGTTAACCTAAGGCTAGTCCGTTAT 71	for one base displacement
Combined CTACTCGGCC GAAACACCGGTACCTTTGTTGATGCTGGGTGGAAGGAGGCTAGAAATAGC 3 into CTACTCGGCC GAAACACCGGTACCTTTGTTGATGCTGGGTGGAAGGAAGCTAGAAATAGC 8	for max_spacer_dist
Combined CTACTCGGCC GAAACACCGGTACCTTTGTTGATGCTGGGTGGAAGAGCTAGAAATAGCAA 6 into CTACTCGGCC GAAACACCGGTACCTTTGTTGATGCTGGGTGGAAGGGCTAGAAATAGCAA 21	for max_spacer_dist
Combined CTACTCGGCC GAAACACCGGTACCTTTGTTGATGCTGGGTGGAAGGAGTGGGGTTAGAGC 7 into CTACTCGGCC GAAACACCGGTACCTTTGTTGATGCTGGGTGGAAGGAATGGGGTTAGAGC 25	for max_spacer_dist
Combined CTACTCGGCC CAAAACACCGGTACCTTTGTTGATGCTGGTTGTGGGGTTAGAGCTAGAAA 5 into CTACTCGGCC GAAACACCGGTACCTTTGTTGATGCTGGTTGTGGGGTTAGAGCTAGAAAT 9	for one base displacement
Combined GAAGACCCGC GAAACACCGGTCGGCGGCAATCGTGGAGCTAGAAATAGCAAGTTAACCTA 4 into GAAGACCCGC GAAACACCGGTCGGCGGCAATCGTGGGGCTAGAAATAGCAAGTTAACCTA 11	for max_spacer_dist
Combined GAAGACCCGC GAAACACCGGTCGGCGGCAGGGGTTAGAGCTAGAAATAGCAAGTTAACCT 8 into GAAGACCCGC GAAACACCGGTCGGCGGCTGGGGTTAGAGCTAGAAATAGCAAGTTAACCT 11	for max_spacer_dist
Combined GAAGACCCGC GAAACACCGGTCGGCGGGTGGGGTTAGAGCTAGAAATAGCAAGTTAACCT 9 into GAAGACCCGC GAAACACCGGTCGGCGGCTGGGGTTAGAGCTAGAAATAGCAAGTTAACCT 19	for max_spacer_dist
Combined GAAGACCCGC GAAACACCGGTCGGTGGGGTTAGAGCTAGAAATAGCAAGTTAACCTAAGG 17 into GAAGACCCGC GAAACACCGGTCGGCGGGGTTAGAGCTAGAAATAGCAAGTTAACCTAAGG 50	for max_spacer_dist
Combined GAAGACCCGC GAAACACCGGTCGTGGGGTTAGAGCTAGAAATAGCAAGTTAACCTAAGGC 18 into GAAGACCCGC GAAACACCGGTCGGGGGGTTAGAGCTAGAAATAGCAAGTTAACCTAAGGC 19	for max_spacer_dist
Combined GACACAGACA GAAACGTTAACCTAAGGCTAGTCCGTTATCAACTTGAAAAAGTGGCACCG 8 into GACACAGACA GAAACGTTAACCTAAAGCTAGTCCGTTATCAACTTGAAAAAGTGGCACCG 13	for max_spacer_dist
Combined GGCACCCTCC CAAAACACCGGTGTGGCTGAGAGTCCGGCAATGGTGTGGCTGTGGGGTTA 3 into GGCACCCTCC GAAACACCGGTGTGGCTGAGAGTCCGGCAATGGTGTGGCTGTGGGGTTAG 2118	for one base displacement
Combined GTGGAGCCTC CAAAACACCGGTTCCCGTCCAGTGGGGTTAGAGCTAGAAATAGCAAGTTA 7 into GTGGAGCCTC GAAACACCGGTTCCCGTCCAGTGGGGTTAGAGCTAGAAATAGCAAGTTAA 2603	for one base displacement
Combined TCTATCGAGG GAGACACCGGTTATATTTGTTAGAGCTAGAAATAGCAAGTTAACCTAAGG 4 into TCTATCGAGG GAAACACCGGTTATATTTGTTAGAGCTAGAAATAGCAAGTTAACCTAAGG 4	for max_spacer_dist
Combined TCTATCGAGG GAAACACCGGTTAGGGGTTAGAGCTAGAAATAGCAAGTTAGCCTAAGGCT 5 into TCTATCGAGG GAAACACCGGTTAGGGGTTAGAGCTAGAAATAGCAAGTTAACCTAAGGCT 8	for max_spacer_dist
Combined TCTATCGAGG GGAACACCGGTTAGGGGTTAGAGCTAGAAATAGCAAGTTAACCTAAGGCT 7 into TCTATCGAGG GAAACACCGGTTAGGGGTTAGAGCTAGAAATAGCAAGTTAACCTAAGGCT 13	for max_spacer_dist
Combined TCTATCGAGG CAAAACACCGGTTATATTTGTAAGTGTGTGGGGTTAGAGCTAGAAATAGC 4 into TCTATCGAGG GAAACACCGGTTATATTTGTAAGTGTGTGGGGTTAGAGCTAGAAATAGCA 1563	for one base displacement
Combined TTAGCTATGT GAAACATTGGGGTTAGAACTAGAAATAGCAAGTTAACCTAAGGCTAGTCC 4 into TTAGCTATGT GAAACATTGGGGTTAGAGCTAGAAATAGCAAGTTAACCTAAGGCTAGTCC 11	for max_spacer_dist
Combined TTAGCTATGT GAAACACCGGTTACGGGTTAGAGCTAGAAATAGCAAGTTAACCTAAGGCT 8 into TTAGCTATGT GAAACACCGGTTAAGGGTTAGAGCTAGAAATAGCAAGTTAACCTAAGGCT 9	for max_spacer_dist
Combined TTAGCTATGT GAACGGGGTTAGAGCTAGAAATAGCAAGTTAACCTAAGGCTAGTCCGTTA 5 into TTAGCTATGT ATTGGGGTTAGAGCTAGAAATAGCAAGTTAACCTAAGGCTAGTCCGTTAT 18	for one base displacement
Combined TTAGCTATGT ATTGGGGTTAGAGCTAGAAATAGCAAGTTAACCTAAGGCTAGTCCGTTAT 23 into TTAGCTATGT GGGTTAGAGCTAGAAATAGCAAGTTAACCTAAGGCTAGTCCGTTATCAAC 41	for one base displacement
Combined TTAGCTATGT GATAGAGCTAGAAATAGCAAGTTAACCTAAGGCTAGTCCGTTATCAACTT 8 into TTAGCTATGT GGGTTAGAGCTAGAAATAGCAAGTTAACCTAAGGCTAGTCCGTTATCAAC 64	for one base displacement
Combined TTGAGCATAA GAAACACCGGTTAAGCCGAGGTGGGGTTAGAGCTAGAAATAGCAAGTTAA 18 into TTGAGCATAA GAAACACCGGTTAAGCCGAGGAGGGGTTAGAGCTAGAAATAGCAAGTTAA 23	for max_spacer_dist
Combined TTGAGCATAA CAAAACACCGGTTAAGCCGAGGAGTTAGAGCTAGAAATAGCAAGTTAACC 4 into TTGAGCATAA GAAACACCGGTTAAGCCGAGGAGTTAGAGCTAGAAATAGCAAGTTAACCT 850	for one base displacement
processing mutantSample-3-PB7 2020-09-23 11:05:13 
Converted TACACCTGCA to GGCCCCTACAbecause it is a known primer mishybridization result 
Combined AGACCCTCGC CAAAACACCGGTGCATTCGAAAGTCCGGTCGTAGTGTGGACGTGGGGTTA 4 into AGACCCTCGC GAAACACCGGTGCATTCGAAAGTCCGGTCGTAGTGTGGACGTGGGGTTAG 1520	for one base displacement
Combined ATGCTTAGCT GAAACACCGGTTTACCTAGAAATAGCAAGTTAACCTAAGGCTAGTCCGTT 5 into ATGCTTAGCT GAAACACCGGTTTAGCTAGAAATAGCAAGTTAACCTAAGGCTAGTCCGTT 7	for max_spacer_dist
Combined ATGCTTAGCT GAAACACCGGTTTACGTTGGGTTAGAGCTAGAAATAGCAAGTTAACCTAA 7 into ATGCTTAGCT GAAACACCGGTTTACGTGGGGTTAGAGCTAGAAATAGCAAGTTAACCTAA 10	for max_spacer_dist
Combined CATCGTCGTC CAAAACACCGGTGTACGTATGGACTGAACCAGGGTGTGCAAGTGGGGTTA 5 into CATCGTCGTC GAAACACCGGTGTACGTATGGACTGAACCAGGGTGTGCAAGTGGGGTTAG 1638	for one base displacement
Combined CGAATCCTTT GAAACACCGGTCTCGAGTGAGGTTAGAGCTAGAAATAGCAAGTTAACCTA 15 into CGAATCCTTT GAAACACCGGTCTCGAGTGGGGTTAGAGCTAGAAATAGCAAGTTAACCTA 29	for max_spacer_dist
Combined CGAATCCTTT CAAAACACCGGTCTCGAGTGAGGTGTTCAGGGTGGGGTTAGAGCTAGAAA 3 into CGAATCCTTT GAAACACCGGTCTCGAGTGAGGTGTTCAGGGTGGGGTTAGAGCTAGAAAT 1843	for one base displacement
Combined CGTGTTGTCT GAAACACCGGTGACATTGGGTTTTAGAAATAGTAAGTTAACCTAAGGCTA 3 into CGTGTTGTCT GAAACACCGGTGACATTGGGTTTTAGAAATAGCAAGTTAACCTAAGGCTA 12	for max_spacer_dist
Combined CGTGTTGTCT GAAACACCGGTGACATTGGGTACGAAATAGCAAGTTAACCTAAGGCTAGT 4 into CGTGTTGTCT GAAACACCGGTGACATTGGGTACGGAATAGCAAGTTAACCTAAGGCTAGT 5	for max_spacer_dist
Combined CGTGTTGTCT GAAACACCGGTGACATTGGGTAGGGGGTTAGAGCTAGAAATAGCAAGTTA 7 into CGTGTTGTCT GAAACACCGGTGACATTGGGTATGGGGTTAGAGCTAGAAATAGCAAGTTA 10	for max_spacer_dist
Combined CGTGTTGTCT GAAACACCGGTGACATTGGGTATGGGGTTAGAGCTAGAAATAGCAAGTTA 10 into CGTGTTGTCT GAAACACCGGTGACATTGGGTGTGGGGTTAGAGCTAGAAATAGCAAGTTA 26	for max_spacer_dist
Combined CGTGTTGTCT GAAGGTGGGGTTAGAGCTAGAAATAGCAAGTTAACCTAAGGCTAGTCCGT 5 into CGTGTTGTCT GTGGGGTTAGAGCTAGAAATAGCAAGTTAACCTAAGGCTAGTCCGTTATC 31	for one base displacement
Combined CGTGTTGTCT CCGTGGGGTTAGAGCTAGAAATAGCAAGTTAACCTAAGGCTAGTCCGTTA 15 into CGTGTTGTCT GTGGGGTTAGAGCTAGAAATAGCAAGTTAACCTAAGGCTAGTCCGTTATC 36	for one base displacement
Combined CGTGTTGTCT GGGTTAGAGCTAGAAATAGCAAGTTAACCTAAGGCTAGTCCGTTATCAAC 3 into CGTGTTGTCT GTGGGGTTAGAGCTAGAAATAGCAAGTTAACCTAAGGCTAGTCCGTTATC 51	for one base displacement
Combined CTACTCGGCC GAAACACCGGTACCTTTGTTGATGCTGGGGTGGGGTTAGAGCTAGAAATA 9 into CTACTCGGCC GACACCGGTACCTTTGTTGATGCTGGGGTGGGGTTAGAGCTAGAAATAGC 10	for one base displacement
Combined GAAGACCCGC GAAACAGGGTTAGAGCTAGAAATAGCAAGTTAACCTAAGGCTAGTCCGTT 3 into GAAGACCCGC GAAACACGGTTAGAGCTAGAAATAGCAAGTTAACCTAAGGCTAGTCCGTT 10	for max_spacer_dist
Combined GAAGACCCGC GAAACACCGGTCGGCGGCAATCTTTAGAGCTAGAAATAGCAAGTTAACCT 7 into GAAGACCCGC GAAACACCGGTCGGCGGCAATCGTTAGAGCTAGAAATAGCAAGTTAACCT 25	for max_spacer_dist
Combined GAAGACCCGC GAAACACCGGTCGGCGGCAGTGGGGTTAGAGCTAGAAATAGCAAGTTAAC 11 into GAAGACCCGC GAAACACCGGTCGGCGGCAATGGGGTTAGAGCTAGAAATAGCAAGTTAAC 14	for max_spacer_dist
Combined GAAGACCCGC GAAACACCGGTCGGTGGGGTTAGAGCTAGAAATAGCAAGTTAACCTAAGG 30 into GAAGACCCGC GAAACACCGGTCGGCGGGGTTAGAGCTAGAAATAGCAAGTTAACCTAAGG 35	for max_spacer_dist
Combined GAAGACCCGC CAAAACACCGGTCGGCGGCAATCGTGGGTGGGGTTAGAGCTAGAAATAGC 4 into GAAGACCCGC GAAACACCGGTCGGCGGCAATCGTGGGTGGGGTTAGAGCTAGAAATAGCA 735	for one base displacement
Combined GACACAGACA GAACACCGGTAGCAAGTGCGAGACGTGTTAGAGCTAGAAATAGCAAGTTA 4 into GACACAGACA GAAACACCGGTAGCAAGTGCGAGACGTGTTAGAGCTAGAAATAGCAAGTT 40	for one base displacement
Combined GTGGAGCCTC CAAAACACCGGTTCCCGTCCAGTGGGGTTAGAGCTAGAAATAGCAAGTTA 3 into GTGGAGCCTC GAAACACCGGTTCCCGTCCAGTGGGGTTAGAGCTAGAAATAGCAAGTTAA 1475	for one base displacement
Combined TCTATCGAGG GAAACACCGGTTATATTTGTAATGGGGTTAGAGCTAGAAATAGCAAGTTA 5 into TCTATCGAGG GAAACACCGGTTATATTTGTAGTGGGGTTAGAGCTAGAAATAGCAAGTTA 22	for max_spacer_dist
Combined TTAGCTATGT GAAACACCGGTTATTGGGGTTAGAGCTAGAAACAGCAAGTTAACCTAAGG 3 into TTAGCTATGT GAAACACCGGTTATTGGGGTTAGAGCTAGAAATAGCAAGTTAACCTAAGG 11	for max_spacer_dist
Combined TTAGCTATGT GATGAGGGTTAGAGCTAGAAATAGCAAGTTAACCTAAGGCTAGTCCGTTA 4 into TTAGCTATGT GTGAGGGTTAGAGCTAGAAATAGCAAGTTAACCTAAGGCTAGTCCGTTAT 13	for one base displacement
Combined TTGAGCATAA GAAACAAACAGCAAGTTAACCTAAGGCTAGTCCGTTATCAACTTGAAAAA 4 into TTGAGCATAA GAAACAAATAGCAAGTTAACCTAAGGCTAGTCCGTTATCAACTTGAAAAA 10	for max_spacer_dist
