CTATCCACCC	GAAACACCGGTACCTTTGTTGATGCTGGGTGGATAGGAATTCGGGCCCAT	35	bc
CTCCCCTGCA	GAAACACCGGTGTGGCTGAGAGTCCGGCAATGGTGTGGCTGTGGGGTTAG	11	bc
AAGAACCTCG	GAAACACCGGTGCATTCGAAAGTCCGGTCGTAGTGTGGACGTGGGGTTAG	6	bc
AACTTTACCG	GAAACACCGGTCGGGGCCACTCAGTGGTGGGGTTAGAGCTAGAAATAGCA	5	bc
ACGAATCATT	GAAACACCGGTCTCGAGTGAGGTGTTCAGGGTGGGGTTAGAGCTAGAAAT	5	bc
ACCTTTAACG	GAAACACCGGTCGGGGCCACTCAGTGGTGGGGTTAGAGCTAGAAATAGCA	4	bc
ACGACTCCTT	GAAACACCGGTCTCGAGTGAGGTGTTCAGGGTGGGGTTAGAGCTAGAAAT	4	bc
AAGACACTCG	GAAACACCGGTGCATTCGAAAGTCCGGTCGTAGTGTGGACGTGGGGTTAG	4	bc
AGGCCACTAC	GAAACACCGGTAAATTTGAGGCTCCGGCATGCAGGAGGCCGTGGGGTTAG	4	bc
GACTTTACCG	GAAACACCGGTCGGGGCCACTCAGTGGTGGGGTTAGAGCTAGAAATAGCA	4	bc
TCGCCCTGCA	GAAACACCGGTGCATTCGAAAGTCCGGTCGTAGTGTGGACGTGGGGTTAG	4	bc
AAGTCTGACT	GAAACACCGGTCCGTAGGAGACCCGTGTGGCATGTACCTGTGGGGTTAGA	3	bc
ACATAGTCGT	GAAACACCGGTGTACGTATGGACTGAACCAGGGTGTGCAAGTGGGGTTAG	3	bc
TCGAATACTT	GAAACACCGGTCTCGAGTGAGGTGTTCAGGGTGGGGTTAGAGCTAGAAAT	3	bc
ACATTTACCG	GAAACACCGGTCGGGGCCACTCAGTGGTGGGGTTAGAGCTAGAAATAGCA	3	bc
ACCGACATAC	GAAACACCGGTGCCCTTACTCTCACCTGATTACTTAATCCGTGGGGTTAG	3	bc
ACTACTAGGC	GAAACACCGGTACCTTTGTTGATGCTGGGTGGAAGGAATTTGTGGGGTTA	3	bc
AAAATTCGGT	GAAACACCGGTCGATTCATATCGAAACCTTCCCGTGACAGTGGGGTTAGA	3	bc
AATGATTAGC	GAAACACCGGTTTACGTTGCATCGGTGTGGGGTTAGAGCTAGAAATAGCA	3	bc
GGCATCTAAA	GAAACACCGGTAAATTTGAGGCTCCGGCATGCAGGAGGCCGTGGGGTTAG	2	bc
AAGTCTGCGT	GAAACACCGGTCCGTAGGAGACCCGTGTGGCATGTACCTGTGGGGTTAGA	2	bc
CTAACCACCC	GAAACACCGGTACCTTTGTTGATGCTGGGTGGTTAGGAATTCGGGCCCAT	2	bc
AAACGACCTA	GAAACACCGGTGCCCTTACTCTCACCTGATTACTTAATCCGTGGGGTTAG	2	bc
AAAAGCACTA	GAAACACCGGTGCCCTTACTCTCACCTGATTACTTAATCCGTGGGGTTAG	2	bc
AGGCAACCTC	GAAACACCGGTGTGGCTGAGAGTCCGGCAATGGTGTGGCTGTGGGGTTAG	2	bc
ACCTTTATCG	GAAACACCGGTCGGGGCCACTCAGTGGTGGGGTTAGAGCTAGAAATAGCA	2	bc
ACACAACGAC	GAAACACCGGTTTGAACTACCTAGTTCAAACCGGTGGGGTTAGAGCTAGA	2	bc
ATAGCTTATA	GAAACACCGGTAACTATATTCATGCGATATCGCCGTATCAGTGGGGTTAG	2	bc
TAACGGCCTA	GAAACACCGGTGCCCTTACTCTCACCTGATTACTTAATCCGTGGGGTTAG	2	bc
GCGTCGCCCT	GAAACACCGGTGTCCGCTGCCGGCTCCATTGTGGGGTTAGAGCTAGAAAT	2	bc
ATACCAACGC	GAAACACCGGTGCATTCGAAAGTCCGGTCGTAGTGTGGACGTGGGGTTAG	2	bc
GCGAATCGTT	GAAACACCGGTCTCGAGTGAGGTGTTCAGGGTGGGGTTAGAGCTAGAAAT	2	bc
AACATTCGGA	GAAACACCGGTCGATTCATATCGAAACCTTCCCGTGACAGTGGGGTTAGA	2	bc
ACACCGTCGT	GAAACACCGGTGTACGTATGGACTGAACCAGGGTGTGCAAGTGGGGTTAG	2	bc
TAATCGTCGT	GAAACACCGGTGTACGTATGGACTGAACCAGGGTGTGCAAGTGGGGTTAG	2	bc
AGGCACACTC	GAAACACCGGTGTGGCTGAGAGTCCGGCAATGGTGTGGCTGTGGGGTTAG	2	bc
ACACAACGCA	GAAACACCGGTTTGAACTAGAAATAGCAAGTTAACCTAAGGCTAGTCCGT	2	bc
AAATTTACCG	GAAACACCGGTCGGGGCCACTCAGTGGTGGGGTTAGAGCTAGAAATAGCA	2	bc
TAGAATCCTT	GAAACACCGGTCTCGAGTGAGGTGTTCAGGGTGGGGTTAGAGCTAGAAAT	2	bc
ACACAACGCG	GAAACACCGGTTTGAACTAGAAATAGCAAGTTAACCTAAGGCTAGTCCGT	2	bc
AGCAGACCCG	GAAACACCGGTCGGCGGCAATCGTGGGTGGGGTTAGAGCTAGAAATAGCA	2	bc
TAAAGCCCTA	GAAACACCGGTGCCCTTACTCTCACCTGATTACTTAATCCGTGGGGTTAG	2	bc
GGTGGAGACT	GAAACACCGGTTCCCGTCCAGTGGGGTTAGAGCTAGAAATAGCAAGTTAA	2	bc
AGGCACTCTC	GAAACACCGGTGTGGCTGAGAGTCCGGCAATGGTGTGGCTGTGGGGTTAG	2	bc
AAACAACGCC	GAAACACCGGTTTGAACTAGAAATAGCAAGTTAACCTAAGGCTAGTCCGT	2	bc
ATTAGATATG	GAAACACCGGTTACATTGAGGGTTAGAGCTAGAAATAGCAAGTTAACCTA	2	bc
ACCTCGTCGT	GAAACACCGGTGTACGTATGGACTGAACCAGGGTGTGCAAGTGGGGTTAG	2	bc
GCCTTTACTG	GAAACACCGGTCGGGGCCACTCAGTGGTGGGGTTAGAGCTAGAAATAGCA	2	bc
AGTGGCGCCT	GAAACACCGGTTCCCGTCCAGTGGGGTTAGAGCTAGAAATAGCAAGTTAA	2	bc
ACACAGCGCC	GAAACACCGGTTTGAACTAGAAATAGCAAGTTAACCTAAGGCTAGTCCGT	2	bc
GAGTATGCCT	GAAACACCGGTCCGTAGGAGACCCGTGTGGCATGTACCTGTGGGGTTAGA	2	bc
ACCTTGACCG	GAAACACCGGTCGGGGCCACTCAGTGGTGGGGTTAGAGCTAGAAATAGCA	2	bc
AATGTTTAGC	GAAACACCGGTTTACGTTGCATCGGTGTGGGGTTAGAGCTAGAAATAGCA	2	bc
ACATAGGCGT	GAAACACCGGTGTACGTATGGACTGAACCAGGGTGTGCAAGTGGGGTTAG	2	bc
TCGAATCATT	GAAACACCGGTCTCGAGTGAGGTGTTCAGGGTGGGGTTAGAGCTAGAAAT	2	bc
AGTGGAGCGT	GAAACACCGGTTCCCGTCCAGTGGGGTTAGAGCTAGAAATAGCAAGTTAA	2	bc
AAGTATGCCT	GAAACACCGGTCCGTAGGAGACCCGTGTGGCATGTACCTGTGGGGTTAGA	2	bc
AGTGGATCCT	GAAACACCGGTTCCCGTCCAGTGGGGTTAGAGCTAGAAATAGCAAGTTAA	2	bc
ACAACTTATA	GAAACACCGGTAACTATATTCATGCGATATCGCCGTATCAGTGGGGTTAG	2	bc
GGACTCATCC	GATACACCGGTGTGGCTGAGAGTCCGGCAATGGTGTGGCTGTGGGGTTAG	1	bc
TGAATCGCGG	GAAACACCGGTTATATTTGTAAGCGGGTGGGGTTAGAGCTAGAAATAGCA	1	bc
ACTAGCGTGG	AAACAACTTGAAAAAGTGGCACCGAGTCGGTGCTTTTTTTCCTGCAGGCC	1	bc
ATAGCCGCTC	GAAACACCGGTTCCCGTCCAGTGGGGTTAGAGCTAGAAATAGCAAGTTAA	1	bc
TTAACGTATA	GAAACACCGGTAACTATATTCATGCGATATCACCGTATCAGTGGGGTTAG	1	bc
GAGACGGTCG	GAAACACCGGTGCATTCGAAAGTCCGGTCGTAGTGTGGACGTGGGGTTAG	1	bc
CACATCGTCG	GAAACACCGGTGTACGTATAGACCGAACCAGGGTGTGCAAGTGGGGTTAG	1	bc
GCGGACACTT	GAAACACCGGTTCCCGTCCAGTGGGGTTAGAGCTAGAAATAGCAAGTTAA	1	bc
AAGGGTCCTG	GAAACACCGGTCAGTAGGAAACGCTTGCTGTTGTGGGGTTAGATCTAGAA	1	bc
ATAAGACAAC	GAAACACCGGTCGGCGGCAATCGAGGGTGGGGTTAGAGCTAGAAATAGCA	1	bc
GAAAAAGAAA	GAAACACCGGTAGCAAGTGCGAGACGTGTTAACGCTATTTCTAGCTCTAA	1	bc
AGACGGCCTT	GAAACACCGGTCCGTAGGAGACCCGTGTGGCATGTACCTGTGGGGTTAGA	1	bc
ACTACTCTGC	GAAACACCGGTACCTTTGTTGATGCTGGGTGGAAGGAATTTGTGGTGTTA	1	bc
AAGTCTGTCT	GAAACACCGGTCCGTAGGAGACCCGTGTGGCATGTACCTGTGGGGTTAGA	1	bc
ACAAAATCGC	GAAACACCGGTTCATTTGAAAGTCCGGTCGTAGTGTGGACGTGGGGATAG	1	bc
GTACCACACA	GAAGCACCGGTAAATTTGAGGCTCCGGCATGCAGGAGGCCGTGGGGTTAG	1	bc
ATAACTCTGT	GAAACACCGGTTATTTGAGGGTTAGAGCTAGAAGTAGCAAGTTAACCTAA	1	bc
GGAGGAGCCT	GAAACACCGGTTCCCGTCCAGTGGGGTTAGAGCTAGAAATAGCAAGTTAA	1	bc
GCTGCTCGGC	GAAACACCGGTACCTTTGTTGATGCTGGGTGGGAGCTAGAAATAGCAAGT	1	bc
AGGAACCCTC	GAAACACCGGTGTGGCTGAGAGTCCGGCAATGGTGTGGCTGTGGGGTTAG	1	bc
GGAAGTCCGG	GAAACACCGGTCGGCGGCAATCGTTAGAGCTAGAAATAGCTAGAAATAGC	1	bc
GACAATGACC	GAAACACCGGTTTGAACTAGAAATAGCAAGTTAACCTAAGGCTAGTCCGT	1	bc
CGAAGCCCTA	GAAAAACCGGTCTCGAGTGAGGTGTTCAGGGTGGGGTTAGAGCTAGAAAT	1	bc
ATTGAGAATA	GAAACACCGGTTAAGCCGAGTGGGGTTAGAGCTAGAAATAGCAAGTTAAC	1	bc
TAGTGTAGTC	GAAACACCGGTGACATTGGGAGCAAGTTAACCTAAGGCTAGTCCGTTATC	1	bc
CCTATCGTGC	GAAACACCGGTTATATTTGTAAGTGTGTGGGGTTAGAGCTAGAAATAGCA	1	bc
CTGAAGGCCC	GAAACACCGGTTTCAACTAGAAATAGCAAGTTAAACTAAGGCTAGTCCGT	1	bc
AAAGTTCGGT	GAAACACCGGTCGATTCATATCGAAACCTTCCCGTGACAGTGGGGTTAGA	1	bc
TTCTTGAACG	GAAACACCGGTCGGGGCCACTCAGTGGTGGAGTTAGAGCTAGAAATAGCA	1	bc
ACCAGGAGGG	GAAACACCGGTCGTTTCTTATCGAAACCTTCGCTTGACAATAGAGTGCAA	1	bc
ACATAACGCC	GAAACACCGGTTTGAACTACCGGGGTTAGAGCTAGAAATAGCAAGTTAAC	1	bc
AATATGGCTC	GAAACACCGGTCCGTAGGAGACCCGTGTGGCATGTACTTGTGGGGTTAGA	1	bc
TACAGAGGCC	GAAACACCGGTAAATTTGAGGCTCCGGCATGCAGGAGGCCGTGGGGTTAG	1	bc
ACCAACATAC	GAAACACCGGTTCCCTTACTCTCACCTGATTGCTTAATCTGTGAATATAG	1	bc
ATGATAATCT	GAAACACCGGTTTACGTTGCATCGGTGTGGGGTTAGAGCTAGAAATAGCA	1	bc
AAGTCTGCAT	GAAACACCGGTCCGTAGGAGACCCGTGTGGCATGTACCCGTGGGGTTAGA	1	bc
CGAAACCTGC	GAAACACCGGTCGCGAGCGAGCGGGTCAGGAGGTGGTAGTGCTAGAAATA	1	bc
CTACTGGGTA	GAAACACCGGTACCTTTGTTGATGCTGGGTGGAAGGAATTTGTGGGGTTA	1	bc
GCTGGTGGCT	GAAACACCGGTACCTTTGTTGAGGCTGTGGGGGTATAGAGCGAGAGATAG	1	bc
TCTCCTCGGC	GAAACACCGGTACCTTTGTTGATGCTGGGTGGTGGGGTTAGAGCTAGAAA	1	bc
GTCTATCGTG	GAAACACCGGTTATATTTGTAAGTGTGTGGGGTCAGAGCTAGAAATAGCA	1	bc
GAGTCTGGCT	GAAACACCGGTCCGTAGGAGACCCGTGTGGCATGTACCTGTGGGGTTAGA	1	bc
CGCCTCAGGC	GAAACAACGGTGCATTCGAGAGTCCGGTCGTAGTGTGGAAGTGGGGTTAG	1	bc
AATGTCCGCT	GAAACACCGGTTTACTTAGCATCAGTTGGGGGTTAGATCTGGAAATATCA	1	bc
AATCAGCCCC	GAAACACCGGTCCGTAGGAGACCCGTGTGGCATGTACCTGTGGGGGTAGA	1	bc
GTTATCTATG	GAAACACCGGTTACATTGAGATTAGAGCTAGAAAAGGCTAGTCCGTTATC	1	bc
AGTATAAGTC	GAAACACCGGTGTACGTATGGACTGAACCAGGGTGTGCAAGTGGGGTTAG	1	bc
CTACTGGGAA	GAAACACCGGTACCTTTGTTGATGCTGGGTGGGGTTAGAGCTAGAAATAG	1	bc
AAGAGTAGGG	GAAACACCGGTCGATTCATATCGAAACCTTCCCGTGACAGTGGGGTTAGA	1	bc
ATGCTCATAA	GAAACACCGGTTAAGCCGAGTGGGGTTAGAGCTTGAGATAGCAAGTTAAC	1	bc
CTAGTCGTGC	GAAACACCGGTACCTTAGAGCTAGAAATAGCAATTTAGCCTAAGGCTAGT	1	bc
GAGACCCTTG	GAAACACCGGTGCATTCGAAAGTCCGGTCGTAGTGTGGACGTGGGGTTAG	1	bc
CATAGCCTTA	GAAACACCGGTCTACGTATCCACTGACCCAGGGGGTGCAAAGTGGGGTTA	1	bc
TCCACTCTAT	GAAACACCGGTTATATTTGTAAGTGTGTGGGGTTAGAGCTAGAAATAGCA	1	bc
CACGCAATCC	GAAACACCGGTAGCAATACTGTCACGTGTTTACTTAATTAGAGCGGTTAA	1	bc
ATGCTAATAA	GAAACACCGGTTAAGCCGAGGGTTTAGAGCTAGAAATAGCAAGTTAACCT	1	bc
ATTGGAGGCT	GAAACACCGGTTCCCGTCCAGTGGGGTTAGAGCTAGAAATAGCAAGTTAG	1	bc
CCTTTAACTA	GAAACACCGGTCGGGGCCACTCAGTGGTGGGGTTAGAGCTAGAAATAGCA	1	bc
GCAGAACGGC	GAAACACCGGTCGGCGGCAATCGTGGGTGGGGTTAGAGCTAGAAATAGCA	1	bc
AGAAGTCCCG	GAAACACCGGTCGGCGGCTAGAAATAGCAAGTTAACCTAAGGCTAGTCCG	1	bc
GCAAGCCGGT	GAAACACCGGTCGGCGGCCATCGGCGGTGGGGCTAGAGCTGGAAATAGCG	1	bc
CCCCTCGCCC	GAAACACCGGTTTGAACTAGAAATAGCAAGTTAACCTAAGGCTAGTCCGT	1	bc
CGTTGACTGC	GAAACACCGGTCTTGGTTATAGCTAGGAATAGCTAGTTAACCTAAGGCTA	1	bc
GAGGATTAGC	GAAACACCGGTTTACAAGTTAACCTAAGGCTAGTCCGTTATCAACTTGAA	1	bc
GTGGTGGATC	GAAACACCGGTTCCCGTCCAGTGGGGTTAGAGCTAGAAATAGCAAGATAA	1	bc
AGGCCGCCGC	GAAACACCGGTGTGGCTGAGAGTCCGGCAATGGTGTGGCTGTGGGGTTAG	1	bc
GGGGGGCCAC	GAAACACCGGTTCCCGTCCAGTGGGGCTAGAGCTAGAAATAGCAAGTTAA	1	bc
AAAATTCGGT	GAAACACCGGTCGATTCATATCGAAGCCTTCCCGTGACAGTGGGGTTAGA	1	bc
GAAGCGCCGA	GAAACACCGGTCGGCGGTGGGGTTAGAGCCAGAAATAGCAAGTTAACCTA	1	bc
AGACAACGCC	GAAACACCGGTAGCAAGTGCGTGGGGTTAGAGCTAGAAATAGCAAGTTAA	1	bc
ATTATCCTTA	GAAACACCGGTTAAGCCGAGAGGGGTTAGAGCTATACATAGCAAGTTAAC	1	bc
GCAACTGATT	GAAACACCGGTAGCAAGTGCGAGACGTGTTGGTGGGGTTAGAGCTAGAAA	1	bc
GCTAACGAGT	GAAACACCGGTTATATTTGTAAGTGTGTGGGGTTAGAGCTAGAAATAGCA	1	bc
TAACGCCTTT	GAAACACCGGTGCCCTTACTCTCACCTGATTACTTAATCCGTGGGGTTAG	1	bc
GGAAACTACG	GAAACACCGGTAAATTTGAGGCTCCGGCATGCAGGAGGCCGTGGGGTTAG	1	bc
ACCTTTAACG	GAAACACCGGTCGGAGCCACTCAGTGGTGGGGTTAGAGCTAGAAATAGCA	1	bc
GGTCTGTACC	GAAACACCGGTAAATTTGAGACCCCGGCATGCAGGACGCCGTGGGGTTAG	1	bc
ATGAGCTATG	GAAACACCGGTTACATTGAGGGTTAGAGCTAGAAATAGCAAGTTAACCTA	1	bc
GTTTTCCCGT	GAAACACCGGTCGGGGCCACTCACGAGTGGGGTTAGAGCTAGAAATAGCA	1	bc
ACCACTCGGC	GAAACACCGGTACCTTTGTTGATGCTGGGTGGGGTTAGAGCTAGAAATAG	1	bc
TTGAGCGGCA	GAAACACCGGTTAAGCCGAGGGTTAGAGCTAGAAATAGCAAGTTAACCTA	1	bc
AAATGTCCTA	GAAACACCGGTGCCCTTACTCTCACCTGATTACTTAATCCGTGGGGTTAG	1	bc
GTGGCCCCGC	GAAACACCGGTCGGCGGCAATCGTGGGTGGGGTTAGAGCTAGAAATAGCA	1	bc
AGACGGCCTA	GAAACACCGGTCCGTAGGAGACCCGTGTGGCATGTACCTGTGGGGTTAGA	1	bc
ACCCCACCTC	GAAACACCGGTCCGTAGGAGACCCGTGTGGCATGTACCTGTGGGGTTAGA	1	bc
GCCAACTACA	GAAACACCGGTAAATTTGAGGCTCCGGCATGCAGAAGGCCGTGGGGTTAG	1	bc
CGAGTTGAAT	GAAACACCGGTGACATTGGGTAGTGGGGTTAGAGCTAGAAATAGCAAGTT	1	bc
GGGCCTCTAC	GAAACACCGGTAAATTTGAGGCTCCGGCATGCAGGAGGCCGTGGGGTTAG	1	bc
TACGCCATAT	GAAACACCGGTTCCCTTACTCTCACCTGATTACCTAATCCGTGGGGTTAG	1	bc
CTATCCACCC	GAAACACCGGTTCATTTGATAGCTATGGATGGAAAGGAAATCGAGCCCTT	1	bc
AGACACAGGC	GTAGAAATAGCAAGTTAACCTAAGGCTAGTCCGTTATCAACTTGAAAAAG	1	bc
GTACCTAAGA	GAAACACCGGTTACATTAAGTGTTAGAGCTGGAAATAGCTAGTTATACTA	1	bc
GGCGCCATTA	GAAACACCGGTGTGGCTGAGAGTCCGGCAATGGTGTGGCTGTGGGGTTAG	1	bc
CGTGTACTTT	GAAACACCGGTCTCGAGTGAGGTGTTCAGGGTGGGGTTAGAGCTAGAGAT	1	bc
GTGACCATAC	GAAACACCGATTAAGCTGAGTGGGGTTAGAGCTAGAAACAGCAAGTTAAC	1	bc
CACACTGCCT	GAAACACCGGTTTGAACTAGAAATAGCAAGTTAACCTAAGGCTAGTCCGT	1	bc
ATACTCTAGC	GAAACACCGGTGCATTCGAAAGTCCGGTCGTAGTGTGGACGTGGGGTTAG	1	bc
GAAGACCGTT	GAAACACCGGTCGGCGGCAATCGTGGGTGGGGTTAGAGCTAGAAATAGCA	1	bc
CAAGACCGAC	GAAACACCGGTGCCCTTACTCTCACCTGATTACTTAATCCGTGGGGTTAG	1	bc
GCTGTAAAGA	GAAACACCGGTCGGAGCCACTCCGGGGTGGGGTTAGAGCTAGAAATAGCA	1	bc
CTGCTTCTAT	GAAACACCGGTTTACGTTGCATCGGTGTGGGGTTAGTGCTAGAAATAGCA	1	bc
AACACGGCCC	GAAACACCGGTTTGAACTACCTAGTTCAAAGAGCTAGAAATAGCAAGTTA	1	bc
TTCGACCTCT	GAAACACCGGTTACCATTGAGGTTCGAGGTGGATATAGCTAGGTAACTAA	1	bc
ACATGACGCC	GAAACACCGGTTTGAACTAGAAATAGCAAGTTAACCTAAGGCTAGTCCGT	1	bc
ACGACTCATT	GAAACACCGGTCTCGAGTGAGGTGTTCAGGGTGGGGTTAGAGCTAGAAAT	1	bc
ATACGAGGCT	GAAACACCGGTTTGAGCTACCGGGGTTAGAGCTAGAAGTAGCAAGTTAAC	1	bc
AAGAATCCTT	GAAACACCGGTCTCGAGTGAGGTGTTCAGGGTGGGGTTAGAGCTAGAAAT	1	bc
ACTACTAGGT	GAAACACCGGTACCTTTGTTGATGCTGGGTGGAAGGAATTTGTGGGGTTA	1	bc
AAGCGTAGTC	GAAACACCGGTGTACGTATGGACTGAACCAGGGTGTGCAAGTGGGGTTAG	1	bc
CGGGTGGGCC	GAAACACCGGTGACATTTGGGTTAGAGCTAGAAATAGCAAGTTAACCTAA	1	bc
GAGTCTGGCT	GAAACACCGGTCCGTAGGAGACCCGTGTGGCATGTAACTGTGGGGTTAGA	1	bc
CGCGCATGTC	GAAACATCGGTGCATTCGAAACGCCGGGCGTAGTGTGGACGAGGGGGTAG	1	bc
AACGCAACCC	GAAACGCCGGTGTGCTTACTCTGACCTGATTACTGAATCCGTAGGGTTAG	1	bc
ACATCGTAGT	GAAACACCGGTGTACGTATGGACTGAACCAGGGTGTGCAAGTGGGGTTAG	1	bc
GCCGGGGGCG	GAAACACCGGTCTATTCATATCGAAACCTTCCCGTGACAGTAGGGAGAGA	1	bc
CAGGCCCTAA	GAAACACCGGTGCCCTTACTCTCACCTGATTACTTAATCCGTGGGGTTAG	1	bc
GAGACGCGCA	GAAACACCGCTGTGCGGATGGCCTGAGTTGGGGGGGGTAAGGGGGGGAAA	1	bc
TTATCGATGA	GAAACACCGGTCGGGGCCACTCAGTGGTGGGGTTCTAGCTAGAAATAGCA	1	bc
TGCCCCTAGC	GAAACACCGGTGCATTCGAAAGTCCGGTCGTAGTGTGGACGTGGGGTTAG	1	bc
CGCGCTCTAT	GAAGCACCGGTGCCCTTACTCTCACCTGATTACTTAATCGTGAGGCTAGA	1	bc
ACTACTCGGA	GAAACACCGGTACCTTTGTTGATGCTGGGTGGAAGGAATTGTGGGGTTAG	1	bc
CTGCGGAGCT	CAAAACACCGGTTTATATTAGATCGGTGTGGCATTAGAGCGAGGAATTGC	1	bc
CGTGTGGCAT	GAAACACCGGTGACATTGGGTAACATGGGGTTAGAGCTAGAAATAGCAAG	1	bc
ATACTAGGCA	GAAACACCGGTACCTTTGTTGTGGGGTTAGAGCTAGAAATAGCAAGTTAA	1	bc
ATACCAGCGC	GAAACACCGGTGCATTCGAAAGTCCGGTCGTAGTGTGGACGTGGGGTTAG	1	bc
GCCCACGCCC	GAAACACCGGTTTGGGGTTAGAGCTAGAAATAGCAAGTTAACCTAAGGCT	1	bc
GTCTAACGAG	GAAACACTGGTTATATCTGTAAGTGTTGTGGGGTTAGAGCTAGAAATAGC	1	bc
TGTTTACGGC	AGTCTGTTAGAACTTGTAAAAGCGGCACCGAGTTGGTGGTTTTTTTCCTG	1	bc
AAGACACCCG	GAAACACCGGTGCATTCGAAAGTCCGGTCGTAGTGTGGACGTGGGGTTAG	1	bc
AACGTCCTTA	GAAACACCGGTGCCCTTACTCTCACCTGATTACTTAATCCGTGGGGTTAG	1	bc
TAGGATCCTT	GAAACACCGGTCTCGAGTGAGGTGTTCAGGGTGGGGTTAGAGCTAGAAAT	1	bc
AGCATAAGGT	GAAACACCGGTCGATTCATATCGAAACCTTCCCGTGACAGTGGGGTTAGA	1	bc
GAGAAGACCC	GAAACACCGGTCGGCGGCAATCGTGGGTGGGGTTAGAGCTAGAAATAGCA	1	bc
CGTCTGCATA	GAAACACCGGTCCGTAGGAGACCCGTGTGGCATGTACCTGTGGGGTTAGA	1	bc
CATTAGCAGT	GAAACACCGGTTACATTGAGATTAGAGCTAGAAAAGGCTAGTCCGTTATC	1	bc
ATACTCGGGT	GAAACACCGGTACCTTTGTTGATGCTGGGGGGAAGGATTTTTGTGGGGTT	1	bc
TATATAGCGG	GAAACACCGGTTATATTTGTAAGTGTGTGGGGTTAGAGCTAGAAATAGCA	1	bc
TTACGATGGA	GAAACAACGGTACCTTTGTTGATGCTGGGTGGGGATAGAGCTAGAAATAG	1	bc
TACAAAGGCG	GAAACACCGGTTATATTTGTAAGTGTTTGTGGGGGTAGAGCTAGAAATAG	1	bc
AGCTATAGAG	GAAACACCGGTTATATTTGTAAGTGTGTGGGGTTAGAGCTAGAAATAGCA	1	bc
ACATCGTCGA	GAAACACCGGTGTACGTATGGACTGAACCAGGGTGTGCAAGTGGGGTTAG	1	bc
CGAAACGCGC	GAAACTCCGGTGCATTCGAAAGTCCGGTCGTAGTGTGGACGTGGGGTTAG	1	bc
GGCCTTATCT	GAAACACCGGTTTACGTTACATTCGGTGTGTGGTTAGGGCTAGAAATAGC	1	bc
AATGCGTAGA	GAAACACCGGTTTACGTTGCATCGGTGTGGGGTTAGAGCTAGAAATAGCA	1	bc
GGAAGCCGCT	GAAACACTGGTCTCGAGTGAGGTGTTCAGGGCGGGGTTAGAGCTAGAAAT	1	bc
AAATATCGAG	GAAACACCGGTTATATTTGTAAGTGTGTGGGGTTAGAGCTAGAAATAGCA	1	bc
AGACACGGAC	GAAACACCGGTAGCAAGTGGGGTTAGAGCTAGAAATAGCAAGTTAACCTA	1	bc
CATCGGAGTA	GAAAAACCGGTGTACGTATGGACTGAACCAGGGTGTGCAAGTGGGGTTAG	1	bc
ATTGAGAATA	GAAACACCGGTTAAGCCGAGGGGTTAGAGCTAGAAATAGCAAGTTAACCT	1	bc
GAATTTCACC	GAAACACCGGTTTACGTTGCATCGGGTTAGAGCTAGAAATAGCAAGTTAA	1	bc
CCGAGCGAGG	GAAACACCGGTTATATTTGTAAGTGTGTGGGGTTAGAGCTAGAAATAGCA	1	bc
AGGGGAACCT	CTAAACACCGGTGTGGCTGAGAGTCCGGCAATGGTGTGGCTGTGGGGTTA	1	bc
ACCATCACCC	GAAACACCGGTGCTTTCCACTACGCAGTGGGGTTAGAGCTAGAAATAGAA	1	bc
GAAGGACGGC	GAAACACCGGTCGGCGGCAATCGTGGGTGGGGTTAGAGCTAGAAATAGCA	1	bc
TCCATAGATG	GAAACACCGGTTATATTTGTAAGTGGGGTTAGAGCTAGAAATAGCAAGTT	1	bc
CGAGCTGACT	GAAACACCGGTGACATTGGGTGCTTTTTCTCCTGCAGGAGACAACACGGA	1	bc
TAAACTACAC	GAAACACCGGTCGGCGGCAATCGTGGGAGTGGGGTTAGAGCTAGAAATAG	1	bc
AAACAACGAC	GAAACACCGGTTTGAACTACCTTAGAGCTAGAAATGGCAAGTTAACCTAA	1	bc
ACTTCTTAGC	GAAACACCGGTTTACGTTGCATCGGTGTGGGGTTAGAGCTAGAAATAGCA	1	bc
GGTCTGCATA	GAAACACCGGTCCGCAGGAGACCCGTGTGGCATGTGTGGGGTTAGAGCTA	1	bc
TTGGCCATAC	GAAACACCGGTTAAGCCGCGGGGTTAGAGCTAGAAATAGCAAGTTAACCT	1	bc
ACGGGTTGTC	GAAACACCGGTGACATTGGGTGGTGGGGTTAGAGCTAGAAATAGCAAGTT	1	bc
GTGCGTAGCA	GAAACACCGGTTTACGTTGCATCGGTGTGGGGTTAGAGCTAGAAATAGCA	1	bc
TCTGCACGGC	GAAACACCGGAACCTTTGTTGATGCTGGGTGGAAGGAATTTTGTGGGGTT	1	bc
GTGTAGTCTA	GAAACACCGGTTCCCGTCCAGTGGGGTTAGAGCTAGAAATAGCAAGTTAA	1	bc
AGGCTGCTGC	GAAACACCGGTCCGTAGGAGACCCGTGTGGCTAGAAATAGCAAGTTAACC	1	bc
CGACGTTGTC	GAAACACCGGTTTACGTATGGACGGAACCAGGGTGTGCATGTGGGGTTAG	1	bc
GGGCACTCTA	GAAACACCGGTAAATTTGAGGCTCCGGCATGCAGGAGGCCGTGGGGTTAG	1	bc
ACTTAGTCGT	GAAACACCGGTGTACGTATGGACTGAACCAGGGTGTGCAAGTGGGGTTAG	1	bc
GAGGAAGACA	GAAACACCGGTTCCCGTCTAGTGGGGTTAGAGCTAGAAATAGCAAGCTAA	1	bc
TTGATCGAGA	GAAACACCGGTTATATTTGTAGGTGTGTGGGGTTAGAGCTAGAAATAGCA	1	bc
CATCTTAGAC	GAAACACCGGTGTACGTATGGACTGAACCAGGGTGTGCAAGTGGGGTTAG	1	bc
AGACCCAGAC	GAAACACCGGTAGCAAGTGCGAGACGTTTTTGTGGGGTTAGAGCTAGAAA	1	bc
AGGCACCTAC	GAAACACCGGTAAATTTGAGGCTCCGGCATGCAGGAGGCCGTGGGGTTAG	1	bc
TATAATCGGC	GAAACACCGGTACCTTTGTTGATGCTGGGTGTTAGAGCTAGGTTAGAGCT	1	bc
GCTAATCGGC	GAAACACCGGTACCTTTGTTGATGCTGGGTGAAAGGAATTTGTGGGGTTA	1	bc
AGGTGTTGTC	GAAACACCGGTGACATTGGGTACAGGGTGGGGTTAGAGCTAGAAATAGCA	1	bc
GGCGACTACT	GAAGCACCGGTAAATTTGAGGCTCCGGCATGCAGGAGGCCGTGGGGTTAG	1	bc
GGCACAGCCC	GAAACACCGGTAGCAAGTGCGAGCTAGAAATAACAAGTTAACCTAAGGCT	1	bc
CACGACCTGA	GAAACACCGGTTTGAACTAGAAATAGCAAGTTAACCTAAGGCTAGTCCGT	1	bc
AAAGGACTCG	GAAACACCGGTTTACGTTGCATCGGGTTAGAGCTAGAAATAGCAAGTTAA	1	bc
TAACTGCGCT	GAAACACCGGTTAACGTGTGGGCTGGACCAGGGTTGGCATGTGGGGCTAG	1	bc
GATCCTTCGT	GAAACACCGGTTATATTTGGAAGATCGCGGGGTTAGAGCTAGATATAGCA	1	bc
ATCTATCTAG	GAAACACCGGTTATATTTGTAAGTGTGTGGGGTTAGAGCTAGAAATAGCA	1	bc
GGAGACCTCC	GAAACACCGGTGTGGCTGAGAGTCCGGCAATGGTGTGGCTGTGGGGTTAG	1	bc
GTGGAAAGTC	GAAACACCGGCTCCCGTCCAGTGGGGTTAGAGCTAGAAATAGCAAGTTAA	1	bc
ACAGGTTGAT	GAAACACCGGTGACATTGGGTACGGGGGGGGGTTAGAGATAGATATAGCA	1	bc
TTCTCTATGC	GAAACACCGGTTACATTGAGGGTTAGAGCTAGAAATAGCAAGTTAACCTA	1	bc
AGTAGCTATG	GAAACACCGGTTACATTGAGGGTTAGAGCTAGAAATAGCAAGTTAACCTA	1	bc
GGGACCCGCG	GAAACACCGGTGCATTCGAAAGTCCGGTCGTAGTGTGGACGTGGGGTTAG	1	bc
CACGCCATCA	GAAACACCGGTGTCCTTGCTGCCCACTGATTAATTAATCCGTGGGGTTAG	1	bc
ATACCGCCTC	GAAACACCGGTGCATTCGAAAGTCCGGTCGTAGTGTGGACGTGGGGTTAG	1	bc
ATAATAAAGC	GAAACACCGGTCGGGGCCACTCAGTGGTGGGGTTAGAGCTAGAAATAGCA	1	bc
GATCGGCGTA	GAAACACCGGTGTACGTATGGACTGAACCAGGGTGTGCAAGCGGGGTTAG	1	bc
CTATCCACCC	GAAACACTGGTACCTTTGTTGATGCTGGGTGGATAGGAATTCGGGCCCAT	1	bc
ACACAACGCT	GAAACACCGGTTTGAACTACCTAGTTCAAACCGGTGGGGTTAGAGCTAGA	1	bc
GCACAACGAC	GAAACACCGGTTTGAACTACCTAGGGGGTAGTTCAAACCGGGGTTAGAGC	1	bc
GGTCCCTTGA	GAAACACCGGTAAATTTGAGGCTCCGGCATGCAGGAGGCCGTGGGGTTAG	1	bc
AGGCTCCTAC	GAAACACCGGTAAATTTGAGGCTCCGGCATGCAGGAGGCCGTGGGGTTAG	1	bc
AATGCTTCGC	GAAACACCGGTTCACGTTGCATCCGTGTGGGGTTAGAGCTAGAAATAGCA	1	bc
GAAGTCTGGC	GAAACACCGGTCCGTAGGAGACCCGTGTGGCATGTACCTGTGGGGTTAGA	1	bc
CATAGCGCCA	GAAACACCGGTTTGAACTAGAAATAGCAAGTTAACCTAAGGCTAGTCCGT	1	bc
GAGGCTCCGC	GAAACACCGGTTCCCGTCCAGTGGGGTTAGAGCTAGAAATAGCAAGTTAA	1	bc
CACACGCTAC	GAAACACCGGTGCCCTTACTCTCACCTGATTACTTAATCCGTGGGGTTAG	1	bc
CCTATAACGA	GAAACACCGGTCGGGGCCACTCAGTGGTGGGGTTAGAGCTAGAAATAGCA	1	bc
AGGACCTAGC	GAAACACCGGTGCATTCGAAAGTCCGGACGGAGTGGGTACGGGTGGATAG	1	bc
AACTTTACCG	GAGACACCGGTCGGGGCCACTCAGTGGTGGGGTTAGAGCTAGAAATAGCA	1	bc
TCATCGTCGA	GAAACACCGGTGTACGTATGGACTGAACCAGGGTGTGCAAGTGGGGTTAG	1	bc
CGAATAATTC	GAAACACCGGTCTCGAGTGAGGTGTTCAGGGTGGGGGTAGAGCTAGAAAT	1	bc
TAAGGCATAA	GAAACACCGGTTAAGCCGAGGAGTTAGAGCTAGAAATAGCAAGTTAACCT	1	bc
GTGGACTCTA	GAAACACCGGTTCCCGTCCAGTGGGGTTAGAGCTAGAAATAGCAAGTTAA	1	bc
AATAGTAGGC	GAAACACCGGTACCTTTGTTGATGCTGGGTGGAAGGAATGGCTAGAGCTA	1	bc
TCTCTCGTAG	GAAACACCGGTTATATTTTTAAGTGTGTGTGGTTAGAGCTATAAATATCA	1	bc
AGTACGGCTA	GAAACACCGGTAGCAAGAGCTAGAAATAGCAAGTTAACCTAAGGCTAGTC	1	bc
TGGAGAACAA	GAAACACCGGTTAAGCCGAGGGGGGTTAGAGCTAGAAATAGCAAGTTAAC	1	bc
CCTTGCGCGC	GAAACACCGGTCGGGGCCACTCAGTGGTGGGGTTAGAGCTAGAAATAGCA	1	bc
GGCGCTGACA	GAAACACCGGTAAATTTGAGGCTCCGGCATGCAGGAGGAGTGGGGTTAGA	1	bc
ACGGAAATAC	GAAACACCGGTGCCCTTACTCTCACCTGATTACTTAATCCGTGGGGTTAG	1	bc
ATTGAGCATC	GAAACACCGGTTAAGCCGAGTGGGGTTAGAGCTAGAAATAGCAAGTTAAC	1	bc
ACTTTAGAGC	GAAACACCGGTCGGGGCCACTCAGTGGTGGGGTTAGAGCTAGAAATAGCA	1	bc
GAGGAGTATC	GAAACACCGGTTAAGCCGCGGGGTTAGAGCTAGAAATAGCAAGTTAACCT	1	bc
CAAGAATCCT	GAAACACCGGTCGGGGCCACTCAGTGGTGGGGTTAGAGCTAGAAATAGCA	1	bc
ACGAATCCCT	GAAACACCGGTCTCGAGTGAGGTGTTTCGTCCTTTTAGAGCTAGAAATAG	1	bc
AGGCACCCTT	GAAACACCGGTGTGGCTGAGAGTCAGGCAATGGTGTGGCTGTGGGGTTAG	1	bc
CCGAACGACC	GAACTAGCAATATAAAGTTAAACGAAGACTGGGCCGTTATCGCTTTAAAA	1	bc
AAACCTCGGT	GAAAGTTAACCTAAGGCTAGTCCGTTATCAACTTAAAACAGGGGCAACGA	1	bc
GTGTATCCAT	GAAACACCGGTTCCCGTCCAGTGGGGTTAGAGCTAGAAATAGCAAGTTAA	1	bc
CATTTAGAGG	GAAACACCGGTTATATTTGTAAGTGTTGTGGGGTTAGAGCTAGAAATAGC	1	bc
AGAAACAGAC	GAAACACCGGTAGCAAGTGCGAGACGTTTTTGTGGGGTTAGAGCTAGAAA	1	bc
TCTCTCGGGC	GAAACACCGGTTATATTTGTAAGTGTGTGGGGTCAGAGCTAGAAATAGCA	1	bc
GAGAAGCCAC	GAAACACCGGTTCGAGCCAAGTGGTGCTAGAGCTAGAAATTACAACTTGA	1	bc
ATTCGCTATG	GAAACACCGGTTACATTGAGGGTTAGAGCTAGAAATAGCAAGTTAACCTA	1	bc
GTGGCCAGTA	GAAACACCGGTTCCCGTCCAGTGGGGTTAGAGCTAGAAATAGCAAGTTAA	1	bc
GAGCATAGCC	GAAACACCGGTCGGCGGCAATCGTGTGGGGGTGGGGTTAGAGCTAGAAAT	1	bc
GCTACGCGGC	GAAACACCGGTACCTTTGTTGATGCTGGGCTAGTCCGTTATCAACTTGAA	1	bc
CATAGTAGTT	GAAACACCGGTGTACGTATGGACTGAACCAGGGTGTGCAAGTGGGGTTAG	1	bc
TTGATCATTT	GAAACACCGGTTTAGCGTGAGGGGTTGAGGGAGGAGTAAGAGCTAGACCT	1	bc
GGCCTCTGCC	GAAACACCGGTAAATTTGAGGCTCCGGCATGCAGGAGGCCGTGGGGTTAG	1	bc
ACCGTTGACG	GAAACACCGGTCGGGGCCACTCAGTGGTGGGGTTAGAGCTAGAAATAGCA	1	bc
ACGAATCCTG	GAAACACCGGTCTCGAGTGAGGTGTTCAGGGTGGGGTTAGAGCTAGAAAT	1	bc
ATATCGTCGT	GAAACACCGGTGTACGTATGGACTGAACCAGGGTGTGCAAGTGGGGTTAG	1	bc
AAATCCGGAC	GAAACACCGGTCGATTCATTTCGAAATGTTCCCGTAACGGGGGGGTTAAA	1	bc
GTTGTTTTCC	GAAACACCGGTGACATTAGAGCTAGAAATAGCAAGTTAACCTAAGGCTAG	1	bc
AGAAGACACG	GAAACACCGGTCGGTTAACCTAAGGCTAGTCCGTTATCAACTTGAAAAAG	1	bc
GGAGACTGGT	CAAAACACCGGTCCATGCATAAGCACAGTCGTAGTGTGTAATGTCAGTAA	1	bc
CGGATTATGT	GAAACACCGGTTACATTGAGGGTTAGAGCTAGAAATAGCAAGTTAACCTA	1	bc
TCACACAGCC	GAAACACCGGTTTGAACTACCTGGGGTTAGAGCTAGAAATAGCAAGTTAA	1	bc
AACTCGGACC	GAAACACCGGTAGCAAGTGCGAGACGTGTTAAATAGCAAGTTAACCTAAG	1	bc
TACCTGTCCT	GAAACACCGGTAAATTTGAGCCCCGGGACTTCAGTAGGCCGTGGGGCTAG	1	bc
ATAACGTATA	GAAACACCGGTAACTATATTCATGCGATATCGCCGTATCAGTGGGGTAGG	1	bc
ATAGAGCGTC	GAAACACCGGTTCCCGTCCAGTGGGTGTAGAGCTAGAAATAGCAAGATAA	1	bc
TCGTGTTGCC	GAAACACCGGTGACAAGTGGGGTTAGAGCTAGAAATAGCAAGTTAACCTA	1	bc
ATGAGCTTAC	GAAGCACTGGTTAAGCCGAGGGGTTAGAGCTAGAAATAGCAAGTTAGCCT	1	bc
ATGCGTAGGA	GAAACACCGGTTTACGCTGCATCGGTTGTGGGGTTAGAGCTAGAAATAGC	1	bc
AATAAAGCGC	GAAACACGGGTTAGAGCTGTAAATAGCAAGGTAACGTGAGAGAAGTCCGA	1	bc
ACTCTTACAC	GAAACACCGGTAACTATATTCATGAGAGATAGTAGAATAAGTGGGGTTAG	1	bc
TTAGATCGGT	GAAACACCGGTTACATTGAGGGTTAGAGCTAGAAATAGCAAGTTAACCTA	1	bc
ACCTTTACAG	GAAACACCGGTCGGGGCCACTCAGTGGTGGGGTTAGAGCTAGAAATAGCA	1	bc
GTGATGACTC	GAAACACCGGTTCCCGTCCTGTGGGCTTAGAACTAGAAATAGCAAGTTAA	1	bc
AGCGACAGAC	GAAACACCGGTAGCAAGTGCAAGACGTGTTTGTGGGGTTAGAGCTAGAAA	1	bc
AACATCGCAC	GAAACACCGGTTTGAACTAGAAATAGCAAGTTAACCTAAGGCTAGTCCGT	1	bc
ACTACTCTGC	GAAACACCGGTACCTTTGTTGATGCTGGGTGGAAGCTAGAAATAGCAAGT	1	bc
AGACACTAGA	GAAACACCGGTGCATTCGAAAGTCCGGTCGTAGTGTGGACGTGGGGTTAG	1	bc
ACGAATCGTT	GAAACACCGGTCTCGAGTGAGGTGTTCAGGGTGGGGTTAGAGCTAGAAAT	1	bc
GCGGCACCTC	GAAACACCGGTTCCCGTCCAGTGGGGTTAGAGCTAGAAATAGCAAGTTAA	1	bc
ATCTATCGTT	GAAACACCGGTTATATTTGTAAGTGTGTGGGGTTAGAGCTAGAAATAGCA	1	bc
AAGTCTGGCT	GAAACACCGGTCCGTAGGAGACCCGTGCGGCATGTACCTGTGGGGTTAGA	1	bc
GGGACGCGCA	GAAACACCGGTGGGGCTGGGAGGCCGGCTATGGTGTGGCGGGGGGGTTAT	1	bc
TATCTACGGC	GAAACACCGGTCGGGGCCACTCAGTGGTGGGGGTAGAGATAGAAATAGAA	1	bc
TCCTTTCACG	GAAGCACCGGTCGGGGCCACTCAGTGGTGGGGTTAGAGCTAGAAATAGCA	1	bc
GTGACAGTCA	GAAACACCGGTGACATTGGGTACAGGGTGGGGTTAGAGCTAGAAATAGCA	1	bc
GAAGACATAT	GAAACACCGGTGCCCTTACTCTCACCTGATTACTTAATCCGTGGGGTTAG	1	bc
ATAATAGGCC	GAAACACCGGTACCTTTGTTGATGCTGGTTGTGGGGTTAGAGCTAGAAAT	1	bc
ACAGAAACGC	GAAACACCGGTCGGCGGGGTTAGAGCTAGAAATAGCAAGTTAACCTAAGG	1	bc
CTACTAGGTA	GAAACACCGGTACCTTTGTTGATGCTGGGTGGAAGGAATTTTGTGGGGTT	1	bc
TAAATCCTCC	GAAACACCGGTGTGTCTGAGAGTCCGGCAATGGCGTGGCTGTGGGGTTAG	1	bc
TTTAGCCTTA	GAAACACCGGTCGTGGGGTTAGACCTAGAAATAGCAAGTTAACCTAAGGC	1	bc
GGGGGTGTCT	GAAACACCGGTTCCATTGGAGTGGGGTTAGAGCTAGAAATAGCAAGTTAA	1	bc
TTGCGTAGAC	GAAACACCGGTTAAGCCGAGGCGTTAGAGCTAGGAATAGCAGGTTAACCA	1	bc
CTATTTATGC	GAAACACCGGTTACATTGAGGGGTTACAGCTAGAAATAGCAAGTTAACCT	1	bc
ACGCGGATAA	GAAACACCGGTTAAGCCGAGTGGGGTTAGAGCTAGAAATAGCAAGTTAAC	1	bc
ATTGAGCATT	GAAACACCGGTTAAGCCGAGGTTAGAGCTAGAAATAGCAAGTTAACCTAA	1	bc
AGTCGGCTCC	GAAACACCGGTCCGTAGGAGACCCGTGTGGCATGTACCTGTGGGGTTAGA	1	bc
CCTATCCGTC	GAACCACCGGTATCCAGCTAGGTCTTACTAGTAGGGCTAGAGCGAGATAT	1	bc
TCTAGTTATG	GAAACACCGGTTACATTGAGATTGGGGTTAGAGCTAGAAATAGCAAGTTA	1	bc
ACAGCCCTAA	GACACACCGGTTCCCTGCGTCCCACCTGATTACTTAATCCGTGGGGTTAG	1	bc
GTTTATCATA	GAAACACCGGTTAAGCCGAGGAGTTAGAGCTAGAAATAGCAAGTTAACCT	1	bc
ACACCACGCC	CAAAACACCGGTTTGAACTACCTAGTTCAAACCGGGTGGGGTTAGAGCTA	1	bc
GCCGCAGCGA	GAAACACCGGTAGGCGGGTGGGGGTAAAGCTAGAAATAGCAAGATAGCCA	1	bc
GGTAGCGCCT	GAAACACCGGTTCCCGTCCAGTGGGGTTAGAGCTAGAAATAGCAAGTTAA	1	bc
ATAGGTAGGT	GAAACACCGGTTACATTGAGATTAGAGCTAGAAAAGGCTAGTCCGTTATC	1	bc
AGGGTACGAC	GAAACACCGGTACCCTTACTCTCACCTGATTACTTAATCCGTGGGGTTAG	1	bc
AAAACATGCA	GAAACACCGGTAAATTTGAGGCTCCGGCATGCAGGAGGCCGTGGGGTTAG	1	bc
GGAGACAGAC	GAAACCGGGGTTAGAGCTAGAAATAGCAAGTTAACCTAAGGCTAGTCCGT	1	bc
AAGTATGCCT	GAAACACCGGTCCGTAGGAGACCCGTGTGGCATGTTAGGGGTTAGAGCTA	1	bc
AGAACATAGC	GAAACACCGGTGCGTTCGAAAGTCCGGTCGTAGTGTGGACGTGGGGTTAG	1	bc
CTCCCCTGCA	GAAACACCGGTGCGGCTGAGAGTCCGGCAATGGTGTGGCTGTGGGGTTAG	1	bc
ATATCCACCC	GAAACACCGGTACCTTTGTTGATGCTGGGTGGATAGGAATTCGGGCCCAT	1	bc
AGACTCTTTG	GAAACACCGGTGCATTCGAAAGTCCGGTCGTAGTGTGGACGTGGGGTTAG	1	bc
TTATATAGGT	GAAACACCGGTTACATTGAGGGTTAGAGCTAGAAATAGCAAGTTAACCTA	1	bc
AGTAAGCGTC	GAAACACCGGTCCGTGGAAGACCCGTGTGGCATGTACCTGTGGGGTTTGG	1	bc
GCAGAACGGC	GAAACACCGGTCGGCGGCAATCGTGCTTTTTTTCCTGCAGGGCGGGTCTT	1	bc
AACCAGCCCG	GAAACACCGGTTTGAATAGCTAGAAATAGCAAGTTAACCTAGGGCTAGTC	1	bc
GGTGGATCCT	GAAACACCGGTTCCCGTCCAGTGGGGTTAGAGCTAGAAATAGCAAGTTAA	1	bc
TTTGAGCGTA	GAAACACCGGTTAAGCCGAGGAGTTAGAGCTAGAAATAGCAAGTTAACCT	1	bc
CACTTAGTCT	GAAACACCGGTGAGATGGTGGACAGGGAGGGGTTAGAGCTAGAAATAGCA	1	bc
ATGCCCAGGC	GAAACACCGGTTTACGTTGCATCGGTGTGGGGTTAGAGCTAGGAATAGCA	1	bc
TAGCTAACTC	GAAACACCGGTGTACGTATGGACTGCACCAGGGAGTGTAAGTGGGGTTAG	1	bc
ACTGACTCGC	GAAACACCGGTCGGCGGCAATCGGGTGGGGGTGGGGTTAGAGCTAGAAAT	1	bc
GCACAACGCA	GAAACACGGGTTAGAGCTAGAAATAGCAAGTTAACCTAAGGCTAGTCCGT	1	bc
CGAAGCTTTC	GAAACACCGGTCTCGAGTGAGGTGTGGTTAGAGCTAGAAATAGCAAGTTA	1	bc
AGAAAGAATC	GAAACGCCGGTCCGTAGGAGACCCGTGTGGCATGTAACTGTGGGGTTAGA	1	bc
ACTTCTTAGT	GAAACACCGGTTTACGTTGCATCGGGGTTAGAGCTAGAAATAGCATGTTA	1	bc
AAGATAGTCG	GAAACACCGGTGCATTCGAAAGTCCGGTCGGAGTGTGGACGTGGGGATAG	1	bc
GAGAGAATAA	GAAACACCGGTTAAGCCGAGGAGTTAGAGCTAGAAATAGCAAGTTAACCT	1	bc
ACTTTCACGC	GAAACACCGGTCGGGGCCACTCAGTGGTGGGGTTAGAGCTAGAAATAGCA	1	bc
GCTGGGGCCT	GAAACACCGGTTCCCGTCCAGTGGGGTTAGAGCTAGAAATAGCAAGTTAA	1	bc
CGTATCGAGT	GAAACACCGGTTATATTTGTAAGTGGGTGTGGTTATAGCTATAAATAGCA	1	bc
ACTACACGGC	GAAACACCGGTACCTTTGTTGATGCTGGGTGGAAGGAATTTGTGGGGTTA	1	bc
TTACGCGGGC	GAAACACCGGTACCTTTGTTGATGCTGGGTGGGGTTAGAGCTAGAAATAG	1	bc
CCTGCACTAC	GAAACACCGGTGCCCTTACTCTCACCTGATTACTTAATCCGTGGGGTTAG	1	bc
TGAATCTTCT	GAAACACCGGTCTCGAGCGAGGTGTTCTGCTGGCGGTTATAGCTAGATAT	1	bc
CTGACACAGA	GAAACACCGGTAGCAAGTGCGAGACGTTTTTGTGGGGTTAGAGCTAGAAA	1	bc
GGGCGCTGGG	GAGACACCGGTGCATTCAAAAGGCCGGTCTTAGCGTGCACGTGGGGTTAG	1	bc
GCTTAAGCGC	GAAACACCGGTCCGGGCCCCTCAGTGGTGGGGTTAGAGCTAGAAATAGCA	1	bc
CGACTTCTGT	GAAACACCGGTCTCGAGTGAGGTGTTCAGGGTGGGGTTAGAGCTAGAAAT	1	bc
CGGACTCGTC	GAAACACCGGTGTACGTATGGACTGAACCAGGGTGTGCAAGTGGGGTTAG	1	bc
CCTCAGCGTC	GAAACACCGGTGTACGTATGGACTGAACCAGGGTGTGCAAGTGGGGTTAG	1	bc
AGAATATTTT	GAAACACCGGTCTCGAGTGAGGTGTTCAGGGTGGGGTTAGAGCTAGAAAT	1	bc
AGTGTTGGAT	GAAACACCGGTGACATTGGGGCTAGCAATAGCAAGTTAACGTTAGGCTAG	1	bc
AACGCACAGC	GAAACACCGGTTCACGTTGCATCGGGGTTAGAGCTAGGAATAGCAAGTTA	1	bc
CGGGAGGCTC	GAAACACCGGTTCCCGTACAGTGGGGTTAGAGCTAGAAATAGCAAGTTAA	1	bc
GAAGAAATGA	GAAACACCGGTCGGCGGCAATCGTGGGAGGGGTTAGAGCTCGAAATAGCA	1	bc
CGTCCTTAGC	GAAACACCGGTGCATTCGAAAGTCCGGTCGTAGTGTGGACGTGGGGTTAG	1	bc
ATCTATCAAG	GAAACACCGGTTATATTTGTAAGTGTGTGGGGTTAGAGCTAGAAATAGCA	1	bc
ACTATAGCGC	GAAACACCGGTCGGGGCCACTCAGTGGTGGGGTTAGAGCTAGAAATAGCA	1	bc
GGTGGGGCCA	GAAACACCGGTTCCCGTCCAGTGGGGTTAGAGCTAGAAATAGCAAGTTAA	1	bc
AGCGTAGTCT	GAAACACCGACAGGGTTAGAGCTAGAAATAGCAAGTTAACATAAGGACAG	1	bc
GGGAGCATAG	GAAACACCGGTGTGGCTGAGAGTCCGGCAATGGTGTGGCTGTGGGGTTAG	1	bc
AATACAGCCC	GAAACACCGGCTAGTCCGATATCAACTTGGCAAAGAGGCGCCGGGTCGGA	1	bc
GAAATAAACA	GAAACACCGGTAGCAAGTGCGAGACGTGTTAAATAGCAAGTTAACCTAAG	1	bc
ATGCATCCTC	GAAACACCGGTGTGGCTGAGAGTCCGGCAATGGTGTGGCTGTGGGGTTAG	1	bc
CCTCTACGTC	GAAACACCGGTGTACGTATGGACTGAACCAGGGTGTGCAAGTGGGGTTAG	1	bc
AGGATGCGCC	GAAACACCGGTAGCCCGTGATCGTCATGTGGCGGGGCTAGAGCTCGGGGC	1	bc
TGGACCATAT	GAAACACCGGTTAAGCCGAGGAGTTAGAGCTAGAAATAGCAAGTTAACCT	1	bc
AGCATCGTCG	GAAACACCGGTGTACGTATGGACTGAACCAGGGTGTGCAAGTGGGGCTAG	1	bc
TGGACCCGCA	GAAACACCGGTATAGCTTAGTGTCCGTCAATGGTGTGTCTAGCTGGTTAG	1	bc
TAGACAATCA	GAAACACCGGTTAAGCCGAGGTTAGAGCTAAAAATATCAAGTTAACCTAA	1	bc
ACGAGTTGTA	GAAACACCGGTGACATTGGGTAACATGGGGTTAGAGCTAGAAATAGCAAG	1	bc
ATCTATAGAG	GAAACACCGGTTATATTTGTAAGTGTTTGTGGGGTTAGAGCTGGAAATAG	1	bc
AGGACCCTAC	GAAACACCGGTAAATTTGAGGCTCCGGCATGCAGGAGGCCGTGGGGTTAG	1	bc
AGGCACGCTA	GAAACACCGGTGTGGCTGAGAGTCCGGCAATGGTGTGGCTGTGGGGTTAG	1	bc
TTCATCGTAA	GAAACACCGGTTAAGCCGAGTGGGGTTAGAGCTAGAAATAGCAAGTTAAC	1	bc
ATTAGCTAGG	GAAACACCGGTTAAGGGTTAGAGCTAGAAATAGCAAGTTAACCTAAGGCT	1	bc
ATATATCGGG	GAAACACCGGTTATATTTGTAAGTGTGTGGGGTTAGAGCTAGAAATAGCA	1	bc
GCTACTCGGA	GAAACACTTAGAGCTAGAAATAGCAAGTTAACCTAAGGCTAGTCCGTTAT	1	bc
ATTGAGCCTA	GAAACACCGGTTAAGCCGAGGAGTTTCGTTAGAGCTAGAAATAGCAAGTT	1	bc
GTTCTACGCC	GAAACACCGGTTCCCGTTGCATCGGGGTTAGAGGTGGTAAAGCCAAGAAA	1	bc
CAGGTTGTCA	GAAACACCGGTGACATTGGGAAGTGGGGTTAGAGCTAGAAATAGCAAGTT	1	bc
AGGCTGAGTC	GAAACACCGGTCCGTAGGAGACCCGTGTGGCATGTACCTGTGGGGTTAGA	1	bc
GAGACACAGA	GAAACACCGGTAGCAAGTGGGGTTAGAGCTAGAAATAGCAAGTTAACCTA	1	bc
AAGCACCCTC	GAAACACCGGTGTGGCTGAGAGTCCGGCAATGGTGTGGCTGTGGGGTTAG	1	bc
ACTGTTAATG	GAAACACCGGTCGGGGCTAGAAATAGCAAGTTAACCTAAGGCTAGTCCGT	1	bc
TCACATAGAC	GAAACACCGGTAACTATATTCATGCGATATCGCCGTGTCAGTGGGGTTAG	1	bc
AGAGTCGGCT	GAAACACCGGTCGCTTCATATCGAAACCTTCCCGTCACAGTGGGGTTAGA	1	bc
ACTACTAGGC	GAAACACCGGTACCTTTGTTGATGCTGGGTGGAAGGAATTTTGGGGGGTT	1	bc
ACATAACGCA	GAAACACCGGTTAGAGCTAGAAATAGCAAGTTAACCTAAGGCTAGTCCGT	1	bc
GAGAAAGAGC	GAAACACCGGTTTGAACTACCTTAGAGCTAGAAATAGCAAGTTAACCTAA	1	bc
ATACTCCGCG	GGGTTAGAGCTAGAACTAGCAAGTTAACCTAAGGCTAGTCCGGTATCAAC	1	bc
AGTGGAGCCG	GAAACACCGGTTCCCGTCCAGTGGGGTTAGAGCTAGAAATAGCAAGTTAA	1	bc
ATTACTCGGC	GAAACACCGGTACCTTTGTTGATGCTGGGTGGAAGGAATGTGGGGTTAGA	1	bc
AAAGCCAGCC	GAAACACCGGTGCGCTTACTCTCACCTGATTACTTAATCCGGGGGGATAG	1	bc
ATTCGCTATG	GAAACACCGGTTACATTGAGTGGGGTTAGAGCTAGAAATAGCAAGTTAAC	1	bc
AGACGATGGC	GAAACACCGGTGCATTCGAAAGTCCGGTCGGAGTGTGGACGTGGGGTTAG	1	bc
GAGAAGCGTC	GAAACACCGGTTCCCGTCCAGTGGGGTTAGAGCTAGAAATAGCAAGTTAA	1	bc
GGATCGTTCA	GAAACACCGGTAAATTTGAGGCTCCGGCATGCAGGAGGCCGTGGGGTTAG	1	bc
GGGATTCCTT	GAAACACCGGCCTCGAGTGAGGAGTTCAGGGTGGGGTTAGAGCTAGAAAT	1	bc
AGAAGAGCCG	GGAACACCGGTCGGGGTGGGGTTAGAGCTAGAAATAGCAAGTTAACCTAA	1	bc
CAAAACGACT	GAAACACCGGTTTGAACTACCTAGGGGTTAGAGCTAGAAAAAGCAAGTTA	1	bc
GCAACTCCTT	GAAACACCGGTCTCGAGTGAGGTGTTCAGGGTGGGGTTAGAGCTAGAAAT	1	bc
GGGGACCATC	GAAACACCGGTTCCCGTACAGTGGGGTTAGAGCTAGAAATAGCAAGTTAA	1	bc
CCCATCACTT	GAAACACCGGTCTCGAGTGCGGTGTTCAGGGTGGGGATAGAGCTAGAAAT	1	bc
AGAGGAGCGT	GAAACACCGGTTCCCGTCCAGTGGGGTTAGAGCTAGAAATAGCAAGTTAA	1	bc
CACAACTTAT	GAAACACCGGTAACTATATTCATGCGATATCGCCGTATCAGTGGGGTTAG	1	bc
ACACAAAGCA	GAAACACCGGTTTGAACTAGAAATAGCAAGTTAACCTAAGGCTAGTCCGT	1	bc
CAGGCCGATT	GAAACACCGGTCCGCGGCACTCGCGGGGGGGGGTAAAGATAGATATAAAA	1	bc
CTGGGCATCA	GAAACACCGGTTAAGCCGTGGGGTTAGAGCTAGAAATAGCAAGTTAACCT	1	bc
GCATTTACAG	GAAACACCGGTCGGGGCCACTCAGTGGTGGGGTTAGAGCTAGAAATAGCA	1	bc
ATATCCACCA	GAAACACCAGTACCTTTGTTGATGCTGGGTGGATAGGAATTCGGGCCCAT	1	bc
TAACACCCTA	GAAACACCGGTGCCCTTACTCTCACCTGATTACTTAATCCGTGGGGTTAG	1	bc
CATAGAGAGG	GAAACACCGGTTATATTTGTAAGTGTGTGGGGTTAGAGCTAGAAATAGCA	1	bc
AGTCCCCTAC	GAAACACCGGTAAATTTGAGGCTCCGGCATGCAGGAGGCCGTGGGGTTAG	1	bc
GGCTCTTAAA	GAAACACCGGTAAATTTGAGGCTCCGGCATGCAGGAGGCCGTGGGGTTAG	1	bc
AAGAATACTT	GAAACACCGGTCTCGAGTGAGGTGTTCAGGGGTGGGGTTAGAGCTAGAAA	1	bc
AGACACAGGT	GAAACAACGGTGCATTCGAAAGTCCGGTCGGAGTGTGGAAGTGGGGATAG	1	bc
AGCAGACCCG	GAAACACCGGTCGGCGGCAATCGTGCTTTTTTTCCTGCAGGGCGGGTCTT	1	bc
TCAACCGGCA	GAAACACCGGTAAATTTGAGGCTCCGGCATGCAGGAGGCCGTGGGGTTAG	1	bc
TGAGCGATGG	GAAACACCGGTTACATTGAGGGTTAGAGCTAGAAATAGCAAGTTAACCTA	1	bc
AAGTCTGTCT	GAAACACCGGTCCGTAGGAGACCCGCGTGGCATGTACCTGTGGGGTTAGA	1	bc
ACTACGCGGC	GAAACACCGGTACCTTTGTTGATGCTGGTGTGGGGTTAGAGCTAGAAATA	1	bc
TCGGATCCTG	GAAACACCGGTCTCGAGTGAGGTGTTCAGGGTGGGGTTAGAGCTAGAAAT	1	bc
GGGACGCTTC	GAAACACCGGTGTGGCTGAGAGTCCGGCAATGGTGTGGCTGTGGGGTTAG	1	bc
ATAAGCGGTA	GAAACACCGGTCGATTCATATCGAAATCTTCCCGTGACTGTGGGGTTAGA	1	bc
AACTCGTCGT	GAAACACCGGTGTACGTATGGACTGAAACAGGGTGTGCAAATAGCAAGTT	1	bc
TCGCCGTGCA	GAAACACCGGTGCATTCGAAAGTCCGGTCGTAGTGTGGACGTGGGGTTAG	1	bc
ACACACCGCA	GAAACACCGGTTTGAACTAGAAATAGCAAGTTAACCTAAGGCTAGTCCGT	1	bc
CATAACTTAT	GAAACACCGGTAACTATATTCATGCGATATCGCCGTATCAGTGGGGTTAG	1	bc
GTCAGAGCCA	GAAACACCGGTAGCAAGTGCGAGCTAGAAATAGCAAGTTAACCTAAGGCT	1	bc
CGAATAACAT	GAAACACCGGTCTCGAGTGAGGTGTTCAGGGTGTGGTTAGAGCTAGAAAT	1	bc
ACCTTAGGTA	GAAACACCGGTCGATTCATATCGAAACCTTCCCGTGACAGTGGGGTTAGA	1	bc
TCATTGGAGT	GAAACACCGGTGTACGTATGGACTGAACCAGGGTGTGCAAGTGGGGTTAG	1	bc
TAATGTCCTA	GAAACACCGGTGCCCTTACTCTCACCTGATTACTTAATCCGTGGGGTTAG	1	bc
TCATCGACGT	GAAACACCGGTGTACGTATGGACTGAACCAGGGTGTGCAAGTGGGGTTAG	1	bc
AAAGTGACAT	GAAACACCGGTGCCCTTACTCTCACCTGATTACTGAATAGGTGGGGATAG	1	bc
GATATCTCGC	GAAACACCGGTCGGCGGCACACGTGTGGGGGTGGGGATAGAGCTAGAACT	1	bc
GAGGCACAGA	GAAACACCGGTCGGCGGCAATCGTGGGTGGGGTTAGAGCTAGAAATAGCA	1	bc
AGAAGCCCTG	GAAACACCGGTCGGCGGCAATCGTGAGTGGGGTTAGAGCTAGAAATAGCA	1	bc
TGTCTGTGTA	GAAACACCGGTCCGTGGAAGACCCGTGTGGCATGTACCTGTGGGGTTAGT	1	bc
AGGTCCCTGA	GAAACACCGGTAAATTTGAGGCTCCGGCATGCAGGAGGCCGTGGGGTTAG	1	bc
AGAGGCTCTC	GAAACACCGGTGCATTCGAAAGTCCGGTCGTGGTGTGGACGTGGGGTTAG	1	bc
ACACACGCGC	GAAACACTGGTTTGAACTAGAAATAGCAAGTTAACCTAAGGCTAGTCCGT	1	bc
AAATCTCAAC	GAAACACCGGTGCAATCGAAAGTCCGGTCGTAGTGTGGTCATGGGGGTCG	1	bc
TGAGTTGGAT	GAAACACCGGTGACATTGGGTACAGGGGGGGGGTTAGAGCTAGAAATAGC	1	bc
GTCCCCCATA	GAAACACCGGTGTGGCTGAGAGTCCGGCAATGGTGTGGCTGTGGGGTTAG	1	bc
AATGATGAGC	GAAACACCGGTTTACGTTGCATCGGTGTGGGGTTAGAGCTAGAAATAGCA	1	bc
ACTTTAACCT	GAAACACCGGTCGAGGCCACTCCGTGGTGGGGTTAGAGCTAGAAATAGCA	1	bc
AGTGACCCTC	GAAACACCGGTGTGGCTGAGAGTCCGGCAATGGTGTGGCTGGGGGGTTAT	1	bc
CGTATACTTC	GAAACACCGGTCTCGAGTGAGGTGTTCAGGGTGGGGTTAGAGCTAGAAAT	1	bc
AAACGCCGTA	GAAACACCGGTGCCCTTACTCTCACCTGATTACTTAATCCGTGGGGTTAG	1	bc
GGTACCGACA	GAAACACCGGTAAATTTTAGGCCCAGGCATGCAGAAGGCTGGGAGGATAG	1	bc
AAGACTGCCA	GAAACACCGGTCCGTAGGAGACCCGTGTGGCATGTACCTGTGGGGTTAGA	1	bc
ACACAACGCA	GAAGCACCGGTTTGAACTAGAAATAGCAAGTTAACCTAAGGCTAGTCCGT	1	bc
GAGATGTGGT	GAAACACCGGTCGACTCATATCGAAACCCTCCCGTGACAGTGGGGTTAGA	1	bc
GGGCGTCGTC	GAAACACCGGTGTACGTATGGACTGAACCAGGGTGTGCAAGTGGGGTTAG	1	bc
ACTCTACGGC	GAAACACCGGTCGGGGCCACTCAGTGGTGGGGTTAGAGCTAGAAATAGCA	1	bc
AGCAGAGCCG	GAAACACCGGTCGGCGGTTAGAGCTAGAAATAGAAAGTTAACCTAAGGCT	1	bc
CTATCAACCC	GAAACACCGGTACCTTTGTTGATGCTGGGTGGATAGGAATTCGGGCCCAT	1	bc
AACATGCGGG	GAAACACCGGTCGATTCATATCGAAACCTTCCCGTGAAGGTTTCGTGGGG	1	bc
AGAATTATGT	GAAACACCGGTTTCGAGTGAGGGGTTCAGGTAGAGGTTGGAACTTGACCT	1	bc
TCGATATTAG	GAAACACCGGTTATGTTTGGATGTGTGTGGGGTTAGAGCTAGAAATAGCA	1	bc
TGTGTTGTAA	GAAACACCGGTTACGTTGGGGACAGGGTGGGGTTAGAGCTAGAAATAGCA	1	bc
ACACAACGTC	GAAACACCGGTTTGAACTACCTAGTTCAAACCGGTGGGGTTAGAGCTAGA	1	bc
CTTAGTCGTA	GAAACACCGGTGTACGTATGGACTGAACCAGGGTGTGCAAGTGGGGTTAG	1	bc
AACGACCTCT	GAAACACCGGTGCCCTTACTCTCACCTGATTACTTAATCCGTGGGGTTAG	1	bc
ACAGTTGGTC	GAAACACCGGTCGATTCATATCGAAACCTTCCCGTGGCAGAGAGGTTAGA	1	bc
TAGCCTGCCT	GAAACACCGGTCCGTAGGAGACCCGTGTGGCATGTACCTGTGGGGTTAGA	1	bc
AAGGACCAAC	GAAACACCGGTGCCCTTACTCTCACCTGATTACTTAATCCGTGGGGTTAG	1	bc
AATTTAAAGC	GGAACACCAAGTGGGGTTAGAGCTAGAAATAGCAAGTTAACCTAAGGCTA	1	bc
ACAATTAACG	GAAACACCGGTCGGGGCCACTCAGTGGTGGGGTTAGAGCTAGAAATAGCA	1	bc
TTAGATGCGT	GAAACACCGGTTACATTGAGGGGTTAGAGCTAGAAATAGCAAGTTAACCT	1	bc
TACTTTACCG	GAAACACCGGTCGGGGCCACTCAGTGGTGGGGTTAGAGCTAGAAATAGCA	1	bc
AGACTGATTC	GAAACACCGGTAAGTAGGAGACCCGTGTGTCATGTACCTGTGGGGGTAGG	1	bc
GGGGCTGTCT	ATAGCAAGTTAACCTAAGGCTAGTCCGTTATCAACTTGAAAAAGTGGCAC	1	bc
GGAGCTATGC	GAAACACCGGTTACATTGAGGGTTAGAGCTAGATATAGCAAGTTAACCTA	1	bc
ATACCCTAGA	GAAACACCGGTGCATTCGAAAGTCCGGTCGTAGTGTGGACGTGGGGTTAG	1	bc
AGTGGAGACT	GAAACACCGGTTCCCGTCCAGTGGGGTCAGAGCTAGAAATAGCAAGTTAA	1	bc
AATTTTACCG	GAAACACCGGTCGGGGCCACTCAGTTAGAGCTAGAAATAGCAAGTTAACC	1	bc
ACCTATCGAG	GAAACACCGGTTATATTTGTAAGTGTTGTGGGGTTAGAGCTAGAAATAGC	1	bc
TAGAAGCCTC	GAAACACCGGTTCCCGTCCAGTGGGGTTAGAGCTCGAAATAGAAATATAA	1	bc
CAGAAAGCAC	GAAACACCGGTTTGAACTTGGGGTTAGAGCTAGAAATAGCAAGTTAACCT	1	bc
ACGAATCATT	GAAACACCGGTCTCGAGTGAGGTGTGGTTAGAGCTAGAAATAGCAAGTTA	1	bc
GACTTCTCGG	GAAACACCGGTACCTTTGTTGATGCTGGGTGGAAGGAATTTGTGGGGTTA	1	bc
CACAAATCCA	GAAACACCGGTTTGAACTAGAAATAGCAAGTTAACCTAAGGCTAGTCCGT	1	bc
AGGCACCTAC	CCGGTAAATTTGAGGCTCCGGCATGCAGGAGGCCGTGGGGTTAGAGCTAG	1	bc
AGGACTCCTT	GAAACACCGGTCTCGAGTGAGGTGTTCAGGGTGGGGTTAGAGCTAGAAAT	1	bc
GCTATCCATT	GAAACACCGGTTATATTTGTAAGTGTGTGGGGTTAGAGCTAGAAATAGCA	1	bc
AACATCCTTC	GAAACACCGGTGCCCTTACTCTCACCTGATTACTTAATCCGTGGGGTTAG	1	bc
ACGGACCTAC	GAAACACCGGTGCCCTTACTCTCACCTGATTACTTAAACCGTGGGGTTAG	1	bc
CGTAGTGTAA	GAAACACCGGTGACATTGGGTTAGGGCTAGAAATAGCAAGTTAACCTAAG	1	bc
ATCCGCGGCC	GAAACACCGGTACCTTTGTTGATGCTGGTTGGAAGGAATTTGTGGGGTTA	1	bc
ACGCATACCT	GAAACACCGGTTTACGTTGCATCGTGGTTAGAGTTGGGCATAACATAGTA	1	bc
TTGAGTAGCT	GAAACACCGGTTAAGCCGAGGAGTTATAGCTAGAAATAGCAAGTTAAACT	1	bc
GTGATGACTC	GAAACACCGGTTCCCGTATTCAGGGGTTAGAGCTAGATCTAGCAAGTTCA	1	bc
GGTTTCTACA	GAAACACCGGTCGGGGCCACTCAGCGGTAGGGTTGGAGCTGGGAGTAGCA	1	bc
GATGCCTAGC	GAAACACCGGTTTACGTTGCATCGGTGTGGGGTTAGAGCTAGAAATAGCA	1	bc
CGAACGATGC	GAAACACCGGTGCGTTCGAAAGTCCGGTCGTAGTGTGGACGTGGGGTTAG	1	bc
AAGTGTTGTC	GAAACACCGGTGACATAGTGGGGTTAGAGCTAGAAATAGCAAGTTAACCT	1	bc
AATGAACTAC	GAAACACCGGTGCCCTTACTCTCACCTGATTACTTAATCCGTGGGGTTAG	1	bc
ACTACTAGGA	GAAACACCGGTACCTTTGTTGATGCTGGGTGGAAGGAAGGGTTAGAGCTA	1	bc
CACATAGCTA	GAAACACCGGTTTGAACTAGAAATAGCAAGTTAACCTAAGGCCAGTCCGT	1	bc
GGGGCGTCTC	GAAACACCGGTTCCCGTCCAGTGGGGTTAGAGCTAGAAATAGCAAGTTAA	1	bc
TGTGGAGTCT	GAAACACCGGTTCCCGTCCAGTGGGGTTAGAGCTAGAAATAGCAAGTTAA	1	bc
TAATTAGGTT	GAAACACCGGTCGATTCATATCGAAACCTTCCCGTGACAGTGGGGTTAGA	1	bc
GACACTGCCT	GAAACACCGGTAGCAAGTGCGAGACGTTTTTGTGGGGTTAGAGCTAGAAA	1	bc
CGGCTCATCT	GAAACACCGGTTTACCTTGGATCGCGGTGGGGTTAGAGCTAGAAATAGCA	1	bc
AGTGAAGCCT	GAAACACCGGTTCCCGTCCAGTGGGGTTAGAGCTAGAAATAGCAAGTTAA	1	bc
GTCTATAGAG	GAAACACCGGTTATGTGGGGTTAGAGCTAGAAATAGCAAGTTAACCTAAG	1	bc
ATACTCTGTC	GAAACACCGGTACCTTTGTTGATGCTGGGTGGAAGGAATTTTGTGGGGTT	1	bc
AGTGAAGCCT	GAAACACCGGTTCCCGTCCAGTGGGGTTAGAGCTAGAAATAGCAAATTAA	1	bc
GCCGACCCGA	GAAACACCGGTCGGCGGCTAGAGCTAGAAATCGCAAGGTAAACTAAAACT	1	bc
CAGATCGGCC	GAAACACCGGTACCTTTGTTGCTGCTGGGTGGAAGGAATTTGTGGGGTTA	1	bc
CACAACGTAT	GAAACACCGGTTTGAACTACCTAGTTCAAACCGGGTGGGGTTAGAGCTAG	1	bc
AAATGGGTAT	GAAACACCGGTCGATTTTTATCGAAAGCTTCGCGAGAGCGTGGGGTTAGA	1	bc
TGAACAGAGC	GAAACACCGGTGCATTCGAAAGTCCGGTCGTAGTGTGGACGTGGGGTTAG	1	bc
CGAATCAGCT	GAAACACCGGTCTCGAGTGAGGTGTTCAGGGTGGGGTTAGAGCTAGAAAT	1	bc
GCATACGCGG	GAAACACCGGTCGATTCATATCGAAACATTCCGGTGAAAGTGGGGATAGA	1	bc
ACGTGTTGCC	GAAACACCGGTGACAATTGGGGTTAGAGCTAGAAATAGCAAGTTAACCTA	1	bc
GACATTCGAT	GAAACACCGGTCGATTCATATCGAAACCTTCCCGTGACAGTGGGGTTAGA	1	bc
AAACACGCCC	GTGGGGTTAGAGCTAGAAATAGCAAGTTAACCTAAGGCTAGTCCGTTATC	1	bc
CGACTATTGC	GAAACACCGGTTGGGGCATCTCAGTGGGGCGGTTAGAGCTAGAAATAGCA	1	bc
ATGGTTGGCA	GAAACACCGGTTTACGTTGCATCGGAGTGTGGTTAGAGATAGAAATAGCT	1	bc
CGGCTCTCGC	GAAACACCGGTGCATTCGAAAGTCCGGTCGTAGTGTGGACGTGGGGTTAG	1	bc
GATTAGCTAT	GAAACACCGGTTATTTGAGGGTTAGAGCTAGAAATAGCAAGTTATCCTAA	1	bc
TCGATAGGGA	GAAACACCGGTTATATTTGTAAGTGTGTGGGGTTAGAGCTAGAAATAGCA	1	bc
ACACAACGCA	GAGAGCTAGAAATAGCAAGTTAACCTAAGGCTAGTCCGTTATCAACTTGA	1	bc
ATTAGATAGG	GAAACACCGGTTACATTGAGGGGTTAGAGCTAGAAATAGCAAGTTAACCT	1	bc
ATGCGCATTA	GAAACACCGGTTAAGACGAGGAGTTATAGCTGGCACTCCCCATTTAGCCT	1	bc
GCGGATGTTA	GAAACACCGGTTCCCGTCCAGTGGGGTTAGAGCTAGAAATAGCACGTTAA	1	bc
TAGTCTGGCT	GAAACACCGGTCCGTAGGAGACCCGTGTGGCATGTACCTGTGGGGTTAGA	1	bc
ACGATCGAAG	GAAACACCGGTTATATTTGTAAGTGTGTGGGGTTAGAGCTAGAAATAGCA	1	bc
AAACGACATA	GAAACACCGGTGCCCTTACTCTCACCTGATTACTTAGTCCGTGGGGTTAG	1	bc
TGGCCCCTAT	GAAACACCGGTAAATTTGAGGCTCCGGCATGCAGGAGGCCGTGGGGTTAG	1	bc
TAAAATGACC	GAAACACCGGTTTGAACTAGAAATAGCAAGTTAACCTAAGGCTAGTCCGT	1	bc
TACGCAGTAA	GAAACACCGGTAGCAAGAGCGAGACGTATGGGGGTTAGAGCTAGAAATAG	1	bc
GAAGGCGCGT	GAAACACCGGTCGGCGGCAATCGTGGGTGGGGTTAGAGCTAGAAATAGCA	1	bc
GCATCCCTAC	GAAACACCGGTGGGCTTACTCTAACCTGATGACTTAATCCGTGGAGATAG	1	bc
AGGCTGACCC	GAAACACCGGTCCGTAGGAGACCCGTGTGGCATGTACCTGTGGGGTTAGA	1	bc
GCTGCTTAGC	GAAACACCGGTTTACGTTGCATCGGTTGTGGGGTTAGAGCTAGAAATAGC	1	bc
AGAGTGGTCT	GAAACACCGGTGACATTGGGTACAGGGTGGGGTTAGAGCTAGAAATAGCA	1	bc
AACATTAGGG	GAAGCACCGGTCGATCCATATCGAAACCTTCCCGTGACAGTGGGGTTAGA	1	bc
AATGGTGAGC	GAAACACCGGTTTACGTTGCATCGGTGTGGGGTTAGAGATAGAAATAGCA	1	bc
AGGCACCGTC	GAAACACCGGTGTGGCTGAGAGTCCGGCAATGGTGTGGCTGTGGGGTTAG	1	bc
CACAATGGCA	GAAACACCGGTTTGAACTAGAAATAGCAAGTTAACCTAAGGCTAGTCCGT	1	bc
GATGGTAAGC	GAAACACCGGTTTACGTTGCGGTGGGGTTAGAGCTAGAAATAGCAAGTTA	1	bc
ACGGGTTGTC	GAAACACCGGTGACATTGGGTACAGGGGTGGGGTTAGAGCTAGAAATAGC	1	bc
GAGACCCACC	GAAACGCCGGTGTGGCTGAGAGTCCGGCAATGGTGTGGATGTGGGGTTAG	1	bc
GAGGCGACTC	GAAACACCGGTTCCCGTCCAGTGGGGTTAGAGCTAGAAATAGCAAGTTAA	1	bc
ATGAATCCTT	GAAACACCGGTCTCGAGTGAGGTGTTCAGGGTGGGGTTAAAGCTAGAAAT	1	bc
GTGTTTAGAG	GAAACACCGGTTTACGTTGCATCGGTGTGGGGTTAGATCTAGAAATAGCA	1	bc
ATGGTTGTCT	GAAACACCGGTTAAAGTTGGAAGGAATAGCAAGTTAACCTAAGGCTAGTC	1	bc
CTTTCACGGT	GAAACACCGGTCGGGGCCACTCAGTGGTGGGGTTAGAGCTAGAAATAGCA	1	bc
AGATTGCGTC	GAAACACCGGTCCGTAGGAGACCCGTGTGGCATGTGGGGTTAGAGCTAGA	1	bc
AAGTGTCGTC	GAAGCACCGGTGTACGTATGGACTGAACCAGGGTGTGCAAGTGGGGTTAG	1	bc
AGACCGTAGA	GAAACACCGGTGCATTCGAAAGTCCGGTCGTAGTGTGGACGTGGGGTTAG	1	bc
ATGGTGCGTA	GAAACACCGGTTAAGTAGAGCTAGAAATAGCAAGTTAACCTAAGGCTAGT	1	bc
AGGATACTGA	GAAACACCGGTAGCAAGTGCGGGACGTGTTTTTGTGGGGTTAGAGCAAGA	1	bc
AATCCCCCCC	GAAACACCGGTGCATTCGGAAGTCCGGTCGGAGTATGGCCGGGGGGATAG	1	bc
ATTAGCAATG	GAAACACCGGTTACATTGAGATTAGAGCTAGAAAAGGCTAGTCCGTTATC	1	bc
GGGGGAGCCT	GAAACACCGGTTCCCGTCCAGTGGGGTTAGAGCTAGAAATAGCAAGTTAA	1	bc
GACAGTCTGC	GAAACACCGATTTGAACTACCTGGGGTTAGAGCTAGAAATAGCAAGTTAA	1	bc
TAGTTTACCG	GAAACACCGGTCGGCGCCACTCAGTCGTGGGGTTAGAGCTAGAAATAGCA	1	bc
CACGAATCCT	GAAACACCGGTCTCGAGTGAGGTGTTCAGGGTGGGGTTAGAGCTAGAAAT	1	bc
CCGTGAACGA	GAAACACCGGTCGGGGCCACTCAGTGGTGGGGTTAGAGCTAGAAATAGCA	1	bc
AATGATTAGC	GAAACACCGGTTTACGTTGCATCGGTTGTGGGGTTAGAGCTAGAAATAGC	1	bc
AAGGCTTAGC	GAAACACCGGTTTACGTTGCATCGGTGTGGGGTTAGAGCTAGAAATAGCA	1	bc
CATCGCAGTA	GAAACACCGGTGTACGTATGGACTGAACCAGGGTGTGCAAGTGGGGTTAG	1	bc
ATTCTTACTC	GAAACACCGGTCCGTAGGAGACCCGTGTGGCATGTACCTGTGGGGTTAAT	1	bc
AATAGTTTTG	GAAACACCGGTTACATTGAGATTGGGGTTAGAGCTAGAAATAGCAAGTTA	1	bc
CAGTTAGTGC	GAAACACCGGTCGCGGTAACTACGTGGTGGGGTTAGAGCTAGAAATAGCA	1	bc
CAACTCATTC	GAAACACCGGTAACTATATTCATGCGATATCGCCGTATTAGTGGTGTTAG	1	bc
TCTGCACTGC	GAAACACCGGTCGGGGCCACTCAGTGGTGGGGTTAGAGCTAGAAATAGCA	1	bc
ACTTTAACAC	GAAACACCGGTCGGGGTTAGAGCTAGAAATAGCAAGTTAACCTAAGGCTA	1	bc
AGAGCTTCTC	GAAACACCGGTGCATTCGAAAGTCCGGTCGTAGTGTGGACGTGGGGTTAG	1	bc
TGGGATGTAT	GAAACACCGGTGACATTGGGATGGGGTTAGAGCTAGAAATAGCAAGTTAA	1	bc
CGAAGCTGTT	GAAACACCGGTCTCGAGTGAGGTGTTCAGGGTGGGGTTAGAGCTAGAAAT	1	bc
ATCGATCGAG	GAAACACCGGTTATATTTGTAAGTGTGTGGGGTTAGAGCTAGAAATAGCA	1	bc
GTATACGGAT	GAAACACCGGTCGATTCATATCGAAACCTTCCCGTGACAGTGGGGTTAGA	1	bc
ATACTCAGTC	GAAACACCGGTACCTTTGTTGATGCTGGGTGTTAGAGCTAGGTTAGAGCT	1	bc
AGAGTCCTAT	GAAACACCGGTGCCCTTACTCTCACCTGATTACTTAATCCGTGGGGTTAG	1	bc
TCGAGGCCTA	GAAACACCGGTCTCGAGTGAGGTGTTCAGGGTGGGGTTAGAGCTAGAAAT	1	bc
TTAGCTCAGA	GAAACACCGGTTACATTGAGGGGTTAGAGCTAGAAATAGCAAGTTAACCT	1	bc
CTCCCCTGCA	GAAACACCGGGGAGGCTGAGAGTCCGTCAATGGCGTGGCTGTGGGGTTAG	1	bc
TAACTTGTTA	GAAACACCGGTAATTATATTCATGCGATATCGCCGTATCAGGGGGGTTAG	1	bc
ACCTTCACCG	GAAACACCGGTCGGGGCCACTCAGTGGTGGGGTTAGAGCTAGAAATAGCA	1	bc
TCACAATGCC	GAAACACCGGTTTGAACTAGAAATAGCAAGTTAACCTAAGGCTAGTCCGT	1	bc
GGATCTCTAG	GAAACACCGGTGTGGCTGAGAGTCCGGCAATGGTGTGGCTGTGGGGTTAG	1	bc
AACATTAGGT	GAAACACCGGTCGATTCATATCGAAACCTTCCCGTGACAGTGGGGTTAGA	1	bc
TGAGGAGCAT	GAAACACCGGTTCCCGTCCAGTGGGGTTAGAGCTAGAAATAGCAAGTTAA	1	bc
TAGATAGAGG	GAAACACCGGTTATATTTGTAAGTGGGGTTAGAGCTAGAAATAGCAAGTT	1	bc
TCCTTTAACG	GAAACACCGGTCGGGGCCACTCAGTGGTGGGGTTCGAGCTAGAAATAGCA	1	bc
GGAAGAGCAT	GAAACACCGGTCGGCGGCAATCGTTTTTGTGGGGTTAGAGCTAGAAATAG	1	bc
ACGTTGCCTA	GAAACACCGGTCTGTGCCACTCAGTGGTTGGGTTAGAGCTAGAAAGAGCA	1	bc
ATTAGTTCTG	GAAACACCGGTTACATTGAGTGGGGTTAGAGCTAGAAATAGCAAGTTAAC	1	bc
AATCCAGACA	GAAACACCGGTAGCAAGTGCGTGGGGTTAGAGCTAGAAATAGCAAGTTAA	1	bc
TATGATATGT	GAAACACCGGTTACATTGAGGGTTAGAGCTAGAAATAGCAAGTTAACCTG	1	bc
TGTATAGTGG	GAAACACCGGTTATCTTTGTATGCGGGTGTGGTTAGGGCTAGAAGTAGCA	1	bc
AGGGTGCGTC	GAAACACCGGTCCGCAGGTAACGGGGCTGGAGCGTGACAGAGGGGGTAGA	1	bc
GCATCGGATG	GAAACACCGGTGTACGTATGGACTGAACCAGGGTGTGCAAGTGGGGTTAG	1	bc
ACGGGTTGTA	GAAACACCGGTGACATTGGGTACAAAGTTAACCTAAGGCTAGTCCGTTAT	1	bc
AGACACAAAC	GAAACACCGGTAGCAGGTTAGAGCTAGAAATAGCAAGTTAACCTAAGGCT	1	bc
GAAAAAGCCC	GAAAGCACCGGTAGCAAGTGCGAGACGTGTTGGTGGGGTTAGAGCTAGAA	1	bc
ACATCGACGC	GAAACACCGGTGTACGTATGGACTGAACCAGGGTGTGCAAGTGGGGTTAG	1	bc
ACGTGTAGTA	GAAACACCGGTGACATTAGAGCTAGAAATAGCAAGTTAACCTAAGGCTAG	1	bc
GAACGCCATA	GAAACACCGGTGCCCTTACTCTCACCTGATTACTTAATCCGTGGGGTTAG	1	bc
GTAAGCTATG	GAAACACCGGTTACATTGAGGGGTTAGAGCTAGAAATAGCAAGTTAACCT	1	bc
AACAACGAAC	GAAGCACCGGTAGCAAGTGCGGGGTTAGAGCTAGAAATAGCAAGTTAACC	1	bc
GAAGACTTGA	GAAACACCGGTCGGCGGCAATCGTGGGGTGGGGTTAGAGCTAGAAATAGC	1	bc
TGCGCCTTAC	GAAACACCGGTGCCCTTACTCTCACCTGATTACTTAATCCGTGGGGTTAG	1	bc
AAGTGTTGTC	GAAACACCGGTGACATTGGGTACAGGGTGGGTTAGAGCTAGAAATAGCAA	1	bc
ACTCCAGCGG	GAAACACCGGTTATATTTGTAAGTGTGTGGGGTTAGAGCTAGAAATAGCA	1	bc
GGGGCCGATA	GAAACACCGGTAAATTTGAGGCTCCGGCATGCAGGAGGCCCGCGGGGTTA	1	bc
GGAACCTACC	GAAACACCGGTAAATTTGAGGCTCCGGCATGCAGGAGGCCGTGGGGTTAG	1	bc
AGTCACAGTC	GAAACACCGGTAGCAGGTTAGAGCTAGAAATAGCAAGTTAACCTAAGGCT	1	bc
ACGGGTTGAA	GAAGCACCGGTGACATTGGGTACAGGGTGGGGTTAGAGCTAGAAATAGCA	1	bc
ATGATTAGAA	GAAACACCGGTTTACCTAATAGCAAGTTAACCTAAGGCTAGTCCGTTATC	1	bc
AAAGATTATA	ACTTGAAAAAGTGGCACCGAGTCGGTGCTTTTTTTCCTGCAGGGTATAAG	1	bc
CCTCGCAGTT	GAAACACCGGTGGACGGATGGACTTAGCTAGGGGGTGTAGAGCTAGATAT	1	bc
AATGCGTAGC	GAAACACCGGTTTACGTTGCATCGGGGTTAGAGCTAGAAATAGCAAGTTA	1	bc
ATACTTCCGC	GAAACACCGGTCTACGGTAATCGTGGGTGGGGTTAGAGCTAGAAATAGCA	1	bc
GGGCTGTCTC	GAAACACCGGTCCGTAGGAGACCCGTGTGGCATGTACCTGTGGGGTTAGA	1	bc
GAAGATATGT	GAAACACCGGTTACATTGAGGGGTTAGAGCTAGAAATAGCAAGTTAACCT	1	bc
AAGTATGCTT	GAAACACCGGTCCGTAGGAGACCCGTGTGGCATGTACCTGTGGGGTTAGA	1	bc
AACAATCGGT	GAAACACCGGTCGATTCATATCGAAACCTTCCCGTGACAGCGGGGTTAGA	1	bc
CTATCCACCC	GAAACACCGGTACCTTTGTTGATGCTGGGGGGATAGGAATTCGGGCACAT	1	bc
TGACGCTGGC	GAAACACCGGTGCATTCGAAAGTCCGGTCGTAGTGTGGACGTGGGGTTAG	1	bc
ATTTAGCATA	GAAACACCGGTTAAGCCGAGTGGGGTTAGAGCTAGAAATAGCAAGTTAAC	1	bc
CGCATTCTGT	GAAACACCGGTCTCGAGTGAGGTGTTCAGGGTGGGGTTAGAGCTAGAAAT	1	bc
ATTAGCTACG	GAAACACCGGTTACATGAGGGGTTAGAGCTAGAAATAGCAAGTTAACCTA	1	bc
TAATACAGCC	GAAACACCGGTACCTTTGTTGATGCTGGGTGGAAGCTTGAAATAGCGAGT	1	bc
GTAGAAACGC	GAAACACCGGTCGGCGGTGGGGGTAGAGCTAGAAATAGCAAGTTAACCTA	1	bc
TATCTTACTC	GAAACACCGGTAACTATATTCATGCGATATCGCCGTTAGATATGGGGTTA	1	bc
CGCCCTCCCC	GAAACACCGGTGCCGTTGCCTCCAGGGTGGGGTTAGAGCTAGAAATAGCA	1	bc
AACGACCGCC	GAAACACCGGTGCCCTTACTCTCACCTGATTACTTAATCCGTGGGGTTAG	1	bc
TTAGATCTGC	GAAACACCGGCTACATTGAGGGGTTAGAGCTAGAAATAGCAGGTTAACCT	1	bc
CGCACACCCC	GAAACACCGGTGTGGCTGAGAGTCCGGCAATGGTGTGGCTGTGGGGATAG	1	bc
CAGTGGAGCC	GAAACACCGGTTCCCGTCCAGTGGGGTTAGAGCTAGAAATAGCAAGTTAA	1	bc
GCCCAACGCC	GAAACACCGGTTTGAACTAGAAATAGCAAGTTAACCTAAGGCTAGTCCGT	1	bc
TCGAAACGTT	GAAACACCGGTCTCGAGTGAGGTGTTCAGGTGGGGTTAGAGCTAGAAATA	1	bc
TTACGCGGGC	GAAACACCGGTACCTTTGTTGATGCTGGGTGGAAGGAATTTGTGGGGTTA	1	bc
AGGAGTAGCT	GAAACACCGGTTTGTGGGGTTAGAGCTAGAAATAGCAAGTTAACCTAAGG	1	bc
AGCGCTGTAC	GAAACACCGGTGCCCTTACTGTCAGCTGTTTACTTAGTCCGTTGGGTTAG	1	bc
AGCCATAGAC	GAAACACCGGTAGCAAGTGGGGTTAGAGCTAGAAATAGCAAGTTAACCTA	1	bc
GATACCCTCG	GAAACACCGGTGCATTCGAAAGTCCGGTCGTAGTGTGGACGTGGGGTTAG	1	bc
TAACGCACTA	GAAACACCGGTGCCCTTACTCTCACCTGATTACTTAATCCGTGGGGTTAG	1	bc
AGGCACCATC	GAAACACCGGTGTGGCTGAGAGTCCGGCAATGGTGTGGCTGTGGGGTTAG	1	bc
AAGACCATAG	GAAACACCGGTGCATTCGAAAGTCCGGTCGTAGTGTGGACGTGGGGTTAG	1	bc
GGCATTGTCA	GAAACACCGGTAGCAAGTGCGAGACGGTTGTGGGGTTAGAGCTAGAAATA	1	bc
ATCGATCGAG	GAAACACCGGTTATAGTAGAGCTAGAAATAGCAAGTTAACCTAAGGCTAG	1	bc
AGTTCGTCCC	GAAACACCGGTCCGTAGGAGACCCGTGTGGCATGTACCTGTGGGGTTAGA	1	bc
AGTGCGCATA	GAAACACCGGTTAAGCCGATGTGCTTTTTTCCTGCAGGTTATGCTCAAGA	1	bc
ACGCGACCTA	GAAACACCGGTGCCCTTACTCTCACCTGATTACTTAATCCGTGGGGTTAG	1	bc
CCTGTTGTGG	GAAACACCGGTGACATTTGGAGGAGGGTGGGGTTAGAGCTAGAAATAGCA	1	bc
CATTGCCTTC	GAAACACCGGTGTACGTATGGACTGAACCAGGGCGTGGGGTTAGAGCTAG	1	bc
TCAGACGAGC	GAAAAACCGGTCGGCGGCAATCGTGGGTGGGGTTAGAGCTAGAAATAGCA	1	bc
AAAGTCGTAC	GAAACACCGGTGCCCTTACTCTCACCTGATTACTTAATCCGTGGGGTTAG	1	bc
TATGCATCGC	GAAACACCGGTTTACGTTGCATCGGGTTAGAGCTAGAAATAGCAAGTTAA	1	bc
GTCGTCAGTG	GAAACACCGGTTATGTTAGTAAGTGTGTGGGGTTAGAGTTAGAAATAGCA	1	bc
ACTAATCGGC	GAAACACCGGTACCTTTGTTGATGCTGGGTGGGGTTAGAGCTAGAAATAG	1	bc
ACACATCGCG	GAAACACCGGTTTGAACTACCTAGTTCAAACCGGGTGGGGTTAGAGCTAG	1	bc
AACATCGGTA	GAAACACCGGTCGATTCATATCGAAACCTTCCCGTGCCAGTGGGGTTAGA	1	bc
ATTACTCGGC	GAAACACCGGTACCTTTGTTGATGCTGGGTGGAAGGTGGGGTTAGAGCTA	1	bc
ACTGCATAGC	GAAACACCGGTTTACGTTGCTGTGGGGTTAGAGCTAGAAATAGCAAGTTA	1	bc
ATGCCTATGT	GACGAAACACCGGTTTACGTTGCATCGGTTGTGGGGTTAGAGCTAGAAAT	1	bc
ATGCGTAGTC	GAAACACCGGTTTACGTTGCATCGGTTTGTGGGGTTAGAGCTAGAGATAG	1	bc
GAAGGCCCTA	GAAACACCGGTGCCCTTACTCTCACCTGATTACTTAATCCGTGGGGTTAG	1	bc
AGAACCGAGC	GAAACACCGGTGCATTCGAAAGTCCGGTCGTAGTGTGGACGTGGGGTTAG	1	bc
AGGACTCTAA	CAAAACACCGGTAAATTTGAGGCTCCGGCATGCAGGAGGCCGTGGGGTTA	1	bc
TATCGTATTT	GAAACACCGGTTACATTGAGGGTTAGAGCTAGAAATAGCAAGTTAACCTA	1	bc
CTCCCCTGCC	GAAACACCGGTGTGGCTGAGAGTCCGGCAATGGTGTGGCTGTGGGGTTAG	1	bc
GGCATCGTCG	GAAACACCGGTGTACGTATGGACTGAACCAGGGTGTGCAAGTGGGGTTAG	1	bc
CGCATTACCT	GAAACACCGGTCATATTCGCTACGCAATGTGGGTAGAGCGATAAAAATAG	1	bc
ATGAACGGCA	GAAACACGTGGGGTTAGAGCTAGAAATAGCAAGTTAACCTAAGGCTAGTC	1	bc
TGTCAGCATA	GAAACACCGGTTAAGCCGAGGGGTTAGAGCTAGAAATAGCAAGTTAACCT	1	bc
ACATCAGGGC	GAAACACCGGTGCATTCGAAATCCCGGTCGTAGTGGGGCTGGGGGTAGAG	1	bc
ATAGATGTGT	GAAACACCGGTTACATTGAGGGTTAGAGCTAGAAATAGCAAGTTAACCTA	1	bc
AACAGTCGGT	GAAACACCGGTCGATTCATATTGAAACCTTCCCGTGACAGTGGGGTTAGA	1	bc
GAGAATAATT	GAAACACCGGTCTCGAGTGCGGTGTTCAGGGTGGGGTTAGAGCTAGAAAT	1	bc
AAAGGCCTTA	GAAACACCGGTGCCCTTACCCTCACCTGATTACTTAATCCGTGGGGTTAG	1	bc
GCAGACACGA	GAAACACCGGTCGGCGGCAATCGTGGGTGGGGTTAGAGCTAGAAATAGCA	1	bc
CAACTCGGAG	GAAACACCGGTACCTTTGTTGATGCTGGGTGGAAGGAATGTGGGGTTAGA	1	bc
GGACGAACGC	GAAACACCGGTGCATTCGAAAGTCCGGTCGTAGTGTGGACGTGGGGTTAG	1	bc
CAGCTTGGCT	GAAACACCGGTTTACGTTGCATCGGTGTGGGGTTAGAGCTAGAAATAGCA	1	bc
CGAGTACGTT	GAAACACCGGTCTCGAGAGAGGGGTTCAGGTGGGGTTAGAGCTAGAAATA	1	bc
GTGCACAAAA	GAAACACCGGTTAAGCCGAGGAGTTAGAGCCAGAAATAGCAAGTTAACCT	1	bc
ATGCGTCGAT	GAAACACCGGTTTACGTTGCATCGGTGTGGGGTTAGAGCTAGAAATAGCA	1	bc
TCTCTACAGG	GAAACACCGGTTATATTTGTAAGTGTGTGGGGTTAGAGCTAGAAATAGCA	1	bc
GTGTGTGTAA	GAAACACCGGTTAATCCGATGTGCTTTTTTGCGGCAGTATACGTAGAAGT	1	bc
ATAACCTCTC	GAAACACCGGTGCATTCGAAAGTCCGGTCGTAGTGTGGACGTGGGGTTAG	1	bc
ACTTCATCGC	GAAACACCGGTCGGGGCCACTCAGTGGTGGGGTTAGAGCTAGAAATAGCA	1	bc
TACATGCTCC	GAAACACCGGTTTGGCTGAGAGTCCGGACATGGTGTGGCTGTGGGGCTAG	1	bc
ACCCTCCCGC	GAAACACCGGTGGATTGGAGAATCTGGTTGTAGTGGGTACGGGTGGAAAG	1	bc
AGAAACTCGA	GAAACACCGGTGCATTCGAAAGTCCGGTCGTAGTGTGGACGTGGGGTTAG	1	bc
AGTATGCATG	GAAACACCGGTCCGTAGGAGACCCGTGTGGCATGTACCTGTGGGGTTAGA	1	bc
GGCTAATACA	GAAACACCGGTAAATTTGAGGCTCCGGCATGCAGGAGGCCGTGGGGTTAG	1	bc
AAGAATCCGT	GAAACACCGGTCTCGAGTGAGGTGTTCAGGGTGGGGTTAGAGCTAGAAAT	1	bc
ACGCACAGCT	GAAACACCGGTTTACGTTGCATCGGGGTTAGAACCACATATAGCAGGTTA	1	bc
AAGACCGTCG	GAAACACCGGTGCATTCGAAAGTCCGGTCGTAGTGTGGACGTGGGGTTAG	1	bc
AGCATCGTCC	GAAACACCGGTGTGGCTGAGAGTACGGCAATGGTGTGGCTGTGGGGTTAG	1	bc
CTCCCCTGCA	GAAACACCGGTGTGGCTGAGAGTCCGGCAATGGTGTGGCTGCGGGGTTAG	1	bc
ACGTTACAGC	GAAACACCGGTCGGGGCCACTCAGTGGTGGGGTTAGAGCTAGAAATAGCA	1	bc
GGGACACGCC	GAAACACCGGTGTGGCTGAGAGTCCGGCAATGGTGTGGCTGTGGGGTTAG	1	bc
TCTGTTGTGT	GAAACACCGGTTATATTTATAACTGTGTGGGGTTAGAGCCAGAAATAGCA	1	bc
ACATCGACGT	GAAACACCGGTGTACGTATGGACTGAACCAGGGTGTGCAAGTGGGGTTAG	1	bc
AAATCGTCGT	GAAACACCGGTGTACGTATGGACTGAACCAGGGCGTGCAAGTGGGGTTAG	1	bc
ACTACTCTGC	GAAACACTTAGAGCTAGAAATAGCAAGTTAACCTAAGGCTAGTCCGTTAT	1	bc
AAAGGACCTA	GAAACACCGGTGCCCTCACTCTCACCTGATTACTTAATCCGTGGGGTTAG	1	bc
AGGCCATCTA	GAAACACCGGTGCATTCGACAGTCCGGTCGTAGTGGGGACGTGGGGTTAG	1	bc
TAGATCGACT	GAGACACCGGTTAACTTTGCATCGGTTTGGGGGTTGAACTTGAAATAACA	1	bc
GAATGCTTGG	CTTAACCTAAGGCTAGTCCGTTATCAACTTGAAAAAGTGGCACCGAGTCG	1	bc
AGTGGAGACT	GAAACACCGGTTCCCGTCCAGTGGGGCTAGAGCTAGAAATAGCAAGTTAA	1	bc
AGAATAATTT	GAAACACCGGTCTCGAGTGAGGTGTTCAGGGTGGGGTTAGAGCTAGAAAT	1	bc
GTGTCTCCGT	GAAACACCGGTTACATTTACGAGTACAGCTAGAAATATAAAGTTAGCCTA	1	bc
AGCCTCCCTG	GAAACACCGGTTCCCGTCCAGTGGGGTTAGAGCTAGAAATAGCAAGTTAA	1	bc
TGCCACAGAG	GAAACACCGGTAGCAAGTGCGAGACGTGTTTTGTGAGATTAGAGCTAAGC	1	bc
GTGTAGACTA	GAAACACCGGTTCCCGTCCAGTGGGGTTAGAGCTAGAACTAGCAAGTTAA	1	bc
TTTAACGCGT	GAAACACCGGTTATATTTGTAAGTGTGTGGGGTTAGAGCTAGAAATAACA	1	bc
AAGGCCCTGT	GAAACACCGGTGCCCTTACTCTCACCTGATTACTTAATCCGTGGGGTTAG	1	bc
AATAACGCGC	GAAACACCGGTTTGAACTAGAAATAGCAAGTTAACCTAAGGCTAGTCCGT	1	bc
GAGGCGCTTC	GAAACACCGGTTCCCGTCCAGTGGGGTTAGAGCTAGAAATAGCAAGTTAA	1	bc
TAGCTAGTAA	GAAACACCGGTAACGATATTCATGCAATATCGCCATATCAGAGAGGATAG	1	bc
AAACTCACGC	GAAACACCGGTGCATTCGAAAGTCAGGTCGTAGTGTGGACGCGGGGTTAG	1	bc
CACAGCACAC	GAAACACCGGTGCCCTTACTCTCACCTGACTACTTAATCCGTGAGGATAA	1	bc
TGTTGACCGC	GAAACACCGGTCGGGGCCACTCAGTGGTGGGGTTAGAGCTAGAAATAGCT	1	bc
GGGTGCGACC	GAAACACGGGTTAGAGCTAGAAATAGCATGTTAACCTAAGGCTAGTCCGT	1	bc
AGGCCCTAGA	GAAGCACCGGTAAATTTGAGGCTCCGGCATGCAGGAGGCCGTGGGGTTAG	1	bc
ACGGGGTGTC	GAAACACCGGTGACAATTGGGGTTAGAGCTAGAAATAGCAAGTTAACCTA	1	bc
TAAGATATCT	GAAACACCGGTTAGAGCTAGAAATAGCAAGTTAACCTAAGGCTAGTCCGT	1	bc
ATTCGTCGTT	GAAACACCGGTTTACGTTTGTACGGAACAGGAATAGGCAGGTAAGGTTAG	1	bc
ATGCAGAGAT	GAAACACCGGTTTACGTTCCATCGGTGTGGGGTTAGACCTAGAAATAGCA	1	bc
CTGGGTGGTA	GAAACACCGGTGTACGTATGGACTGAACCAGGGTGTGCAAGTGGGGTTAG	1	bc
TCTCTGGCGG	GAAACACCGGTTATAATTGTAAGTGCTTTTTTTCCTCCAGGCGGCGTTAG	1	bc
AAGACCCTAG	GAAACACCGGTGCATTCGAAAGTCCGGTCGTAGTGTGGACGTGGGGTTAG	1	bc
ATAAGATATG	GAAACACCGGTTACATTGAGTGGGGTTAGAGCTAGAAATAGCAAGTTAAC	1	bc
CACGACCTTC	GAAACACCGGTGCCCTTACTCTCACCTGATTACTTAATCCGTGGGGTTAG	1	bc
GGCGAAGCCT	GAAACACCGGTTCCCGTCCAGTGGGGTTAGAGCTAGAAATAGCAAGTTAA	1	bc
GGGCCCAGCA	GAAACACCGGTAAATTTGAGGCTCCGGCATGCAGGAGGCCGTGGGGATAG	1	bc
CACACTCCCC	GAAACACCGGTTTGAACTACCTAGTTCAAGCCGGTGGGGTTAGAGCTAGA	1	bc
AATCCTGAGC	GAAACACCGGTGATTGGGGTTAGAGCTAGAAATAGCAAGTTAACCTAAGG	1	bc
GACTGTACCG	GAAACACCGGTCGGGGCCACTCAGTGGTGGGGTTAGAGCTAGAAATAGCA	1	bc
CTACACTCGC	GAAACACCGGTGCATTCGAAAGTCCGGTCGTAGTGCGGACGTGGGGTTAG	1	bc
GAACTCCTGC	GAAACACCGGTCGGCGGCAGCGGGGTTAGAGCTAGAAATAGCAAGTTAAC	1	bc
ATGATTCGCC	GAAACACCGGTTTACGTTGCATCGCTAGAAATAGCAAGTTAACCTAAGGC	1	bc
ACTTTAGCGA	GAAACACCGGTCGGGGCCACTCAGTGGTGGGGTTAGAGCTAGAAATAGCA	1	bc
GAGAAGGCTC	GCTAGAAATAGCGATTTCACCTAAGGCTAGTCCGTTTTCAACTTGAAAAA	1	bc
AGTGCTGTCC	GAAAGACCGGTACATTTTTCCTGCCGGACAGAGCGCGGACATCGGGCTAG	1	bc
GACATTCTGT	GAAACACCGGTCGATTCATATCGAAACCTTCCCGTGACAGTGGGGTTAGA	1	bc
GCACTCGCAC	GAAACACCGGTACCTTTGTTGATGCTGGGTGGAAGGAATGTGGGGTTAGA	1	bc
CTAGAGTCAC	GAAACACCGGTTCCCGTACACTGGGGATGCGGATGGGACTGTCAAGTTAA	1	bc
TCACTCGAGT	GAAACACCGGTTATATTGGGGTTAGAGCTAGAAATAGCAGGTTAACCTAA	1	bc
GAACAACGAC	GAAACACGGGTTAGAGCTAGAAATAGCAAGTTAACCTAAGGCTAGTCCGT	1	bc
AGTGTAGGCT	GAAACACCGGTGACATTGGGTACAGGGTGGGGTTAGAGCTAGAAATAGCA	1	bc
AGGATACTTT	GAAACACCGGTCTCGAGTGAGGTGTTCAGGGTGGGGTTAGAGCTAGAAAT	1	bc
TGCCACACTG	GAAACACCGGTCCGTAGGAGACCCGTGTGGCATGTACCTGTGGGGTTAGA	1	bc
AGACACAGCC	GAAACACCGGTAGCAAGTGGGGTTAGAGCTAGAAATAGCAAGTTAACCTA	1	bc
AGAAGCATAT	GAAACACCGGTCTCGAGTGCGGGGTTCAGGGTGGGGTTAGAGCTAGAAAT	1	bc
ACCCTTACCG	GAAACACCGGTCGGGGCCACTCAGTGGTGGGGTTAGAGCTAGAAATAGCA	1	bc
TATAACGACC	GAAACACCGGTTTGAACTAGAAATAGCAAGTTAACCTAAGGCTAGTCCGT	1	bc
CACATCGACA	GAACCACCGGTTTGAACTACCTAGTTCAAACCGGTGGGGTTAGAGCTAGA	1	bc
ATAAATGGCC	GAAACATCGGTACCTTTGTTGATGCTGGGTGGGGTTAGAGCTAGCAATAG	1	bc
GTGGATATTT	GCAACACCCGTTCCCGTCCAGTGGCGTTAGAGCTAGAAATAGCAAATTAA	1	bc
TAAACACCAC	GAAACACCGGTCGGCGGCAATCGTTAGAGCTAGAAATAGCAAGTTAACCT	1	bc
AAACCCATCG	GAAACACCGGTGCATTCGAAAGTCCGGTCGTAGTGTGGACGTGGGGTTAG	1	bc
GACGACCAGA	GAAACACCGGTCGGCGGCAATCGTTAATCGGTTAATCGTGGGGTTAGAGC	1	bc
GGCAACTCCA	GAAACACCGGTAAATTTGAGGCTCCGGCATGCAGGAGGCCGTGGGGTTAG	1	bc
GATTTAGGGC	GAAACACCGGTCGGGGCCACTCAGTGGTGGGGTTAGAGCTAGAAATAGCA	1	bc
TGTGCGCATA	GAAACACCGGTTAAGCCGAGTGGGGTTAGAGCTAGAAATAGCAAGTTAAC	1	bc
GTACATTCGG	GAAACACCGGTCGATTCATATCGAAACCTTCCCGTGACAGTGGGGTTAGA	1	bc
GAACAACGCC	GAAACACCGGTTTGAGGAGCTAGAAATAGCAAGTTAACCTAAGGCTAGTC	1	bc
ATAAAAAGCG	GAAACACCGGTCGGCGGCAATCGTGGTTAGAGCTAGAAATAGCAAGTTAA	1	bc
ACTACTTGGC	GAAACACCGGTACCTTTGTTGATGCTGGGGGGGGTTAGAGCTAGAAATAG	1	bc
GCTAATTGGC	GAAACACCGGTACCTTTGTCGATGCTGGGTGGATGGAGGGGTTAGGGTTA	1	bc
AGTTAGAATC	GAAACACCGGTCCGTAGGAGACCCGTGTGGCATGTACCTGTGGGGTTAGA	1	bc
AGAGCACTAC	GAAACACCGGTGCCCTTACTCTCACCTGATTACTTAATCCGTGGGGTTAG	1	bc
AGATACTAAA	GAAACACCGGTAAATTTGTGGCTCCTGCTTGCAGGAGGCCGGGTGGTTAT	1	bc
GTCGAATCCT	GAAACACCGGTCTCGAGTGAGGTGTTCAGGGTGGGGTTAGAGCTAGAAAT	1	bc
AGATACAGAC	GAAACACCGGTAGCAAGTGCGAGACGTGTTTGTGGGGTTAGAGCTAGAAA	1	bc
AGGGGTTGTC	GAAACACCGGTGACATTGGGTGGGGTTAGAGCTAGAAATAGCAAGTTAAC	1	bc
ACCTTTAGCG	GAAACACCAAGTGGGGTTAGAGCTAGAAATAGCAAGTTAACCTAAGGCTA	1	bc
TTGCGAAATC	GAAACACCGGTTAAGCCGAGGAGTTAGAGATAGAAATAGCAAGTTAACCT	1	bc
AACGCTCAGC	GAAACACCGGTTTACGTTGCATCGTTAGAGCTAGAAATAGCTAGAAATAG	1	bc
ATAACTTCTA	GAAACACCGGTAACTATATTCATGCGATATCGCCGTATCAGTGGGGTTAG	1	bc
AGTCGTCTTC	GAAACACCGGTCCGTAGGAGACCCGTGTGGCATGTACCTGTGGGGTTAGA	1	bc
ACCTCTGGTG	GAAACACCGGTCGATTCATATCGAAACCTTCCCGTGACAGTGGGGTTAGA	1	bc
GGTATCGACA	GAAACACCGGTTATATTTGTAAGAGATGTGGTGTTAGAGCTAGAAAAAGT	1	bc
ACCGTTGGTT	GAAACACCGGTCGATTCATATCGAAACCTTCCCGTGACAGTGGGGTTAGA	1	bc
ACACAACGCA	GAAACACCGGTTTGAACTACCTAGTTCAAACCGGTGGGGTTAGAGCTAGA	1	bc
TTTGCTGTGG	GAAACACCGGTTATATTGAGGGGATAGAGCTAGAAATAGCAAGAAAATCA	1	bc
GACAATCACA	GAAACACCGGTAAGAAGCTTGGTTGGATCTAGCGGTAGCAAGGTGGCCTA	1	bc
AACATACGGC	GAAACACCGGTCGATTCATATCGAAACCTTCCCGTGACAGTGGGGTTAGA	1	bc
ATAGCCATAC	GAAACACCGGTGCCCTTACTCTCACCTGATTACTTAATCCGTGGGGTTAG	1	bc
TAATACGCCC	GAAACACCGGTTTGAACTAGAAATAGCAAGTTAACCTAAGGCTAGTCCGT	1	bc
CTAAAAGGCA	GAAACACCGGTACCTTTGTTGATGCTGGGTGGAAGGAGCTAGATGCTGGT	1	bc
AAAGAACTAC	GAAACACCGGTGCCCTTACTCTCACCTGATTACTTAATCGTGGGGTTAGA	1	bc
CACACAGCAC	GAAACACCGGTAGCAAGTGCGAGGCGTGTTAGATAGAACTATAACCTAAG	1	bc
GATATATACA	GAAACACCGGTATCGTGTGCGTGTCGGGTTGGTTGGGGCAGAACTAGGCA	1	bc
TATAACGTGG	GAAACACCGGTTATATTTGTAAGTTTGGGGTTAGAGCTAGAAATAGCACG	1	bc
TTGCGTCCAA	GAAACACCGGTTAAGCCGAGTGGGGTTAGAGCTAGAAATAGCAAGTTAAC	1	bc
CTGGATAGCT	GAAACACCGGTTTACGTTGCATCGGTGTGGGGTTAGAGCTAGAAATAGCA	1	bc
GAAGCCCTAA	GAAACACCGGTGCCCTTACTCTCACCTGATTACTTAATCCGTGGGGTTAG	1	bc
CGTGTACACT	GAAACACCGGTGACATTGGGTACAAGATTGAACTAGCACGTTAACCTAAG	1	bc
AAGTGTGCCT	GAAACACCGGTCCGTAGGAGACCCGTGTGGCATGTACCTGTGGGGTTAGA	1	bc
ACGTTTACCT	GAAACACCGGTGTCCGCTGCCAGGGCCAGTGTTTGGATCGAGAAAGAGAA	1	bc
TCTCGCGTGG	GAAACACCGGTTATATTTGTAAGCGTGTGGGGTTAGAGCTAGAAATAGCA	1	bc
GGCCAATACC	GAAACACCGGTAAATTTGAGGCTCCGGCATGCAGGAGGCCGTGGGGTTAG	1	bc
AGTACACTTC	GAAACACCGGTCCGTAGGAGACCCGTGTGGCATGTACCTGTGGGGATAGA	1	bc
TCCTTTACAG	GAAACACCGGTCGGGGCCACTCAGTGGTGGGGTTGGAGCTAGAAATAGCA	1	bc
ATTGAGCCTA	GAAACACCGGTTAAGCCGAGGGGTTAGAGCTAGAAATAGCAAGTTAACCT	1	bc
CCTTACAGCC	GAAACACCGGTCGGGGCCACTCAGTGGTGGGGTTAGAGCTAGAAATAGCA	1	bc
TCTTTAGATC	GAAACACCGGTCGAGGCCACTCAGCCGATAGCGCAAAGTGAGAAATAGCG	1	bc
AGACTCGGAC	GAAACACCGGTACAAGGGGTTAGAGCTAGAAATAGCAAGTTAACCTAAGG	1	bc
AGTGGAGACT	GAAACACCGGTTCCCGTCCAGTGGGGTTAGAGCTAGAAATAGCAAGTTAA	1	bc
CGTAACGCAA	GAAACACCGGTTTGAACTACCGGGGTTAGAGCTAGAAATAGCAAGTTAAC	1	bc
TCTAATCGGC	GAAACACCGGTACCTTTGTTGATGCTGGTGTGGGGTTAGAGCTAGAAATA	1	bc
GAGTCTGGCG	GAAACACCGGTCCGTAGGAGACCCGTGTGGCATTTACCTGTGGGGTTAGA	1	bc
ACATCGGCGT	GAAACACCGGTGTACGTATGGACTGAACCAGGGTGTGCAAGTGGGGTTAG	1	bc
GCTTTAACGT	GAAACACCGGTCGGGGCCACTCAGTGGTGGGGTTAGAGCTAGAAATAGCA	1	bc
GATAGTCGCT	GAAACACCGGTGTACGTATGGACTGAACCAGGGTGTGCAAGTGGGGTTAG	1	bc
GAATCGTGGT	GAAACACCGGTGTACGTATGGACTGAACCAGGGTGTGCAAGTGGGGTTAG	1	bc
GAGACGCTCG	GAAACACCGGTGCATTCGAAAGTCCGGTCGTAGTGTGGACGTGGGGTTAG	1	bc
TAAGATATTT	GAAACACCGGTTACATTGAGGGGTTGGAGCTAGAAATAGCAAGTTAACCT	1	bc
CCAGCCTCGC	GAAACACCGGTCGGCGGCAATCGTGGGTGGGGTTAGAGCTAGTAATAGCA	1	bc
TTGCAGCTTA	GAAACACCGGTTAAGGGAGACTACCCTTTCGTGTGGTTATAGCAAGTTAA	1	bc
ATACTCGGAT	GAAACACCGGTACCTTTGTTGAAGCTAGAAATAGCAAGTTAACCTAAGGC	1	bc
CATTTTACGC	GAAAAACCGGTCGGGGCCACTCAGTGGTGGGGTTAGAGCTAGAAATAGCA	1	bc
ATATTTAGTT	GAAACACCGGTTTACGTTGCATCGGGGTTAGAGCTAGAAATAGCAAGTTA	1	bc
CACGAAGAAA	GAAACACCGGTTTGAACTACCTAGGGGGTAGTTCAAACCGGGGTTAGAGC	1	bc
AAGTGATGAC	GAAACACCGGTGACATTGGGTCGGAGAAATAGCAAGTTAACCTAAGGCTA	1	bc
AACGATCGGT	GAAACACCGGTTACATTGAGGGTTAGAGCTAGAAATAGCAAGTTAACCTA	1	bc
AAAGGACTAC	GAAACACCGGTTCCCTTACTCTCACCTGATTACTTAATCCGTGGGGTTAG	1	bc
CATGAAGCGC	GAAACACCGGTTTGAACTACCTAGTTCAAACCGGTGGGGTTAGAGCTAGA	1	bc
AGACTCTGCC	GAAACACCGGTGCCTTCGTTGGGCGGGTAGAAGTGGGGACGTCAAGTTAG	1	bc
CGGATATTTT	GAAACACCGGTCTCGAGTGAGGTGTTCAGGGTGGGGTTAGAGCTAGAAAT	1	bc
CAGTGCGTCT	GAAACACCGGTTAAACCGAGGGATTAGGGCTAGGAGTTACAGGTAAAACT	1	bc
AAACAACGCC	GAAACACCGGTTTGAACTACCGGGGTTAGAGCTAGAAATAGCAAGTTAAC	1	bc
CCTCGTGGCC	GAAACACCGGTGTACGTATGGACTGAACCAGGGTGTGCAAGTGGGGTTAG	1	bc
GTGAGAATCG	GAAACACCGGTTAAGCCGAGTGGGGTTAGAGCTAGAAATAGCAAGTTAAC	1	bc
ATTACTCGGT	GAAACACCGGTACCTTTGTTGTGGGGTTAGAGCTAGAAATAGCAAGTTAA	1	bc
AGTTGGACGC	GAAACACCGGTCCGTAGGAGACCCGTGTGGCATGTACCTTGTGGGGTTAG	1	bc
GGGGTTGTTC	GAAACACCGGTTCCCGTCGGGCGGGGTTTAGACTAAAAAATACAAGTTAA	1	bc
GAAAAGCGCA	GAAACACCGGTCGATTCATATCGAAACCTTCCCGTGACAGTGGGGTTAGA	1	bc
GATATCGTCT	GAGACACCGGTCCCATTTGGCAACAAGAGGGGGGATAGCTCTAAATATCA	1	bc
ACGGCGCTAC	GAAACACCGGTGCCCTTACTCCCACCTGATTACTTAATCCGTGGGGTTAG	1	bc
AAGGCCCGCC	GAAACACCGGTGCCCTTACTCTCACCTGATTACTTAATCCGTGGGGTTAG	1	bc
GGGAGCCATG	GAAACACCGGTGCGCTCAATAGCACGTTAGTACTTAAGCCGTGGGGTTAG	1	bc
GAAAGCGGCC	GAAACACCGGTACCTTTGATGATGCTGGGATGGAGGGATTTTTGGGGTGT	1	bc
ACAGACACGC	GAAACACCGGTCGGCGGCATGGGGTTAGAGCTAGAAATAGCAAGTTAACC	1	bc
TGTAGAGAAG	GAAACACCGGTTATATTTGTAAGTGTGTGGGGTTAGAGCTAGAAATAGCA	1	bc
TTTATACTGC	GAAACACCGGTCGAGGCGACTCATTGGGCTAGATATAGCTAGAGATAGTA	1	bc
AAGGTGGATC	GAAACACCGGTCCGTATCAGACCGGGGTGACAGGTGCTATAGCGAGATAT	1	bc
CAGTTACCTC	GAAACACCGGTCAGGGCCACTCAGTGGAGGGGTTAGAGCTAGAAGTAGCA	1	bc
CTTTTTGGCT	GAAACACCGGTGGGGTTAGAGCTAGAAATAGCAAGTTAACCTAAGGCTAG	1	bc
AGGTGTTGTC	GAAAGGACGAAACACCGGTGACATTAGAGCTAGAAATAGCAAGTTAACCT	1	bc
TCCTGTACCG	GAAACACCGGTCGGGGCCACTCAGTGGTGGGGTTAGAGCTAGAAATAGCA	1	bc
GTGCTCATAA	GAAACACCGGTTAAGCCGAGGAGTTAGAGCTAGAAATAGCAAGTTAACCT	1	bc
GAGCCTGCCT	GAAACACCGGTCCGTAGGAGACCCGTGTGGCATGTACCTGTGGGGTTAGA	1	bc
AGAGCTGTGT	GAAACACCGGTTACATTGAGGGTTAGAGCTAGAAATAGCAAGTTAACCTA	1	bc
GTGCTTCGCC	GAAGCACCGGTTTACGTTGCATCGGTGTGGGGTTAGAGCTAGAAATAGCA	1	bc
GTGGCTACTT	GAAACACCGGTTCCCGTCCAGTGGGGTTAGAGCTAGAACTAGCAAGTTCA	1	bc
GAGGACTCGT	GAAACACCGGTCGGCGGTGGGGTTAGAGCTAGAAATAGCAAGTTAACCTA	1	bc
ACCTTTACCT	GAAACACCGGTCGGGGCCACTCAGTGGTGGGGTTAGAGCTAGAAATAGCA	1	bc
CACGACAGAC	GAAACACCGGTGCCCTTACTCTCACCTGATTACTTAGTGGGGTTAGAGCT	1	bc
ATGTTGCGCT	GAAACACCGGTTTATCTTGCATCGGTTCTGGGGTAGAGCTAGAAATAGCT	1	bc
CCTATCTAAG	GAAACACCGGTTATATTTGTAATTTTGTGGGGTTAGAGCTAGAAATAGCA	1	bc
ACCTGTACAT	GAAACACCGGTCGGGGCCACTCAGTGGTGGGTTAGAGCTAGAAATAGCAA	1	bc
GCGGAGTATC	GAAACACCGGTTCCCGTCCAGTGGGGTTAGAGCTAGAAATAGCAAGTTAA	1	bc
AAGAGCCTAC	GAAACACCGGTGCCCTTACTCTCACCTGATTACTTAATCCGTGGGGTTAG	1	bc
GAAGTCATAC	GAAACACCGGTGCCTTTATTCATGCGATATTTCCGAATCAGTGGGGTTAG	1	bc
AATAATCGAC	GAAACACCGGTGTACGTATGGACTGAACCAGGGTGTGCAAGTGGGGTTAG	1	bc
CATTAGCCGC	GAAACACCGGTCGGCGGCTAGAGCTTTAAAAAGCAAAGTAACCTAAGTCG	1	bc
ATAGATATGC	GAAACACCGGTTACATTGAGGGGTTAGAGCTAGAAATAGCAAGTTAACCT	1	bc
AATGCAGAGC	GAAACACCGGTTTACGTTGCATCGGTGTGGGGTTAGAGCTAGAAATAGCA	1	bc
CCTGTCGGGG	GAAACACCGGTTATATTTGTAAGGGTGTGGGGTTAGAGCTAGAAATAGCA	1	bc
GGGCTAACTC	GAAACACCGGTCCGTAGGAGACCCGTGTGGCATGTACCTGTGGGGTTAGA	1	bc
ATGATCATTT	GAAACACCGGTTAAGCCGAGGAGTTTCGTTAGAGCTAGAATTAGCAAGTT	1	bc
ATCGAATCCT	GAAACACCGGTCTCGAGTGAGGTGTTCAGGTGGGGTTAGAGCTAGAAATA	1	bc
CAGAGAGCCC	GAAACACCGGTTTGAACTACCTGGGGTTAGAGCTAGAAATAGCAAGTTAA	1	bc
CTAATCGGAA	GAAACACCGGTACCTTTGTTGATGCTGGGTGGAAGGAATTTTGTGGGGTT	1	bc
GATTCCCCGC	GAAACACCGGTCGGCGGCAATCGTGGGGGGGGTTAGAGCTAGAAATAGCA	1	bc
GCTGTCGGGG	GAAACACCGGTTATATTTGTAAGTGTGTGGGGTTAGAGCTAGAAATAGCA	1	bc
ATCGAACGAG	GAAACACCGGTTCTGTTTCTATGTGTGTGGGGTTAGAGCTAGAAATAGCA	1	bc
CAAAACTCAC	GAAACACCGGTTTGAACTAGAAATAGCAAGTTAACCTAAGGCTAGTCCGT	1	bc
TTATCGTCGT	GAAACACCGGTGTACGTATGGCCTGAACCAGGGTGTGCAAGTGGGGTTAG	1	bc
CGCGTTTTAT	GAAACACCGGTGACACTGGGTACAGGGTGGGGTTAGAGCTAGAAATAGCA	1	bc
GGAGATGATT	GAAACACCGGTGACATTGGGTACAGAGCTAGAAATAGCAAGTTAACCTAA	1	bc
GCACAGCGTA	GAAACACCGGTTTGAACTACCGGGGTTAGAGCTAGAGATAGCAAGTTAAC	1	bc
ACATCGTCGG	GAAACACCGGTGTACGTATGGACTGAACCAGGGTGTGCAAATAGCAAGTT	1	bc
ACAGCGTCGT	GAAACACCGGTGTACGTATGGACTGAACCAGGGTGTGCAAGTGGGGTTAG	1	bc
CCCACCCTGC	GAAACACCGGTGCCCTTACTCTTACCTGATTAATTGATCCGTGGGGTTAG	1	bc
AGACCCCAGT	GAAACACCGGTGCATTCGAAAGTCCGGTCGTAGTGTGGACGTGGGGTTAG	1	bc
GACACATGCC	GAAACACCGGTAGCAAGTGCGAGACGTTTTTGTGGGGGTAGCGCTAGAAA	1	bc
CGCATCAGTT	GAAACACCGGTCTCGAGTGAGGTGTTCAGGTGGGGTTAGAGCTAGAAATA	1	bc
ATCCACCGAC	GAGGCTAGTCCCGTTTCAACTTGAAAAAATGGCTGCGGGGCGGGGGCTTG	1	bc
ATACGCCTTA	GAAACACCGGTGCCCGTACTCTCACCTGATTACTTAATACGTGGGGATAG	1	bc
GACGGACAGC	GAAACACCGGTCGGCGGCAATCGTGGGTGGGGTTAGAGCTAGAAATAGCA	1	bc
ACGATAGGGC	GAAACACCGGTTAAGCCTAAGAGTTAGAGGTGGTAGTGCTAGGTTTAGCA	1	bc
GAGACCTTCC	GGAACACCGGTGTGGCTGAGAGTCCGGCAATGGTGTGGCTGTGGGGCTAG	1	bc
ACAGCCATGA	GAAACACCGGTTACATTGAGATTGGGGTTAGAGCTAGAAATAGCAAGTTA	1	bc
AGTCGGCCGT	GAAACACCGGTCCGTAGGAGACCCGTGTGGCATGTACCTGTGGGGTTAGA	1	bc
CCCAAAGCTC	GAAACACCGGTTTGAACTAGAAATAGCAAGTTAACCTAAGGCTAGTCCGT	1	bc
GAACCAGAAA	GAAACACCGGTAGCAAGTGCGAGACGTGTTTGTGGGGTTAGAGCTAGAAA	1	bc
ATAACATATA	GAAACACCGGTAACTATATTCATGCGATATCGCCGTATCAGTGGGGTTAG	1	bc
ACAGTCGTAC	GAAACACCGGTGGACTTACTCTCACCTGATTACTTAATCCGTGGGGTTAG	1	bc
ATAACGTCGT	GAAACACCGGTGTACGTATGGACTGAACCAGGGTGTGCAAGTGGGGTTAG	1	bc
TCGCAACCTC	GAAACACCGGTCTCGAGTGAGGTGTTCAGGGTGGGGTTAGAGCTAGAAAT	1	bc
GACTAGCCAT	GAAACACCGGTTCCCGTCCAGTGGGGATAGAGCTAGAAATAGCAAGTTAA	1	bc
TCTATAGCGC	GAAACACCGGTTGTGGCTGCTCAGGGGTGAGGGTAAGGCTAGGAAAGGCA	1	bc
GGGGCGCCTA	GAAACACCGGTTCCCGTCCAGTGGGGTTAGAGCTAGAAATAGCAAGTTAA	1	bc
TAGGCTGCCT	GAAACACCGGTCCGTAGGAGACCCGTGTGGCATGTACCTGTGGGGTTAGA	1	bc
CACGAATCCT	GAAACACCGGTCTCGAGTGAGGTGTTCAGGGTGGGGTTAGAGATAGAAAT	1	bc
ATAGACGCTC	GAAACACCGGTGCATTCGAAAGTCCGGTCGTAGTGTGGACGTGGGGTTAG	1	bc
ACGGATCCTT	GAAACACCGGTCTCGAGTGAGGTGTTCAGGGTGGGGTTAGAGCTAGAAAT	1	bc
GCCACTGGGA	GAAACACCGGTAGCAAGTGCGAGACGTGTTTGTGGGGTTAGAGCTAGAAA	1	bc
AACTTCGGCT	GAAACACCGGTCGATTCATATCGAAACCTTCCCGTGACAGTGGGGTTAGA	1	bc
TTGAGGCTCA	GAAACACCGGTTAGGCCGAGTGGGGTTAGAGCTAGAAATAGCAAGTTAAC	1	bc
GCTTTCGGCT	GAAACACCGGTCGATTCATATCGAAACCTTCCCGTGAGAGTGGGGTTAGA	1	bc
GTGGTGCGTT	GAAACACCGGTTCACGTCCAGTGGGGTTAGAGCTAGAAATAGCAAGTTAA	1	bc
AATACTCGGC	GAAACACCGGTACCTTTGTTGATGCTGGGTGGAAGGAATTTGGTGGGGTT	1	bc
ATAGCTCTGA	GAAACACCGTTTACATTGAGATTGGGGTTAGAGCTAGAAATAGCAAGTTA	1	bc
CCTTTAGGGA	GAAACACCGGTCGGGGTTAGAGCTAGAAATAGCAAGTTAACCTAAGGCTA	1	bc
GTAAATTATA	GAAACACCGGTAACTATATTCATGCGATATCGCCGTATCAGTGGGGTTAG	1	bc
GGAACCGGCT	GAAACACCGGTGTGGCTGAGAGTCCGGCAATGGTGTGGCTGTGGGGTTAG	1	bc
ACAGTCAGAT	GAAACACCGGTCGATTCATATCGAAACCTTCCCGTGACAGTGGGGTTAGA	1	bc
TGTTTACAGC	GAAACACCGGTCGGGGCCACTCAGTGGTGGGGTTAGAGCTAGAAATAGCA	1	bc
GACGACACAC	GAAACACCGGTCGGCGGGTTAGAGCTAGAAATAGCAAGTTAACCTAAGGC	1	bc
AGGCCACTAG	GAAACACCGGTAAATTTGAGGCTCCGGCATGCAGGAGGCCGTGGGGTTAG	1	bc
AGGGGTGCCT	GAAACACCGGTTCCCGTCCAGTGGGTTTAGAGCTAGGTATAGCAAGTTAA	1	bc
CCTCTAGAGG	GAAACACCGGTTATATTTGTAAGTGTGTGGGGCTAGAGCTAGAAATAGCA	1	bc
CACAAAACGC	GAAACACCGGTTTGAACTACCTAGTTCAAACCGGTGGGGTTAGAGCTAGA	1	bc
AAGGGTTGTC	GAAACACCGGTGACATTAGAGCTAGAAATAGCAAGTTAACCTAAGGCTAG	1	bc
GGCATTCGCC	GAAACACCGGTGTGGCTGAGAGTCCGGCAATGGTGTGGCTGTGGGGTTAG	1	bc
GCTAGCGACG	GAAACACCGGTTATATTTGTAAGTGTTGTGGGGTTAGAGCTAGAAATAGC	1	bc
GCGAATACTT	GAAACACCGGTCTCGAGTGAGGTGTTCAGGGTGGGGTTAGAGCTAGAAAT	1	bc
AGCATCCTTA	GAAACACCGGTCTCGAGTGAGGTGTTCAGGGTGGGGTTAGAGCTAGAAAT	1	bc
AATTTACGCA	GAAACACCGGTCGGGGCCACTCAGTGGTGGGGTTAGAGCTAGAAATAGCA	1	bc
AGAAGCTCGA	GAAACACCGGTGCATTCGAAAGTCCGGTCGTAGTGTGGACGTGGGGTTAG	1	bc
GAGATTCGGT	GAAACACCGGTCGATTCATATCGAAACCTTCCCGTGGGGTTAGAGCTAGA	1	bc
GGCAACAAAT	GAAACACCGGTAAATTTGAGGCTCCGGCATGCAGGAGGCCGTGGGGTTAG	1	bc
TATGCTCTAC	GAAACACCGGTGCCATTACTCTCACCTGATTACTTAATCCGTGGGGTTAG	1	bc
GCACAACGAC	GAAACACCGGTTTGAACTACCGGGGTTAGAGCTAGAAATAGCAAGTTAAC	1	bc
TATAGCCTAA	GAAACACCGGTTAAGCCGAGGTTAGAGCTAGAAATAGCAAGTTAACCTAA	1	bc
GCCTTTAACG	GAGACACCGGTCGGGGCCACTCAGTGGTGGGGTTAGAGCTAGAAATAGCA	1	bc
ATTGCACGTA	GAAACACCGGTTAAGCCGAGTGGGGTTAGAGCTAGAAATAGCAAGTTAAC	1	bc
TTGATTATAC	GAAACACCGGTAACTATATTCATGCGATATCGCCGTATCAGTGGGGTTAG	1	bc
CCACCTGCCG	GAAACACCGGTACCTTTGTTGTTGGTGGGGGGAAGGTAGTGTGAGGGGTA	1	bc
CGGTTCGGTT	GAAACACCGGTCGATTCATATCGAAACCTTCCCGTGACAGTGGGGTTAGA	1	bc
AAGCGGACTC	GAAACACCGGTCCGTAGGAGACCCGTGTGGCATGTACCTGTGGGGTTAGA	1	bc
AGTGCGCTAC	GAAACACCGGTGCCCTTACACTCACCTGATTACTTAATCCGTGGGGTTAG	1	bc
GGCTTTTGCC	GAAACACCGGTCGGGGCCACTCAGTGGTGGGGTTAGAGCTAGAAATAGCA	1	bc
GCATATCCGC	GAAACACCGGTCGGCGGCAATCGTGGGTGGGGTTAGAGCTAGAAATAGCA	1	bc
AAGACTGCGT	GAAACACCGGTTATATTTGTAAGTGTGTGGGGCTAGAGCTAGAAATAGCA	1	bc
GACACACCCC	GAAACACCGGTCGGCGGTTCGAGCTAGAACTAGCAAGATCAACTTAAGCT	1	bc
AAAGTCCCCC	GAAACACCGGTGCCCTTACTCTCACCTTATTACTTTATCCGTGGGGTTAG	1	bc
AACGAGATAC	GAAACACCGGTGCCCTTACTCTCACCTGATTACTTAATCCGTGGGGTTAG	1	bc
CATAACTTAT	GAAACACCGGTAACTATATTCATGCGATATCGCCGTATCAAGTGGGGTTA	1	bc
GGCCGCAACT	GAAACACCGGTAAATTTGAGGCCCCGGCATGCAGGAGGCCGTGGGGTTAG	1	bc
GTGGGACATC	GAAACACCGGTTCCCGTCCAGTGGGGTTAGAGCTAGAAATAGCAAGTTAA	1	bc
TCGATAGCGG	GAAACACCGGTTATATTTGTATGTGGGGTTAGAGCTAGAAATAGCAAGTT	1	bc
CAACGCCTTT	GAAACACCGGTCTCGAGTGAGGTGTTCAGGGTGGGGTTAGAGCTAGAAAT	1	bc
CGGATTCCTA	GAAACACCGGTCCGTAGGAGACCCGTGTGGCATGTATGTGGGGTTAGAGC	1	bc
AAAGAACCTG	GAAACACCGGTGCATTCGAAAGTCCGGTCGTGGTGTGGACGTGGGGTTAG	1	bc
ATCCTCGGAC	GAAACACCGGTACCTGTGTTGATGCTGGGTGGAAGGAATTTGTGGGGTTA	1	bc
GGTTTCCCCC	GAAACACCGGTTGGGGCCCCTCAGTGATAGAGCAAGTTCACCTAAGGCTA	1	bc
GGATTCTCGC	GAAACACCGGTGCATTCGAAAGTCCGGTCGTAGTGTGGACGTGGGGTTAG	1	bc
AAGGATTAGC	GAAACACCGGTTTACGTTGCATCGGTGTGGGGTTAGAGCTAGAAATAGCA	1	bc
ACATAGTTGT	GAAACACCGGTGTACGTATGGACTGAACCAGGGTGTGCAAGTGGGGTTAG	1	bc
CCCAAAACAC	GAAACACCGGTTCACGGGCAGAGGGCTTAGAGCTAGAGATAGCAATTTAA	1	bc
GCCTTTACAT	GAAACAACGGTCGGGGCCACTCAGTGGTGGGGTTAGAGCTAGAAATAGCA	1	bc
TAGGCCGGAC	GAAACACCGGTGCCCTTACTCCCACCTGATTACTTAATCCGTGGGGTTAG	1	bc
AGAAGACCAG	GAAACACCGGTCGGCGGCAACGTGGTTAGAGCTAGAAATAGCAAGTTAAC	1	bc
TTGATATTGA	GAAACACCGGTTAAGCCGAGGTTAGAGCTAGAAATAGCAAGTTAACCTAA	1	bc
AAGCACCGTC	GAAACACCGGTTCCCGTCCAGTGGGGTTAGAGCTAGAAATAGCAAGTTAA	1	bc
ATCTGTCGAG	GAAACACCGGTTATATTTGTAAGTGTTGTGGGGTTAGAGCTAGAAATAGC	1	bc
TCCTTTAACG	GAAACACCGGTCGGGGCCACTCAGTGGTGGGGTTAGAGCTAGAAATAGCA	1	bc
AACGTCCACC	GAAACACCGGTGCCCTTACTCTCACCTGATTACTTAATCCGTGGGGTTAG	1	bc
AACGCTACCG	GAAACACCGGTCGGGGCCACTCAGTGGTGGGGTTAGAGCTAGAAATAGCA	1	bc
GGCGTACTCC	GAAACACCGGTGTGGCTGAGAGTCCGGCAATGGTGTGGCTGTGGGGTTAG	1	bc
AACACAACGC	GAAACACCGGTTTGAACTAGAAATAGCAAGTTAACCTAAGGCTAGTCCGT	1	bc
GACCTCCATT	GAAACACCGGTCCATAGAAAACCCGTTTGGCATTTTGCTCTGGGGGTAGG	1	bc
GCTTTCGGCC	GAAACACCGGTCGCTTCATATCGAAACCTTCCCGTGACAGTGGGGTTAGA	1	bc
AGCAAACTTC	GAAACACCGGTGTGGCTGAGAGTCCGGCAATGGTGTGGCTGTGGGGTTAG	1	bc
AATCTGCCCA	GAAACACCGGTCCGTAGGAGACCCGTGTGGCATGTACCTGTGGGGTTAGA	1	bc
CGTAGCGTGC	GAAACACCGGTTATATTTGTAAGTGTGTGGTGTTAGAGCTAGAAATAGCA	1	bc
GGAATCTCCC	GAAACACCGGTAAATCTGAGGCTCCGGCATGCAGGAGGCCGTGGGGTTAG	1	bc
ATAGGGCATA	GAAACACCGGTTAAGCCGAGGTGGGGTTAGAGCTAGAAATAGCAAGTTAA	1	bc
TGAAGCGCGC	GAACCTAAAACTAGTCCGTTATCAACTTGAAAAAGTGGCACCGAGTCGGT	1	bc
AGTCACAGAA	GAGACACCGGTAGCAAGTGCGAGCAAGTGTGGGGTTAGAGCTAGAAACAG	1	bc
CATAGCGTGG	GAAACACCGGTTATATTGGGGCTAGAGCTAGAATTAGCAAGTTAACCAAA	1	bc
ATCTATGGAG	GAAACACCGGTTATATTTGTAAGTGTGTGGGGTTAGAGCTAGAAATAGCA	1	bc
CACATAGCAC	GAAACACCGGTTTGAACTAGAAATAGCAAGTTAACCTAAGGCTAGTCCGT	1	bc
GACGTTCGGT	GAAACACCGGTCGATTCATATCGAAACCTTCCCGTGACAGTGGGGTTAGA	1	bc
ATGAGCAGCT	GAAACACCGGTTAAGCCGAGTGGGGTTAGAGCTAGAAATAGCAAGTTAAC	1	bc
GGCCTGTATA	GAAACACCGGTAAATTTGAGGCTCCGGCATGCAGGAGGCCGTGGGGTTAG	1	bc
GTACTCGGTT	GAAACACCGGTTACTGTAAATTGGCTGGGTGGTGATAGAGCTAGAAATAG	1	bc
AATAGCTATG	GAAACACCGGTTACATTGAGTGGGGTCAGAGCTAGAAATAGCAAGTTAAC	1	bc
AAGGCCAAAC	GAAACACCGGTCCCCTTACCCTCACCTCATGACTTATTACGGTTAGCAAT	1	bc
AACTCACGAC	GAAACACCGGTGCCCTTACTCTCACCTGATTACTTAATCCGTGGGGTTAG	1	bc
AAATAACGCT	GCTAGAAATAGCAAGTTAACCTAAGGCTAGTCCGTTATCAACTTGAAAAA	1	bc
CTGCGCGGCA	GAAACACCGGTACCTTTGTTGATGCTGGGTGGAAGGAAGGTGGGGTTAGA	1	bc
GCATCGTCGA	GAAACACCGGTGTACGTATGGACTGAACCAGGGTGTGCAAGTGGGGTTAG	1	bc
ACATTTACCG	GAGACACCGGTCGGGGCCACTCAGTGGTGGGGTTAGAGCTAGAAATAGCA	1	bc
ACTACTTGGA	GAAACACCGGTACCTTTGTTGGTGCTGGGTGGAAGGAATTTGTGGGGTTA	1	bc
AGGCTCATAA	GAAACACCGGTAAATTTGAGGCTCCGGCATGCAGGAGGCCGTGGGGTTAG	1	bc
TGAGCTGACT	GAAACACCGGGGTGGGGTTAGAGCTAGAAATAGCAAGTTAACCTAAGGCT	1	bc
GTCACAGTAA	GAAACACCGGTTGCACGGGGGGTTATAACTAGAAGTAGCAAGTTAACATC	1	bc
TTAAGTATGC	GAAACACCGGTTAAGCCGAGGAGTGGGGTTAGAGCTAGAAATAGCAAGTT	1	bc
CCGTTAGTGC	GAAACACCGGTCGGGGCCACTCAGTGGTGGGGTTAGAGCTAGAAATAGCA	1	bc
AACACAACGC	GAAACACCGGTTTGGGGTTAGAGCTAGAAATAGCAAGTTAACCTAAGGCT	1	bc
AACGGAGTAC	GAAACACCGGTGCCCTTACTCTCACCTGATTACTTAATCCGTGGGGTTAG	1	bc
CATGTGGTGT	GAAACACCGGTGACAATTGGGGTTAGAGCTAGAAATAGCAAGTTAACCTA	1	bc
GCGGAGTGTC	GAAACACCGGTTCCCGTCCAGTGGGGTTAGGGCTAGAAATAGCAAGTTAA	1	bc
AAGACCCTGG	GAAACACCGGTGCATTCGAAAGTCCGGTCGTAGTGTGGACGTGGGGTTAG	1	bc
AATTTACAGC	GAAACACCGGTCGGGGCCACTCAGTGGTGGGGTTAGAGCTAGAAATAGCA	1	bc
ACGCAGTGTA	GAAACACCGGTCGATTCATATCGAAACCTTCCCGTGGGGTTAGAGCTAGA	1	bc
CACAACTAAG	GAAACACCGGTTTGAAGAGCTAGAAATAGCAAGTTAACCTAAGGCAAGTC	1	bc
GACCGTCGCC	GAAACACCGGTGTACGTATGGACTGAACCATTGTGTGCAAGTGGGGTTAG	1	bc
AAGCCACTCG	GAAACACCGGTGCATTCGAAAGTCCGGTCGTAGTGTGGACGTGGGGTTAG	1	bc
AGGCACCATC	GAAACACCGGTGTGGTTGAGAGTCCGGCAATGGTGTGGCTGTGGGGTTAG	1	bc
ACCATCGGTA	GAAACACCGGTCGATCTAAATCGAAACCTTCGCGGGACCGTGGGGGTAGA	1	bc
GACCCCTTGC	GAAACACCGGTAAACTTGAGGCTCCGGCATGCAGGAGGCCGGGGGGTTAG	1	bc
CAGATCCTCT	GAAACACCGGTCTCGCGTGAGGCTTTCAGGGTTTGGTTAGAGCTAGAAAT	1	bc
AACTCTCAAC	GAAACACCGGTGCCCTTACTCTCACCTGATTACTTAATCCGTGGGGTTAG	1	bc
GTGGTTCCCC	GAAACACCGGTCGGCGGCACTCGTGGGTGGGGTTAGGGCTAGAAATAGCA	1	bc
AAGTCTGTAT	GAAACACCGGTCCGTAGGAGACCCGTGTGGCATGTACCTGTGGGGTTAGA	1	bc
AAATTCTGCT	GAAACACCGGTCGATTCATATCGAAACCTTCCCGTGACAGTGGGGTTAGA	1	bc
GCCTCCCGCA	GAAACACCGGTAAATTTGATGCTCCGGCATGCAGGAGGCCCGTGGGGTTA	1	bc
GACATCGAGA	GAAACACCGGTTACATGTGTAAGTAGACCTGGATATAGCAAGTTAACCTA	1	bc
AGGCATCCGC	GAAACGCCGGTGTGGCTGAGAGTCCGGCAATGGTGTGGCTGTGGGGTTAG	1	bc
GCACGACGCC	GAAACACCGGTTTGAACTACCTAGTTCAAACCGGTGGGGTTAGAGCTAGA	1	bc
TGTAGGGCCG	GAAACACCGGTCGGCGGTGGGGTTAGAGCTAGAAATAGCAAGTTAACCTA	1	bc
CGGATGCTTC	GAAACCCCGGTCTCGAGTGAGGAGTTCAGGGGGGGGTTAGAGCTAGAAAT	1	bc
AAAGCCTGAC	GAAACACCGGTGCCCTTACTCTCACCTGATTACTTAATCCGTGGGGTTAG	1	bc
TGCGCCATCC	GAAACACCGGTTACATTGAGGGGCTAGAGCTAGAAATAGCAAGTTAACAT	1	bc
GGAAACAGGC	GTAGAAATAGCAAGTTAACCTAAGGCTAGTCCGTTATCAACTTGAAAAAG	1	bc
CACTCCTACG	GAAACACCGGTAAATTTGAGGCTCCGGCATGCAGGAGGCCGTGGGGTTAG	1	bc
ACGAATCCCT	GAAACACCGGTCTCGAGTGAGGTGTTCAGGGTGGGGTTAGAGCTAGAAAT	1	bc
AAGAACCTCG	GAAACACCGGTGCATTCGAAAGTCCGGTCGTAGTGTGGACGTGGGGATAG	1	bc
AATGTAGTCT	GAAACACCGGTGACATTGGGTACAGGGTGGGGTTAGAGCTAGAAATAGCA	1	bc
GAAGAGCCCT	GAAACACCGGTCGGCGGCAATAGTGGGTGGGGTTAGGGCTAGAAATGGCA	1	bc
CATTTACCTT	GAAACACCGGTCCGTAGGAGACCCGTGTGGGATGTGCCCGTGGGGTTAGA	1	bc
ACATTTTGCA	GAAACACCGGTCGATTCATATCGAAACCTTCCCGTGACGGTTGGGGTTGA	1	bc
GGACGCCGGC	GAAACACCGGTGCATTCGAAAGTCCGGTCGTAGTGTGGACGTGGGGTTAG	1	bc
AGGGGAGCCT	GAAACACCGGTTCCCGTCCAGTGGGGTTAGAGCTAGAAATAGCAAGTTAA	1	bc
AGATATCGCG	GAAACACCGGTTATATTTGTAAGTGTGTGGGGTTAGAGCTAGAAATAGCA	1	bc
CCATGTGGTC	GAAACACCGGTCGATTCATATCGAAACCTTCCCGTGACAAGTGGGGTTAG	1	bc
TCCTTTAGCG	GAAGCACCGGTCGGGGCCACTCAGTGGTGGGGTTAGAGCTAGAAATAGCA	1	bc
AGGTCTGTCT	GAAACACCGGTCCGTAGGAGACCCGTGTGGCATGTACCTGTGGGGTTAGA	1	bc
GAAAGGCCAA	GAAACACCGGTGCCCTTACTCTCACCTGATTACTTAATACGTGGGGTTAG	1	bc
GTAGTCGACA	GAAACACCGGTACCTTTGTTGATGCTGGGTGGAAGGTACACCGGTACCTT	1	bc
CGTATTCGTC	GAAACACCGGTGTACGTATGGACTGAACCAGGGTGTGCAAGTGGGGTTAG	1	bc
TTGTGCCAAA	GAAACACCGGTCGTCATCAACTCACGTGACTACTGAATACGTGTGGATAT	1	bc
ATCCTTTACC	GAAACACCGGTCGGGGCCACTCAGTGGTGGGGTTAGAGCTAGAAATAGCA	1	bc
ACCAATCGGC	GAAACACCGGTACCTTTGTTGATGCTGGTGTGGGGTTAGAGCTAGAAATA	1	bc
TGCCCAGCGC	GAAACACCGGTGCATTCGAACTTCCGGTGGTAGTGGGGACGTGAGGATAG	1	bc
GCTTGTTGTA	GAAACACCGGTGACATTGGGTATGGGGTTAGAGCTAGAAATAGCAAGTTA	1	bc
ACACAACTCT	GAAACACCGGTTTGAATTACCTAGTTCAAACCGGTGGGGTTAGAGCTAGA	1	bc
GACGACATAC	GAAACACCGGTGCCCTTACTCTCACCTGATTACTTAATCCGTGGGGTTGG	1	bc
TGCATCCCTG	GAAACACCGGTCCGTAGGAGATCCGTGTGGCATGTACCTGAGGAGGTTGA	1	bc
TACCTTCGGT	GAAACACCGGTCGATTCATATCGAAACCTTCCCGTGACAGTGGGGTTAGA	1	bc
TCAGTGACGT	GAAACACCGGTGTACGTATGGACTGAACCAGGGTGTGCAAGTGGGGTTAG	1	bc
ATACAACGCC	GAAACACCGGTTTGAACTACCTAGCAAGTTAACCTAAGGCTAGTCCGTTA	1	bc
GAGGACGCAA	GAAACACCGGTTTGAACTAGAAATAGCAAGTTAACCTAAGGCTAGTCCGT	1	bc
CTTTTACAGA	GAAACACCGGTCGTGGCCACTCAGTGGTGGGGGTAGATCTAGAAATAGCA	1	bc
GAGTCTGCTT	GAAACACCGGTCCGTAGGAGACCCGTGTGGCATGTACCTGTGGGGTTAGA	1	bc
ACATAAAGCA	GCTAGAAATAGCAAGTTAACCTAAGGCTAGTCCGTTATCAACTTGAAAAA	1	bc
AAAATGACTC	GAAACACCGGTCCGTAGGAGACCCGTGTGGCATGTACCTGTGGGGTTAGA	1	bc
AAACGCACAA	GAAACACCGGTGCCCTTACTCTCACCTGATTACTTAATCCGTGGGGTTAG	1	bc
AAGACCCTAG	GAAACACCGGTGCATTCGGAAGTCCGGTCGTAGTGTGGACGTGGGGTTAG	1	bc
GCTCTACGCC	GAAACACCGGTGTACGTTGCATCGGGTGAGGGGTTAGAGCTAGAAATAGT	1	bc
ATACTTATGT	GAAACACCGGTTTACGTTGCATCTAGAGGTGGAAATAGCTAGATATAGTA	1	bc
AGTGTTCTGT	GAAACACCGGTGGGGTTAGAGCTGGATATAGCAAGTTAACCTAAGGCTAG	1	bc
CCTGTACGGA	GAAACACCGGTCGGGGCCACTCAGTGGTGGGGTTAGAGCTAGAAATAGCA	1	bc
TTACCCATGG	GAAACACCGGTTACATTGAGGGTTAGAGCTAGAAATAGCAAGTTAACCTA	1	bc
TTAACCATGC	GAAACACCGGTTAGGTTGAGGGTTAGGGCTTGATGTGGCAGGTTAGCTTA	1	bc
GTCGCATATA	GAAACACCGGTAACTATATTCATGCGATATCGCCGTATCAGTGGGGTTAG	1	bc
AGACACACAC	GAAACACCGGTAGCAAGTGGGGTTAGAGCTAGAAATAGCAAGTTAACCTA	1	bc
AAAGGCGGTT	GAAACACCGGTCGATTCATATCGAAACCTTCCCGTGACAGTGGGGTTAGA	1	bc
TATGATCGTC	GAAACACCGGTGTACGTATGGACTGAACCAGGGTGTGCAAGTGGGGTTAG	1	bc
GAGGGTCCAC	GAAACACCGGTCGGCGGCAATTAGAGCTAGAATTAGAATTAGAGCTAGAA	1	bc
AGTGTCGGAC	GAAACACCGGTACCTTTGTTGATGCTGGGTGGAAGGATTTTTGTGGGGTT	1	bc
AAATACGGTC	GAAACACCGGTCGATGGATATCGAAACCTTGCCGTGAGAAGTAGAGATAG	1	bc
AGCCCGTCTC	GAAACACCGGTGCATTCGAAAGTCCGGTCGTAGTGTGGACGTGGGGTTAG	1	bc
GCTACTCAGT	GAAACACCGGTACCTTTGTTGATGCTGGGTGGAAGGTACACCGGTACCTT	1	bc
AAGGCCATCC	GAAACACCGGTGCCCTTACTCTCACCTGATTACTTAATCCGTGGGGTTAG	1	bc
GACAAAGCAC	GAAACACCGGTTTGAACTAGAAATAGCAAGTTAACCTAAGGCTAGTCCGT	1	bc
GGAGATCTGC	GAAACACCGGTCACAGGCAATCCAGAGCTAGAAATAGCAAGTTAACCTAA	1	bc
ATCTCTCGTA	GAAACACCGGTTATATTTGTAAGTGTGTGGGGTTAGAGCTAGAAATAGCA	1	bc
ATGATTAGAC	GGAACACCGGTTTACGTTGCATCGGTGTGGGGTTAGAGCTAGAAATAGCA	1	bc
GCAAAACGCC	GAAACACCGGTTTGAACTAGAAATAGCAAGTTAACCTAAGGCTAGTCCGT	1	bc
CATTTGACGC	GAAACACCGGTCGGGGCCACTCAGTGGTGGGGTTAGAGCTAGAAATAGCA	1	bc
ATTGAGGATA	GAAACACCGGTTAAGCCGAGGTGGGGTTAGAGCTAGAAATAGCAAGTTAA	1	bc
AGTATGTATC	GAAACACCGGTCCGTAGGAGACCCGTGTGGCATGTACCTGTGGGGTTAGA	1	bc
AGACACTAAA	GAAACACCGGTAGCAAGTGCGAGACGGGGTGAGAGTGGGGTTAGAGCTAG	1	bc
ACACAACGCT	GAAACACCGGTTTGAACTAGAAATAGCAAGTTAACCTAAGGCTAGTCCGT	1	bc
GGCCTCGACG	GAAACACCGGTAAATTTGAGGCTCCGGCATGCAGGAGGCCGTGGGGTTAG	1	bc
TGTGGAGCGT	GAAACACCGGTTCCCGTCCAGTGGGGTTAGAGCTAGAAATAGCAAGTTAA	1	bc
AACCTTTACA	GAAACACCGGTCGGGGCCACTCAGTGGTGGGGTTAGAGCTAGAAATAGCA	1	bc
GGCACTCGTC	GAAACACCGGTGTGGCTGAGAGTCCGGCAATGGTGTGGCTGTGGGGTTAG	1	bc
AGCACAGCGC	GAAACACCGGTGTATTCGAAAGTCCGGTCGTAGTGTGGATGTGGGGATAG	1	bc
AGAACCATGC	GAAACACCGGTGCATTCGAAAGTCCGGTGGTAGTGTGGAAGTGGGGTTAG	1	bc
ACCTTTAACG	GAAACACCGGTCGGGGCCACTCAGTGGAGGGGTTAGAGCTAGAAATAGCA	1	bc
TTATCAACGC	GAAACACCGGTTACATTGAGGGTTAGAGCTAGAAATAGCAAGTTAACCTA	1	bc
CAACGCGGCA	GAAACACCGGTACCTTTGTTGATGCTGGACGGAAGGATTGAGGTGTTAGA	1	bc
ACGAATCCGT	GAAACACCGGTCTCGAGTGAGGTGTTCAGGGGTGGGGTTAGAGCTAGAAA	1	bc
TAGACCCGCG	GAAACACCGGTGCATTCGAAAGTCCGGTCGTAGTGTGGACGTGGGGTTAG	1	bc
GGAGATCAGC	GAAACACCGGTCGGGGTTAGAGCTAGAAATAGCAAGTTAACCTAAGGCTA	1	bc
AGTGCCCGTC	GAAACACCGGTACCCTTACTCTCACCTGATTACTTAATCCGTGGGGTTAG	1	bc
AATTCTGCCT	GAAACACTGGTCCGTAGGAGACCCGTGTGGCATGTACCTGTGGGGTTAGA	1	bc
AGTGGCGCAT	GAAACACCGGTTCCCGTCCAGTGGGGTTAGAGCTAGAAATAGCAAGTTAA	1	bc
ATAACCATGC	GAAACACCGGTTACATTGAGGGGTTACAGCTTAAAATAGCGAGATAACCT	1	bc
AATACTCGGT	GAAACACCGGTACCTTTGTTGATGCTGGGTGGAAGGATTTTTTTGTGGGG	1	bc
AGATTATTTT	GAAACACCGGTCTCGAGTGAGGTGTTCAGGGTGGGGTTATAGCTAGAAAT	1	bc
CATATACCGA	GAAACACCGGTCGGTGCCACTCAGTGGTGGGGTTAGAGCTAGAAATAGCA	1	bc
GGCAATTACA	GAAACACCGGTAAATTTGAGGCTCCGGCATGCAGGAGGCCGTGGGGTTAG	1	bc
GGTCGCTAGA	GAAACACCGGTAAATTTGAGGCTCCGGCATGCAGGAGGCCGTGGGGTTAG	1	bc
AGACCTATAC	GAAACACCGGTAACTATATTCATGCGATATCGCCGTATCAGTGGGGTTAG	1	bc
AACAACGCAA	GAAACACCGGTTTGAACTACCTGGGGTTAGAGCTAGAAATAGCAAGTTAA	1	bc
GGGAGTGTAA	GAAACACCGGTTAAGCCGAGGCGTTAATTAGAGCTAGAAATAGCAAGTTA	1	bc
AGAATCGCGC	GAAACACCGGTGCATTCAAAAGTCCGGTCGTAGTGTGGACGTGGGGTTAG	1	bc
TAGGTTACTC	GAAACACCGGTTCCCGTCCTGTGGGGTTAGAGCTAGAAATAGCAAGTTAA	1	bc
AGGAACCATC	GAAACACCGGTGTGGCTGAGAGTCCGGCAATGGTGTGGCTGTGGGGTTAG	1	bc
ACTTGTCGTC	GAAACACCGGTGTACGTATGGACTGAACCAGGGTGTGCAAGTGGGGTTAG	1	bc
GGCCCCGTGC	GAAACACCGGTGTGGCTGAGAGTCCGGCAATGGTGTGGCTGTGGGGTTAG	1	bc
AAGGCTGACT	GAAACACCGGTCCGTAGGAGACCCGTGTGGCATGTACCTGAGGGGTTAGA	1	bc
GGATCGTCGT	GAAACACCGGTGTACGTATGGACTGAACCAGGGTGTACAAGTGGGGTTAG	1	bc
TTAATCGTAC	GAAACACCGGTACCTTTGTTGATGCTGGTGTGGGGTTAGAGCTAGAAATA	1	bc
GCAAAACGCC	GAAACACCGGTTTGAACTAGAAATAGCAAATTAACCTAAGGCTAGTCCGT	1	bc
ACTCTACCGG	GAAACACCGGTCGGGGCCACTCAGTGGTGGGGTTAGAGCTAGAAATAGCA	1	bc
ACGAGCGGTG	GAAACACCGGTTGATTCATATCGAAACCTTCCCGTGACAGTGGGGTTAGA	1	bc
ATACGCTCGA	GAAACACCGGTTAATTCGAAGAGCCGGTCGAGGTGTAGACGTGGGGTTAG	1	bc
GAGTCTGCAT	GAAACACCGGTCCGTAGGAGACCCGTGTGGCATGTACCTGTGGGGTTAGA	1	bc
GAACGCACTA	GAAACACCGGTGCCCTTACTCTCACCTGATTACTTAATCCGTGGGGTTAG	1	bc
AGAGCGTAGC	GAAACACCGGTGTACGCATGGACTGAACCAGGGTGTGCAAGTGGGGTTAG	1	bc
ACGAATTCTT	GAAACACCGGTCTCGAGTGAGGTGTTCAGGGTGGGGTTAGAGCTAGAAAT	1	bc
AGGAATCCTC	GAAACACCGGTGTGGCTGAGAGTCCGGCAATGGTGTGGCTGTGGGGTTAG	1	bc
TGTAGCATAC	GAAACACCGGCTAAGCCGAGGAGTTAGAGCTAGAAATAGCAAGTTAACCT	1	bc
GGAGCTACGA	GAAACACCGGTTACATTGAGATTAGAGCTAGAAAAGGCTAGTCCGTTACC	1	bc
CACGCCGCTC	GAAACACCGGTGGCCTTACTCTCACCTGATTACTTAATCCGTGGGGTTAG	1	bc
ATAACACCGT	GAAACACCGGTTACATTGCGGCGTAGGGCTAGATATAGCTAGTTAACCTA	1	bc
CATGTCCCGA	GAAACACCGGTCGGGGCCACTCAGTGGTGGGGTTAGAGCTAGAAATAGCA	1	bc
ACTCGTAGTC	GAAACACCGGTGTACGTATGGACTGAACCAGGGTGTGCAAGTGGGGTTAG	1	bc
GCGCCGCCTC	GAAACACCGGTTCCCGTCCAGTGGGGTTAGAGCTAGAAATAGCAAGTTAA	1	bc
GAGACCTTCC	GAAGCACCGGTTTGGCTGAGAGTCCGCCAATGGTGTGGCTGTGGGGTTAG	1	bc
ACCGATACTT	GAAACACCGGTCTCGAGTGAGGAGTTCAGGGTGGGGTTAGAGCTAGAAAT	1	bc
AGGCGCATAA	GAAACACCGGTTAAGCCGGGGAGTTAGAGCTAGAAATAGCAAGTTAACCT	1	bc
CAGCAAGCCA	GAAACACGGGTTAGAGCTCGAACTAGCAAGTTAAACTAATGCTAGTACGT	1	bc
AACACGGCCA	GAAACACCGGTTTGAACTACCGGGGTTAGAGCTAGAAATAGCAAGTTAAC	1	bc
GAAAAAGCCA	GAAACACCGGTAGCAAGTGCGGGTTAGAGCTAGAAATAGCAAGTTAACCT	1	bc
AACATACAGT	GAAACGCCGGTCGATTCATATCGAAACCTTCCCGTGACAGTGGGGTTAGA	1	bc
ATACAACGCA	GAAACACCGGTTTGAACTAGAAATAGCAAGTTAACCTAAGGCTAGTCCGT	1	bc
ATCTACTCGG	GAAACACCGGTACCTTTGTTGATGCTGGGTGGTGGGGTTAGAGCTAGAAA	1	bc
AAGAGCCCTG	GAGACACCGGTGCATTCGAAAGTCCGGTCGTAGTGTGGACGTGGGGTTAG	1	bc
ACACGCCGTC	GAAACACCGGTTCCCTTACTCTCACCTGATTACTTAATCCGTGGGGTTAG	1	bc
TCGAGTTGTG	GAAACACCGGTGACATTGGGTATGGGGTTAGAGCTAGAAATAGCAAGTTA	1	bc
TGAGCGATGC	GAAACACCGGTTACATTGAGGGGTTAGAGCTAGAAATGGCAAGTTAACCT	1	bc
AAGTCGGCCT	GAAACACCGGTCCGTAGGAGACCCGTGTGGCATGTACCTGTGGGGTTAGA	1	bc
ATCCATCGAG	GAAACACCGGTTATATCTGTAAGTGTGTGGGGTTAGAGCTAGAAATAGCA	1	bc
ATGACAAGCT	GAAACACCGGTTTACGTTGCATCGGTTTGTGGGGTTAGAGCTAGAAATAG	1	bc
ATGCCAAACA	GAAACACCGGTATACGGTGCATCGGTTGTTTGGTCAGAGCTAGAAATAAC	1	bc
CAAGCCGTAC	GAAACACCGGTGCCCTTACTCTCACCTGGTTGCTTAATCCGTGGGGTTAT	1	bc
AAACAACGCC	GAAACACCGGTTTGAACTACCTGGGGTTAGAGCTAGAAATAGCAAGTTAA	1	bc
AGGAAGCCTC	GAAACACCGGTGTGGCTGAGAGTCCGGCAATGGTGTGGCTGTGGGGTTAG	1	bc
TTAGGCACAA	GAAACACCGGTTAAGCCGAGGAGTTAATTAGAGCTAGAAATAGCAAGTTA	1	bc
AAGAAACTCG	GAAACACCGGTGCATTCGAAAGTCCGGTCGTAGTGTGGACGTGGGGTTAG	1	bc
GAGCTGTCGG	GAAACACCGGTAAAGGGCATATGAGGGAGGGAATCGATGTGTGGGGTTAG	1	bc
GAAGATAGGC	GAAACACCGGTAACTATATTCATGCGATATCGCCGTATCAGGGGGGTTAG	1	bc
AAAGCCGAAC	GAAACACCGGTGCCCTTACTCTCACCTGATTACTTAATCCGTGGGGTTAG	1	bc
ACGTTTAGTT	GAAACACCGGTCGATTCATATCGAAACCTTCCCGTGACAGTGGGGTTAGA	1	bc
AAAATTGCCA	GAAAAACAGGTTTGGGGTTAGAGCTAGAAATAGCAAGTTAACCTAAGGCT	1	bc
AGTATGACTA	GAAACACCGGTCCGTAGGAGACCCGTGTGGCATGTACCTGTGGGGTTAGA	1	bc
TGAGCCATGA	GAAACACCGGTTACAATTGGGGTTAGAGCTAGAAATAGCAAGTTAACCTA	1	bc
CGTCTGTATC	GAAACACCGGTCCGTAGGAGACCCGTGTGGCATGTACCTGTGGGGTTAGA	1	bc
CTATCCACGC	GAAACACCGGTACCTTTGTTGATGCTGGGTGGATAGGAATTCGGGCCCAT	1	bc
ATCACACTAC	GAAACACCGGTGCCCTTACTCTCACCTGATTACTTAATCCGTGGGGTTAG	1	bc
AGCCTCCGGC	GAAACACCGGTACCTTTCTTGAGGCTGGGGGGGGCTAGAGCTAGAAATAG	1	bc
ATTGAGCATC	GAAACACCGGATAATACGATAGGGGTTAGAGCTAGAAATAGCAAGTTAAC	1	bc
TCCATTAAGG	GAAACACCGGTCGGGGCCACTCAGTGGTGGGGTTAGAGCTAGAAATAGCA	1	bc
TATATAAGGG	GAAACACCGGTTATATTTGTAAGTGTGTGGGGTTAGAGCTAGAAATAGCA	1	bc
CAGAGTCATC	GAAACACCGGTGTACGTATGGACTGAACAGGGTGTGCAAGTGGGGTTAGA	1	bc
AAACAACGCC	GAAACCCGGGTTAGAGCTAGAAATAGCAAGTTAACCTAAGGCTAGTCCGT	1	bc
AAGGCGGATC	GAAACACCGGTACCACGCACATCAGGAGTAGTGGAGTTAGAGCTAGAAAT	1	bc
AAAGACCTAT	GAAACACCGGTGCCCTTACTCTCACCTGATTACTTAATCCGTGGGGTTAG	1	bc
AAAAACTCTC	GAGCTAGAAATAGCAAGTTAACCTAAGGCTAGTCCGTTATCAACTTGAAA	1	bc
CTACCCACCC	GAAACACCGGTACCTTTGTTGATGCTGGGTGGGTAGGAATTCGGGCCCAT	1	bc
AGAATACATC	GAAACACCGGTCCGTAGGAGACCCGTGTGGCATGTACCTGTGGGGTTAGA	1	bc
CATGGTAGAC	GAAACACCGGTGTACGTATGGACTGAACCAGGGTGTGCAAGTGGGGTTAG	1	bc
ACCGCCACAC	GAAACACCGGTGCCCTTACTCTCACCTGATTACTTAATCCGTGGGGTTAG	1	bc
TTAGCCGAGT	GAAACACCGGTTACATTGTGATTAGAGCTAGACAAGGCAAGTCCGTTATA	1	bc
ACGAATACTT	GAAACACCGGTCTCGAGTGAGGTGTTCAGGTGGGGTTAGAGCTAGAAATA	1	bc
TACAAAGAGA	GAAACACCGGTAGCAAGTGCGAGACGTGTTTTTGTGGGGTTAGAGCTAGA	1	bc
TCACGCCCTC	GAAACACCGGTGCCCTTACTCTCACCTGATTACTTAATCCGTGGGGTTAG	1	bc
CCATTAGGGT	GAAACACCGGTCGATTCATATCGAAACCTTCCCGTGACAGTGGGGTTAGA	1	bc
ATGATGCCTC	GAAACACCGGTCCGTAGGAGACCCGTGTGGCATGTACCTGTGGGGTTAGA	1	bc
AAATCGTCGT	GAAACACCGGTGTACGTATGGACTGAACCAGGGTGTGCAAGTGGGGTTAG	1	bc
CCCACCTCCC	GAAACACCGGTTTGAACTAGAAATAGCAAGTTAACCTAAGGCTAGTCCGT	1	bc
ATGACTACCA	GAAACACCGGTTTACGTTGCATCGGCTGTGGGGTTAAAGCTAGAATTAGC	1	bc
AGGCATCGGA	GAAACACCGGTGTAGCTGAGAGTCCGGCAATGGTGTGGCTGTGGGGTTAG	1	bc
GAAAGGTTCC	GAAACACCGGTGTGGCTGAGAGTCCGGCAATGGTATGGCTGGGGGTTGAG	1	bc
AAGGCGATAC	GAAGCACCGGTGCCCTTACTCTCACCTGATTACTTAATCCGTGGGGTTAG	1	bc
ACGGGTTGTC	TTAGAGCTAGAAATAGCAAGTTAACCTAAGGCTAGTCCGTTATCAACTTG	1	bc
TGAAGCATTA	GAAACACCGGTCTCGAGTGAGGTGTTCAGGGTGGGGTTAGAGCTAGAAAT	1	bc
TAGTCTGACT	GAAACACCGGTCCGTAGGAGACCCGTGTGGCATGTACCTGTGGGGTTAGA	1	bc
GTGGACTCGC	GAAACACCGGTGCATTCGAAAGTCCGGTCGTAGTGGAGACGTGGGGTTAG	1	bc
ACTCGTCTTC	GAAACACCGGTGTACGTATGGACTGAACCAGGGTGTGCAAGCGGGGTTAG	1	bc
GCCGCCGTCT	GAAACACCGGTCGATTCATATCGAAACCTTCCCGTGACAGTGGGGTTAGA	1	bc
CTATCCACCC	GAAACACCGGTACCTTCGTTGATGCTGGGTGGATAGGAATTCGGGCCCAT	1	bc
GCGATACCGC	GAAACACCGGTCGGGGCCACCGGTGGGGTTAGAGCTAGAAATAGCAAGTT	1	bc
ATACGGTCGC	GAGACACCGGTGCATTCGAAAGTCCGGTCGTAGTGTGGACGTGGGGTTAG	1	bc
AGACAATAGC	GAAACACCGGCGCATTGGAAAGTCGGGTGGTATTGTGGACGTGGGGTTAA	1	bc
GAGGCAGCTC	GAAACACCGGTTCCCGTCCAGTGGGGTTAGAGCTAGAAATAGCAAGTTAA	1	bc
ATGATCATAT	GAAACACCGGTTAAGACGAGTGGGGTTAGAGCTAGAAATAGCAAGTTAAC	1	bc
GTTACACCTG	GAAACACCGGTAAATTTGAGGCTCCGGCATGCAGGAGGCCGTGGGGTTAG	1	bc
ATAGGGATGA	GAAACACCGGTTACATTGAGGGTTAGAGCTAGAAATAGCAAGTTAACCTA	1	bc
GCAACTCGGC	GAAACACCGGTACCTTTGTTGATGCTGGGTGGAAGGAATGTGGGGTTAGA	1	bc
CAAAAAGACC	GAAACACGGGTTAGAGCTAGAAATAGCAAGTTAACCTAAGGCTAGTCTGT	1	bc
CGAGATGCGC	GAAACACCGGTCGGCGGCAATCGTGGGTGGGGTTAGAGCTAGAAATAGCA	1	bc
AAGGTTGTAC	GAAACACCGGTAACTGTATTCATGCGATATCGCCGTATCAGTGGGGGTAG	1	bc
ACACTTAGGT	GAAACACCGGTCGATTCATATCGAAACCTTCCCGTGACAGTGGGGTTAGA	1	bc
CCGTTAATGA	GAAACACCGGTCGAGGCCAATCAGTGGTGGGGGTAGAGCTAGCTAGAACA	1	bc
ATGTGAGTAA	GAAACACCGGTTAAGCCGAGTGGGGTTAGAGCTAGAAATAGCAAGTTAAA	1	bc
ACGAATCGTT	GAAACACCGGTCTCGAGTGAGGTGTTCAGGTGGGGTTAGAGCTAGAAATA	1	bc
ACCCAACGCC	GAAACACCGGTTTGAACTAGAAATAGCAAGTTAACCTAAGGCTAGTCCGT	1	bc
GAGGCGGTCC	GAAACACCGGTATCAAGTGTGTGGGGGTAGAGCTAGAAATAGCAAGGTAA	1	bc
AGTCTAGTCA	GAAACACCGGTCCGTAGGAGACCCGTGTGGCATGTACCTGTGGGGGTAGA	1	bc
GAAGACGAGT	GAAACACCGGTCGGCGGCAATCGCGGGTGGGGTTAGATCTAGAAATAGCA	1	bc
ATGGAGGGTC	GAAACATCGGTTCCCTCCCAGTGAGACTATAGCTAGAAATAGCAAGTTAA	1	bc
GCATCTGGTT	GAAACACCGGTCGATTCATATCGAAACCTTCCCGTGACAGTGGGGTTAGA	1	bc
AGCATGCTGC	GAAACACCGGTCCGGAGGAGACCCGGGTGATATGGACCCTTTGGGGTAGA	1	bc
GCTTCAGAGA	GAAACACCGGTAGCAAGTGCGGGGTTAGAGCTAGAAATAGCAAGTCAACC	1	bc
TCTTTCGGGT	GAAACACCGGTTATATTTGTAAGTGTGTGGGGTTAGAGCTAGAAATAGCA	1	bc
GTCACCGCCA	GAAACACCGGTAGCAAGTGCGAGACGTGTTTTTGTGGGGTTAGAGCTAGA	1	bc
ACCTTTACTG	GAAACACCGGTCGGGGCCACTCAGTGGTGGGGTTAGAGCTAGAAATAGCA	1	bc
CGTTTAGTCC	GAAACACCGGTGACAGTGGCTACGGGGTGGGGTTAGAGCTAGAAATAGCA	1	bc
CACCTTTACC	GAAACACCGGTCGGGGCCACTCAGTGGTGGGGTTAGAGCTAGAAATAGCA	1	bc
CGTCCTATTA	GAAACACCGGTCACAAGGAGACCCTTGTGGCGTTAACGCTAGAAATTACA	1	bc
TCAATCGGGT	GAAACACCGGTCGATTCATATCGAAACCTTCCCGTGACAAGTGGGGTTAG	1	bc
TTGCCCATCA	GAAACACCGGTTAAGCCGAGTGGCGTTAGAGCTAGAATTAGCAAGGTAAC	1	bc
CGTACCTCGT	GAAACACCGGTGCATTCGAAAGTCCGGTCGTAGTGTGGACGTGGGGTTAG	1	bc
AATAAGGCCC	GAAACACCGGTTTGAACTACCTAGTTCAAACCGGTGGGGTTAGAGCTAGT	1	bc
CTATCCACCC	CAAAACACCGGTACCTTTGTTGATGCTGGGTGGATAGGAATTCGGGCCCA	1	bc
GGGACAGTCC	GAAACACCGGTGTGGCTGAGAGTCCGGCAATGGTGTGGCTGGGGGGTTAG	1	bc
TCTCTCCTTC	GAAACACCGGTCGGGGCCACTCAGTGGTGGGGTTAGAGCTAGAAATAGCA	1	bc
CCCACCCCCC	GAAACACGGGTTAGAGCTAGAAATAGCAAGTTAACCGAAGGCGGGGCCGT	1	bc
ACCAACGCAC	GAAACACCGGTTTGAACTACCTAGGGGGTAGTTCAAACCGGGGTTAGAGC	1	bc
GTGCAGACTT	GAAACACCGGTTCACGTCCTGTGGGGTTAGAGCTAGAAAAAAGCAGTTAA	1	bc
AACCTAGATC	GAAACACCGGTCGGGGCCACTCAGTGGTGGGGTTAGAGCTAGAAATAGCA	1	bc
GGGGCGCCGC	GAAACACCGGTCGGCGGCAATCGTGGTATGAGCCACGTGGGGTTAGATCG	1	bc
TTAGATGTGC	GAGTTGGGGTTAGAGCTAGAAATAGCAAGTTAACCTAAGGCCAGTCCGTT	1	bc
AAGATCCTCG	GAAACACCGGTACAATCGAAAGTCTGGTCGTAGTGTGGACGTGGGGAAAG	1	bc
AGGATCCTAC	GAAACACCGGTAAATTTGAGGCTCCGGCATGCAGGAGGCCGTGGAGTTAG	1	bc
CGCCTTTACC	GAAACACCGGTCGGGGCCACTCAGTGGTGGGGTTAGAGCTAGAAATAGCA	1	bc
AACATCGACG	GAAACACCGGTGTACGTATGGACTGAACCAGGGTGTGCAAGTGGGGTTAG	1	bc
AGCAGACCCG	GAAACACCGGTCGGCGGCAATCGTGTTACCTGGCAAGAGCTAGAAATAGC	1	bc
TCCCTTAACG	GAAACACCGGTCGGGGCCACTCAGTGGTGGGGTTAGAGCTAGAAATAGCA	1	bc
GTAGTCTGCC	GAAACACCGGTCCGTAGGAGACCCGTGTGGCATGTACCTGTGGGGTTAGA	1	bc
GGGGCCCTAC	GAAACACCGGTAAATTTGAGGCTCCGGCATGCAGGAGGCCGTGGGGTTAG	1	bc
CATAACGGGC	GAAACACGGGTTAGCGCTAGAAATAAAAAGTTAACCTAAGCATAGTCCGT	1	bc
GAAACGCCCT	GAAACACCGGTGCCCTTACTCTCACCTGATTACTTAATCCGTGGGGTTAG	1	bc
ACTTTATTCC	GAAACACCGGTCGGGGCCACTCAGTGGTGGGGTTAGAGCTAGAAATAGCA	1	bc
AGACCCGGGA	GAAACACCGGTGCATTCGAAAGTCCGGTCGTAGTGTGGACGTGGGGTTAG	1	bc
TGACAAAGAC	GAAGCACCGGTAGCAAGTGGGGTTAGAGCTAGAAATAGCAAGTTAACCTA	1	bc
CGGGTTGCTC	GAAACACCGGTGACAGTGGGGAGGGGTAGAGCTAGAAAAAGCAAGTTTAC	1	bc
CTAGCTGTGG	GAAACACCGGTTACATTGGGCGCTATAGCTAGAAATAGCAGGTTAACCTA	1	bc
GGCACCGAAA	GAAACACCGGTAAATTTGAGGCTCCGGCATGCAGGAGGCCGTGGGGTTAG	1	bc
ACACAACGGC	GAAACACCGGTTTGAACCGGTGGGGTTAGAGCTAGAAATAGCAAGTTAAC	1	bc
GCTATTGAAC	GAAACACCGGTTATATTTGTAAGTGTGTGGGGTTAGAGCTAGAAATAGCA	1	bc
GAGCGGACAA	GAAACACCGGTCCGTAGGAGACCCGTCCTGTTGTGGGGTTAGAGCTAGAA	1	bc
CGTTCTGACT	GAAACACCGGTGACATTGGGTAATATGGGGGTAGAGCTAGAAATAGCAAG	1	bc
GGACACCTCT	GAAACACCGGTGTGGCTGAGAGTGCGGCTATGGTGTGGCTGTGGGGGTAA	1	bc
ACTCTCCTTC	GAAACACCGGTGTACGTATGGACTGAACCAGGGTGTGCGAGTGGGGATAG	1	bc
TTTGATCATA	GAAACACCGGTTAAGCCGAGGAGTTAGAGCTAGAAATAGCAAGTTAACCT	1	bc
CGAACCTCGT	GAAACACCGGTGCATTCGAAAGTCCGGTCGTAGTGTGGACGTGGGGTTAG	1	bc
ACTTTAACTA	GAAACACCGGTCGGGGCCACTCAGTTAGAGCTAGAAATAGCAAGTTAACC	1	bc
GGCTCAGGCC	GAAACACCGGTGAGGCTGCTTTTCCGGCGGTGGTAGGGCTAGGGGTAGCA	1	bc
ATGGAATCCT	GAAACACCGGTCTCGAGTGAGGTGTTCAGGGTGGGGTTAGAGCTAGAAAT	1	bc
ACTACTCGGT	GAAACACCGGTACCTTTGTTGATGCTGGGTGGAAGGAATTTGTGGGGTTA	1	bc
GAACCCCTCC	GAAACACCGGTGTGGCTGAGAGTCCGGCAATGGTGTGGCTGTGGGGTTAG	1	bc
AAGAGTAACG	GAAACACCGGTGCATTCGAAAGTCCGGTCGTAGTGTGGACGTGGGGTTAG	1	bc
AAGCGCCGTC	GAAACACCGGTGTACGTATGGACTGAACCAGGGTGTGCAAGTGGGGTTAG	1	bc
AGGAAACGGA	GAAACACCGGTAGCAAGTGCGTGGGGTTAGAGCTAGAAATAGCAAGTTGA	1	bc
GCGAATCATG	GAAACACCGGTCTCGAGTGAGGTGTTCAGGGTGGGGTTAGAGCTAGAAAT	1	bc
ATCTTTACAG	GAAACACCGGTCGGGGCCACTCAGTGGTGGGGTTAGAGCTAGAAATAGCA	1	bc
CTCATTTACC	GAAACACCGGTCGGGGCCACTCAGTGGTGGGGTTAGAGCTAGAAATAGCA	1	bc
AATGCGGAGC	GGAACAACGGTTTACGTTGCATCGGTGTGGGGTTAGAGCTAGAAATAGCA	1	bc
AAAAGCCGAC	GAAACACCGGTGCATTCGAAAGTCCGGTCGTAGTGTGGACGTGGGGTTAG	1	bc
AAGCTAAGAT	GAAACACCGGTTTAAGTTGCTTCGTGGTAGGGCTAGATATAGCAAGATAA	1	bc
ATGTTGAGTT	GAAACACCGGTTTACTTTGCATCGGCTTCGTGCTTGACATAGCAAGTTAA	1	bc
ATGCATAGAA	GAAACACCGGTTTAAGACGCATCGGGCTGGAGGTAGAAATAGGAAGTTAG	1	bc
AAAGGCCCTA	GAAACACCGGTGCCCTTACTCTCACCTGATTACTTAATCCGTGGGGTTAG	1	bc
GGGCAACCTC	GAAACACCGGTGTGGCTGAGAGTCCGGCAATGGTGTGGCTGTGGGGTTAG	1	bc
CGTTATGTTT	TTAGAGCTAGAAATAGCAAGTTAACCTAAGGCTAGCCCGTTATCAACTTG	1	bc
ATGCTGACTT	GAAACACCGGTTTACGTTGCATCGGGGTTAGAGCTAGAAATAGCAAGTTA	1	bc
AAAGCAGTAC	GAAACACCGGTGCCCTTACTCTCACCTGATTACTTAATCCGTGGGGTTAG	1	bc
ACAGCGACGT	GAAACACCGGTGTACGTATGGACTGAACCAGGGTGTGCAAGTGGGGTTAG	1	bc
GGCGCTTGGT	GAAACACCGGTAACTTTGAGGCTCCGGCATGCAGGAGGCCGTGGGGATAG	1	bc
ACGAATGCTT	GAAACACCGGTCTCGAGTGAGGTGTTCAGGGTGGGGTTAGAGCTAGAAAT	1	bc
CTGCGCTTGA	GAAACACCGGTTAAGCCGAGTGGGGTTAGAGCTAGAAATAGCAAGTTAAC	1	bc
ATTCTCAGCG	AAACAACTTGAAAAAGTGGCACAGAGTCGGTGCTTTTTTTCCTGCAGGCC	1	bc
AAATACGCCC	GAGCTAGAAATAGCAAGTTAACCTAAGGCTAGTCCGTTATCAACTTGAAA	1	bc
GGCACACTAA	GAAACACCGGTGTGGCTGAGAGTCCGGCAATGGTGTGGCTGTGGGGTTAG	1	bc
ATAATTTATA	GAAACACCGGTAACTATATTCATGCGATATCGCCGTATCAGTGGGGTTAG	1	bc
TGTGGAGACT	GAAACACCGGTGACATTGGGTACATTGGGTACATTGGGTGGGGGTAGAGC	1	bc
ACACAACGAT	GAAACACCGGTTTGAACTAGAAATAGCAAGTTAACCTAAGGCTAGTCCGT	1	bc
AGTGGAGGCT	GAAACACCGGTTCCCGTCCAGTGGGGTTAGAGCTAGAAATAGCAAGTTAA	1	bc
AGTCACAGAT	GAAACACCGGTAGCAAGTGCGAGACGTGTTTTGTGGGGTTAGAGCTAGAA	1	bc
AGGAAACATT	GAAACACCAGTGTGGCTGAGTGTCCGGCAGTGGTGTGGCTGGGGGGATAG	1	bc
GACCCAGAAC	GAAACACCGGTAGCAAGTGCGAGCTAGAAATAGCAAGTTAACCTAAGGCT	1	bc
TAATTCGTGG	GAAACACCGGTTATATTTGTTAGTGTGTGGGGTTAGAGCTAGAAATTGCA	1	bc
CATTTATGGC	GAAACACCGGTCGGGGCCACTCAGTGGTGGGGTTAGAGCTAGAAATAGCA	1	bc
ACAAAACGCC	GAAACACCGGTTTGGGGTTAGAGCTAGAAATAGCAAGTTAACCTAAGGCT	1	bc
TACATTATAA	GAAACACCGGTAACTATATTCATGCGATATCACCGTATCAGTGGGGTTAG	1	bc
ATTCTATCTG	GAAACACCGGTTATATTTGTAAGTGGGGTTAGAGCTAGAAATAGCAAGTT	1	bc
GTCCCGTAAA	GAAACACCGGTAAATTTGAGGCTCCGGCATGCAGGAGGCCGTGGGGTTAG	1	bc
GACGATCCTC	GAAACACCGGTCGGGGTTAGATCTAGAAATAGCAAGTTAACCTAAGGCTA	1	bc
TGCTGTACCA	GAAACACCGGTTCCCGTCCAGCGGGGTTAGAGCTAGAAATAGCAAGTTAA	1	bc
TTCTATCGCG	GAAACACCGGTTATATTTGTAAGTGGGGTTAGAGCTAGAAATAGCAAGTT	1	bc
ATAAACCTGT	GAAACACCGGTAAATTTGAGGCTCCGGCATGCAGGAGGCCGTGGGGTTAG	1	bc
GATGAGCTAT	GAAACACCGGTTACATTGAGGGTTAGAGCTAGAAATAGCAAGTTAACCTA	1	bc
GGTACGCCTC	GAAACACCGGTCCGTAGGAGACCCGTGTGGCATGTACCTGTGGGGTTAGA	1	bc
AACGTCGCCT	GAAACACCGGTTTGAACTAGAAATAGCAAGTTAACCCAAGGCTAGTCCGT	1	bc
AGGCTGAGTC	GAAACACCGGTCCGTAGGAGACCCGTGTGGCATGTTAGGGGTTAGAGCTA	1	bc
CACATGACTT	GAAACACCGGTTTGAACTACCTAGTTGTGGGGTTAGAGCTAGAAATAGCA	1	bc
AAACCCTGGA	GAAACACCGGTGCATTCGAAAGTCCGGTCGTAGTGTGGACGTGGGGTTAG	1	bc
AAAACACCGC	GAAACACCGGTTTGAACTAGAAATAGCAAGTTAACCTAAGGCTAGTCCGT	1	bc
CGAGTTGGCC	GAAACACCGGTGACTTTGGGGATAGGGGGGGGTTAGAGCTTGAAATGGCA	1	bc
TCCTATACCG	GAAACACCGGTCGGGGCCACTCAGTGGTGGGGTTAGAGCTAGAAATAGCA	1	bc
GAAGCTAGGT	GAAACACCGGTCGGCGGCAATCGTGGGTGGGATTAGAGCTAGAAATAGCA	1	bc
AGAAGAGCCG	GAAACACCGGTCGGCGGGGGGGCTAGAGCTAGAAATAGCAAGGTAACCTA	1	bc
ACCACCCGGC	GAAACACCGGTACCTTTGTTGATGCTGGGTGGAAGGAATAGAAATAGCAA	1	bc
AGACTGTATC	GAAACACCGGTCCGTAGGAGACCCGTGTGGCATGTACCTGTGGGGTTAGA	1	bc
TTATTGGTCC	GAAACACCGGTACGTTTGTTGGTGCTGTACGGAAGTAATTTGGTGGGGAT	1	bc
AACAAAGACC	GAAACACCGGTTTGAACTAGAAATAGCAAGTTAACCTAAGGCTAGTCCGT	1	bc
CCTAACGCAC	GCTAGAAATAGCAAGTTAACCTAAGACTAGGCCGTTATCAACTTGAAAAA	1	bc
AACAACGCAA	GAAACACGGGTTAGAGCTAGAAATAGCAAGTTAACCTAAGGCTAGTCCGT	1	bc
GCTCTCCGCC	GAAACACCGGTGAGGCTGATAGTACGGCAATGGTGGGGCTGTGGGGTTAG	1	bc
AAAGGCATAC	GAAACACCGGTGCCCTTACTCTCACCTGATTACTTAATCCGTGGGGTTAG	1	bc
AGTAGACCCG	GAAACACCGGTCGGCGGCAATCGTGGTTAGAGCTAGAAATAGCAAGTTAA	1	bc
AACAGTCGGT	GAAACACCGGTCGATTCATATCGAAACCTTCCCGTGACAGTGGGGTTAGA	1	bc
CTATCTACCC	GAAACACCGGTACCTTTGTTGATGCTGGGTGGATAGGAATTCGGGCCCAT	1	bc
GGCGTCCCGC	GAAACACCGGTCGGCGGCAATCGTGGGTGGGGTTAGAGCTAGAAATAGCA	1	bc
CAGATCGAGG	GAAACACCGGTTATATTTGTAAGTGTGTGGGGTTAGAGCTAGAAATAGCA	1	bc
GGACACGCGC	GAAACACCGGTACGTTCCAAAATCCGGTCGTAGTGTGGACGTGGGGTTAG	1	bc
GACACGGATC	GAAACACCGGTAGCAATCGCGAAACGTGGTAAATAGCAAGTTAACCTAAG	1	bc
ACGTTCCCGC	GAAACACCGGTCGGGGCCACTCAGTGGCGGGGTTAGAGCTAGAAATAGCA	1	bc
TTAGCGATTA	GAAACACCGGTTACTCGTTGATTCGTTCTAGAGCTAGTAATACTAAGATA	1	bc
ACGACACGCC	GAAACACCGGTCGGCGGCAATCGTGGGGGGGGTTAGAGCTAGAAATAGCA	1	bc
GGCAACATAC	GAAACACCGGTGTGGCTGAGAGTCCGGCAATGGTGTGGCTGTGGGGTTAG	1	bc
GAGATTCTCG	GAAACACCGGTGCATTCGAAAGTCCGGTCGTAGTGTGGACGTGGGGTTAG	1	bc
AGGGCCCCTA	GAAACACCGGTAAATTTGAGGCTCCGGCATGCAGGAGGCCGTGGGGTTAG	1	bc
AAGACCATCG	GAAACACCGGTGCATTCGAAAGTCCGGTCGTAGTGTGGACGTGGGGTTAG	1	bc
AACGTACTTC	GAAACACCGGTGCCCTTATTCTCACCTGATTACGTAATACGTGGGGTAAG	1	bc
TGGACCATAC	GAAACACCGGTAAATTTGAGGCTCCGGCATGCAGGAGGCCGTGGGGTTAG	1	bc
AGACGATGTC	GGAACACCGGTGCATTCGAGAGTCCGGTCGTAGTGTGGCCGTGGGGTTAG	1	bc
GAGGACGCTC	GAAACACCGGTTTCAACTAGAAGTAGCAAGAGAAACTAAGAGTAGTCCGA	1	bc
AAGACCGCCT	GAAACACCGGTCCGTAGGAGACCCGTGTGGCATGTACCTGTGGGGTTAGA	1	bc
AAGTATGCAT	GAAACACCGGTCCGTAGGAGACCCGTGTGGCATGTACCTGTGGGGTTAGA	1	bc
TGCACGGGTC	GAAACACCGGTCCGTAGGAGACCCGTGTGGCATGTACCTGTGGGGTTAGA	1	bc
ACCGATCTAC	GAAACACCGGTGCCCTTACTCTCACCTGATTACTTAATCCGTGGGGTTAG	1	bc
GAGGGCCTAA	GAAACACCGGTTAAGTCGCGGTGGCGTTAGTGCTAGAAATAGGAGGTTAA	1	bc
TAATCGGCCT	GAAACACCGGTCCGTAGGAGACCCGTGTGGCATGTACCTTGTGGGGTTAG	1	bc
AGAGGACACG	GAAACACAGGTCGGCGGCAATCGTGGGTGGGGTTAGAGCTAGAAATAGCA	1	bc
GGAAGAATCG	GAAACACCGGTCGGCTAGAAATAGCAAGTTAACCTAAGGCTAGTCCGTTA	1	bc
AGCAAGACTC	GAAACACCGGTCCGTAGGAGACCCGTGTGGCATGTACCTGTGGGGTTAGA	1	bc
GACTACTCGG	GAAACACCGGTACCTTTGTTGATGCTGGGTGGAAGGAATTTGTGGGGTTA	1	bc
AGCACCGTTA	GAAACACCGGTTAAGTAGAGCTAGAAATAGCAAGTTAGCCTAAGGCTAGT	1	bc
AGCCTTTACC	GAAACACCGGTCGGGGCCACTCAGTGGTGGGGTTAGAGCTAGAAATAGCA	1	bc
AGAGGAGCCT	GAAACACCGGTTCCCGTCCAGTGGGGTTAGAGCTAGAAATAGCAAGTTAA	1	bc
GCGTAGCCCT	GAAACACCGGTCGGCGGCAATCGTGGGTGGGGTTAGAGCTAGAAATAGCA	1	bc
CACGAACTCC	GAAACACCGGTGCCCTTACTCTCACCTGATTACTTAATCCGTGGGGTTAG	1	bc
ACAACCGACT	GAAACACCGGTTTGAACTACCTGTGGTTAGAGCTAGAGCTAGCAAGATAA	1	bc
ACGATAGAGA	GAAACACCGGTTATATTTGTAAGTGTGTGGGGTTAGAGCTAGAAATAGCA	1	bc
AGAAGAACGC	GAAACACCGGTTTGAACTACCTAGTTCAAACCGGTGGGGTTAGAGCTAGA	1	bc
TCTCGCGCGG	GAAACACCGGTTATATTTGTAAGTGTTTGTGGGGTTAGAGCTAGAAATAG	1	bc
GTGCCCCCCC	GAAACACCGGTTTGGCTGAGTTTACGGCAATGGTATGGCTGGGAGGATAG	1	bc
AAGTGTTGTC	GAAACACCGGTGACATTGGGTACAAAAAGTGGGGTTAGAGCTAGAAATAG	1	bc
GCCATTACCG	GAAACACCGGTCGGGGCCACTCAGTGGTGGGGTTAGAGCTAGAAATAGCA	1	bc
TATGATTATC	CTTAACCTAAGGCTAGTCCGTTATCAACTTGAAAAAGTGGCACCGAGTCG	1	bc
CGACTTATTT	GAAACACCGGTCTCGAGTGAGGTGTTCAGGGGGGGGTTGGAGCTAGAAAT	1	bc
TCGGGTTGTC	GAAACACCGGTGACATTGGGTGCAGGGTGGGGTTAGAGCTAGAAATAGCA	1	bc
GTGACGCCCC	GAAACACCGGTGCGCCTCAAGTGAGGTTAGTGCTAGGACTGGCAGGTTAA	1	bc
AAGCGATGTC	GAAACACCGGTGACATTGGGGCTAGAAATAGCAAGTTAACCTAAGGCTAG	1	bc
TCGGGTCATT	GAAACACCGGTCTCGAGTGAGGTGTTCAGGGTGGGGTTAGAGCTAGAAAT	1	bc
ACAGCCCTAT	GAAACACCGGTGCCCTTACTCTCACCTGATTACTTAATCCGTGGGGTTAG	1	bc
GGGGTGGACT	GAAACACCGGTGACATTGGGTGTGGGGTTAGAGCTAGAAATAGGAAGTTA	1	bc
CTGCTTCGTT	GAAACACCGGTTTACGTTGCATCGGTGTGGGGTTAGGGCTAGAAATAGCA	1	bc
AGAGCACCGC	GAAACACCGGTGCATTCGAAAGTCCGGTCGTAGTGTGGACGTGGGGTTAG	1	bc
AGCCACGCGC	GAAACACCGGTGCATTCGAAAGTCCGGTCGTAGTGTGGACGCGGGGTTAG	1	bc
AATATCCACC	GAAACACCGGTACCTTTGTTGATGCTGGGTGGATAGGAATTCGGGCCCAT	1	bc
GTGAGAGTAA	GAAACACCGGTTAAGCCGAGTGGGGTTAGAGCTAGAAATAGCAAGTTAAC	1	bc
ACAGAAGCGC	GAAACACCGGTCGGCGGCAATCGTGGGTGGGGTTAGAGCTAGAAATAGCA	1	bc
GAAACTGACC	GAAACACCGGTAGCAAGTGGGGTTAGAGCTAGAAATAGCAAGTTAACCTA	1	bc
AATATGCTTC	GAAACACCGGTCCGTAGGAGGCCCGTGTGGCATGTACCTGTGGGGTTAGA	1	bc
ATGCCATGCA	GAAACACCGGTGTGGCTGAGAGTCCGGCAATGGTGTGGCTGTGGGGTTAA	1	bc
GGACCCTTCT	GAAACACCGGTAAATTTGAGGCTCCGGCATGCAGGAGGCCGTGGGGTTAG	1	bc
ATAAATTACA	GAAACACCGGTAACTATATTCATGCGATATCGCCGTATCAGTGGGGTTAG	1	bc
GAGACCCTAG	GAAACACCGGTGCATTCGAAAGTCCGGTCGTAGTGTGGACGTGGGGTTAG	1	bc
GGGGAGAATC	GAAACACCGGTTCCCGTCCAGTGGGGTTAGAGCTAGAGATAGCAAGTTAA	1	bc
CACGAGCTAC	GAAACACCGGTGCCCTTACTCTCACCTGATTACTTAGTGGGGTTAGAGCT	1	bc
GCCGACCTCC	GAAACACCGGTGCCCTTACTCTCACCTGATTACTTAATCCGTGGGGTTAG	1	bc
AAACGCCATT	GAAACACCGGTAACTATATTCATGCGATATCGCCGTATCAGTGGGGTTAG	1	bc
TCGCACAAAA	GTAACACCGGTTAAGCCGATGTGCTTTTTTCCTGCAGGTTATGCTCAAGA	1	bc
AACGCCTGAA	GAAACACCGGTGCCCTTACTCTCACCTGATTACTTAATCCGTGGGGTTAG	1	bc
ATGTTGAGGC	GAAACACCGGTCGGGGCCACTCAGTGGTGGGGTTAGAGCTAGAAATAGCA	1	bc
AAACAACGCC	GCTAGAAATAGCAAGTTAACCTAAGGCTAGTCCGTTATCAACTTGAAAAA	1	bc
AACATACTAC	GAAACACCGGTGCCCTTACTCTCACCTGATTACTTAATCCGTGGGGTTAG	1	bc
GCGTCGTAGT	GAAACACCGGTGTACGTATGGACTGAACCAGGGTGTGCAAGTGGGGTTAG	1	bc
AAGGCTGCCT	GAAACACCGGTCCGTAGGAGACCCGTGTGGCATGTACCTGTGGGGTTAGA	1	bc
GGCCGTCTCC	GAAACACCGGTGTGGCTGAGAGTCCGGCAATGGTGTGGCTGTGGGGTTAG	1	bc
GGGCCGTACT	GAAACACCGGTAAATTTTAGGCTCCGGCATGCAGGAGGCCGTGGGGTTAG	1	bc
TCTTGTTGTC	GAAACACCGGTGTACGTATGGACTGAACCAGGGTGTGCAAGTGGGGTTAG	1	bc
CAATTTGGTT	GAAACACCGGTCGATTCGTATCGAAACCTTCCCGTTACAGTGGGGTTAGA	1	bc
GTCACCTACT	GAAACACCGGTTTGAACTACCTAGTTCAAACCGGTGGGGTTAGAGCTAGA	1	bc
AAGTTACCGC	GAAACACCGGTCGGGGCCACTCAGTGGTGGGGTTAGAGCTAGAAATAGCA	1	bc
ACGGGTTGTC	GAAACACCGGTGACATTGGGTACAGGGTGGGGTTAGAGCTAGAAATAGCA	1	bc
GTAATGCTTT	GAAACACCGGTTCCCGTCCAGTGGGTCTAGAGCTAGATATAGCTAGTTAT	1	bc
AACGCCGACC	GAAACACCGGTGCACTTACTCTCACCTGATTACTTAATCCGGGGGGTTAG	1	bc
TTATCCGCCG	GAAACACCGGTAACTTTTTTGATGCTGGGTGGATAGGACTTGGGACACCT	1	bc
ACGTCTGCGT	GAAACACCGGTCCGTAGGAGACCCGTGTGGCATGTACCTGTGGGGTTAGA	1	bc
ACACAACGCT	GAAACACGGGTTAGAGCTAGAAATAGCAAGTTAACCTAAGGCTAGTCCGT	1	bc
AATCTATCGA	GAAACACCGGTTATATTTGTAAGTGTGTGGGGTTAGAGCTAGAAATAGCA	1	bc
ATTGTTGATT	GAAACACCGGTGACTTTGGGTAGAAATCGCAAGTTAATATAGGTCTAAAC	1	bc
AAAGAGACGC	GAAACACCGGTCGGCGGCAATCGTGGGTGGGGTTAGAGCTAGAAATAGCA	1	bc
GACTTTACGG	GAAACACCGGTCGGGGCCACTCAGTGGTGGGGTTAGAGCTAGAAATAGCA	1	bc
CAATACGGCC	GAAACACCGGTTTGAACTACCGGGGTTAGAGCTAGAAATAGCAAGTTAAC	1	bc
CGTGGTGGAT	GAAACACCGGTGACATTGGGTAGTGGGGTTAGAGCTAGAAATAGCAAGTT	1	bc
AAGTGTGCCG	GAAACACCGGTCCGTAGGAGACCCGTGTGGCATGTACCTTGTGGGGTTAG	1	bc
CTGGCTATGC	GAAACACCGGTTACATTGAGGGTTAGAGCTAGAAATAGCAAGTTAACCTA	1	bc
CGGGTTAGCT	GAAACACCGGTTTAAGTTGCCTCGGAATGGGGAGTTAGCGCTAGGAATAG	1	bc
AGTGGTGTTT	GAAACACCGGTGACATTGGGGTGGGGTTAGAGCTAGAAATAGCAAGTTAA	1	bc
ACATCTCTCG	GAAACACCGGTCGGGCCCACTCAGTGGTGGGGTTAGAGCTAGAAATAGCA	1	bc
TAGCTATGAC	GAAACACCGGTTACATTGAGGGGTTAGAGCTAGAAATAGCAAGTTAACCT	1	bc
ATACACGGAC	GAAACACCGGTACCTTTGTTGATGCTGGGTGGGGTTAGAGCTAGAAATAG	1	bc
TCATCTACCG	GAAACACCGGTCGGGGCCACTCAGTGGTGGGGTTAGAGCTAGAAATAGCA	1	bc
GTCACCTAAA	GAAACACCGGTTAAGCCGAGGAGTTAGAGCTAAAAATAGCGAGTTAACCT	1	bc
TAATACCAGC	GAAACACCGGTCGGCGGCGGTGGGGTTAGAGCTAGAAATAGCAAGTTAAC	1	bc
GAATGCGTCG	GAAACACCGGTTTACGTTGCATCGGTGTGGGGTTAGAGCTAGAAATAGCA	1	bc
ATACGCAGTA	GAAACACCGGTGCCCTTACTCTCACCTGATTACTTAATCCGTGGGGTTAG	1	bc
TCGAGTGAGG	GAAACACCGGTTATATTTGTAAGTGTTGTGGGGTTAGAGCTAGAAATAGC	1	bc
GCGGCGGCTA	GAAACACCGGTTCCCGTCCAGTGGGGTTAGAGCTAGAAATAGCAAGTTAA	1	bc
GCTTTACAGA	GAAACACCGGTCGGGGCCACTCAGTGGTGGGGTTAGAGCTAGAAATAGCA	1	bc
CATCTATCGA	GAAACACCGGTTATATTGGGGTTAGAGCTAGAAATAGCAAGTTAACCTAA	1	bc
GGCTGCCTGC	GAAACACCGGTGTGGCTGAGAGTCCGGCGATGGTGTGGCTGTGGGGCTAG	1	bc
TCGCCCTGCC	GAAACACCGGTGCATTCGAAAGTCCGGTCGTAGTGTGGACGTGGGGTTAG	1	bc
GCTGTAGATC	GAAACACCGGTCGGGGCCACTCAGTGGTGGGGTTAGAGCTAGAAATAGCA	1	bc
CTGCTTAGGC	GAAACACCGGTTTACGTTGCATCGGTGTGGGGTTAAAGCTAGAAATAGCA	1	bc
CATGTACAGC	GAAACACCGGTCGGGGCCACTCAGTGGTGGGGTTAGAGCTAGAAATAGCA	1	bc
GAGGAACAGT	GAAACACCGGTCGGCGGAAATTGTGGGTGGGGTTAGAGCTAGAAATAGCA	1	bc
AGTACTCGGA	GAAACACCGGTACCTTTGTTGTGGGGTTAGAGCTAGAAATAGCAAGTTAA	1	bc
TATATCGCAG	GAAACACCGGTTATATTTGTAAGTGTGGGGTTAGAGCTAGAAATAGCAAG	1	bc
AGTAGACCCC	GAAACACCGGTCCGTAGCCGACGCGTGTGGCATGTACATGAGGGAGTAGA	1	bc
AAGGAGCCGC	GAAACACCGGTTCCCGTCCAGTGGGGTTAGAGCTAGAAATAGCAAGTTAA	1	bc
CGACCATGGC	GAAACACCGGTGCATTCGAAAGTCCGGTCGTAGTGTGGACGTGGGGTTAG	1	bc
CATAGTAGTA	GAAACACCGGTGTACGTATGGACTGAACCAGGGTGTGCAAGTGGGGTTAG	1	bc
ACATCGGTGC	GAAACACCGGTGTACGTATGGACTGAACCAGGGTGTGCAAGTGGGGCTAG	1	bc
TCCAACGCGC	GAAACACCGGTTATATTTGTATGGGTGTGGGGTTAGAGCTAGAAATAGCA	1	bc
GAAGTACCGA	GAAACACCGGTCGGCGGCAATCGTGGGTGGGGTTAGAGCTAGAAATAGCA	1	bc
GAGACAGTAA	GAAACACCGGTAGCAAGTGCGAGACGTGTTAAATAGCAAGGCAACCTTAG	1	bc
ATACCTTCTC	GAAACACCGGTGCATTCGAAAGTCCGGTCGTAGTGTGGACGTGGGGTTAG	1	bc
TCTACCTGCC	GAAACACCGGTAAATTTGAGGCTCCGGCATGCAGGAGGCCGTGGGGTTAG	1	bc
CCGTTACTGA	GAAACGCCGGTCGGGGCCACTCAGTAGTGGGGTTAGGGCTAGAAATAGCA	1	bc
TCGAGCTTCA	GAAACACCGGTTCAGCCGAGTGGGGTTAGAGCTAGAAATAGCAAGTTAAC	1	bc
TTTAGCGTAC	GAAACACCGGTTAAGCCGAGTGGGGTTAGAGCTAGAAATAGCAAGTTAAC	1	bc
TATTTAAAGC	GAAACACCGGTCGGGCCACTCAGTGGTGGGGTTAGAGCTAGAAATAGCAA	1	bc
AAATCCAAGG	GAAACACCGGTGCATTCGAAAGTCCGGTCGTAGTGTGGACGTGGGGTTAG	1	bc
ATGAAGCGAA	GAAACACCGGTCGGCGGCAATCGTGTGGGGGTGGGGTTAGAGCTAGAAAT	1	bc
AAGGGAGCCT	GAAACACCGGTTCCCGTCCAGTGGGGTTAGAGCTAGAAATAGCAAGTTAA	1	bc
CTGGGTTTTT	GAAACACCGGTTAAAATTGAGGGTTAGAGCTAGGGATAACAGCTTGACCT	1	bc
GGAACACTCA	GAAACACCGGTGTGGCTGAGAGTCCGGCAATGGTGTGGCTGTGGGGTTAG	1	bc
CCAATCGTTG	GAAACACCGGTTATATTTGTAAGTGTGTGGGGTTAGAGCTAGAAATAGCA	1	bc
TACGACGCTC	GAAACACCGGTCGGCGGCAATCGTGGGTGGGGTTAGAGCTAGAAATAGCA	1	bc
ACGATTATCT	GAAACACCGGTTTACGTTGCATCGGTGTGGGGTTAGAGCTAGAAATAGCA	1	bc
GACATGCGGT	GAAACACCGGTCGATTCATATCGAAACCTTCCCGTGACAGTGGGGTTAGA	1	bc
AGAACGCCTG	GAAACACCGGTGCCCTTACTCTCACCTGATTACTTAATCCGTGGGGTTAG	1	bc
ATTAGATATG	GAAACACCGGTTACATTGAGGGGTTAGAGCTAGAAATAGCAAGTTAACCT	1	bc
AACTATCGAG	GAAACACCGGTTATATTTGTAAGCGTGTGGGGTTAGAGCTAGAAATAGCA	1	bc
AATTGAGTAT	GAAACACCGGTTAAGCCGAGGGGTTAGAGCTAGAAATAGCAAGTTAACCT	1	bc
GAAGAATCGA	GAAACACCGGTCGGCGGCAAGTTAATAAATAGCAAGTTAGCCTAAGGCTA	1	bc
CGACTTCGTC	GAAACACCGGTGTACGTATGGACTGAACCAGGGTGTGCAAGTGGGGTTAG	1	bc
AGGGGGCCTC	GAAACACCGGTCCGTAGGAGACCCGTGTGGCATGAACCCTTGGGGTTACA	1	bc
ACTATGGATC	GAAACACCGGTAATCAGGGGAGAAGGTAAGCATGTGCTAGAGCGAGAAAT	1	bc
AGTGGAGCAT	GAAACACCGGTTCCCGTCCAGTGGGGTTAGAGCTAGAAATAGCAAGTTAA	1	bc
CGCGCCGCCC	GAAACACCGGTGACATTGGGTAGAGGGTGGGGTTAGAGCTAGAAAGTTCA	1	bc
ACGTTCGGGC	GAAACACCGGTCAATTCATGTCAAAACATTCCAGCGAAAGTGTGGTTCGA	1	bc
AAGGCTGCGT	GAAACACCGGTCCGTAGGAGACCCGTGTGGCATGTACCTGTGGGGTTAGA	1	bc
GTGGGCCCCC	GAAACACCGGTTCCCGTCCAGTGGGGTTAGAGCTAGAAATAGCAAGTTAA	1	bc
ATATACACCC	GAAACACCGGTACCTTTGTTGATGCTGGGTGGATAGGAATTCGGGCCCAT	1	bc
CGACCCTCTG	GAAACACCGGTGCATTCGAAAGTCCTGTCGTGGGGTTAACGTGGGGAAAA	1	bc
CTCCACGCCT	GAAACACCGGTTGAGGGCGTGTGAGGGATTGAAGCGATGAGTTGAGCTAA	1	bc
TCGATTCCTT	GAAACACCGGTCTCGAGTGAGGTGTTCAGGGTGGGGTTAGAGCTAGAAAT	1	bc
CATACTCGTA	GAAACACCGGTGTACGTATGGACTGAACCAGGGTGTGCAAGTGGGGTTAG	1	bc
ACGTTATCGT	GAAACACCGGTCGGGGCCACTCAGTGGTGGGGTTAGAGCTAGAAATAGCA	1	bc
GCGAGCCAAA	GAAACACCGGTTAAGCCGTGTGTGGTTAGAGCTAGAAATAGCAGGTTAAC	1	bc
ACGCATCCTT	GAAACACCGGTCTCGAGTGAGGTGTTCAGGGTGGGGTTAGAGCTAGAAAT	1	bc
ATAACGTTCT	GAAACACCGGTTGCAATCAGGGTGAGATATTGACCTAGCAGGTTGACCTA	1	bc
GAACGACGCC	GAAACACCGGTTTGAACTACCTAGTTCAAACCGGTGGGGTTAGAGCTAGA	1	bc
AGGCGGATTC	GAAACACCGGTCAGTAGGAGACCCGTGTGGCATGTACCTGTGGGGTTAGA	1	bc
AAACGCAATA	GAAACACCGGTGCCCTTACTCTCACCTGATTACTTAATCCGTGGGGTTAG	1	bc
CGTGGGGTCC	GAAACACCGGTGACATTGGGTTAGGGCTAGAAATAGAAAGTTAACCTAAG	1	bc
TTAGCCAAGG	GAAACACCGGTTACAGGGGTTAGAGCTAGAAATAGCAAGTTAACCTAAGG	1	bc
TGACACAGGC	GAAACACCGGTAGCAAGTGCGAGACGTGTTAAATAGCAAGTTAACCTAAG	1	bc
ATCTATAGAG	GAAACACCGGTTATATTTGTAAGGGGTTAGAGCTAGAAATAGCAAGTTAA	1	bc
GATTAGCTAT	GAAACACCGGTTACATTGAGGGTTAGAGCTAGAAATAGCAAGTTAACCTA	1	bc
AGCATGGGGT	GAAACACCGGTCGATTCATATCGAAACCTTCCCGTGACAGTGGGGTTAGG	1	bc
GCGACCTCTT	GAAACACCGGTCTCGAGTGAGGTGTTCAGGGTGGGGTTAGAGCTAGAAAT	1	bc
ATCTATCGAC	GAAACACCGGTCTCGAGTGAGGTGTTCAGGTGGGGTTAGAGCTAGAAATA	1	bc
ACTTGAGCGC	GAAACACCGGTCGGGGCCACTCAGTGGTGGGGTTAGAGCTAGAAATAGCA	1	bc
ACAGTACTAC	GAAACACCGGTGCCCTTACTCTCACCTGATTACTTAATCCGTGGGGTTAG	1	bc
AAACGCAGTC	GAAACACCGGTGCCCTTACTCTCACCTGATTACTTAATCCGTGGGGTTAG	1	bc
TGTCTGATTA	GAAACACCGGTTCGTAGGAGACCCGTGAGGCATGTTAAGGGTTAGAGCTA	1	bc
ACGAATCCGT	GAAACACCGGTCTCGAGTGAGGTGTTCAGGTGGGGTTAGAGCTAGAAATA	1	bc
CGTATCCCCT	GAAACACCGGTCTCGAATGTCGTCTTCAGGGGGTAGATATAGCTATAACT	1	bc
CATAACGTAT	GAAACACCGGTAACTATATTCATGCGATATCGCCGTATCAGTGGGGTTAG	1	bc
GAGGCACCCT	GAAACACCGGTGTGGCTGAGAGTCCGGCAATGGTGTGGCTGGGGGGTTAG	1	bc
AAGAGCCTCG	GAAACACCGGTGCATTCGAAAGTCCGGTCGTAGTGTGGACGTGGGGTTAG	1	bc
CTGCTTCCTT	GAAACACCGGTTTACGTTGCATCGGTTGTGGGGGTATAGCTAGTAATAGC	1	bc
ATTCCCATCT	GAAACACCGGTTTGGCTGACAGTGCGGCAATGGTGTGGCTGTGGGGATAG	1	bc
ACGCTTAGAC	GAAACACCGGTTTACGTTGCATCGGTGTGGGGTTAGAGCTAGAAATAGCA	1	bc
CATTGAGCAT	GAAACACCGGTTAAGCCGAGTGGGGTTAGAGCTAGAAATAGCAAGTTAAC	1	bc
GTGTGGAGCC	GAAACACCGGTTCCCGTCCAGTGGGGTTAGAGCTAGAAATAGCAAGTTAA	1	bc
CAATCCTCGC	GAAACACCGGTGCATTCGAGAGTCCGGTCGTAGTGTGGACGTGGGGTTAG	1	bc
GCATGCGGGT	GAAACACCGGTCGACTCATATCGAAACCTTGCCGTGGCAGGGTAGCTAGA	1	bc
CTCCCCTGCA	GAAACACCAGTGTGGCTGAGAGTCCGGCAATGGTGTGGCTGTGGGGTTAG	1	bc
ACATCTGCGT	GAAACACCGGTGTACGTATGGACTGAACCAGGGTGTGCAAGTGGGGTTAG	1	bc
AATGCATCGC	GAAACACCGGTTTACGTTGCATCGGTTGTGGGGTTAGAGCTAGGAATAGC	1	bc
CCCATCGTTT	GAAACACCGGTCTCGAGTGAGGTGTTCAGGGTGGGGTTAGAGCTAGAAAT	1	bc
TCGCATCCTT	GAAACACCGGTCTCGAGTGAGGTGTTCAGGGTGGGGTTAGAGCTAGAAAT	1	bc
AGAGTGGTGT	GAAACACCGGTGCCCTTACTCTCACCTGATTACTTAATCCGTGGGGTTAG	1	bc
ACAACTAGGC	GAAACACCGGTACCTTTGTTGATGCTGGGTGGGGTTAGAGCTAGAAATAG	1	bc
ACAGAATGCT	GAAACACCGGTTTGAACTAGAAATAGCAAGTTAACCTAAGGCTAGTCCGT	1	bc
ACCAAAGCAC	GAAACACCGGTTTGAACCTGGGGTTAGAGCTAGAAATAGCAAGTTAACCT	1	bc
CTTTTATCTC	GAAACACCGGTCGGGGCCACTCAGTGGTGGGGTTAGAGCTAGAAATAGCA	1	bc
TAGAGTAGAC	GAAACACCGGTTAAGCCGAGGAGTTTCGTTAGAGCTAGAAATAGCAAGTT	1	bc
CATAAACCCC	GAAACACCGGTCCAAGCCACCCAGTGGTGGGGTTAGAGCTAGAAATAGCA	1	bc
AATCTCCTCC	GAAAAACCGGTGCCCTTACTCTCACCTGATTACTTAATCCGTGGGGTTAG	1	bc
AGCACGCTTC	GAAACACCGGTGTGGATGAGAGTCCGGCCATGGTTTCGCTGGGGGGTTTA	1	bc
ATGATAATCT	GAAACGCCGGTTTACGTTGCATCGGTGTGGGGTTAGAGCTAGAAATAGCA	1	bc
AGAAAATGGA	CTAAACACCGGTGCATTCGGAAGTCCGGTCGTAGTGTGGACGTGGGGTTA	1	bc
GGCTCGCTAG	GAAACACCGGTGTGGTTGGGAGTTCGGCAGTGGTAGGGCTGGGGATATCA	1	bc
CTATTAACGC	GAAACACCGGTCGGGGCCACTCAGCTGTGGGGTTAGAGCTAGAAATAGCA	1	bc
GCCCACATCT	GAAACACCGGTGTGGCTGAGAGTCCTGCAATGGGGTGGCTGTAGAGTTAG	1	bc
GTAAACACCC	GAAACACCGGTACCTCTGTTGATGCTGGGTGGATAGGAAATCGGGCCCAT	1	bc
TCCAGTGAGG	GAAACACCGGTTATATTTGTAAGTGTGTGGGGTTAGAGCTAGAAATAGCA	1	bc
TAGCGAATAT	GAAACACCGGTTAAGCCGAGGTTAGAGCTAGAAATAGCAAGTTAACCTAA	1	bc
ACTGACCCTT	GAAACACCGGTCTCGAGTGAGGTGTTCAGGTGGGGTTAGAGCTAGAAATA	1	bc
CCTTTGACGA	GAAACACCGGTCGGGGCCGCTCAGTGGTGGGGTTAGAGCTAGTAATAGCA	1	bc
CCAAACGCTC	GAAACACCGGTTTGAACTACCTAGGGGGTAGTTTAAACCGGGGTTAGAGC	1	bc
CGGATACTCC	GAAACACCGGTCTCGAGTGAGGTTGGGGGAGAGCTAGCTAAAGCAAGGTA	1	bc
TCACTCGGGG	GAAACACCGGTTATATTTGTAAGTGGGGTTAGAGCTAGAAATAGCAAGTT	1	bc
GAAAAAGCGC	GAAACACCGGTCGGCGGCAATCGTGGGTGGGGTTAGAGCTAGAAATAGCA	1	bc
AAGAATGCCC	GAAACACCGGTTTGAACTAGAAATAGCAAGTTAACCTAAGGCTAGTCCGT	1	bc
CGAATACTGC	GAAACACCGGTCTCGAGTGAGGTGTTCAGGGTGGGGTTAGAGCTAGAAAT	1	bc
ACCAAAGCCC	GAAACACCGGTTTGAACTACCTGGGGTTAGAGCTAGAAATAGCAAGTTAA	1	bc
TAGGCTGGTT	GAAACACCGGTCCGTAGGAGACCCGTGTGGCATGTACCTGTGGGGTTAGA	1	bc
TATACAGAGG	GAAACACCGGTTATATTTGTAAGTGTGTGGGGTTAGAGCTAGAAATAGCA	1	bc
GGTAGCTATG	CAAAACACCGGTTACATTGAGATTGGGGTTAGAGCTAGAAATAGCAAGTT	1	bc
AGTGGAGCGT	GAACCACCGGTTCCCGTCCAGTGGGGTTAGAGCTAGAAATAGCAAGTTAA	1	bc
TGCCTCGACA	GAAACACCGGTAAATTTGAGGCACCGGCATGCAGGAGGCCGTGGGGTTAG	1	bc
ATTAGATATG	GAAACACCGGTTACAATTGAGGGTTAGAGCTAGAAATAGCAAGTTAACCT	1	bc
GCACGCCCTT	GAAACACCGGTGCCCTTACTCTCACCTGATTACTTAATCCGTGGGGTTAG	1	bc
AACGAATCAT	GAAACACCGGTCTCGAGTGAGGTGTTCAGGGTGGGGTTAGAGCTAGAAAT	1	bc
AAAAGCCCTA	GAAACACCGGTGCCCTTACTCTCACCTGATTACTTAATCCGTGGGGTTAG	1	bc
AGCATCATTT	GATACACCGGTCTCGAGTGAGGTGTTCAGGGTGGGGTTAGAGCTAGAAAT	1	bc
AAATTTAGAC	GAAACACCGGTAACTATATTCATGCGATATCGCCGTATCAGTGGGGTTAG	1	bc
TGGAGCGTAC	GAAACACCGGTTAAGTAGAGCTAGAAATAGCAAGTTAACCTAAGGCTAGT	1	bc
TAAGTCCCAC	GAAACACCGGTGCCCTTGCTCTCACCTGATTACTTAATCCGTGGGGTTAG	1	bc
AGCGTGATGC	GAAACACCGGTGCGCTTCCTCTCCACTGCTTACTTAATCTGTGGGGTTAG	1	bc
GGGAACTACA	GAAACACCGGTAAATTTGAGGCTCCGGCATGCAGGAGGCCGTGGGGTTAG	1	bc
AACACCTAAC	GAAACACCGGTTTGAACTACCTTGGAGTTGGGATAGGCAAGTTAATCGAA	1	bc
TTGGCGACGA	GAAACACCGGTTCCATTGCGGTAGTCGTTAGGTCTGAGCTTAGAATATTA	1	bc
TTCATTATCC	GAAACACCGGTAACTATATTCATGCGATATCGCCGTATCAGTGGGGTTAG	1	bc
CTGCTCATGA	GAAACACCGGTTTACGTTGCATCGGTGTGGGGTTAGAGCTAGAAATAGCA	1	bc
GGAACCTTCA	GAAACACCGGTGTGGCTGAGAGTCCGGCAATGGTGTGGCTGTGGGGTTAG	1	bc
TCTAGACGGC	GAAACACCGGTACCTTTGTTGGTGCTGGGTGGAAGGAATTTGTGGGGTTA	1	bc
ATGAGCTTAT	GAAACACCGGTTAAGCCGAGGAGTTAGTGCTAGGAATAGCAAGTTAACAT	1	bc
AGAAGACCAG	GAAACACCGGTCGGCGGCAATCGTGGGTGGGGTTAGAGCTAGAAATAGCA	1	bc
AGCAGCGTAA	GAAACACCGGTGCCCTTGCTCGGGGTTAGAGCTAGAATTAGCAAGGTAAC	1	bc
CCAAGTCGTC	GAAACACCGGTGTACGTATGGACTGAACCAGGGTGTGCAAGTGGGGTTAG	1	bc
GTGGACGATC	GAAACACCGGTTCCCGTCCAGAGGGGTTAGAGCTAGAAATAGCAAGTTAA	1	bc
CGTGGGCTGC	GAAACACCGGTGTTCGTATGGGCTGAACCAGGGTGGGCAAGTGGTGTTAG	1	bc
AAACAATGTA	GCTAGAAATAGCAAGTTAACCTAAGGCTAGTCCGTTATCAACTTGAAAAA	1	bc
GACATAATCA	GAAACACCGGTAGCTGTATTGATTAGAGCTAGAAATATCAAGGTAACCTG	1	bc
GTGGCTCTGT	GAAACACCGGTTACATTGAGTGGGGTTAGAGCTAGAAATAGCAAGTTAAC	1	bc
ACCTTACAGC	GAAACACCGGTCGGGGCCACTCAGTGAGCTAGAAATAGCAAGTTAATAGC	1	bc
AGAAGACGCG	GAAACACCGGTCGGCGGCTAGTCCGTTATCAACTTGAAAAAGTGGCACCG	1	bc
CTTCTGCCTA	GAAACACCGGTCCGTAGGAGACCCGTGTGGCATGTACCTGTGGGGTTAGA	1	bc
AATGCTTCGC	GAAACACCGGTTTACGTTGCATCGGTGTGGGGTTAGAGCTAGAAATAGCA	1	bc
AGGATAAGCT	GAAACACCGGTTTACGTTGCATCGTTAGAGCTAGAAATAGCTAGAAATAG	1	bc
ATTAGCTCTG	GAAACACCGGTTACATTGAGGGTTAGAGCTAGAAATAGCAAGTTAACCTA	1	bc
AGAGCTGTAC	GAAACACCGGTGCATTTACTCTCAACTGATTACTCAGTCCGTGGGGTTAG	1	bc
TTCAATAGTG	GAAACACCGGTTATATTTGTAAGTGTGTGGGGTTAGAGCTAGAAATAGCA	1	bc
GGGAGCAAAC	GAAACACCGGTTAAGCCGAGGCGTTAGAGCTAGAAATAGCAAGTTAACCT	1	bc
GATCGGCGCC	GAAACACCGGTGTACGTATGGACTGAACCAGGGTGTGCAAGTGGGGTTAG	1	bc
ATCCTAGGCC	GAAACACCGGTACCTTTGTTGATGCTGGGTGGAAGGAATGTGGGGTTAGA	1	bc
TTAACTTTTA	GAAACACCGGTAACTATATTCATGCGATATCGCCGTATCAGTGGGGTTAG	1	bc
GGCACACCAC	GAAACACCGGTGTGGCTGAGAGTCCGGCAATGGTGTGGCTGTGGGGTTAG	1	bc
TCGGATCCTT	GAAACACCGGTCTCGAGTGAGGTGTTCAGGGTGGGGTTAGAGCTAGAAAT	1	bc
ATCTATAGAG	GAAACACCGGTTATATTTGTAAGTGTGTGGGGTTAGAGCTAGAAATAGCA	1	bc
GCGACTCCTT	GAAACACCGGTCTCGAGTGAGGTGTTCAGGTGGGGTTAGAGCTAGAAATA	1	bc
AAATTCTGTG	GAAACACCGGTCGATTCATATCGAAACCTTCCCGTGACAGTGGGGTTAGA	1	bc
TAGATAGAGG	GAAACACCGGTTATATTTGTAAGTGTGTGGGGTTAGAGCTAGAAATAGCA	1	bc
AATACTCGGC	GAAACACCGGTACCTTTGTTGATGCTGGGTGAAAGGAATTTGTGGGGTTA	1	bc
TTTAGGCATG	GAAACACCGGTTACATTGAGGGGTTAGAGCTAGAAATAGCAAGTTAACCT	1	bc
TAACGAACTA	GAAACACCGGTGCCCTTACTCTCACCTGATTACTTAATCCGTGGGGTTAG	1	bc
AGAGACAGAC	GAAACACCGGTAGCAAGTGCGAGACGTGTTTGTGGGGTTAGAGCTAGAAA	1	bc
GAAGGACTGC	GAAACACCGGTCGGCGGCAATCGTGGTATGAGCCACGTGGGGTTAGATCG	1	bc
ATGGCGTCTC	GAAACACCGGTTCCCGTCCAGTGGGGTTAGAGCTAGAAATAGCAAGTTAA	1	bc
AGTGGGGCTT	GAAACACCGGTTCCCGTCCAGTGGGGTTAGAGCTAGAAATAGCAAGTTAA	1	bc
ACCATTACCG	GAAACACCGGTCGGGGCCACTCAGTGGTGGGGTTAGAGCTAGAAATAGCA	1	bc
CTATTAGGTC	GAAACACCGGTACCTTTGTTGATGCTGGGTGGGGTTAGAGCTAGAAATAG	1	bc
GCTATAGCGC	GAAACACCGGTCGGGGCCACTCAGTGGTGGGGATAGAGCTATAAATAGCA	1	bc
ACACCACGCC	GAAACACCGGTTTGAACTACCTAGTTCAAACCGGTGGGGTTAGAGCTAGA	1	bc
GTGGATGTTC	GAAACACCGGCGCCATTGGGTACATCGTGGGGTTAGAGCTAGAAATAGCA	1	bc
ACGTGTTGTA	GAAACACCGGTGACATTGGGTAGTGGGGTTAGAGCTAGAAATAGCAAGTT	1	bc
GCTCAACGCC	GAAACACCGGTTTGAACCGGTGGGGTTAGAGCTAGAAATAGCAAGTTAAC	1	bc
TGAGCGTTGT	GAAACACCGGTTACATTGAGGGTTAGAGCTAGAGATAGCAAGTTAACCTA	1	bc
GAATTCGGGT	GAAACACCGGTCGATTCATATCGAAACCTTCCCGTGACAGTGGGGGTAGA	1	bc
GCGAATCATT	GAAACACCGGTCTCGAGTGAGGTGTTCAGGGTGGGGTTAGAGCTAGAAAT	1	bc
TCTTTACCTG	GAAACACCGGTCGGGGCCACTCAGTGGTGGGGTTAGAGCTAGAAATAGCA	1	bc
ACGATTCAGT	GAAACTAAGGCTAGACCGGTATGACCTTTAGAGAGTTTCGCGCTATCGAT	1	bc
GACAGTCGGT	GAAACACCGGTCGATTCATATCGAAACCTTCCCGTGACAGTGGGGTTAGA	1	bc
ACTTTAAAGC	GAAACACCGGTCGGGGCCACTCAGTGGTGGGGTTAGAGCTAGAAATAGCA	1	bc
TATAACGCGG	GAAACACCGGTTATATTTGTAAGTGTGTGGGGTTAGAGCTAGAAATAGCA	1	bc
AGGCCCATAC	GAAACACCGGTAAATTTGAGGCTCCGGCATGCAGGAGGCGTGGGGTTAGA	1	bc
CCGAAGCCCC	GAAACACCGGTTCCCGTCCAGAGTGGCTAGATCTCGTAATACCAATCTAA	1	bc
ACCAACGCGA	GAAACACCGGTTGGAACTAGTAAGAGCAAGGTATCCTGATGCTGGTAGGA	1	bc
ATTAGCGATG	GAAACACCGGTTACAGGGGTTAGAGCTAGAAATAGCAAGTTAACCTAAGG	1	bc
AGTAGGACGC	GAAACACCGGTCCGTAGGAGACCCGTGTGGCATGTACCTGTGGGGTTAGA	1	bc
ATCGCCATAA	GAAACACCGGTGCCCTTACTCTCACCTGATTACTTAATCCGTGGGGTTAG	1	bc
GATGAGCATA	GAAACACCGGTTAAGCCGAGGAGTTAGAGCTAGAAATAGCAAGTTAACCT	1	bc
GCAGAACAGC	GAAACACCGGTCGGGGTTAGAGCTAGAAATAGCAAGTTAACCTAAGGCTA	1	bc
GTACACCATT	GAAACACCGGTCCGAGGGAGTCGCGTGTGGCATTAGCCTGAGGGGTAGCA	1	bc
TGAGACGTTT	GAAACACCGGTCTCGAGTGAGGCGTTCAGGGGGGGGTTAGAGCTAGAAAT	1	bc
CATGGTAGTT	GAAACACCGGTGTACGTATGGACTGAACCAGGGTGTGCAAGTGGGGTTAG	1	bc
ACCGTAACAG	GAAACACCGGTCGGGGCCACTCAGTGGTGGGGTTAGAGCTAGAAATAGCA	1	bc
ACAAAACGAC	GAAACACCGGTTTGAACTAGAAATAGCAAGTTAACCTAAGGCTAGTCCGT	1	bc
ATGCTAGCCC	GAAACACCGGTTTACGTTGCATCGGTGTGGGGTTAGAGCTAGAAATAGCA	1	bc
GATAAGCCTA	GAAACACCGGTTCACGACCAGTCGGCTTAGAGCTAGAACTAGCAAGTTCA	1	bc
ATTGAGCTTA	GAAACACCGGTAGTGGGGTTAGAGCTAGAAATAGCAAGTTAACCTAAGGC	1	bc
CTGATTCTTT	GAAACACCGGTCTCGAGTGCGGTGTTCTGGGGGGAGTTCTAGCTAGAGCT	1	bc
AGGTACCCTC	GAAACACCGGTGTGGCTGGGAGTCCGGCAATGGTGTGGCTGTGGGGTTAG	1	bc
AGACCATTGA	GAAACACCGGTGCATTCGAAAGCCCGGTCGTAGTGTGGACGTGGGGTTAG	1	bc
TCTAGCCTAC	GAAACACCGGTTAAGCCGAGGGTGGGGTTAGAGCTAGAAATAGCAAGTTA	1	bc
GAACGCCTTA	GAAACACCGGTGCCCTTACTCTCACCTGATTACTTAATCCGTGGGGTTAG	1	bc
ACCAAGGTTC	GAAACACCGGTTCCCGGCTAGTTCGGTTCTAGCGAGAAATAGCAAAGTAA	1	bc
GTCTACCTAC	GAAACACCGGTGTGGCTGAGAGTCCGGCAATGGTGTGGCTGTGGGGTTAG	1	bc
AGGGTTGTCG	GAAACACCGGTGACATTGGGTGGGGTTAGAGCTAGAAATAGCAAGTTAAC	1	bc
AAAAACGCCA	GAAACACCGGTTTGAACTACCGGGGTTAGAGCTAGAAATAGCAAGTTAAC	1	bc
ATATATCGAG	GAAACACCGGTTATATTTGTAGTGGGGTTAGAGCTAGAAATAGCAAGTTA	1	bc
GGTGATCCTC	GAAACACCGGTTCCCGTCCAGTGGGGTTAGAGCTAGAAATAGCAAGTTAA	1	bc
GAGTACCCTC	GAAACACCGGTTCCCGTCCAGTGGGGTTAGAGCTAGAAATAGCAAGTTAA	1	bc
CATTAGCTAT	GGAACACCGGTTACATTGAGGGGTTAGAGCTAGAAATAGCAAGTTAACCT	1	bc
ATACTATGCC	GAAACACCGGTACCTTTGTTGATGCTGGGGGGAAGGAATTTTGTGTGGTT	1	bc
GGAACCTAAA	GAAACACCGGTAAATTTGAGGCTCCGGCATGCAGGAGGCCGTGGGGTTAG	1	bc
GCACAACGAC	GAAACACCGGTTTGAACTACCTAGTTCAAACCGGTGGGGTTAGAGCTAGA	1	bc
GTAACAGCCT	GAAACACCGGTAGCAAGTGCGAGACGTGTTTTTGTGGGGTTAGAGCTAGA	1	bc
GAGGATCGTC	GAAACACCGGTTCCCGTCCAGTGGGGTTAGAGCTAGAAATAGCAAGTTAA	1	bc
ACGCCACGCC	GTGGGGTTAGAGCTAGAAATAGCAAGTTAACCTAAGGCTAGTCCGTTATC	1	bc
TCATTACAGC	GAAACACCGGTCGGGGCCACCGGTGGGGTTAGAGCTAGAAATAGCAAGTT	1	bc
GCCTATACCG	GAAACACCGGTCGGGGCCACTCAGTGGTGGGGTTAGAGCTAGAAATAGCA	1	bc
TTGACTATGA	GAAACACCGGTTACGCCGAGGAGTTAGAGCTAGAAATAGCAAGTTAACCT	1	bc
TGGCACCGTC	GAAACACCGGTGTGGCTGAGAGTCCGGCAATGGTGTGGCTGTGGGGTTAG	1	bc
TATATTCGGT	GAAACACCGGTCGATTCATATCGAAACCTTCCCGTGACAGTGGGGTTAGA	1	bc
AAGAATCGTT	GAAACACCGGTCTCGAGCGAGGTGTTCAGGGTGGGGTTAGAGCTAGAAAT	1	bc
GCGAGGATAA	GAAACACCGGTTAAGCCGTGGGGTTAGAGCTAGAAATAGCAAGTTAACCT	1	bc
GGCATCTACT	GAAACACCGGTAAATTTGAGGCTCCGGCATGCAGGAGGCCGTGGGGTTAG	1	bc
GGGACCATCG	GAAACACCGGTGTGGCTGAGAGTACGGCAATGGTGTGGCTGTGGGGTTAG	1	bc
GCTATACTCC	GAAACACCGGTGTGGCTGAGACTCCGGCAGTGGTGTGGCTGGGGGGATAG	1	bc
GTCAACCATT	GAAACACCGGTTAGAGTGAATTGCCGGCGATGGTAGGGCTAGAGATATCA	1	bc
ATATTTACCG	GAAACACCGGTCGGGGCCGCTCAGTGGTGGGGTTAGAGCTAGAAATAGCA	1	bc
CGTGTAGACA	GAAACACCGGTGACATTGGCTCCACCCGGTGGGTATAGAGCTAGAAATAG	1	bc
GGCCTTAACC	GAAACACCGGTAAGTTTGTTGCTCCGGCATGCCGGAGGCCGTGGGGTTAG	1	bc
GTAAAACTTT	GAAACACCGGTCTCGAGAGAGGTGGTCTTCTGGGGGGGGTTAGAGCTAGA	1	bc
ACGAGTCGCT	GAAACACCGGTTTACAGTGCATCGGGTTGGGGTTAGAGCTAGAAATATCA	1	bc
CCTCGTAGTG	GAAACACCGGTGTACGTATGGACTGAACCAGGGTGTGCAAGTGGGGTTAG	1	bc
AGATATCCGC	GAAACACCGGTGCATTCCAAAGTCCGGTCGTAGTGTGGACGTGGGGTTAG	1	bc
CCGAGCATGC	GAAACACCGGTCAGGGACAGTTAGAAATGGCATGATAACTTGAAACTGGT	1	bc
GACCCTATAA	GAAACACCGGTAACTATATTCATGCGATATCGCCGTATCAGTGGGGTTAG	1	bc
AGGATACGTT	GAAACACCGGTCGATTCATATCGAAACCTTCCCGTGACAGTGGGGTTAGA	1	bc
ACTTGACCTC	GAAACACCGGTAACTATATTCATGCGATATCGCCGTATCAGTGGGGTTAG	1	bc
AGAAACAGAC	GAAACACCGGTAGCAAGTGGGGTTAGAGCTAGAAATAGCAAGTTAACCTA	1	bc
GAATCCGGTT	GAAACACCGGTCGATTAATATCGAACCCTTCCCGTGACCTTGGAGTTAGA	1	bc
GTCACTATCC	GAAACACCGGTGTGGCTGAGAGCCCGGCAATGGTGGGGCTGTGGGGTTAA	1	bc
AGAATGATTC	GAAACACCGGTCTCGAGTGAGGTGTTCAGGGTGGGGTTAGAGCTAGAAAT	1	bc
GGACCGTAAA	GAAACACCGGTAAATTTGAGGCTCCGGCATGCAGGAGGCGTGGGGTTAGA	1	bc
GGGCGCCGTC	GAAACACCGATGTGGCTGAGAGTCCGGCAATGGTGTGGCTGTGGGGTTAG	1	bc
GAGTCGTACA	GAAACACCGGTCCGTAGGAGACCCGTGTGGCATGTACCTGTGGGGTTAGA	1	bc
GATGTGACAT	GAAACACCGGTCCGTAGGAGACCCGTGTGGCATGTACCTGTGGGGTTAGA	1	bc
AGGATGCCAC	GAAACACCGGTCCGTAGGAGACCCGTGTGGCATGTACCTGTGGGGTTAGA	1	bc
TCTACTCGGA	GAAACACCGGTACCTTTGTTGATGCTGGGTGGCACCGAGTCGGTGCTTTT	1	bc
AGGGGGGGGA	GAAACACCGGTTCCCGTCCAGTGGGGTTAGAGCTAGAAATAGCAAGTTAA	1	bc
AATGAGCATA	GAAACACCGGTTAAGCCGAGGTGGGGTTAGAGCTAGAAATAGCAAGTTAA	1	bc
AATGCTTAGA	GAAACACCGGTTTACGTTGCGGTGGGGTTAGAGCTAGAAATAGCAAGTTA	1	bc
ACTTTGCGTT	GAAACACCAGTCGATTCATATCGAAACCTTCCCGTGACAGTGGGGTTAGA	1	bc
ATATCTGGAT	GAAACACCGGTCGATTCATATCGAAACCTTCCCTAGACAGTGGGGTTAGA	1	bc
CACACCCTAA	GAAACACCGGTGCCCTTACTCTCACCTGATTACTTAATCCGTGGGGTTAG	1	bc
CAGTTACAGC	GAAAAACCGGTTGGGGCCACTCAGTGGTGGGGTTAGAGCTAGAAATAGAA	1	bc
GAAACCGCCC	GAAACACCGGTAGCAAGTGCGAGACGTTTTTGTGGGGTTAGAGCTAGAAA	1	bc
CAGACACAGA	GAAACACCGGTAGCAAGTGCGAGACGTGTTTGTGGGGTTAGAGCTAGAAA	1	bc
CACGTCCTAT	GAAACACCGGTGTCGTTACTGGCATTTGATTACTTAATACGGCTAGTTAT	1	bc
TGTGTAGTCA	GAAACACCGGTGACATTGGGTACAGGGTGGGGTTAGAGCTAGAAATAGCA	1	bc
ACGCAACGCC	GAAACACCGGTTTGAACTACCTAGTTCAAACCGGTGGGGTTAGAGCTAGA	1	bc
TGGATTATCC	GAAACACCGGTAACTATATTCATGCGATATCGCCGGAGCAGTAGTGTTAG	1	bc
CTGCAGCCCC	GAAACACCGGTTCCCGTCCAGTGGGGTTAGAGCTAGAAATAGCAAGTTAA	1	bc
AATCGTTTTC	GAAACACCGGTGTACGTATGGACTGAACCAGGGTGTGCAAGTGAGGTTAG	1	bc
AACGACTAGC	GAAACACCGGTTTACGGTGCATCGTGGGGGTAGTACTAGTAGAAGCAAGA	1	bc
CTGTTGGGGC	GAAACACCGGTACCTTTGTTGATGCTGGGAGGAAGGAAATTGCGGGGTTA	1	bc
TCTCTCCTGG	GAAACACCGGTTATATTTGTAATTGTGTATGGTTAGAGATAGCAATAACA	1	bc
AAACTCCCTA	GAAACACCGGTGCCCTTACTCTCACCTGATTACTTAATCCGTGGGGTTAG	1	bc
ATGATAAGCA	GAAACACCGGTTTACGTTGCATCGGTGTGGGGTTAGAGCTAGAAATAGCA	1	bc
ACGAATCATT	GAAACACCGGTCTCGAGTGAGGTGTTCAGGTGGGGTTAGAGCTAGAAATA	1	bc
AGTGGAGCTT	GAACACCGGTTCCCGTCCAGTGGGGTTAGAGCTAGAAATAGCAAGTTAAC	1	bc
CTGATCCAAA	GAAACACCGGTTAAGCCGAGTGGGGTTAGAGCTAGAAATAGCAAGTTAAC	1	bc
