GCGTCGCCCT	GAAACACCGGTGTCCGCTGCCAGCTCCATTGTGGGGTTAGAGCTAGAAAT	2	bc
TTTTACTTAT	GAAACACCGGTTACATTGAGATTGGGGTTAGAGCTAAAAATAGCAAGTTA	1	bc
AGACTCTGGT	GAAACACCGGTGCATTCGAAAGTCCGGTCGTAGTGTGGACGTGGGGTTAG	1	bc
TACATCATCC	GAAACACCGGTTTCTACTTTCATGCTGTATCGCCGTATCAAGTGGGGTTA	1	bc
CAAACCCTAC	GAAACACCGGTGTCCTTTCTGTCGCTTGGTTACTAGATCCAGGGAGATAG	1	bc
GTTAACGATT	GAAACACCGGTTATATTTGTATGCGTGTGGGGTTAGAGCTAGAAATAGCA	1	bc
AAGGCCTCAC	GAAACACCGGTGCACTTACTCTCACCTGATTACTTAATCCGTGGGGTTAG	1	bc
GGTCCCTCAC	GAAACACCGGTGCATTCGAAAGTCCGGTCGTAGTGTGGACGTGGGGTTAG	1	bc
AATTTCGTCC	GAAACACCGGTCGCTTCATATCGAAACCTTACCGCGAGAGAGGGGATAGT	1	bc
ACCTTGGGTC	GAAACACCGTTCGATTCATATCGAAACCTTCCTACGACAGTTGGGTTAGT	1	bc
CATGGCGGTC	GAAACACCGGTGTACGTATGGACTGAACCAGGGTGTGCAAGTGGGGTTAG	1	bc
CCTCAGGGTC	GAAACACCGGTGTACGTATGGACTGAACCAGGGTGTGCAAGTGGGGTTAG	1	bc
TTACCGCTCT	GAAACACCGGTTACATTGAGGGGTTAGAGCTAGAAATAGCAAGGTAACCT	1	bc
CGGCGGCCTC	GAAACACCGGTCTGGGGGATACCGGAGTGGCATGAAAGCGGGGGTATAAA	1	bc
TCGGGTTGTC	GAAACACCGGTGACATTGGGAAATAGTAAGTTAACCTAAGGCTAGTCCGT	1	bc
AATGTCCCTC	GAAACACCGGTCCCCTTACTCCCACTTTATCATTTAATCCGTGGGGTTAG	1	bc
TAAAATACAC	GAAACACCGGTCGGCGGTGGGATTAGAGCTAGAAATAGCAAGGTAACCTA	1	bc
GATCGTCGAT	GAAACACCGGTGTACGCAGGGACTGCTCCCGGGTGTGCTCGTGGGGTTAG	1	bc
CACTCCCTAA	GAAACACCGGTTTACGTTGCCTCGGTGTGGGGTTAGAGCTAGAAATAGCA	1	bc
TCATTCGAGT	GAAACACCGGTCGATTCATATCGAAACTTTGCCGTGACCGAGAGGTTAGA	1	bc
ATACTCGCCT	GAAACACCGGTACCCAAGGCTAGTCCGTTATCAACTTGAAAAAGAGGCAC	1	bc
CGTGTGGCTC	GAAACACCGGTGACATTGGGTACAGGGTGGGGTTAGAGCTAGAAATAGCA	1	bc
TTAAGTTTTA	GAAACACCGGTTACATTTGAGGGGTTAGAGCTAGAAATAGCAAGTTAACC	1	bc
TCATTTACCG	GAAACACCGGTCGAGGCAACTCAGTGGTGGGGTTAGAGCTAGAAATAGCA	1	bc
TGGCCCCCAC	GAAACACCGGTAAATTTGAGGCTCCGGCATGCAGGAGGCCGTGGGGTTAG	1	bc
AGTCGGCTAC	GAAACACCGGTCCGTAGGAGACCCGTGTGGCATGGATCATGGGGGGATAT	1	bc
AAGCCGCGCG	GAAACACCGGTAGCAATTGAGAGACGTGTTAAATAGAAAGATAAACTGAG	1	bc
CTACTGTCCC	GAAACACCGGTACCTTTGTTGGTGCTGGGCGGAAGGAATTTTGTGGGGTT	1	bc
CATAGCCGCC	GAAACACCGGTTTACGTATGGACTGAACTAAGGGGTGCAAGTGGCATTAG	1	bc
GGGAAGCCCC	GAAACACCGGTTCCCGTCCAGTGGCGGTAATGCTAGAACTAGCAAGTTAA	1	bc
GAGCGCTGGG	GAAACACCGGTAATAATTCCTGCCGGGTGGGGTTAGAGCTAGAAATAGCA	1	bc
TTTTTCATAA	GAAACACCGGTTAAGCCGAGTGGGGTTAGAGCTAGAAATAGCAAGTTAAC	1	bc
TCGCCCTGCA	GAAACACCGGTGCATTCGAAAGTCCGGTCGTAGTGTGGACGTGGGGTTAG	1	bc
AATGTCCCAC	GAAACACCGGTGCCCTTACTCTCACCTGATTACTAAATCCGTGGGGTTAG	1	bc
ATAGTTATCT	GAAACACCGGTTAACTTTGCATTAGAGCGAGAATTGGCATGTTAACATAA	1	bc
CATATATTCC	GAAGCACCGGTCTCGTATCCATGTATGTGGGGTTAGAGCTAGAAATAGCA	1	bc
ACGACTCCTT	GAAACACCGGTCTCGAGTGAGGTGTTCAGGGTGGGGTTAGAGCTAGAAAT	1	bc
AGCCCTAAGT	GAAACACCGGTTGACATGGAGCTAGAAGTAAAACGTTAAGGTAAGGCTAG	1	bc
GAGAACCATG	GAAACACCGGTTGGGGGTCTGTAGGGGTAGAGCTAGAGATAGCAATATAA	1	bc
AAGTCGGCCT	GAAACACCGGTCCGTAGGAGACCCGTGTGGCATGTACCTGTGGGGTTAGA	1	bc
ATGACCCACC	GAAACACCGGTATATAAAAATACGAGTACAGTGGGGTTAGAGCTAGAAAT	1	bc
GGACTCCTTC	GAAACACCGGTCTCGCGTGAGGTGTTCAGGTGGGGTTAGAGCTAGAAAAA	1	bc
CGACTCGTCT	GAAACACCGGTACCTTTGTTGATGCTGGGGGGGGGTATAGCTAGAAATAG	1	bc
CTAAGCCTAT	GAAACATGGGGTTAGAGCTAGAAATAGCAGGTTAACCTAAGGCTAGTCCG	1	bc
GACTCTGCCT	GAAACACCGGTCCGCAGCCAACCCGGGGGGCATGTGAGTGGGGGGGTAGG	1	bc
TCGTGCGGGA	GAAACACCGGTCGTTTCCGATGGAATGCTTCGCGTGAGCGTGGAGTTAGA	1	bc
AAAAACCCCC	GAAACACCGGTTTGAACTAGAAATAGCAAGTTAACCTAAGGCTAGTCCGT	1	bc
CCAACCGAGG	GAAACACCGGTTATATTTGTAAGTGTGTGGGGTTAGAGCTAGAAATAGCA	1	bc
CATCCTAGCC	GAAACACCGGTTTACGTATGGTCTGAATGAGGGTGGGCATGGAGGGATAG	1	bc
TTTAGACGAC	GAAACACCGGTGAACGTATGGACTGAATCAGGGAGTAATAGCGGGGTTAG	1	bc
ACGCCCCACC	GAAACACCGGTGCCCTTACTCTCGCCTGATTACTTAATCCGTGGGGTTAG	1	bc
ATGGAGGGAC	GAAACACCGGTCGTCGCTATATCATTGTGGGGTTAGACTAGAAATAGCAA	1	bc
