AAAAAAGAAT	GAAACACCGGTTAGAGCTAGAAATAGCAAGTTAACCTAAGGCTAGTCCGT	1
AAAAACGCCA	GAAACACCGGTTTGAACTACCTAGCTCAAACCGGTGGGGTTAGAGCTAGA	1
AAAAATGTGC	GAAACACCGGTCGACGGCAATCGTGGTTGGGGGTAGAGCTAGAAATATCA	1
AAAACACTCT	GAAACACCGGTTTGAACTACCGGGGTTAGAGCTAGAAATAGCAAGTTAAC	1
AAAAGCCCTA	GAAACACCGGTGCCCTTACTCTCACCTGATTACTTAATCCGTGGGGTTAG	1
AAAATCCGGG	GAAACACCGGTTCCGTTATCAACTTGAAAAAGTGGCACCGAGTCGGTGCT	1
AAAATTCGGG	GAAACACCGGTCGATTCATATCGAAACCTTCCCGTGACAGTGGGGTTAGA	1
AAAATTCGGT	GAAACACCGGTCGATTCATATCGAAACCTTCCCGTGACAGTGGGGTTAGA	1
AAACAACGCA	GAAACACCGGTTTGAACTAGAAATAGCAAGTTAACCTAAGGCTAGTCCGT	1
AAACAACGCC	GAAACACCGGTTTGAACTAGAAATAGCAAGTTAACCTAAGGCTAGTCCGT	1
AAACAACGCC	GAAACACCGGTTTGAACCGGTGGGGTTAGAGCTAGAAATAGCAAGTTAAC	1
AAACAACGCC	GAAACACCGGTTAGAGCTAGAAATAGCAAGTTAACCTAAGGCTAGTCCGT	1
AAACCACGCC	GAAACACCGGTTTGAACTAGAAATAGCAAGTTAACCTAAGGCTAGTCCGT	1
AAACCCTGAC	GAAACACCGGTAAATTTGAGGCTCCGGCATGCAGGAGGCCGTGGGGTTAG	1
AAACGACCTA	GAAACACCGGTGCCCTTACTCTCACCTGATTACTTAATCCGTGGGGTTAG	2
AAACGCACTA	GAAACACCGGTGCCCTTACTCTCACCTGATTACTTAATCCGTGGGGTTAG	1
AAACGCTCTA	GAAACACCGGTGCCCTTACTCTCACCTGATTACTTAATCCGTGGGGTTAG	1
AAACGCTCTG	GAAACACCGGTGCCCTTACTCTCACCTGATTACTTAATCCGTGGGGTTAG	1
AAACGGCGTA	GAAACACCGGTGCCCTTACTCTCACCTGATTACTTAATCCGTGGGGTTAG	1
AAACTAGGCC	GAAACACCGGTACCTTTGTTGATGCTGGGTGGAAGGAATTTTGTGGGGTT	1
AAACTCCCTA	GAAACACCGGTGCCCTTACTCTCACCTGATTACTTAATCCGTGGGGTTAG	1
AAACTCCTAC	GAAACACCGGTACCCTTACTCTCACCTGATTACTTAATCCGTGGGGTTAG	1
AAAGAACGCC	GAAACACCGGTTTGAACTAGAAATAGCAAGTTAACCTAAGGCTAGTCCGT	1
AAAGAACGGC	GAAACACCGGTCGGCGGCAATCGTGGAGGGGGTTAGCGCTAGAAATAGCA	1
AAAGCCTTGC	GAAACACCGGTGCCCTTACTCTCACCTGATTACTTAATCCGTGGGGTTAG	1
AAAGCGCTAT	GAAACACCGGTGCCCTTACTCTCACCTGATTACTTAATCCGTGGGGTTAG	1
AAAGGAGTAC	GAAACACCGGTGCCCTTACTCTCACCTGATTACTTAATCCGTGGGGTTAG	1
AAAGGCACAA	CAAAACACCGGTACCCTTACTCTCCACCGATCACGTGATCCGTTGGCTTA	1
AAATAGCGAG	GAAAACACCGGTTATATTTGTAAGTGTGTGGGGTTAGAGCTAGAAATAGC	1
AAATAGGGTT	GAAACACCGGTCGATTCATATCGAAACCTTCCCGTGACAGTGGGGATAGA	1
AAATCCCTCC	GAAACACCGGTGCCCTTACTCTCACCTGATTACTTAATCCGTGGGGTTAG	1
AAATCGGCGT	GAAACACCGGTCCGTAGGAGACCCGTGTGGCATGTACCTGTGGGGTTAGA	1
AAATCGTTGT	GAAACACCGGTGTACGTATGGACTGAACCAGGGTGTGCAAGTGGGGTTAG	1
AAATGCTTAT	GAAACACCGGTTTACGTTGCATCGGTGTGGGGTTAGAGCTAGAAATAGCA	1
AAATGGTCGT	GAAACACCGGTGTACGTATGGACTGAACCAGGGTGTGCAAGTGGGGTTAG	1
AAATTCAGAT	GAAACACCGGTCGATTCATATCGAAACCTTCCCGCGACAGTGGGGTTAGA	1
AAATTCATTA	GAAACACCGGTTACATTTTGGAGTTAGAGCTAGAAATAACGAGTTAACCT	1
AACAAAACGC	GAAACACCGGTTTGAACTACCTAGTTCAAACCGGTGGGGTTAGAGCTAGA	1
AACAAACGCC	GAAACACCGGTTTTAGAAATAGCAAGTTAACCTACGGCTAGTCCGTTATC	1
AACAAAGCAC	GAAACACCGGTTTGAACTAGAAATAGCAAGTTAACCTAAGGCTAGTCCGT	1
AACAAATCGC	GAAACACCGGTGCATTCGAAAGTCCGGTCGTAGTGTGGACGTGGGGTTAG	1
AACAACGATC	GAAACACCGGTTTGAACTAGAAATAGCAAGTTAACCTAAGGCTAGTCCGT	1
AACAACGGTC	GAAACACCGGTTTAGAGATAGAAATAACCAGTTAACCTAAGGCTAGTCAG	1
AACACAGCCC	GAAACGCAGGTTAACCTACGGCTAGTCCGTTATCAACTTGAAAAAGAGGC	1
AACACATAAA	GAAACACCGGTAGCAATTGCGAAATAGCAAGTTAACCTAAGGCTATTCCG	1
AACACCGCCA	GAAACACCGGTTTGAACTACCTAGGGGGTAGTTCAAACCGGGGTTAGAGC	1
AACAGTCGGT	GAAACACCGGTCGATTCATATCGAAACCTTCCCGTGAGTGGGGTTAGAGC	1
AACAGTCGTC	GAAACACCGGTGAAAGTATGGACTGAACCAGGATGTGCAAGTGGGGCTAG	1
AACATACGGT	GAAACACCGGTCGATTCATATCGAAACCTTCCCGTGACAAGTGGGGTTAG	1
AACATCGTCG	GAAACACCGGTGTACGTATGGACTGAACCAGGGTGTGCAAGTGGGGTTAG	1
AACATGCGGA	GAAACACCGGTTGAGTCATATCGAGACAGTCCCGGCACAGTGGGGTTAGA	1
AACATGCGGT	GAAACACCGGTCGATTCATATCGAAACCTTCCCGTGACAGTGGGGTTAGA	1
AACATTAGAT	GAAACACCGGTCGATTCATATCGAAACCTTCCCGTGACAGTGGGGTTAGA	1
AACATTAGGT	GAAACACCGGTCGATTCATATCGAAACCTTCCCGTGACAGTGGGGTTAGA	1
AACATTCAGT	GAAACACCGGTCGATTCATATCGAAACCTTCCCGTGACAGTGGGGTTAGA	1
AACATTCGGA	GAAACACCGGTCGATTCATATCGAAACCTTCCCGTGACAAGTGGGGTTAG	1
AACATTTGGC	GAAACACCGGTCGATTCATATCGAAACCTTCCCGTGACAGTGGGGTTAGA	1
AACATTTGGT	GAAACACCGGTCGATTCATATCGAAACCTTCCCGTGACAGTGGGGTTAGA	1
AACGAACCAC	GAAACACCGGTTCCCTTACTCTCACCTGATTACTTAATCCGTGAGGTTAG	1
AACGAACTAA	GAAACACCGGTGCCCTTACTCTCACCTGATTACTTAATCCGTGGGGTTAG	1
AACGACGAAC	GAAACACCGGTAACTATATTCATTCGATATCGCCGTAGCTAGAGGGGTTA	1
AACGACGTCT	GAAACACCGGTCGGCGGCAATCGTGGGTGGGGTTAGAGCTAGAAATAGCA	1
AACGATGCGC	GAAACACCGGTTTGAACTAGAAATAGCAAGTTAGCCTAAGGCTAGTCCGT	1
AACGCAATTC	GAAACACCGGTCCCGTTACTCCCACCTGATTATTTAATTAGAGGGATTAG	1
AACGCACTCA	GAAACACCGGTGCCCTTACTCTCACCTGATTACTTAATCCGTGGGGTTAG	1
AACGCCACAA	GAAACACCGGTGCCCTTACTCTCACCTAATTACTTAATCCGTGGGGTTAG	1
AACGCCCTAC	GAAACACCGGTGCCCTTACTCTCACCTGATTACTTAATCCGTGGGGTTAG	985
AACGCCCTAC	GAAACACCGGTGCCCTTACTCGAAATAGCAAGTTAACCTAAGGCTAGTCC	9
AACGCCCTAC	GACACCGGTGCCCTTACTCTCACCTGATTACTTAATCCGTGGGGTTAGAG	7
AACGCCCTAC	GAAACACCGGTGCCCTTACTCTCACCTGATTACTTAATCCCGTGGGGTTA	4
AACGCCCTAC	CAAAACACCGGTGCCCTTACTCTCACCTGATTACTTAATCCGTGGGGTTA	1
AACGCCCTAC	GAAACACCGGTCCGCTGACTCCCACCTGATCATTTAATCGGGGGGGTTAG	1
AACGCCCTAC	GAAACACCGGTGACATTGGGTGGGGTTAGAGCTAGAAATAGCAAGTTAAC	1
AACGCCCTAC	GAAACACCGGTGCCCCTCCTCTCACCCGGTTACTTAATCCGTGGAGTCAG	1
AACGCCCTAC	GAAACACCGGTGCCCTACTCTCACCTGATTACTTAATCCGTGGGGTTAGA	1
AACGCCCTAC	GAAACACCGGTGCCCTTACTCTCACCTGATACTTAATCCGTGGGGTTAGA	1
AACGCCCTAC	GAAACACCGGTGCCCTTACTCTCATCTGATTACTTAATCCCGTGGGGTTA	1
AACGCCTGCC	GAAACACCGGTACCCTTACTCTCACCTATTGACTTAATACGTGGAGATAG	1
AACGCTATAG	GAAACACCGGTGCCCTTACTCTCACCTGATTACTTAATCCGTGGGGTTAG	1
AACGGTGTAC	GAAACACCGGTGTGGCTGAGAGTCCGGCAATGGTGTGGTTGTGGGGTTAG	1
AACGTATTGC	GAAACACCGGTTCCCTTACTCTCACCTGATTACTTAATCCGGGGGGATAG	1
AACGTGTTGT	GAAACACCGGTGACATTGGGTGGGGTTAGAGCTAGAAATAGCAAGTTAAC	1
AACGTTGTAT	GAAACACCGGTGACATTGGGTACAGGGTGGGGTTAGAGCTAGAAATAGCA	1
AACTACCTTT	GAAACACCGGTGCCCTTACTCTCACCTGATTACTTAATCCGTGGGGTTAG	1
AACTATGCCC	GAAACACCGGTTTGAACTAGATGAAGCAAGGTAACCTAAGGCTAGTCCGG	1
AACTCCTAAA	GAAACACCGGTGCCCTTACTCTCACCTGATTACTTAATCCGTGGGGTTAG	1
AACTCTTTGC	GAAACACCGGTCTCGAGCGTGTTGGTCAGGGAGGCGTTAGAGCTAGAAAT	1
AACTTAGGTT	GAAACACCGGTTCCGTTATCAACTTGAAAAAGTGGCACCGAGTCGGTGCT	1
AACTTGAGCG	GAAACACCGGTCGGGGCCACTCAGTGGTGGGGTTAGAGCTAGAAATAGCA	1
AACTTTAACG	GAAACACCGGTCGGGGCCACTCAGTGGTGGGGTTAGAGCTAGAAATAGCA	1
AAGAACCTCG	GAAACACCGGTGCATTCGAAAGTCCGGTCGTAGTGTGGACGTGGGGTTAG	2
AAGAACGCTC	GAAACACCGGTTTGAACCGGTGGGGTTAGAGCTAGAAATAGCAAGTTAAC	1
AAGAAGACCC	GAAACACCGGCCGGCGGCAATCGTGGGTGGGGTTAGAGCTAGAAATAGCA	1
AAGAATCATT	GAAACACCGGTCTCGAGTGAGGTGTTCAGGGCGGTGTTAGAGCTAGTAAT	1
AAGAATCCTT	GAAACACCGGTCTCGAGTGAGGTGTTCGGGGTGGGGTTAGAGCTAGAAAT	1
AAGAATCCTT	GAAACACCGGTCTCGAGTGAGGCGTTCAGGGTGGGGTTAGAGCTAGAAAT	1
AAGAATGACC	GAAACACGGGTTAGAGCTAGAAATAGCAAGTTAACCTAATGCTAGTCCGT	1
AAGACAAGAC	GAAACACCGGTAAATTTGAGGCTCCGGCATGCAGGAGGCCGTGGGGTTAG	1
AAGACCATCG	GAAACACCGGTGCATTCGAAAGTCCGGTCGTAGTGTGGACGTGGGGTTAG	1
AAGACCCTTG	GAAACACCGGTGCATTCGAAAGTCCGGTCGTAGTGTGGGCGTGGGGATAG	1
AAGACTCTCG	GAAACACCGGTGCATTCGAAAGTCCGGTCGTAGTGTGGACGTGGGGTTAG	1
AAGAGACTCG	GAAACACCGGTGCATTCGAAAGTCCGGTCGTAGTGTGGACGTGGGGTTAG	1
AAGATAATAC	GAAACACCGGTTAAGCCGAGTGGGGTTAGAGCTAGAAATAGCAAGTTAAC	1
AAGATCCTCG	GAAACACCGGTGCATTCGAAAGTCCGGTCGTAGTGTGGACGTGGGGTTAG	1
AAGATTAGAT	GAAACACCGGTTTACGTTGCATCGGTGTGGGGTTAGAGCTAGAAATAGCA	1
AAGATTCGGT	GAAACACCGGTCGATTCATATCGAAACCCTCCCGTGACAGTGGGGTTAGA	1
AAGCCAGGCG	GAAACACCGGTCCGTAGGAGACCCGTGTGGCATGTACGGGGTTAGAGCTA	1
AAGCCCTGGG	GAAACACCGGTGCATTCGAAAGTCCGGTCGTAATGTGGACGTGGGGTTAG	1
AAGCGTCGGC	GAAACACCGGTGTACGTATGGACTGAACCAGGGTGTGCAAGTGGGGTTAG	1
AAGCTCTCTA	GAAACACCGGTGCCCTTACTCTCACCTGATTACTTAATCCGTGGGGTTAG	1
AAGCTGAGAT	GAAACACCGGTTTACGTTGCATCGGTTTGTGGGGTTAGAGCTAGAAATAG	1
AAGGCAATAC	GAAACACCGGTGCCCTTACTCTCACCTGATTACTTAATCCGTGGGGTTAG	2
AAGGCACCCT	GAAACACCGGTGTGGCTGAGAGTCCGGCAATGGTGTGGCTGTGGGGTTAG	1
AAGGCGCGTC	GAAACACCGGTTCCAGTTAAGAGGGGTTAGAGCTAGAAATAGAAAGTTAA	1
AAGGCGGCCT	GAAACACCGGTCCGTAGGCGACCCGTGTGGCATGTACCTGTGGGGTTAGA	1
AAGGCTGCCT	GAAACACCGGTCCGTAGGAGACCCGTGTGGCATGTACCTGTGGGGTTAGA	1
AAGGGGTGTA	GAAACGCAAGTTAACCTAAGGCTAGTCCGTTATCAACTTGAAAAAGTGGC	1
AAGGGTTGTC	TAGCCTTAGTCCGTTATCAACTTGAAAAAGTGGCACCGAGTCGGTGCTTT	1
AAGGTGAGTC	GAAACACCGGTTACTATATTCATGCGATATCGCCGTATCAAGTGGGGTTA	1
AAGTATGCAT	GAAACACCGGTCCGTAGGAGACCCGTGTGGCATGTACCTGTGGGGTTAGA	1
AAGTATGCCT	GAAACACCGGTCCGTAGGAGACCCGTGTGGCATGTACCTGTGGGGTTAGA	1
AAGTCCGGTT	GAAACACCGGTCGATTCATATCGAAACCTCCCCGTGACAGTGGGGTTAGA	1
AAGTCTGACT	GAAACACCGGTCCGTAGGAGACCCGTGTGGCGAGCTAGAAATAGCAAGTT	1
AAGTCTGACT	GAAACACCGGTCCGTAGGAGACCCGTGTGGCATGTACCTGTGGGGTTAGA	1
AAGTCTGACT	GAAACACCGGTCCGTAGGAGACCCGTGTGGCATGTACCTGTGGGGTTAGT	1
AAGTCTGCAT	GAAACACCGGTCCGTAGGAGACCCGTGTGGCATGTACCTGTGGGGTTAGA	1
AAGTCTGGCT	GAAACACCGGTCCGTAGGAGACCCGTGTGGCATGTACCTGTGGGGTTAGA	1
AAGTCTGTCT	GAAACACCGGTCCGTAGGAGACCCGTGTGGCATGTACCTGTGGGGTTAGA	1
AAGTCTTCGT	GAAACACCGGTCCGTAGGAGACCCGTGTGGCATGTACCTGTGGGGTTAGA	1
AAGTGAGCCT	GAAACACCGGTCCGTAGGAGACCCGTGTGGCATGTACCTGTGGGGTTAGA	1
AAGTGATGTC	GAAACACCGGTGACATTGGGTGGGGTTAGAGCTAGAAATAGCAAGTTAAC	1
AAGTGCGACG	GAAACACCGGTACAACCGTCTCACTTGGTCGTGGGGTTAGAGCTAGAAAT	1
AAGTGTTGTC	GAAACACCGGTGACATTGAGTGGGGTTAGAGCTAGAAATAGCAAGTTAAC	1
AAGTTGGCCT	GAAACACCGGTCCGTAGGAGACCCGTGTGGCATGTACCTGTGGGGTTAGA	1
AAGTTTACCG	GAAACACCGGTCGGGGCCACTCAGTGGTGGGGTTAGAGCTAGAAATAGCA	1
AATAACCTAC	GAAACACCGGTGCCCTTACTCTCACCTGATTACTTAATCCGTGGGGTTAG	1
AATACTCGGC	GTGGCACCGAGTCGGTGCTTTTTTCCCTGCAGGGGCCGAGTAGGAATTCG	1
AATACTCGGC	GAAACACCGGTACCTCTGTTGATGCTGGGTGGGGTTAGAGCTAGAAATAG	1
AATAGTTGTC	GAAACACCGGTGTACGTATGGACTGAACCAGGGTGTGCAAGTGGGGTTAG	1
AATCAATCGA	GAAACACCGGTGGGGTTAGAGCTAGAAATAGCAAGTTAACCTAAGGCTAG	1
AATCGAGGCC	GAAACACCGGTGTACGTATGGACTGAACCAGGGTGTGCAAGTGGGGTTAG	1
AATCGGAGTC	GAAACACCGGTGTACGTATGGACTGAACCAGGGTGTGCAAGTGGGGTTAG	1
AATCGTGGAC	GAAACACCGGTGTACGTATGGACTGAACCAGGGTGTGCAAGTGGGGTTAG	1
AATCGTTGTA	GAAACACCGGTGAACGTATGGACTGAACCAGGTTGTGCAGGTTAGAGCTA	1
AATCTTGCAC	GAAACACCGGTTATATTTGTCAGTGTGTGGGGTTAGAGCTAGAAATAGCA	1
AATGAGCATA	GAAACACCGGTTAAGCCGAGGTTAGAGCTAGAAATAGCAAGTTAACCTAA	1
AATGATTAGC	GAAACACCGGTTTACGTTGCATCGGTTGTGGGGTTAGAGCTAGAAATAGC	2
AATGATTAGC	GAAACACCGGTTTACGTTGCATCGGTGTGGGGTTAGAGCTAGAAATAGCA	2
AATGCCTAGC	GAAACACCGGTTTACGTTGCATCGGGATCCGGTGCTTTTTTTCCTGCAGG	1
AATGCTAAGC	GAAACACCGGTTTACGTTGCATCGGTGTGGGGTTAGAGCTAGAAATAGCA	1
AATGCTTAGA	GAAACACCGGTTTACGTTGCATCGGTGTGGGGTTAGAGCTAGAAATAGCA	1
AATGCTTCGC	GAAACACCGGTTTACGTTGCATCGGTGTGGGGTTAGAGCTAGAAATAGCA	1
AATGCTTGGT	GAAACACCGGTTTACGTTGCATCGGTTGTGGGGTTAGAGCTAGAAATAGC	1
AATGGCACTG	GAAACACCGGTGCCCTTACTCTCACCTGATTACTTAATCCGTGGGGTTAG	1
AATGGTCGAC	GAAACACCGGTGTACGTATGGACTGAACCAGGGTGTGCAAGTGGGGTTAG	1
AATTAACATC	GAAACACCGGTCGGGGCCACGGGCTACAGCTAGAGATTGCAAGTTGAAAT	1
AATTAGCTAT	GAAACACCGGTTACATTGAGGGTTAGAGCTAGAAATAGCAAGTTAACCTA	1
AATTCCATAC	GAAACACCGGTGCCCTTACTCTCACCTGATTACTTAATCCCGTGGGGTTA	1
ACAAAAAGCC	GAAACACCGGTGTGGGCGACACAGTGGCGGGGGTAGAGCTGGGAATAGCA	1
ACAAAACGCC	GAAACACCGGTTTGAACTAGAAATAGCAAGTTAACCTAAGGCTAGTCCGT	1
ACAAAACGCG	AAAGTGGGGTTAGAGCTAGAAATAGCAAGTTAACCTAAGGCTAGTCCGTT	1
ACAAACGAGG	GAAACACCGGTTATATTTGTAAGTGTGTGGGGTTAGAGCTAGAAATAGCA	1
ACAACTCGGC	GAAACACCGGTACCTTTGTTGATGCTGGGTGGAAGGAATTTGGAGCTAGA	1
ACAACTTATA	GAAACACCGGTAACTATATTCATGCGATATCGCCGTATCAGTGGGGTTAG	1
ACAAGAGGTT	GAAACACCGGTCGATTCATATCGAAGCCTTCCCGTGACAGTGGGGTTAGA	1
ACAAGCCTTT	GAAACACCGGTCTCGAGTGAGGCGTTCAGGTGGGGTTAGAGCTAGAAATA	1
ACAATCGCGG	GAAACACCGGTTATATTTGTAAGTGTGTGGGGTTAGAGCTAGAAATAGCA	1
ACACAAAGCC	GAAACACCGGTTTGAACCGGTGGGGTTAGAGCTAGAAATAGCAAGTTAAC	1
ACACAAAGCC	GAAACACCGGTCTGAACTAGAAATAGCAAGTTAACCTAAGGCTAGTCCGT	1
ACACAACGCA	GAAACACCGGTTTGAACTAGAAATAGCAAGTTAACCTAAGGCTAGTCCGT	3
ACACAACGCA	GAAACACCGGTTTGAACTACCTAGAGCTAGAAATAGCAAGTTAACCTAAG	2
ACACAACGCT	GAAACACCGGTTTGAACTAGGAATAGCAAGTTAACCTAAGGCTAGTCCGT	1
ACACACCAAC	GAAACACCGGTTTGAACTAGAAATAGCAAGTTAACCTAAGGCTAGTCCGT	1
ACACACCGCC	GAAACACCGGTTTGAACTAGAAATAGCAAGTTAACCTAAGGCTAGTCCGT	1
ACACACTGTA	GAAACACCGGTGTACGTATGGACTGAATCAGGGAGTGCAAGTGGGGTTAG	1
ACACAGCGCA	GAAACACCGGTTTGAACTAGAAATAGCAAGTTAACCTAAGGCTAGTCCGT	1
ACACCTCGGC	GAAACACCGGTACCTTTGTTGATGCTGGGTGGAAGGAATGTGGGGTTAGA	1
ACACGCGGCT	GAAACACCGGTCGATTCATATCGACACCTTCCCGTGACCGTGGGGTTAGA	1
ACACTCGCGC	GAAACACCGGTGCATTCGATAGCCCGGTGGTAGTGTGGCCGTGGGGTTAA	1
ACACTGATAT	GAAACACCGGTCTCTCGGGAGGCGGTCGTGGTGGGGTTAGAGCTAGAAAT	1
ACAGCCCTAT	GAAACACCGGTGCCCTTACTCTCACCTGATTACTTAATCCGTGGGGTTAG	1
ACAGCGCCGT	GAAACACCGGTGTACGTATGGACTGAACCAGGGTGTGCAAGTGGGGTTAG	1
ACAGCGTAGT	GAAACACCGGTGTACGTATGGACTGAACCAGGGTGTGCAAGTGGGGTTAG	1
ACAGCGTCGT	GAAACACCGGTGTACGTATGGACTGAACCAGGGTATGCAAGTGGGGTTAG	1
ACATAACGCA	GAAACACCGGTTTGAACTAGAAATAGCAAGTTAACCTAAGGCTAGTCCGT	1
ACATAACGCT	GAAACGCAAGTTAACCTAAGGCTAGTCCGTTATCAACTTGAAAAAGTGGC	1
ACATACAGTA	GAAACACCGGTCGAATCATATTGAAACCTTCCCGTGACAGTGGGATTAGA	1
ACATAGTCGT	GAAACACCGGTGTACGTATGGACTGAACCAGGGTGTGCAAGTGGGGTTAG	1
ACATTACCGT	GAAACACCGGTCGGGGCCACTCAGTGGTTGGGGTAGAGCTAGAAATAGCA	1
ACATTCGGTT	GAAACACCGGTCGATTCATATCGAAACCTTCCCGTGACAGTGGGGTTAGA	979
ACATTCGGTT	GAAACACCGGTCGATTCATATCGAAACCTTCCCGTGACAAGTGGGGTTAG	46
ACATTCGGTT	GAAACACCGGTTCCGTTATCAACTTGAAAAAGTGGCACCGAGTCGGTGCT	46
ACATTCGGTT	GAAACACCGGTCGATTCATATCGGGTTAGAGCTAGAAATAGCAAGTTAAC	13
ACATTCGGTT	GAAACACCGGTCGATTCATGGGGTTAGAGCTAGAAATAGCAAGTTAACCT	9
ACATTCGGTT	GAAACACCGGTCGATTCATATCGAAACCTTCCCGTGACCCCAGTGGGGTT	5
ACATTCGGTT	GAAACACCGGTCGATTCATATCGAAACCTTCAAGTGGGGTTAGAGCTAGA	4
ACATTCGGTT	GAAACACCGGTCGATTCATATCGAAACCTTCCCGGGTTAGAGCTAGAAAT	4
ACATTCGGTT	GAAACACCGGTCGATTCATATCGAAACCTTCCCGTGACAGTCAGAGCTAG	4
ACATTCGGTT	GAAACACCGGTCGATTCATATCGAAACCTTCCCGTGGGGTTAGAGCTAGA	4
ACATTCGGTT	CAAAACACCGGTCGATTCATATCGAAACCTTCCCGTGACAGTGGGGTTAG	3
ACATTCGGTT	GAAACACCGGTCGATTCATATCGAAACCTTCCCGTGAGTGGGGTTAGAGC	3
ACATTCGGTT	GAAACACCGGTCGATTCATATCGAAACCTTCCCGGTGGGGTTAGAGCTAG	2
ACATTCGGTT	GAAACACCAGTCGATTCATATCGAAACCTTCCCGTGACCCCAGTGGGGTT	1
ACATTCGGTT	GAAACACCGGTAAATTTGAGGCTCCGGCATGCAGGAGGCCGTGGGGTTAG	1
ACATTCGGTT	GAAACACCGGTAGCAAGTGCGAGACGTGTTTGTGGGGTTAGAGCTAGAAA	1
ACATTCGGTT	GAAACACCGGTCGATTCATATCGAAACCTTCCCGCGACCCCAGTGGGGTT	1
ACATTCGGTT	GAAACACCGGTCGATTCATATCGAAACCTTCCCGTGTGGTTAGAGCTAGA	1
ACATTCGGTT	GAAACACCGGTCGATTCATATCGAAACCTTCCCGTTAGAGCTAGAAATAG	1
ACATTCGGTT	GAAACACCGGTCGATTCATATCGGAACCTTCCCGGTGGGGTTAGAGCTAG	1
ACATTCGGTT	GAAACACCGGTCGATTCATATCGGGTTAGCTAGAAATAGCAAGTTAACCT	1
ACATTCGGTT	GAAACACCGGTCGATTCATATCTCAACCTTCCCGTGCCATTGGGTGTCTC	1
ACATTCGGTT	GAAACACCGGTCGCTTCATATCGAAACCTTCCCGAGGGGTTGGAGCTAGA	1
ACATTCGGTT	GAAACACCGGTCGCTTTATAACTAAACCTACCCGTGACAAGAGGGGGTTG	1
ACATTCGGTT	GAAACACCGGTCGGCGGCAATCGTGGGTGGGGTTAGAGCTAGAAATAGCA	1
ACATTCGGTT	GAAACACCGGTGACATTGGGTACAGGTGGGGTTAGAGCTAGAAATAGCAA	1
ACATTCGGTT	GAAACACCGGTTATATTTGTTCGAGTGCGGGGTTAGAGCTAGAAATTGCA	1
ACATTCGGTT	GAAACATCGGTCGATTCATATCGAAACCTTCCCGGGTTAGAGCTAGAAAT	1
ACATTCGGTT	GAAACATCGGTCGATTCATATCGAAACCTTCCCGTGACCCCAGTGGGGTT	1
ACCAACATAC	GAAACACCGGTGCCCTTACTCTCACCTGATTACTTAATCCGTGGGGTTAG	1
ACCAACGCCA	GAAACACGGGTTAGAGCTAGAAATAGCAAGTTAACCTAAGGCTAGTCCGT	1
ACCAAGGCCC	GAAACACCGGTTTGACCTACCTAGTTCAAACCGTGGGTATAGAGCTAGAA	1
ACCACCGCCC	GAAACACCGGTTTGAAAATAGCAAGTTAACCTAAGGCTAGTCCGTTATCA	1
ACCAGCGTCC	GAAACACCGGTTTGAACTAGAAATAGCAAGTTAACCTAAGGCTAGTCCGT	1
ACCATTACCG	GAAACACCGGTCGGGGCCACTCAGTGGGGTTAGAGCTAGAAATAGCAAGT	1
ACCGCACTAA	GAAACACCGGTGCCCTTACTCTCACCTGATTACTTAATCCGTGGGGTTAG	1
ACCGCGCTAT	GAAACACCGGTGCCCTTACTCTCACCTGATTACTTAATCCGTGAGGTTAG	1
ACCGGTAGTC	GAAACACCGGTGACACCGGGTACTTGACAAAGTGGCACAGAGTCGGTGCT	1
ACCTATCGAA	GAAACACCGGTTATATTTGTAAGTGTGTGGGGTTAGAGCTAGAAATAGCA	1
ACCTCCTGTT	GAAACACCGGTCGATTCATATCGAAACCTTCCCGTGACAAGTGGGGTTAG	1
ACCTTGGGTC	GAAACACCGGTCGATTCATATCGAAACCTTCCCGTGACAGGGGGGGTAGA	1
ACCTTTAACG	GAAACACCGGTCGGGGCCACTCAGTGGTGGGGTTAGAGCTAGAAATAGCA	1
ACCTTTACAG	GAAACACCGGTCGGGGCCACTCAGTGGTGGGGTTAGAGCTAGAAATAGCA	1
ACCTTTAGCG	GAAACACCGGTCGGGGCCACTCAGTGGTGGGGTTAGAGCTAGAAATAGCA	1
ACGAATACTT	GAAACACCGGTCTCGAGTGAGGTGTTCAGGGTGGGGTTAGAGCTAGAAAT	2
ACGAATCATT	GAAACACCGGTCTCGAGTGAGGTGTTCAGGGTGGGGTTAGAGCTAGAAAT	1
ACGAATCCTC	GAAACACCGGTCTCGAGTGAGGTGTTCAGGGTGGGGTTAGAGCTAGAAAT	1
ACGAATCCTG	GAAACACCGGTCTCGAGTGAGGTGGGGTTAGAGCTAGAAATAGCAAGTTA	1
ACGAATCGTT	GAAACACCGGTCTCGAGTGAGGTGTTCAGGGTGGGGTTAGAGCTAGAAAT	1
ACGAATGCTT	GAAACACCGGTCTCGAGTGAGGTGTTCAGGGTGGGGTTAGAGCTAGAAAT	1
ACGACTCTCG	GAAACACCGGTGCATTCGAAAGTCCGGTCGTAGTGTGGACGTGGGGTTAG	1
ACGAGTGTTC	GAAACACCGGTGACATTGGGTAGAGCTAGAAATAGCAAGTTAACCTAAGG	1
ACGAGTTGCT	GAAACACCGGTGACATTGGGTGGGGTTAGAGCTAGAAATAGCAAGTTAAC	1
ACGATAGAGG	GAAACACCGGTTATATTTGTAAGTGTGTGGGGTTAGAGCTAGAAATAGCA	1
ACGATTCCTT	GAAACACCGGTCTCGAGTGAGGTGTTCAGGGTGGGGTTAGAGCTAGAAAT	1
ACGCATCCTT	GAAACACCGGTCTCGAGTGAGGTGTTCAGGTGGGGTTAGAGCTAGAAATA	1
ACGCATCTTA	GAAACACCGGTGCATTCGAAAGTCCGGTCGGAGTGAGGACGTGAGTTTAG	1
ACGCATGAGG	GAAACACCGGTTATATTTGTAAGGGGTTAGAGCTAGAAATAGCAAGTTAA	1
ACGCCAATTT	GAAACACCGGTTAAGCCGAGGGTTAGAGCTAGAAATAGCAAGTTAACCTA	1
ACGCTCGCTC	GAAACACCGGTAGCTATATTCCGGCGATTTCGCCGTATCAGTGGGGTTAG	1
ACGGATCATT	GAAACACCGGTCTCGAGTGAGGTGTTCAAGGTGGGGTTAGAGCTAGAAAT	1
ACGGATCCTT	GAAACACCGGTCTCGAGTGAGGTGGGGTTAGAGCTAGAAATAGCAAGTTA	1
ACGGGTTGTC	GAAACACCGGTGACATTGGGTAGTGGGGTTAGAGCTAGAAATAGCAAGTT	1
ACGTCAAGCT	GAAACACCGGTTTACGATCCTTCTAAGTGGGGTTAGAGCTAGAAATAGCA	1
ACGTCACTAC	GAAACACCGGTGCCCTTACTCTCACCTGATTACTTAATCCGGGGGGTTAG	1
ACGTCGTCGT	GAAACACCGGGGTACGTATGGACTGAACCAGGGTGTGCAAGTGGGGTTAG	1
ACGTGCTGTC	GAAACACCGGTGACATTGGGTGGGGTTAGAGCTAGAAATAGCAAGTTAAC	1
ACGTGGTGTC	GAAACACCGGTGACATTGGGTAGAGCTAGAAATAGCAAGTTAACCTAAGG	1
ACGTGTTGTA	GAAACACCGGTGACATTGGGTACAGTTAGAGCTAGAAATAGCAAGTTAAC	1
ACGTGTTGTA	GAAACACCGGTGACATTGGGTACAGGGTGGGGTTAGAGCTAGAAATAGCA	1
ACGTGTTGTA	GAAACACCGGTGACATTGGGGTTAGAGCTAGAAATAGCAAGTTAACCTAA	1
ACGTGTTGTA	GAAACACCGGTGACATTGGGTTAGAAATAGCAAGTTAACCTAAGGCTAGT	1
ACTACACGGC	GAAACACCGGTACCTTTGTTGATGCTGGGTGGAAGGAATTCTAGAAATAG	1
ACTACTCAGC	GAAACACCGGTACCTTTGTCGATGCTGGGTGGAAGGAATGGGGTTAGAGC	1
ACTACTCAGC	GAAACACCGGTACCTTTGTTGATGCTGGGTGGAAGGAATGGGGTTAGAGC	1
ACTACTCGGT	GAAACACCGGTACCTTTGTTGATGCTGGGTGGAAGGGATTTTGTGGGGTT	1
ACTACTTGGC	GAAACACCGGTACCTTTGTTGATGCTGGGTGGAAGGTGTGGGGTTAGAGC	1
ACTATATCGC	GAAACACCGGTGCATTCGAAAGTCCGGTCGTAGTGTGGACGTGGGGTTAG	1
ACTATGCTGG	GAAACACCGGTCCGTAGATAACTCGGGTCTCGTGTGCGTGTGTGGTGAGA	1
ACTCTTGAGT	GAAACACCGGTTATATTTGTAAGTGTGTGGGGTTAGAGCTAGAAATAGCA	1
ACTCTTGGAC	GAAACACCGGTACCTTTGTTGATGCTGGGTAGAAGGAATTTTGTGGGGTT	1
ACTGAGCATA	GAAACACCGGTTAAGCCGAGGTTAGAGCTAGAAATAGCAAGTTAACCTAA	1
ACTGCGTAGC	GAAACACCGGTTTACGTTGCATCGGTGTGGGGTTAGAGCTAGAAATAGCA	1
ACTGTAGCGC	GAAACACCGGTCAGAGCCACTAAGGGGTGGGGTTAGAGCTAGAAATAGCA	1
ACTGTCGAAG	GAAACACCGGTGATCTTTGTAAGAGCGGGGGACTAGAGCTGTAGGGATCA	1
ACTGTCTGAC	GAAACAGCGGTGCCCTTACTCTCACCTGATTACTTAATCCGTGGGGTTAG	1
ACTTGTAGTA	GGAACACCGGTGACATCGGGTGGGGTTAGAGCTAGAAATAGCAAGTTACC	1
ACTTGTGGTC	GAAACACCGGTTTACGTTGCATCGGTTGTGGGGTTAGAGCTAGAAATAGC	1
ACTTTAGCGT	GAAACACCGGTCGGGGCCACTCAGTGGTGGGGTTAGAGCTAGAAATAGCA	1
ACTTTCACGC	GAAACACCGGTCAGGGGTTAGAGCTAGAAATAGCAAGTTAACCTAAGGCT	1
AGAAACAGAC	GAAACACCGGTAGCAAGTGCGACATCGCACGTTACCGTACGTCTCGTCCG	1
AGAAACAGAC	GAAACACCGGTAGCAAGTGGGGTTAGAGCTAGAAATAACAAGTTAACCTA	1
AGAAACCGAC	GAAACACCGGTAGCAAGTGCGAGCTAGAAATAGCAAGTTAACCTAAGGAT	1
AGAACAGCGC	GAAACACCGGTGCATTCGAAAGTCCGGTCGTAGTGTGGACGTGGGGTTAG	1
AGAACATCGA	GAAACACCGGTGCATTCGAAAGTCCGGTCGTAGTGTGGACGTGGGGTTAG	1
AGAACCTGCA	GAAACACCGGTAAATTTGAGGCTCCGGCATGCAGGAGGCCGTGGGGTTAG	1
AGAAGAAGCG	GAAACACCGGTCGGCGGTGGGGTTAGAGCTAGAAATAGCAAGTTAACCTA	1
AGAAGACACG	GAAACACCGGTCGGCGGCAATGTGGGGTTAGAGCTAGAAATAGCAAGTTA	1
AGAAGACCGG	GAAACACCGGTCGGCGGCAAGAAATAGCAAGTTAACCTAAGGCTAGTCCG	1
AGAAGACGCG	GTGGGGTTAGAGCTAGAAATAGCAAGTTAACCTAAGGCTAGTCCGTTATC	1
AGAAGCTAGG	GAAACACCGGTTATATTTGTAAGTGTGTGGGGTTAGAGCTAGAAATAGCC	1
AGAAGGCTCG	GAAACACCGGTCGGCGGCAATCGTGCTTTTTTTGGTTTAGGGCGGGTATT	1
AGAATATTTT	GAAACACCGGTCTCGAGTGAGGTGTTCAGGGTGGGGTTAGAGCTAGAAAT	1
AGAATTCCTT	GAAACACCGGTCTCGAGTGAGGTGTTCAGGGTGGGGTTAGAGCTAGAAAT	1
AGACAAATCC	GAGACACCGGTAGCAAGTGCGAGACGTGTTGGTGGGGTTAGAGCTAGAAA	1
AGACACAGAT	GAAACACCGGTAGCAAGTGGGGTTAGAGCTAGAAATAGCAAGTTAACCTA	1
AGACACAGGT	GAAACACCGGTAGCAAGTGCGAAGTAGCAAGTTAACCTAAGGCTAGTCCG	1
AGACACCGCC	GAAACACCGGTAGCAAGTGCGAGACGTGTTAAATAGCAAGTTAACCTAAG	1
AGACACGTGC	GAAACACCGGTGCATTCGAAAGTCCGGTCGTAGTGTGGACGTGGGGTTAG	1
AGACACTGAC	GAAACACCGGTTGCAAGAGCGCAACGTGTTTGTGGGGTTAGAGCTAGTAA	1
AGACCAGAGC	GAAACACCGGTGCATTCGAAAGTCCGGTCGTAGTGTGGACGTGGGGTTAG	1
AGACCATCTA	GAAACACCGGTGCATTCGAAAGTCCGGTCGTAGTGTGGACGTGGGGTTAG	1
AGACCCAGAC	GAAACACCGGTAGCAAGTGCGAGACGTGTTAAATAGCAAGTTAACCTAAG	1
AGACCCTCGC	GAAACACCGGTGCATTCGAAAGTCCGGTCGTAGTGTGGACGTGGGGTTAG	1148
AGACCCTCGC	CAAAACACCGGTGCATTCGAAAGTCCGGTCGTAGTGTGGACGTGGGGTTA	1
AGACCCTCGC	GAAACACCGGTGCATTCGAAAGTCCGGTCGTAGTGTGACGTGGGGTTAGA	1
AGACCCTCGC	GAAACACCGGTGCATTCTACAGCCCGGTCGTGGTATAGCTAGGGGTATCA	1
AGACCCTCGC	GAAACACCGGTGTGGCTGAGAGTCCGGCAATGGTGTGGCTGTGGGGTTAG	1
AGACCCTCGC	GAAACACCGGTTAAGCCGAGGTGGGGTTAGAGCTAGAAATAGCAAGTTAA	1
AGACCCTCGC	GAAACACCGGTTAAGCCGAGGTTAGAGCTAGAAATAGCAAGTTAACCTAA	1
AGACCCTCGC	GAAACACCGGTTACATTGAGTGGGGTTAGAGCCAGCACTAGCCAGTTAAC	1
AGACCCTCGC	GAAACACCGGTTTGAACCGGTGGGGTTAGAGCTAGAAATAGCAAGTTAAC	1
AGACCCTCGC	GAAACACCGGTTTGTTCTAAAGTCCGTTCGGCGAGTGAACGCAGGGTAAG	1
AGACCCTCGC	GAGACACCGGTTTAATCTAAAGATAGCACGTTAACCTGACGCTAGGCTAG	1
AGACGAGGGC	GAAACACCGGTGCATTCGAAAGTCCGGTCGTAGTGTGGACGTGGGGTTAG	1
AGACGGCCTG	GAAACACCGGTGGGGTTAGAGCTAGAAATAGCGAGTTAACCTAAGGCTAG	1
AGACGTGCGC	GAAACACCGGTGCATTCGAAAGCCCGGTCGTAGTGTGGACGTGGGGTTAG	1
AGACGTTCTC	GAAACACCGGTGCATTCGAAAGTCCGATCGTCGTGTGGACGTGGGGTTAG	1
AGACTCTTTT	GAAACACCGGTGCATTCGAAAGTCCGGTCGTAGTGTGGACGTGGGGTTAG	1
AGAGACAGAC	GAAACACCGGTAGCAAGTGGGGTTAGAGCTAGAAATAGCAAGTTAACCTA	1
AGAGAGAGAC	GAAACACCGGTAGCAAGTTAACCTAAGGCTAGTCCGTTATCAACTTGAAA	1
AGAGCCGTGC	GAAACACCGGTGCCTTCAATATCACCTGCGTAGTTTGTCCGTGGGGTTAG	1
AGAGGAGACT	GAAACACCGGTTCCCGTCCAGTGGGGTTAGAGCTAGAAATAGCAAGTTAA	1
AGAGGTGTCT	GAAACACCGGTGACAGGTGGGGTTAGAGCTAGAAATAGCAAGTTAACCTA	1
AGAGTACGCT	GAAACACCGGTAACATGTAGTTCTGAAAGCTAGAATTCTGAATTTGACCC	1
AGAGTAGGTT	GAAACACCGGTCGATTCAGATCGAAATCTTCCCGTGACAGTGGGGTTAGA	1
AGAGTGTGCC	GAAACACCGGTCCGTAGGAGACCCGTGTGGCATGTACCTGTGGGGTTAGA	1
AGATACACCC	GAAACACCGGTCCAAAATGTCGCCACGTGGGGTTAGAGCTAGCAATAGCA	1
AGATACCACC	GAAACACCGGTCCAAAATGTCGCCACGTGGGGTTAGAGCTAGAAATAGCA	1
AGATTGAGTC	GAAACACCGGTCCGTTCATTTCGAAACCTTCCCGTGACAAGTGGGGTTAG	1
AGATTTGTTT	GAAACACCGGTGAAATTGGGTGGGGATAGAGCTAGAAATAGCAAGTTAAC	1
AGATTTGTTT	GAAACACCGGTCGATTCATATCGAAATCTTCCCGGGTCAGTGGTGTTAGT	1
AGCACGTCTC	GAAACACCGGTAAATTTGAGGCTCCGGCATGCAGGAGGCCGTGGGATTAG	1
AGCAGACCCG	GAAACACCGGTCGGCGGCAATGTGGGGTTAGAGCTAGAAATAGCAAGTTA	1
AGCAGACCCG	GAAACACCGGTCGGCGGCAATCGTGCTTTTTTTCCTGCAGGGCGGGTCTT	1
AGCAGCATCC	GAAACACCGGTGTGGCTGAGAGTCCGGCAATGGTGTGGCTGTGGGGGTAG	1
AGCAGCCTTT	GAAACACCGGTCTCGAGTGAGGTGTTCAGGGTGGGGTTAGAGCTAGAAAT	1
AGCATACACA	GAAACACCGGTAGCCTGTGATTCTGCAGGGGCGTATCCTGAATTCTAGCA	1
AGCCAACGAC	GAAACACCGGTAGCAAGTGCGAGACGTGTTTGTGGGGTTAGAGCTAGAAA	1
AGCCGCTCCA	GAAACACCGGTAATTTTTAGGCCCCGGCATGCAGGAGGCCGTGGGTTTAG	1
AGCCTCGCGC	GAAACACCGGTGCATTCGAAAGTCCGGTCGTAGTGTGGACGTGGGGTTAG	1
AGCGCCAAAC	GAAACACCGGTGCCCTTACTCTCACCTGATTACTTAATCCGTGGGGTTAG	1
AGCGCCGTCC	GAAACACCGGTGCCCTTACTCTCACCTGATTACTTAATCCGTGGGGTTAG	1
AGCGGAGCCT	GAAACACCGGTTCCCGTCCAGTGGGGTTAGAGCTAGAAATAGCAAGTTAA	3
AGCGGAGCCT	GAAACACCGGTTCCCGTCCAGCGGGGTTAGAGCTAGAAATAGCAAGTTAA	1
AGCGGTGTCT	GAAACACCGGTGAACAGGGGTTAGAGCTAGAAATAGCAAGTTAACCTAAG	1
AGCGTTGTTT	GGAACACCGGTGACATTGGGGTGGGGTTAGAGCTAGAAATAGCAAGTTAA	1
AGCTATCGAG	GAAACACCGGTTATATTTGTAAGTGTGTGGGGTTAGAGCTAGAAATAGCA	1
AGCTCCTCTC	GAAACACCGGTGCATTCGAAAGTCCGGTCGTAGTGTGGACGTGGGGTTAG	1
AGGAACTCGC	GAAACACCGGTGCATTCGAAAGTCCGGTCGTAGTGTGGACGTGGGGTTAG	1
AGGACACAGA	GAAACACCGGTAGCGAGTGGGGTTAGAGCTAGAAATAGCAAGTTAACCTA	1
AGGACTCTCG	GAAACACCGGTGCATTCGAAAGTCCGGTCGTAGTGTGGACGTGGGGTTAG	1
AGGAGCCAAG	GAAACACCGGTAAATTTGAGGCTCCGGCATGCAGGAGGCCGTGGGGTTAG	1
AGGAGGATAC	GAAACACTGGTCCGTAGGAGACCCGTGTGGCATGTACCTGTGGGGTTAGA	1
AGGATCGGGC	GAAACACCGGTAACACTTGTTAGTGCGTGGGCGTATAGCTAGTAATAGCA	1
AGGCAACCGG	GAAACACCGGTGTGGCTGAGAGTCCGGCAATGGGGTGGCTGTGGGGGTAG	1
AGGCACCCTT	GAAACACCGGTGTGGCTGAGAGTCCGGCAATGGTGTGGCTGTGGGGTTAG	1
AGGCACCTAC	GAAACACCGGTAAATTTGAGGCCCCGGCATGCAGGAGGCCGTGGGGTTAG	1
AGGCACCTAC	GAAACACCGGTAAATTTGAGGCTCCGGCATGCAGGAGGCCGTGGGGTTAG	1
AGGCCACTAC	GAAACACCGGTAAATTTGAGGCTCCGGCATGCAGGAGGCCGTGGGGTTAG	1
AGGCCCAGGC	GAAACACCGGTTTACGTTGCATCGGTTGTGGGGTTAGAGCTAGAAATAGC	1
AGGCCCGGGA	GAAACACCGGTGCATTCGAAAGTCCGGTCGTGGTGTGGACGTGGGGTTAG	1
AGGCCCTTAC	GAAACACCGGTAAATTTGAGGCTCCGGCATGCAGGAGGCCGTGGGGTTAG	1
AGGCTCCTAC	GAAACACCGGTAAATTTGAGGCTCCGGCATGCAGGAGGCCGTGGGGTTAG	1
AGGCTGATTC	GAAACACCGGTCCGTAGGAGACCCGTGTGGCATGTACCTGTGGGGTTAGA	1
AGGGAAGCCT	GAAACACCGGTTCCCGTCCAGTGGGGTTAGAGCTAGAAATAGCAAGTTAA	1
AGGGCGGCTT	GAAACACCGGTGTCATTGGGTAAGTTAGAGCTAGAAATAGCAAGTTAAAT	1
AGGTGTTGTC	GAAACACCGGTGGGGATAGAGCTAGAAATAGCAAGTTAACCTAAGGCTAG	1
AGGTTCGAAT	GAAACACCGGTCAATTCGAATCTCCACCTTCCCGGGGGCCGAGGGCTAGA	1
AGTAAGCATA	GAAACACCGGTTAAGCCGAGGAGTTAGAGCTAGAAATAGCAAGTTAACCT	1
AGTATCGATG	GAAACACCGGTTATATTTGTAAGTGTTTGTGGGGTTAGAGCTAGAAATAG	1
AGTATCGTGG	GAAACACCGGTTATATTTGTAAGTGTGTGGGGTTAGAGCTAGAAATAGCA	1
AGTATTGTAT	GAAACACCGGTGACATTGGGGTTAGAGCTAGAAATAGCAAGTTAACCTAA	1
AGTCACGGAC	GAAACACCGGTAGCAAGTGCGAGACGTGTTAAATAGCAAGTTAACCTAAG	1
AGTCAGACTA	GAAACACCGGTCCGTAGGAGACCCGTGTGGCGAGCTAGAAATAGCAAGTT	1
AGTCTGCCTC	GAAACACCGGTCCGTAGGAGACCCGTGTGGCATGTACCTGTGGGGTTAGA	830
AGTCTGCCTC	GAAACACCGGTCCGTAGGAGACCCGTGTGGCATGTACCTTGTGGGGTTAG	38
AGTCTGCCTC	GAAACACCGGTCCGTAGGAGACCCGTGTGGCGAGCTAGAAATAGCAAGTT	17
AGTCTGCCTC	GAAACACCTGTGGGGTTAGAGCTAGAAATAGCAAGTTAACCTAAGGCTAG	16
AGTCTGCCTC	GAAACACCGGTCCGTAGGAGACCCGTGTGGCATGTAGTTAGAGCTAGAAA	12
AGTCTGCCTC	GAAACACCGGTGGGGTTAGAGCTAGAAATAGCAAGTTAACCTAAGGCTAG	12
AGTCTGCCTC	GAAACACCGGTCCGTAGGAGACCCGTGTGGCATGTGGTTAGAGCTAGAAA	9
AGTCTGCCTC	CTAGAAATAGCAAGTTAACCTAAGGCTAGTCCGTTATCAACTTGAAAAAG	8
AGTCTGCCTC	GAAACACCGGTCCGTAGGAGACCCGTGTGGCATGTACGGGGTTAGAGCTA	8
AGTCTGCCTC	GAAACACCGGTCCGTAGGAGACCCGTGTGGCATGTGTGGGGTTAGAGCTA	8
AGTCTGCCTC	GAAACACCGGTCCGTAGGAGACCCGTGTGGCATGTACCTCTGTGGGGTTA	5
AGTCTGCCTC	GAAACACCTGTGGGGTTAGAGCTAGGAATAGCAAGTTAACCTAAGGCTAG	5
AGTCTGCCTC	GAAACACCGGTCCGTAGGAGACCCGTGTGGCATGTACAGAGCTAGAAATA	3
AGTCTGCCTC	GAAACACCGGTCCGTAGGAGACCCGTGTGGCATGTGGGGTTAGTGCTAGA	3
AGTCTGCCTC	GAAACACCGGTCCGTAGGTGTGGGGTTAGAGCTAGAAATAGCAAGTTAAC	3
AGTCTGCCTC	GAAACACCGGTCCGTAGGAGACCCGTGTGGCATGTGGGGTTAGAGCTAGA	2
AGTCTGCCTC	GAAACACCGGTGCATTCGAAAGTCCGGTCGTAGTGTGGACGTGGGGTTAG	2
AGTCTGCCTC	CAAAACACCGGTCCGTAGGAGACCCGTGTGGCATGTACCTGTGGGGTTAG	1
AGTCTGCCTC	CAAAACACCTGTGGGGTTAGAGCTAGAAATAGCAAGTTAACCTAAGGCTA	1
AGTCTGCCTC	CTAAACACCGGTCCGTAGGAGACCTGTGTGGCATGTACCTGTGGGGTTAG	1
AGTCTGCCTC	GAAACACCGGCCCGTAGGAGACCCGTGTGGCATGTACCTCTGTGGGGTTA	1
AGTCTGCCTC	GAAACACCGGTAACTATATTCATGCGATATCGCCGTATCAGTGGGGTTAG	1
AGTCTGCCTC	GAAACACCGGTCCGGAGGAGACTCGTGTGGCATGTAGGTTGGGGGGTTAA	1
AGTCTGCCTC	GAAACACCGGTCCGTAGGAGACCGGTTTGCCATGTATATGTGGGGTAAGA	1
AGTCTGCCTC	GAAACACCGGTCCGTAGGAGGCCCGCGTAGCATGTACCTGGGGGGGTAAG	1
AGTCTGCCTC	GAAACACCGGTCCGTAGTCGACCCGTGTGGCGTGTACGTGGGGGGTGAAA	1
AGTCTGCCTC	GAAACACCGGTCCGTGGGAGACCCTTGTGGCGTGAGCCTAGAAATTGAGA	1
AGTCTGCCTC	GAAACACCGGTGTACGTATGGACTGAACCAGGGTGTGCAAGTGGGGTTAG	1
AGTCTGCCTC	GAAACACCGGTGTGGCTGAGAGTCCGGCAATGGTGTGGCTGTGGGGTTAG	1
AGTCTGCCTC	GAAACACCGGTTCCCGTCTATGTTGGGTTAGAGCTAGAAATAGCAAGTTA	1
AGTCTGCCTC	GAAACCCCGGTTACATTGGGGGGTTAGAGCTAGAAATAGCAAGTTAACCT	1
AGTCTGCCTC	GACGAAACACCGGTCCGTAGGAAACCCGTGTGGCATGTACCTGTGGGGTT	1
AGTCTGCCTC	GACGAAACACCGGTCCGTAGGAGACCCGTGTGGCATGTACCTGTGGGGTT	1
AGTCTGCCTC	GGAACACCGGTAAATTTGAGGCTCCGGCATGCAGGAGGCCGTGGGGTTAG	1
AGTCTGCCTC	GGAACACCGGTCCGTAGGAGACCCGTGTGGCATGTGGGGTTAGAGCTAGA	1
AGTCTGGTTA	GAAACACCGGTCCGTAGGAGACCCGTTTGGCATGTACCTGTGGGGGTAGA	1
AGTGAGCATA	GAAACACCGGTTAGAGCTAGAAATAGCAAGTTAACCTAAGGCTAGTCCGT	1
AGTGAGCATA	GAAACACCGGTTAAGCCGAGTGGGGTTAGAGCTAGAAATAGCAAGTTAAC	1
AGTGAGCATA	GAAACACCGGTTAAGCCGAGGAGTTGGAGCTAGAAATAGCAAGTTAACCT	1
AGTGGACACT	GAAACACCGGTTCCCGTCCAGTGGGGGTAAAGCTAGAAATAGCAGGATAA	1
AGTGGAGACT	GAAACACCGGTTCCCGTCCAGTGGGGTTAGAGCTAGAAATAGCAAGTTAA	1
AGTGGAGCAT	GAAACACCGGTTCCCGTCCAGTGGGGTTAGAGCTAGAAATAGCAAGTTAA	1
AGTGGAGCGT	GAAACACCGGTTCCCGTCCAGTGGGGTTAGAGCTAGAAATAGCAAGTTAA	2
AGTGGAGGCT	GAAACACCGGTTCCCGTCCAGTGGGGTTAGAGCTAGAAATAGCAAGTTAA	1
AGTGGATCCT	GAAACACCGGTTCCCGTCCAGTGGGGTTAGAGCTAGAAATAGCAAGTTAA	1
AGTGGCGCCT	GAAACACCGGTTCCCGTCCAGTGGGGTTAGAGCTAGAAATAGCAAGTTAA	1
AGTGGGGCCT	GAAACACCGGTTCCCGTCCAGTGGGGTTAGAGCTAGAAATAGCAAGTTAA	1
AGTGGTGCCT	GAAACACCGGTTCCCGTCCAGTGGGGTTAGAGCTAGAAATAGCAAGTTAA	1
AGTGGTGTCA	TAGCCTTAGTCCGTTATCAACTTGAAAAAGTGGCACCGAGTCGATGCTTT	1
AGTGTAGCCT	GAAACACCGGTTCCCGTCCAGTGGGGTTAGAGCTAGAAATAGCAAGTTAA	1
AGTTTACCGA	GAAACACCGGTCGGGGCCACTCAGTGGTGGGGTTAGAGCTAGAAATAGCA	1
AGTTTGCATG	GAATCACCGGTCCGTAGGAGTCCCGAGTGGCATTAACCTGAGGGGCTACA	1
AGTTTGGCTT	GAAACACCGGTCCGTAGGAGACCCGTGTGGCATGTACCTGTGGGGTTAGA	1
AGTTTTAGCT	GAAACACCGGTTTACGTTGCATAGGTGTGGGGGTAGGGCTAGGAATAGAA	1
ATAAATTATA	GAAACACCGGTAACTATATTCATGCGATGTCGTAGAGCTAGAAATAGCAA	1
ATAACTTCTA	GAAACACCGGTAACTATATTCATGCGATATCGCCGTATCAGTGGGGTTAG	1
ATAAGCTATG	GAAACACCGGTTTGAGGGTTAGAGCTAGAAATAGCAAGTTAACCTAAGGC	1
ATACACCGGC	GAAACACCGGTAAATTTGAGGCTCCGGCATGCAGGAGGCCGTGGGGTTAG	1
ATACCTAATC	GAAACACCGGTAACTATATTCATGCGATATCGCCGTATCAGTGGGGTTAG	1
ATACCTTATA	GAAACACCGGTAACTATATTCATGCGATATCGCCGTATCAGTGGGGTTAG	1
ATACTCGGAG	GAAACACCGGTACCTTTGTTGATGCTGGGTGGAAGGAATTGTGTGGGGTT	1
ATACTGCGAC	GAAACACCGGTTATATTTGTAAGAGTTTGTGGGGTTAGAGCTAGAACTAC	1
ATAGCTCCTA	GAAACACCGGTCGGCGGCAATCGTGGGCGGGGGTAGAGCTAGAAATAGAA	1
ATATATAGAG	GAAACACCGGTTATATTTGTAAGTGTGTGGGGTTAGAGCTAGAAATAGCA	1
ATATATCGAG	GAAACACCGGTTATATTTGTAAGTGTGTGGGGTTAGAGCTAGAAATAGCA	1
ATATGCGGTA	GAAACACCGGTCAATTCGTATCGTAACCTTGCCGAGACAGAGAGGTTACA	1
ATCAATCGGG	GAAACACCGGTTATATTTGTAAGTGTGTGGGGTTAGAGCTAGAAATAGCA	1
ATCAGTTCCG	GAAACACCGTCGAGGCCACTCATTGGGGTTAGAGCTAGAAATTGCACTTT	1
ATCCACAATT	GAAACACCGGTTACCGTACTTTGAGCGGATTACTAAATCCGGAGATATAG	1
ATCGAGCATA	GAAACACCGGTTAAGCCGAGGTTAGAGCTAGAAATAGCAAGGTAACCTAA	1
ATCGAGCATA	GAAACACCGGTTAAGCCGAGGTTAGAGCTAGAAATAGCAAGTTAACCTAA	1
ATCGATCGAG	GAAACACCGGTTATATTTGTAAGTGTGTGGGGTTAGAGCTAGAAATAGCA	2
ATCGATCTAC	GAAACACCGGTGCCCTTACTCTCACCTGATTACTTAATCCGTGGGGTTAG	1
ATCGCGCTAG	GAAACACCGGTGCCCTTACTCTCACCTGATTACTTAATCCGTGGGGTTAG	1
ATCGCTGCAC	GAAACACCGGTGCCCTTACTCTCACCTGATTACTTAATCCGGGGGGTTAG	1
ATCTAACGCG	GAAACACCGGTTATATTTGTAAGTGTGTGGGGTTAGAGCTAGAAATAGCA	1
ATCTACCGAG	GAAACACCGGTGGGGTTAGAGCTAGAAATAGCAAGTTAACCTAAGGCTAG	1
ATCTATAGAG	GAAACACCGGTTATATTTGTAAGTGTGTGGGGTTAGAGCTAGAAATAGCA	1
ATGACTTACA	GAAACACCGGTAAATTTGAGGCTCCGGCATGCAGGTGGCCGTGGGGTTAG	1
ATGAGAATAC	GAAACACCGGTTAAGCCGAGGGTTAGCGCTAGAAATAGCAAGTTAACCTA	1
ATGAGCACAC	GAAACACCGGTTAAGCCGAGGTTAGAGCTAGAAATAGCAAGTTAACCTAA	1
ATGAGCATCC	GAAACACCGGTTAAGCCGAGGGTTAGAGCTAGAAATAGCAAGTTAACCTA	1
ATGAGCATCG	GAAACACCGGTTAAGCCGATGTGCTTTTTTCCTGCAGGTTAGGCTCAAGA	1
ATGAGTCATT	GAAACACCGGTCTCGAGTGAGGGCAAGTTAACCTAAGGCTAGTCCGTTAT	1
ATGATTAGAG	GAAACACCGGTTTACGTTGCATCGGTTAGAGCTAGAAATAGCAAGTTAAC	1
ATGCATTCCC	GAAACACCGGTGCATTCGAAAGTCCGGTCGTAGTGTGGACGTGGGGTTAG	1
ATGCCTAATT	GAAACACCGGTTTACGTGCCAGCGGTGCGGGGTTTGAGTTAGAAAGATCG	1
ATGCCTAGGC	GAAACACCGGTTTACGCTGCATCGGTGTCGGGTTAGAGCTAGAAATAGCA	1
ATGCGCATTA	GAAACACCGGTTAAGCGGTTGTGCTTTTTTCCTGCGGGATCTTCTCAATA	1
ATGCTAGGCC	GAAACACCGGTACCGGGTTAGAGCTAGAAATAGCAAGTTAACCTAAGGCT	1
ATGCTTAGCT	GAAACACCGGTTTACGTTGCATCGGTGTGGGGTTAGAGCTAGAAATAGCA	1109
ATGCTTAGCT	GAAACACCGGTTTACGTTGCATCGGTTGTGGGGTTAGAGCTAGAAATAGC	317
ATGCTTAGCT	GAAACACCGGTTTACGTTGCATCGTTGAAAAAGTGGCACCGAGTCGGTGC	56
ATGCTTAGCT	GAAACACCGGTTTACGTTGCATCGGTTTGTGGGGTTAGAGCTAGAAATAG	49
ATGCTTAGCT	GAAACACCGGTTTACGTTGCATCGGGGTTGCATGGGGTTAGAGCTAGAAA	31
ATGCTTAGCT	CAAGTTAACCTAAGGCTAGTCCGTTATCAACTTGAAAAAGTGGCACCGAG	26
ATGCTTAGCT	GAAACACCGGGGTTAGAGCTAGAAATAGCAAGTTAACCTAAGGCTAGTCC	26
ATGCTTAGCT	GAAACACCGGTTTACGTTGCATCGGGGTTAGAGCTAGAAATAGCAAGTTA	26
ATGCTTAGCT	GACACCGGTTTACGTTGCGTTAGAGCTAGAAATAGCAAGTTAACCTAAGG	24
ATGCTTAGCT	GAAACACCGGTTTACGTTGCATCGGGATCCGGTGCTTTTTTTCCTGCAGG	19
ATGCTTAGCT	GAAACACCGGTTACGTTGCATCGGTGGGGTTAGAGCTAGAAATAGCAAGT	15
ATGCTTAGCT	GAAACACCGGTTACGTTGCATGGGGTTAGAGCTAGAAATAGCAAGTTAAC	15
ATGCTTAGCT	GAAACACCGGTTTACGTTGCATCGGTTAGAGCTAGAAATAGCAAGTTAAC	15
ATGCTTAGCT	GAAACACCGCTAGAAATAGCAAGTTAACCTAAGGCTAGTCCGTTATCAAC	13
ATGCTTAGCT	GAAACACCGGTTTACGTTGCATCGGTTACTAGAAATAGCAAGTTAACCTA	12
ATGCTTAGCT	GAAACACCGGTCCGTAGGAGACCCGTGTGGCATGTACCTGTGGGGTTAGA	11
ATGCTTAGCT	GAAACACCGGTTAGCAAGTTAACCTAAGGCTAGTCCGTTATCAACTTGAA	11
ATGCTTAGCT	GAAACACCGGTTTACGTTGCATCGGGTTAGAGCTAGAAATAGCAAGTTAA	11
ATGCTTAGCT	GAAACACCGGTTTACGTTGCTGTGGGGTTAGAGCTAGAAATAGCAAGTTA	6
ATGCTTAGCT	GAAACACCGGTTTACGTGGGGTTAGAGCTAGAAATAGCAAGTTAACCTAA	4
ATGCTTAGCT	GAAACACCGGTTACGTTGCATCGGTGTGGGGTTAGAGCTAGAAATAGCAA	3
ATGCTTAGCT	GAAACACCGGTTTACGTTGCATCGCTAGAAATAGCAAGTTAACCTAAGGC	3
ATGCTTAGCT	CAAAACACCGGTTTACGTTGCATCGGTGTGGGGTTAGAGCTAGAAATAGC	2
ATGCTTAGCT	GAAACACCGGTTGGCAAGTTAACCTAAGGCTAGTCCGTTATCAACTTGAA	2
ATGCTTAGCT	CAAAACACCGGTTTACGTTGCATCGGTTGTGGGGTTAGCGCTAGAGATAT	1
ATGCTTAGCT	CAAACCACCGGTTTACGTTGCATCGTTGAAAAAGTGGCACCGAGTCGGTG	1
ATGCTTAGCT	GAAACACAGGTTAACGTAAATTGGGAGTGGGGGTAAAACTAGGAAAAACA	1
ATGCTTAGCT	GAAACACCGGTACCACTCCCGTGTGGAGCTGTGGGGATACAGCTAGCAAT	1
ATGCTTAGCT	GAAACACCGGTATCTGTGTTGATGGTGGGTGGAAGGTGGGGGTAAAGCTA	1
ATGCTTAGCT	GAAACACCGGTGACAGTGGGGTTAGAGCTAGAAATAGCAAGGTAACCTAA	1
ATGCTTAGCT	GAAACACCGGTTACATTGAGGGTTAGAGCTAGAAATAGCAAGTTAACCTA	1
ATGCTTAGCT	GAAACACCGGTTATATTTGTAAGTGTGTGGGGTTAGAGCTAGAAATAGCA	1
ATGCTTAGCT	GAAACACCGGTTTACGGGGCATCCGTGTGGGGTTAAAGCTAGAAATTGGA	1
ATGCTTAGCT	GAAACACCGGTTTACGTTGCATCGTTGCTGGGGTAGATCTAGCAATAGCA	1
ATGCTTAGCT	GAAACACCGGTTTACGTTTAATCAGTGCGTGCTTAGAGATAGAGATAGCA	1
ATGCTTAGCT	GAGTTAACCTAAGGCTAGTCCGTTATCAACTTGTAAAAGTGGAACCGAGT	1
ATGCTTCCTT	GAAACACCGCTAGAAATAGCAAGTTAACCTAAGGCTCGTCCGGTATCAAC	1
ATGCTTTCGT	GAAACACCGGTTTACGTTGCATCGGTGTGGGGTTAGAGCTAGAAATAGCA	1
ATGGACCCCC	GAAACACCGGTTACCGTCCAGCGCGGTTAGAGCTAGAAATAGCAAGTTAG	1
ATGGAGAGTC	GAAACACCGGTTCCCGTCCAGTGGGGTTAGAGCTAGAAATAGCAAGTTAA	1
ATGGAGCATA	GAAACACCGGTTAAGCCGAGTGGGGTTAGAGCTAGAAATAGCAAGTTAAC	1
ATGGAGCATA	GAAACACCGGTTAAGCCGAGGAGTTAGAGCTAGAAATAGCAAGTTAACCT	1
ATGGCTAGGT	GAAACACCGGTTACTAGTGCTAGGAATAGCAAGTTGACCTAGAGCTAGTC	1
ATGGCTAGTC	GAAACACCGGTTTACGTTGCATCGGTGTGGAGTTAGAGCTAGAAAGATCA	1
ATGGCTATTC	GAAACACCGGTTACTTTGAGGGTTAGAGCTATAAGTATCGAGTTAACCTT	1
ATGGGAGCCT	GAAACACCGGTTCCCGTCCGGTGGGGTTAGAGCTAGAAATAGCAAGTTAA	1
ATGGGCTGTC	GAAACACCGGTGACATTTGTGGGTTTAGAGCTAGAAATATCAAGTTAACC	1
ATGGTGCGTT	GAAACACCGGTTTACGTTGCATCGGGATCCGGTGCTTTTTTTCATGCAGG	1
ATTAGATATG	GTGTGGAAAGGGTTAGAGCTAGAAATAGCAAGTTAACCTAAGGCTAGTCC	1
ATTAGATATG	GAAACACCGGTTACATTGAGGGGTTAGAGCTAGAAATAGCAAGTTAACCT	1
ATTAGCTACG	GAAACACCGGTTACATTGAGGGGTTAGAGCTAGAAATAGCAAGTTGACCT	1
ATTAGCTCTG	GAAACACCGGATACATTGAGGGTTAGAGCTAGAAATAGCAAGTTAACCTA	1
ATTAGCTCTG	GAAACACCGGTTACATTGAGGGGTTAGAGCTAGAAATAGCAAGTTAACCT	1
ATTAGCTGTG	GAAACACCGGTTACATTGAGGGGTTAGAGCTAGAAATAGCAAGTTAACCT	1
ATTAGTTATG	GAAACACCGGTTACATTGGGGTTAGAGCTAGAAATAGCAAGTTAACCTAA	1
ATTCGCATAC	GAACCACCGGTTAAGCCGAGGTTAGAGCTAGAAATAGCAAGTTAACCTAA	1
ATTCGCTATG	GAAACACCGGTTACATTGAGGGTTAGAGCTAGAAATAGCAAGTTAACCTA	1
ATTCGGCGTC	GAAACACCGGTGTACGTATGGACTGAACCAGGGTGTGCAAGTGGGGTTAG	1
ATTGAGAATA	GAAACACCGGTTAAGCCGAGGAGTTAGAGCTAGAAATAGCAAGTTAACCT	1
ATTGAGAATA	GAAACACCGGTTAAGCCGAGGTTAGAGCTAGAAATAGCATGTTAACCTAA	1
ATTGAGCATC	GAAACACCGGTTAAGCCGAGTGGGGTTAGAGCTAGAAATAGCAAGTTAAC	1
ATTGAGCATT	GAAACACCGGTTAAGCCGAGTGGGGTTAGAGCTAGAAATAGCAAGTTAAC	1
ATTGAGCGTA	GAAACACCGGTTAAGCCGAGGAGTTAGAGCTAGAAATAGCAAGTTAACCT	1
ATTGCGCATA	GAAACACCGGTTAAGCCGAGGAGTTAGAGCTAGAAATAGCAAGTTAACCT	1
ATTGCTCTGT	GAAACACCGGTTACATTGAGGGTTAGAGCTAGAAATAGCAAGTTAACCTA	1
ATTGGCTATG	GAAACACCGGTTACATTGAGGGTTAGAGCTAGAAATAGCAAGTTAACCTA	1
ATTTGCTATG	GAAACACCGGTTACTAGAGCTAGAAATAGCAAGTTAACCTAAGGCTAGTC	1
CAAAACGTCA	GAAACACCGGTGTGGCTGAGAGTCCGGCAATGGTGTGGCTGTGGGGTTAG	1
CAAACAGCCT	GAAACACCGGTTTGAACTACCGGGGTTAGAGCTAGAAATAGCAAGCTAAC	1
CAAACCGCCA	GAAACACCGGTTTGAGCTACCTAGTTCAAACCGGTGGGGTTAGAGCTAGA	1
CAACATGGCC	GAAACACCGGTACCTTTGTTGATGCTGGTGGGGCTAGAGCTAGAAATAGC	1
CAACTACAAT	GAAACACCGGTCGGGGCCAATCAGTGGTGGGGTTAGAGCTAGAAATAGCA	1
CAACTAGACC	GAAACACCGGTAGCAAGTGTGAGACGTGTTCAATAGCAAGTTAACCTAAG	1
CAAGATGCCC	GAAACACCGGTTTGAACTAGAAATAGCAAGTTAACCTAAGGCTAGTCCGT	1
CAATCCGACT	GAAACACCGGTACAACCGTCTCACTTGGTCGTGGGGTTAGAGCTAGAAAT	31
CAATGTCGAC	GAAACACCGGTGTACGTATGGACTGAACCAGGGTGTGCAAGTGGGGTTAG	1
CACAAAGCGA	GAAACACCGGTTTGAACTACCTAGTAGCAAGTTAACCTAAGGCTAGTCCG	1
CACAAAGTCA	GAAACACCGGTTTGAACTAGAAATAGCAAGTTAACCTAAGGCTAGTCCGT	1
CACAACGCCC	GAAACACCGGTTTGAACTAGAAATAGCAAGTTAACCTAAGGCTAGTCCGT	948
CACAACGCCC	GAAACACCGGTTTGAACTACCTAGTTCAAACCGGTGGGGTTAGAGCTAGA	130
CACAACGCCC	GAAACACCGGTTTGAACCGGTGGGGTTAGAGCTAGAAATAGCAAGTTAAC	117
CACAACGCCC	GAAACACCGGTTTGAACTACCGGGGTTAGAGCTAGAAATAGCAAGTTAAC	82
CACAACGCCC	TAGCAAGTTAACCTAAGGCTAGTCCGTTATCAACTTGAAAAAGTGGCACC	51
CACAACGCCC	GAAACACCGGTTTGAACTACCTAGAGCTAGAAATAGCAAGTTAACCTAAG	49
CACAACGCCC	GAAACGCAAGTTAACCTAAGGCTAGTCCGTTATCAACTTGAAAAAGTGGC	26
CACAACGCCC	GAAACACCGGTTTAGAGCTAGAAATAGCAAGTTAACCTAAGGCTAGTCCG	25
CACAACGCCC	GAAACACCGGTTTGAACTACCTAGCAAGTTAACCTAAGGCTAGTCCGTTA	23
CACAACGCCC	GAAACACCGGTTTTAGAAATAGCAAGTTAACCTAAGGCTAGTCCGTTATC	22
CACAACGCCC	GAAACACCGGTTTGAACTACCTAGTAGCAAGTTAACCTAAGGCTAGTCCG	19
CACAACGCCC	GAAATAGCAAGTTAACCTAAGGCTAGTCCGTTATCAACTTGAAAAAGTGG	19
CACAACGCCC	GAAACACCGGTTTGAAAATAGCAAGTTAACCTAAGGCTAGTCCGTTATCA	17
CACAACGCCC	GAAACACCGGTTTGAACTACCTAGAAATAGCAAGTTAACCTAAGGCTAGT	17
CACAACGCCC	AGCTAGAAATAGCAAGTTAACCTAAGGCTAGTCCGTTATCAACTTGAAAA	15
CACAACGCCC	GAAACACCGGTTTGAACTACCTAGGGGGTAGTTCAAACCGGGGTTAGAGC	14
CACAACGCCC	AAAGTGGGGTTAGAGCTAGAAATAGCAAGTTAACCTAAGGCTAGTCCGTT	12
CACAACGCCC	GAAACACCGGTTTGAACTACCTAGTTCAAACCGTGGGGTTAGAGCTAGAA	11
CACAACGCCC	GAAACACCGGTTTGGGGTTAGAGCTAGAAATAGCAAGTTAACCTAAGGCT	11
CACAACGCCC	CACGGGTTAGAGCTAGAAATAGCAAGTTAACCTAAGGCTAGTCCGTTATC	10
CACAACGCCC	GAAACACCGTGGGGTTAGAGCTAGAAATAGCAAGTTAACCTAAGGCTAGT	10
CACAACGCCC	GACACGGGTTAGAGCTAGAAATAGCAAGTTAACCTAAGGCTAGTCCGTTA	7
CACAACGCCC	GAAACACCGGTTTGAACTACCTAGTTCAAACGGTTAGAGCTAGAAATAGC	3
CACAACGCCC	GAAACACCGGTAAATTTGAGGCTCCGGCATGCAGGAGGCCGTGGGGTTAG	2
CACAACGCCC	GAAACACCGGTTTGAACTACCTAGTTCAAACACCGGTTTGAACTACCTAG	2
CACAACGCCC	GAAACACCGGTTTGAACTAGAAATAGCAAGTTAACCTAGGCTAGTCCGTT	2
CACAACGCCC	CAAAACACCGGTTTGAACTACCGGGGTTAGAGCTAGAAATAGCAAGTTAA	1
CACAACGCCC	CAAAACACCGGTTTGAACTAGAAATAGCAAGTTAACCTAAGGCTAGTCCG	1
CACAACGCCC	CAAAACACCGGTTTTAGAAATAGCAAGTTAACCTAGGGCTAGTCCGTTAT	1
CACAACGCCC	GAAACACCGGTCGGCAGCAATCGCGGGCGGGGGTATAGCTAGAAATAGCA	1
CACAACGCCC	GAAACACCGGTCGGCGGCAATCCCGTGGGGTTAGAGCTAGAAATAGCAAG	1
CACAACGCCC	GAAACACCGGTCGGGGCCACTCAGTGGAGGGGTTAGAGCTAGAAATAGCA	1
CACAACGCCC	GAAACACCGGTTTGAAACTCGCAAGTTAACCTAAGGCTCGACAGATATCA	1
CACAACGCCC	GAAACACCGGTTTGAACTACCTAGGATTAGAGCTAGAAATAGCAAGTTAA	1
CACAACGCCC	GAAACACCGGTTTGAACTAGAAATAGCAGTTAACCTAAGGCTAGTCCGTT	1
CACAACGCCC	GAAACACCGGTTTGAACTCCCTAGAACTTCTAGGGTTAGAGCTAGAAATA	1
CACAACGCCC	GAAACACCGGTTTGATCTCCCTCGTTCAAACCGGAGAGGTTAAAGCTAGA	1
CACAACGCCC	TAGCAAGTTAACCTAAGGCTAGTCCGTTATCAACTTGAAAAGTGGCACCG	1
CACACCCACC	GAAACACCGGTAGCAAGTGGGGTTAGAGCTAGAAATAGCAAGTTAACCTA	1
CACAGTCGCT	GAAACACCGGTGTACGTATGGACTGAACCAGGGTGTGCAAGTGGGGTTAG	1
CACATAGACT	GAAACACCGGTTTGAACTAGAAATAGCAAGTTAACCTAAGGCTAGTCCGT	1
CACATGGCGC	GAAACACCGGTTTGAACTAGAAATAGCAAGTTAACCTAAGGCTAGTCCGT	1
CACATTGCCT	GAAACACCGGTTTGAACTAGAAATAGCAAGTTAACCTAAGGCTAGTCCGT	1
CACCACGTAC	GAAACACCGGTTTGAACTAGAAATAGCAAGTTAACCTAAGGCTAGTCCGT	1
CACCCCGACA	GAAACACCGGTAGCAAGTGGGGTTAGAGCTAGAAATAGCAAGTTAACCTA	1
CACCTCGGCT	GAAACACCGGTACCCTTGTTGATGCTGGGGGGATGGAAGGTGGGGTTAGA	1
CACCTCGTCC	GAAACACCGGTACCTTTGTTGTTGCTGGGTGGATGGAGGTGTTAGAGCTA	1
CACCTTATCC	GAAACACCGGTAACTATATTCATGCGATATCGCCGTAGCAGTGGGTGAGG	1
CACGACATAC	GAAACACCGGTGCCCTTACTCTCACCTGATTACTTAATCCGTGGGGTTAG	1
CACGACGTAC	GAAACACCGGTGCCCTTACTCTCACCTGATTACTTAATCCGTGGGGTTAG	1
CACGCCAACC	GAAACACCGGTAAACTTGAGGCCCCGGCATGCATTAGGCCGTGGGGTTAG	1
CACGCCCATC	GAAACACCGGTGCCCTTACTCTCACCTGATTACTTAATCCGTGGGGTTAG	1
CACGCCCCGC	GAAACACCGGTTTCAACTACTTAGAAAGTTAACCTAAGGCAAGTCCGTTA	1
CACGTTGTAT	GAAACACCGGTGACATTACTCTCACCTGGTTATTTAATGCGAGGCGTTAG	1
CACTTCGGAT	GAAACACCGGTCGATTCATATCGAAACCTTCCCGTGACAGTGGGGTTAGA	1
CAGAACGACA	GAAACACCGGTTTGAACCGGTGGGGTTAGTGCTAGAAATAGCAAGTTAAC	1
CAGACACGTC	GAAACACCGGTGTACGCATGGACTGAACCGGGGTGTGCCTAGGGAGATAG	1
CAGATAGCCC	GAAACACCGGTTTGAACTAGAAATAGCAAGTTAACCTAAGGCTAGTCCGT	1
CAGATCGCGC	GAAACACCGGTTTGAACTAGAAATAGCAAGTTAACCTAAGGCTAGTCCGT	1
CAGCACGGCC	GAAACACCGGTTTGAACTACCTAGTTCAAACCGGTGGGGTTAGAGCTAGA	1
CAGCAGACCC	GAAACACCGGTCGGCGGCAATCGTGGGTGGGGTTAGGGCTAGAAATAGCA	1
CAGCTGACAC	GAAACACCGGTCGGCGGCAATGGGGTTAGAGCTAGAAATAGCAAGTTAAC	1
CAGCTTATGC	GAAACACCGGTAACTATATTCATGCGATATCGCCGTATCAGTGGGGTTAG	1
CAGGTTCTCC	GAAACACCGGTCAGAGACAGTCGTTAGAGCTAGAAATAGCAAGTTAACCT	1
CATAAAGCAC	GAAACACCGGTTTGAACTAGAAATAGCAAGTTAACCTAAGGCTAGTCCGT	1
CATAATGCTC	GAAACACCGGTTTGAACGAGAAATAGCAGGTTTACCTAAGGCTAGTCCGT	1
CATACCGCAC	GAAACACCGGTTTGAACTACCTAGCAAGTTAACCTAAGGCTAGTCCGTTA	1
CATAGTAGCA	GAAACACCGGTGTACGCATGGGCTGAACCGGGGTGAGCAGGTGGGTATCG	1
CATAGTAGTG	GAAACACCGGTGTACGTATGGACTGAACCAGGGTGTGCAAGTGGGGTTAG	1
CATAGTGGTA	GAAACACCGGTGTACGTATGGACTGAACCAGGGTGTGCAAAGTGGGGTTA	1
CATCGTCGTC	GAAACACCGGTGTACGTATGGACTGAACCAGGGTGTGCAAGTGGGGTTAG	824
CATCGTCGTC	GAAACACCGGTGTACGTATGGACTGAACCAGGGTGCATTAGGTTAGTCCG	30
CATCGTCGTC	GAAACACCGGTGTACGTATGGACTGAACCAGGGTGTGCAAAGTGGGGTTA	25
CATCGTCGTC	GAAACACCGGTGTCGGTGCTTTTTTTCCTGCAGGGACGACGATGGAATTC	14
CATCGTCGTC	GAAACACCGGTGTACGTATGGACTAACCTAAGGCTAGTCCGTTATCAACT	13
CATCGTCGTC	GAAACACCGGTGTACGTATGGACTGAACCAGGGTGTGCAATGGGGTTAGA	11
CATCGTCGTC	GAAACACCGGTGTACGTATGGACTGAACCAGGGTGTGCAGGTTAGAGCTA	4
CATCGTCGTC	GAAACACCGGTGTACGTATGGACTGAACCAGGGTGTGCTGAACCAGGGTG	4
CATCGTCGTC	GAAACACCGGTCCGTAGGAGACCCGTGTGGCATGTACCTGTGGGGTTAGA	3
CATCGTCGTC	GAAACACCGGTGTCGGTGCTTCTTTTCCTGCAGGGACGACGATGGAATTC	2
CATCGTCGTC	CAAAACACCGGTGTACGTATGGACTGAACCAGGGTGTGCAAGTGGGGTTA	1
CATCGTCGTC	GAAACACCGGCGTACGTATGGACTGAACCAGGGTGTGCAGGTTAGAGCTA	1
CATCGTCGTC	GAAACACCGGTAAAGGTATTGTGTGAACCGGGGTGTGTGTGTGGGGTTAG	1
CATCGTCGTC	GAAACACCGGTAACCTAAGGCTAGTCCGTTATCAACTTGAAAAAGTGGCA	1
CATCGTCGTC	GAAACACCGGTACCTTTGTTGATGCTGGGTGGAAGGAATTTGTGGGGTTA	1
CATCGTCGTC	GAAACACCGGTCGGCGGCAATCGGTCGCCGACCGTCGGTGGGGTTAGAGC	1
CATCGTCGTC	GAAACACCGGTGACATTGGGTACAGGGTGGGGTTAGAGCTAGAAATAGCA	1
CATCGTCGTC	GAAACACCGGTGCACGGATGGACTGAATCAGGGTGTGCCAGTGGGGATCG	1
CATCGTCGTC	GAAACACCGGTGCATTCGAAAGTCCGGTCGTAGTGTGGACGTGGGGTTAG	1
CATCGTCGTC	GAAACACCGGTGGCGGTGCTTTTTTTCTAGTAGGCTCGTTGTTGGATTAG	1
CATCGTCGTC	GAAACACCGGTGTACGGCTGGACTGCACACGGGCGTGCTAGTGGGGTTAG	1
CATCGTCGTC	GAAACACCGGTGTACGTATGACTGAACCAGGGTGTGCAAGTGGGGTTAGA	1
CATCGTCGTC	GAAACACCGGTGTACGTATGGACTGAACAGGGTGTGCAAGTGGGGGTAGA	1
CATCGTCGTC	GAAACACCGGTGTACGTATGGACTGAACCAGGGTGTGCCGAACCAGGGTG	1
CATCGTCGTC	GAAACACCGGTGTACGTATGGACTGAACCTGGGCGTGCAGGTTGGAGCTA	1
CATCGTCGTC	GAAACACCGGTGTACGTATGGATTGAACCAGAGCCTGAAAGTGGGCTTAT	1
CATCGTCGTC	GAAACACCGGTGTCGGTGCTTTTTTCCTGCAGGGACGACGATGGAATTCG	1
CATCGTCGTC	GAAACACCGGTGTGCGTATGAACTGTACCAGGGTATGCAAGGGGGGTTAA	1
CATCGTCGTC	GAAACACCGGTTAAATTGAGGATTAAAGCTGGGAATACCAGGGTAGCCTG	1
CATCGTCGTC	GAAACGCCGGTTAAGCCGAGTGGGGTTAGAGCTAGAAATAGCAAGTTAAC	1
CATCTAACGC	GAAACACCGGTCGGGGCCACTCAGTGGTGGGGTTAGAGCTAGAAATAGCA	1
CATCTCCGTT	GAAACACCGGTGTACGTATGGACTGAACCAGGGTGTGCAAGTGGGGTTAG	1
CATTAGCCGC	GAAACACCGGTCGGCGGCAATCGGGGGTGGGGTTAGAGCTAGAAATAGCA	1
CATTGACTGC	GAAACACCGGTCGGGGCCACTCAGTGGTGGGGTTAGAGCTAGAAATAGCA	1
CATTGCAGTC	GAAACACCGGTGTACGTATGGACTGAACCAGGGTGTGCAAGTGGGGTTAG	1
CATTTATAGC	GAAACACCGGTCGGGGCCACTCAGTGGTGGGGTTAGAGCTAGAAATAGCA	1
CCAATCGTGG	GAAACACCGGTTAAATTTCTAAGTGTTTTGGGGTTAGAGTTAGAAATAGC	1
CCATGCGGTC	GAAACACCGGTCGATTCATATCGAAACCTTCCCGTGACAGTGGGGTTAGA	1
CCATTACTTC	GAAACACCGGTCTCGAGTGAGGTGTTCAGGGTGGGGTTAGAGCTAGAAAT	1
CCCATACCTC	GAAACACCGGTTGGCTGGATGGGTACATCTAGAAATAGCAAGTTAACCTA	1
CCCCTCACTT	GAAACACCGGTGGAAGGTTGTATGTTGCTAGTGGGGTTAGAGCTAGAAAT	1
CCGCGTCTTC	GAAACACCGGTGTACGTATGGACTGAACCAGGGTGTGCAAGTGGGGTTAG	1
CCTCACCCCA	GAAACACCGGTTTGAACTAGAAATAGCAAGTTAACCTAAGGCTAGTCCGG	1
CCTGCCCCAC	GAAACACCGGTCGGGGCAATTCCACGTGATTGCTAAAGCTGGGAGTAGAG	1
CCTTACAGCC	GAAACACCGGTCGGGGCCACTCAGTGGTGGGGTTAGAGCTAGAAATAGCA	1
CCTTTACCGC	GAAACACCGGTCGGGGCCACTCAGTGGTGGGGTTAGAGCTAGAAATAGCA	1003
CCTTTACCGC	GAAACACCGGTCGGGGCCACTCAGTGGGGTTAGAGCTAGAAATAGCAAGT	61
CCTTTACCGC	GAAACACCGGTCGGGGGTTAGAGCTAGAAATAGCAAGTTAACCTAAGGCT	33
CCTTTACCGC	GAAACACCGGTCGGGGCCACTCAGTGTGGGGTTAGAGCTAGAAATAGCAA	25
CCTTTACCGC	GAAACACCGGTCGGGGCCACGGGTTAGAGCTAGAAATAGCAAGTTAACCT	22
CCTTTACCGC	GAAACACCGGTCGGGGCCACGGTTAGAGCTAGAAATAGCAAGTTAACCTA	19
CCTTTACCGC	GAAACACCGGTCGGGGCCGGTTAGAGCTAGAAATAGCAAGTTAACCTAAG	19
CCTTTACCGC	GAAACACCGGTCGGGGCCACTCAGTGGGTGGGGTTAGAGCTAGAAATAGC	17
CCTTTACCGC	GAAACACCGGTTATATTTGTAAGTGTGTGGGGTTAGAGCTAGAAATAGCA	13
CCTTTACCGC	GAAACACCGGTCGGGAGCTAGAAATAGCAAGTTAACCTAAGGCTAGTCCG	11
CCTTTACCGC	GAAACACCGGTCGGGGCCAGAGCTAGAAATAGCAAGTTAACCTAAGGCTA	11
CCTTTACCGC	GAAACACCGGTCGGGGCCACTCAGGTGGGGTTAGAGCTAGAAATAGCAAG	9
CCTTTACCGC	GAAACACCGGTCGGGGCCACTGGGGTTAGAGCTAGAAATAGCAAGTTAAC	7
CCTTTACCGC	GAAACAGGTGGGGTTAGAGCTAGAAATAGCAAGTTAACCTAAGGCTAGTC	6
CCTTTACCGC	GAAACACCGGTCGGGGCCACTCGAGCTAGAAATAGCAAGTTAACCTAAGG	5
CCTTTACCGC	GAAACACCGGTCGGGTTAGAAATAGCAAGTTAACCTAAGGCTAGTCCGTT	5
CCTTTACCGC	GAAACACCGTCGGGGCCACTCAGTGGGGTTAGAGCTAGAAATAGCAAGTT	5
CCTTTACCGC	GAAACACCGGTCGGGGCCACTCAGGGTTAGAGCTAGAAATAGCAAGTTAA	3
CCTTTACCGC	GAAACACCGGTCGGGGCCACTCAGTGGCGGGGGTTGAGGTAGAAAAAACA	2
CCTTTACCGC	GAAACAGGTGGGGTTAGAGCTAGAGATAGCAAGTTAACCTAAGGCTAGTC	2
CCTTTACCGC	CAAAACACCGGTCAGGGCCACGGTTAGAGCTAGAAATAGCAAGTTAACCT	1
CCTTTACCGC	CAAAACACCGGTCGGGGCCACTCAGTGGTGGGGTTAGAGCTAGAAATAGC	1
CCTTTACCGC	GAAACACCGGCCGGGGCCACTCGAGCTAGAAATAGCAAGTTAACCTAAGG	1
CCTTTACCGC	GAAACACCGGTCAGGGCCACGCATAGAGGTTAGAGCTGGAAATAACCAGA	1
CCTTTACCGC	GAAACACCGGTCGGGCCACTCAGTGGTGGGGTTAGAGCTAGAAATAGCAA	1
CCTTTACCGC	GAAACACCGGTCGGGGCCACTCAGTGGGGGGGGTTAGGGTAGGAATAGGC	1
CCTTTACCGC	GAAACACCGGTCGGGTTAGAAATAGCGAGTTAACCTAAGGCTAGTCCGTT	1
CCTTTACCGC	GAAACACCGGTTGCCGCCCCTCAGTGGTGGGGTTAGAGCTAGCAAGAGCA	1
CCTTTACCGC	GAAACACCGTCGGGGCCACTCAGTGGGGTTAGAGCTAGAAATAGCGAGTT	1
CCTTTACCGC	GAAACACCGTCGGGGCCACTCAGTGGGGTTAGAGCTAGAAGTAGCAAGTT	1
CCTTTACCGC	GAAACACCGTCGGGGCCGCTCAGTGGGGTTAGAGCTAGAAATAGCAAGTT	1
CCTTTAGAGG	GAAACACCGGTCGTATTTACTCAGGGTTGGGGTTAGAGCTAGAAATAGCA	1
CCTTTAGGGA	GAAACACCGGTCGGGAGCTAGAAATAGCAAGTTAACCTAAGGCTAGTCCG	1
CCTTTAGTGT	GAAACACCGGTGACATTGGTGGGGTTAGAGCTAGAAATCGCAAGTTAACC	1
CGAAGACGTG	GAAACACCGGTCTCGAGTGAGGTGTTCAGGGGGGGGTTAGAGCGAGAAAT	1
CGAATAGTTC	GAAACACCGGTTTCGAGTGAGGTGTTCAGGGTGGGGTTAGAGCTAGAAAT	1
CGAATATTTC	GAAACACCGGTCTCGAGTGAGGTGCTAGAAATAGCAAGTTAACCTAAGGC	1
CGAATCCTTT	GAAACACCGGTCTCGAGTGAGGTGTTCAGGGTGGGGTTAGAGCTAGAAAT	1047
CGAATCCTTT	GAAACACCGGTCTCGAGTGAGGTGTTCAGGGGTGGGGTTAGAGCTAGAAA	73
CGAATCCTTT	GAAACACCGGTCTCGAGTGAGGTGTTCAGGTGGGGTTAGAGCTAGAAATA	73
CGAATCCTTT	GAAACACTAAGGCTAGTCCGTTATCAACTTGAAAAAGTGGCACCGAGTCG	33
CGAATCCTTT	GAAACACCGGTCTCGAGTGAGGTTAGCAAGTTAACCTAAGGCTAGTCCGT	32
CGAATCCTTT	GAAACACCGGTCTCGAGTGAGGTTAGAGCTAGAAATAGCAAGTTAACCTA	26
CGAATCCTTT	GAAACACCGGTCTCGAGTGAGGGCAAGTTAACCTAAGGCTAGTCCGTTAT	21
CGAATCCTTT	GAAACACCGGTCTCGAGTGAGATTAGAGCTAGAAATAGCAAGTTAACCTA	16
CGAATCCTTT	GAAACACCGGTCTCGAGTGAGGTGCTAGAAATAGCAAGTTAACCTAAGGC	14
CGAATCCTTT	GAAACACCGGTCTCGAGTGAGTGGGGTTAGAGCTAGAAATAGCAAGTTAA	10
CGAATCCTTT	GAAACACCGGTCTCGAGTGAGGTGGGGTTAGAGCTAGAAATAGCAAGTTA	8
CGAATCCTTT	GAAACACCGGTCTCGAGTGAGGTGTTCAGTTCAGGTGGGGTTAGAGCTAG	7
CGAATCCTTT	GAAACACCGGTCTCGAGTGAGGTGTTCAGAGCTAGAAATAGCAAGTTAAC	5
CGAATCCTTT	GAAACACCGGTCTCGAGTGAGGTATAGCAAGTTAACCTAAGGCTAGTCCG	3
CGAATCCTTT	GAAACACCGGTCTTGAGTGAGGTGGGGTTAGAGCTAGAAATAGCAAGTTA	2
CGAATCCTTT	GAAACACCGGTTACATTGAGGGTTAGAGCTAGAAATAGCAAGTTAACCTA	2
CGAATCCTTT	AGGGAAGAAACACCGGTCTCGAGTGAGGTGTTCAGGGTGGGGTTAGAGCT	1
CGAATCCTTT	CAAAACACTAAGGCTAGTCCGTTATCAACTTGAAAAAGTGGCACCGAGTC	1
CGAATCCTTT	GAAACACCGGTCGATTCATAGCGAAACCTTCCCGTGACACCAGTAGGGAT	1
CGAATCCTTT	GAAACACCGGTCGGGGCCACTCAGTGGTGGGGTTAGAGCTAGAAATAGCA	1
CGAATCCTTT	GAAACACCGGTCTCGAGTGAGGCGTTCAGAGCTAGAAATAGCAAGTTAAC	1
CGAATCCTTT	GAAACACCGGTCTCGAGTGAGTGTTTGTGGGGTTGTTGCTAGTAGTAGCA	1
CGAATCCTTT	GAAACACCGGTCTCGTGTGAGGTTTCCAGGGTGGGGGTAGGGCTAGACAT	1
CGAATCCTTT	GAAACACCGGTGACATGGGGGGCATTGGGGGGGGTAGTACTGGAAATAGC	1
CGAATCCTTT	GAAACACCGGTGTGGCTGAGAGTCCGGCAATGGGGTGGCTGGGGGGTTAG	1
CGAATCCTTT	GAAACACTGATACTCGTCCTTTATCCACTTGAATAAAGGGCAACATATCG	1
CGAATCCTTT	GAAATACCGGTGTGGCTGAGAGTGTTGAAATGGTGTTGCTGCTAGGATTG	1
CGAATCCTTT	GAGACACCGGTCTCGAGTGAGGTGTTCAGAGCTAGAAATAGCAAGTTAAC	1
CGACACTCAC	GAAACACCGGTGCATTCGAACGCCAGGTCGTCGTGTGGCCGTGGGGTTAG	1
CGACATTCGC	GAAACACCGGTGCATTCGAAAGTCCGGTCGTAGTGTGGACGTGGGGTTAG	1
CGACGTCGTT	GAAACACCGGTGTACGTATGGACTGAACCAGGGTGTGCAAGTGGGGTTAG	1
CGAGATCCTC	GAAACACCGGTGCATTCGAAAGTCCGGTCGTAGTGTGGACGTGGGGTTAG	1
CGAGATGTCC	GAAACACCGGTGACATTGAGCTAGACATTAGAGCTAGAAATAGCAAGTTA	1
CGAGCGGTCA	GAAACACCGGTGACATTGGGTCATGCCTATTGACCTAGTAGTAGCGCTAT	1
CGAGCTGCCG	GAAACACCGGTGACATTGGGAACAGAGCTAGAAATAGCAAGTTAACCTAA	1
CGAGTCGGCT	GAAACACCGGTGACATTGGGCGGGGTTAGAGCTAGCAATAGCAAGTTAAC	1
CGATCCCCTT	GAAACACCGGTCTCGAGTGAGGCGTTCAGGGGTGGGGTTAGAGCTAGAAA	1
CGCAACCATT	GAAACACCGGTCTCGAGTGAAGTGTTCAGGGTGGGGTTAGAGCTAGAAAT	1
CGCAACTCCA	GAAACACCGGTTTATTTGACCCTGCTGCATGCAGGAAGCCGTGAGGATAG	1
CGCAGCCCCC	GAAACACCGGTTTGAACCGGTGGGGTTAGAGCTAGAAATAGCAAGTTAAC	1
CGCATCGACT	GAAACACCGGTGACATTGGGAACAGAGCTAGACATAGGGAGTTAACCTAA	1
CGCATCGTTC	GAAACACCGGTCTCGAGTGAGGAGCTCAGGGTGGGGTTAGAGCTAGAAAT	1
CGCATCTACA	GAAACACCGGTAAATTTGAGGCTCCGGCATGCAGGAGGCCGTGGGGTTAG	1
CGCCCCCCGC	GAAACACCGGTGCATTCGAAAGTCCGGTCGTAGTGTGGACGTGGGGTTAG	1
CGCCTCTCGC	GAAACACCGGTGCATTCGAAAGTCCGGTCGTAGTGTGGACGTGGGGTTAG	1
CGCCTTATGC	GAAACACCGGTAAGTATATTCATGCGATATCGCTGTATCAGTGGGGTTAG	1
CGCGCTACGC	GAAACACCGGTTACATTGAGGGGTTAGAGCTAGAAATAGCAAGTTAACAT	1
CGCTTGAGGT	GAAACACCGGTCGGTTCCTATCGAAACCTTCCCGTGACAGTGGGGTTAGA	1
CGGACCTTTT	GAAACACCGGTCTCGAGTGAGGTGTTCAGGGTGGGGTTAGAGTTAGAAAT	1
CGGATCATTA	GAAACACCGGTTAAGCCGAGGGGGTAGAGGTAGAATTAGCGATAGAACTA	1
CGGCACGCCC	GAAACACCGGTTTGAACTAGAAATAGCAAGTTAACCTAAGGCTAGTCCGT	1
CGGGAGTTAT	GAAACACCGGTTCCCGTCCAGTGGGGTTAGAGCTAGAAATAGCAAGTTAA	1
CGGGCCCCTA	GAAACACCGGTAAATTTGAGGCTCCGGCATGCAGGAGGCCGTGGGGTTAG	1
CGGGTCGGAC	GAAACACCGGATTGGGGTTAGAGCTAGAAATAGCAAGTTAACCTAAGGCT	1
CGGGTGGTCC	GAAACACCGGTGACATTGGGTTAGAGCTAGAAATAGCAAGTTAACCTAAG	1
CGGTTCCATT	GAAACACCGGTCTCGAGTGAGGTGTTCAGGGTGGGGTTAGAGCTAGAAAT	1
CGTAGCGTCT	GAAACACCGGTTACAGGGGGGGGTAGAGCTAGAAATAGTAAGTTAACCTA	1
CGTAGTCTTT	GAAACACCGGTCTCGAGAGAGGTTTTCAGGGTGGGGTTAGAGCTAGAAAT	1
CGTAGTGCCT	GAAACGCAAGTTAACCTAAGGCTAGTCCGTTATCAACTTGAAAAGGTGGC	1
CGTATACCTT	GAAGCACCGGTCTCGAGTGAGGTGTTCAGGGGTGGGGTTAGAGCTAGAAA	1
CGTCTGTGTA	GAAACACCGGTCCGTAGGAGACCCGTGTGGCATGTACCTTGTGGGGTTAG	1
CGTGACGGCT	GAAACACCGGTGACATTGGGTGGGGTTAGAGCTAGAAATAGCAAGTTAAC	1
CGTGGCGGTT	GCTAGTCCGTTATCAACTTGAAAAAGTGGCACCGAGTCGGTGCTTTTTTT	1
CGTGTTCTTC	GAAACACCGGTTCCCGAGTGGGGTTAGTACTAGAAGTAGTAAGTTAACAT	1
CGTGTTGTCT	GAAACACCGGTGACATTGGGTGGGGTTAGAGCTAGAAATAGCAAGTTAAC	212
CGTGTTGTCT	GAAACACCGGTGACATTGGGTACAGGGTGGGGTTAGAGCTAGAAATAGCA	170
CGTGTTGTCT	GAAACACCGGTGACATTGGGGTTAGAGCTAGAAATAGCAAGTTAACCTAA	154
CGTGTTGTCT	GAAACACCGGTGACATTGGGTAGAGCTAGAAATAGCAAGTTAACCTAAGG	128
CGTGTTGTCT	GAAACACCGGTGACATTGGGTACAGGGGTGGGGTTAGAGCTAGAAATAGC	113
CGTGTTGTCT	GAAACACCGGTGACATTGGGTACAGAGCTAGAAATAGCAAGTTAACCTAA	61
CGTGTTGTCT	TAGCCTTAGTCCGTTATCAACTTGAAAAAGTGGCACCGAGTCGGTGCTTT	52
CGTGTTGTCT	GAAACGCAAGTTAACCTAAGGCTAGTCCGTTATCAACTTGAAAAAGTGGC	42
CGTGTTGTCT	GAAACACCGGCTAGAAATAGCAAGTTAACCTAAGGCTAGTCCGTTATCAA	36
CGTGTTGTCT	GAAAAATAGCAAGTTAACCTAAGGCTAGTCCGTTATCAACTTGAAAAAGT	34
CGTGTTGTCT	GCTAGTCCGTTATCAACTTGAAAAAGTGGCACCGAGTCGGTGCTTTTTTT	30
CGTGTTGTCT	GAAACACCGGTGGGGTTAGAGCTAGAAATAGCAAGTTAACCTAAGGCTAG	28
CGTGTTGTCT	GAAACACCGGTAACCTAAGGCTAGTCCGTTATCAACTTGAAAAAGTGGCA	27
CGTGTTGTCT	GAAACACCGGTGACAGGTGGGGTTAGAGCTAGAAATAGCAAGTTAACCTA	25
CGTGTTGTCT	GAAACACCGGTGACATTGGGTTAGAGCTAGAAATAGCAAGTTAACCTAAG	24
CGTGTTGTCT	GAAACACCGGTGACATTGGGTTAGAAATAGCAAGTTAACCTAAGGCTAGT	22
CGTGTTGTCT	GAAACACCGGAGTGGGGTTAGAGCTAGAAATAGCAAGTTAACCTAAGGCT	21
CGTGTTGTCT	GAAACACCGGTGACATTGGGTACAAAAGTGGGGTTAGAGCTAGAAATAGC	21
CGTGTTGTCT	GAAACACCGGTGACATTGGGTATGGGGTTAGAGCTAGAAATAGCAAGTTA	21
CGTGTTGTCT	GAAACACCGGTGACATTGGGTACTTGAAAAAGTGGCACCGAGTCGGTGCT	20
CGTGTTGTCT	GAAACACCGGTGATTGGGGTTAGAGCTAGAAGTAGCAAGTTAACCTAAGG	18
CGTGTTGTCT	GAAACACCGGTGAAATAGCAAGTTAACCTAAGTTAACCTAAGGCTAGTCC	17
CGTGTTGTCT	GAAACACCGGTGACATTGGGCAGGGGTTAGAGCTAGAAATAGCAAGTTAA	17
CGTGTTGTCT	GAAACACCGGTGACATTGGGTACAAGTTAACCTAAGGCTAGTCCGTTATC	17
CGTGTTGTCT	GAAACACCGGTGACATTGGGTACACAGGGTGGGGTTAGAGCTAGAAATAG	17
CGTGTTGTCT	GAAACACCGGTGACATTGGGTACGTTAGAGCTAGAAATAGCAAGTTAACC	17
CGTGTTGTCT	GAAACACCGGTGACATTGGTATGGGGTTAGAGCTAGAAATAGCAAGTTAA	17
CGTGTTGTCT	GAAACACCGTTAGAGCTAGAAATAGCAAGTTAACCTAAGGCTAGTCCGTT	17
CGTGTTGTCT	GAAACACCGGTGACAAGTTAACCTAAGGCTAGTCCGTTATCAACTTGAAA	16
CGTGTTGTCT	GAAACACCGGTGACATTGGGTAGGGGTTAGAGCTAGAAATAGCAAGTTAA	16
CGTGTTGTCT	GAAACACCGGTGACATTGGGTAGTGGGGTTAGAGCTAGAAATAGCAAGTT	16
CGTGTTGTCT	GAAACACCGGTGACGTGGGGTTAGAGCTAGAAATAGCAAGTTAACCTAAG	16
CGTGTTGTCT	GAAACACCGGTGACATTGGGTACAGAAATAGCAAGTTAACCTAAGGCTAG	14
CGTGTTGTCT	GAAACACCGGTGACATTGAGCTAGACATTAGAGCTAGAAATAGCAAGTTA	13
CGTGTTGTCT	GAAACACCGGTGACATTGGGTACAGGTGGGGTTAGAGCTAGAAATAGCAA	12
CGTGTTGTCT	GAAACACCGGTGGTTAGAGCTAGAAATAGCAAGTTAACCTAAGGCTAGTC	12
CGTGTTGTCT	GAAACACCGGTGACATTGGGTACAGGTTACAGGTACAGGTGGGGTTAGAG	11
CGTGTTGTCT	GAAACACCGGTGACATTGGGGTGGGGTTAGAGCTAGAAATAGCAAGTTAA	10
CGTGTTGTCT	GAAACACCGGTGACATTGGGTACGTGGGGTTAGAGCTAGAAATAGCAAGT	10
CGTGTTGTCT	GAAACACCGGTGAACAGGGGTTAGAGCTAGAAATAGCAAGTTAACCTAAG	9
CGTGTTGTCT	GAAACACCGGTGACATTGGGTACATGGGGTTAGAGCTAGAAATAGCAAGT	9
CGTGTTGTCT	GAAACACCGGTGACATTGGGTACGGTGGGGTTAGAGCTAGAAATAGCAAG	9
CGTGTTGTCT	GAAACACCGGTGACATTGGGTACTAGAGCTAGAAATAGCAAGTTAACCTA	9
CGTGTTGTCT	GAAACACCGGTGACATTGGGTAGAAAGAGCTAGAAATAGCAAGTTAACCT	9
CGTGTTGTCT	GAAACACCGGGTGGGGTTAGAGCTAGAAATAGCAAGTTAACCTAAGGCTA	8
CGTGTTGTCT	GAAACACCATTGGGGTTAGAGCTAGAAATAGCAAGTTAACCTAAGGCTAG	7
CGTGTTGTCT	GAAACACCGGTGACATTGGGTGGGTTAGAGCTAGAAATAGCAAGTTAACC	7
CGTGTTGTCT	GAAACACCGGTGACATTGGTGGGGTTAGAGCTAGAAATAGCAAGTTAACC	7
CGTGTTGTCT	GAAACACCGGTGACATTTGTGGGGTTAGAGCTAGAAATAGCAAGTTAACC	7
CGTGTTGTCT	GAAACACCGGTGACTGAGTGGGGTTAGAGCTAGAAATAGCAAGTTAACCT	7
CGTGTTGTCT	GAAACACCGGTGACATTGGGTTAGGGGTTAGAGCTAGAAATAGCAAGTTA	6
CGTGTTGTCT	GAAACACCGGTGACATTGCTAGAAATAGCAAGTTAACCTAAGGCTAGTCC	5
CGTGTTGTCT	GAAACACCGGTGACATTGGGTACAGGTTAGAGCTAGAAATAGCAAGTTAA	5
CGTGTTGTCT	GAAACACCGGTGACATTGGGAGTGGGGTTAGAGCTAGAAATAGCAAGTTA	4
CGTGTTGTCT	GAAACACCGGTGACATTGGGTCATGGGGTTAGAGCTAGAAATAGCAAGTT	4
CGTGTTGTCT	GAAACACCGGTGACATTGGGTGGTGGGGTTAGAGCTAGAAATAGCAAGTT	4
CGTGTTGTCT	GAAACACCGGTGACGGGGTTAGAGCTAGAAATAGCAAGTTAACCTAAGGC	4
CGTGTTGTCT	GAAACACCGGTGGCAGGCTTGGGGTTAGAGCTAGAAATAGCAAGTTAACC	4
CGTGTTGTCT	GAAACACTGGTGACATTGGGTACAGGTTACAGGTACAGGTGGGGTTAGAG	2
CGTGTTGTCT	CAAAACACCGGTGACATTGGGCAGGGGTTAGAGCTAGAAATAGCAAGTTA	1
CGTGTTGTCT	CAAAACACCGGTGACATTGGGTACAGGGGTGGGGTTAGAGCTAGAAATAG	1
CGTGTTGTCT	CTAAACACCGGTGACATTGGGTACAGGTTACAGGTACAGGTGGGGTTAGA	1
CGTGTTGTCT	CTAAACACCGTTGACATTGGGTACAGGGGTGGGGTTAGAGCTAGAACTAG	1
CGTGTTGTCT	GAAACACCGGTAACAGGGGTTAAAGCTAGAAATAGCATAGTAACATAAAG	1
CGTGTTGTCT	GAAACACCGGTGACAGGTGGGGTTAGAGCTAGAAATTGCCACTTAAAAGA	1
CGTGTTGTCT	GAAACACCGGTGACATTGTTAGAAATAGCAAGTTAGCCTAAGGCTAGTCC	1
CGTGTTGTCT	GAAACACCGGTGATTGGGGTTAGAGCTAGAAATAACAAGTTAACCTAAGG	1
CGTGTTGTCT	GAAACACCGGTGATTGGGGTTAGAGCTAGAAATAGCAAGTTGACCTAAGG	1
CGTGTTGTCT	GAAACACCGGTGATTGGGGTTAGAGCTGGAAATAGCAAGTTAACCTAAGG	1
CGTGTTGTCT	GAAACACCGGTGATTGGGTTAGAGCTAGAAATAGCAAGTTAACCTAAGGC	1
CGTGTTGTCT	GAAACACCGGTGGCAGGCTTGGGGTTAGAGCCAGAAATAGCAAGTTAACC	1
CGTGTTGTCT	GAAACACCGGTTCCCGTCCAGTGGGGTTAGAGCTAGAAATAGCAAGTTAA	1
CGTGTTGTCT	GAAACACCGGTTTACGTTGCATCGGTGTGGGGTTAGAGCTAGAAATAGCA	1
CGTGTTGTCT	GCAACACCGGTGATTGGGGTTAGAGCTAGAAATAGCAAGTTAACCTAAGG	1
CGTGTTGTCT	TAGCCTTAGTGAGTTATCAACTTGTACAAGTGGAACCGCGTCGGGCCTTT	1
CGTTCCTCGC	GAAACACCGGTCGGGGCCACTCAGTGGGGTTAGAGCTAGAAATAGCAAGT	1
CGTTGAGCAT	GAAACACCGGTTAAGCCGGTGGGGTTAGAGCTAGAAATAGCAAGTTAACC	1
CTAAATACGC	GAAACACCGGTTACATTGAGGGGTTAGAGCTAGAAATAGCGAGTTAGCCT	1
CTAAGCGACC	GAAACACCGGTACCTTTGTTGATGCTGGGTGGAAGGTGTGGGGTTAGAGC	1
CTACACGGAA	GAAACACCGGTACCTTTGTTGATGCTGGGTGGAAGGATGCTGGGAGGGGT	1
CTACTCGGCC	GAAACACCGGTACCTTTGTTGATGCTGGGTGGGGTTAGAGCTAGAAATAG	80
CTACTCGGCC	GAAACACCGGTACCTTTGTTGATGCTGGGTGGAAGGAATTTTGTGGGGTT	77
CTACTCGGCC	GAAACACCGGTACCTTTGTTGATGCTGGGTGGAAGGAATTTGTGGGGTTA	75
CTACTCGGCC	GAAACACCGGTACCTTTGTTGATGCTGGGTGGAAGGAATGTGGGGTTAGA	70
CTACTCGGCC	GTGGCACCGAGTCGGTGCTTTTTTTCCTGCAGGGGCCGAGTAGGAATTCG	35
CTACTCGGCC	GAAACACCGGTACCTTTGTTGATGCTGGGTGGAAGGAATTTTTGTGGGGT	31
CTACTCGGCC	GAAACACCGGTACCTTTGTTGATGCTGGGTGGAAGTTAGAGCTAGAAATA	31
CTACTCGGCC	GAAACACCGGTACCTTTGAGCTAGAAATAGCAAGTTAACCTAAGGCTAGT	22
CTACTCGGCC	GAAACACCGGTACCTTTGTTGATGCTGCGGTGCTTTTTTTCCTGCAGGGG	22
CTACTCGGCC	GAAACACCGGTACCTTTGTTGATGCTGGTGTGGGGTTAGAGCTAGAAATA	20
CTACTCGGCC	GAAACACCGGTACCTTTGTTGATGCTGGGTGGAAGGTGGGGTTAGAGCTA	17
CTACTCGGCC	GAAACACCGGTACCTTTGTTGATGCTGGGTGGTGTGGGGTTAGAGCTAGA	17
CTACTCGGCC	GAAACAGTGGGGTTAGAGCTAGAAATAGCAAGTTAACCTAAGGCTAGTCC	17
CTACTCGGCC	GAAACACCGGTACCTTTGTTGATGCTAGAAATAGCAAGTTAACCTAAGGC	15
CTACTCGGCC	GAAACACCGGTACCTTTGTTGATGCTGGTTGTGGGGTTAGAGCTAGAAAT	15
CTACTCGGCC	GAAACACCGGTACCTTTGTTGATGCTGGGTGGAGCTAGAAATAGCAAGTT	13
CTACTCGGCC	GAAACACCGGTACCTTTGTTGATGCGTTAGAGCTAGAAATAGCAAGTTAA	12
CTACTCGGCC	GAAACACCGGTACCTTTGTTGTGGGGTTAGAGCTAGAAATAGCAAGTTAA	11
CTACTCGGCC	GAAACACCGGTACCGGGTTAGAGCTAGAAATAGCAAGTTAACCTAAGGCT	10
CTACTCGGCC	GAAACACCGGTACCTTTGTTGATGCTGGGTGGAAGGATTGGGGTTAGAGC	10
CTACTCGGCC	GAAACACCGGTACCTTTGTTGGGGTTAGAGCTAGAAATAGCAAGTTAACC	10
CTACTCGGCC	GAAACACCGGTACCTTTGTTGATGCTGGGTGGAAGGAGCTAGATGCTGGT	9
CTACTCGGCC	GAAACACCGGTACCTTTGTTGATGCTGGTGGGGTTAGAGCTAGAAATAGC	8
CTACTCGGCC	GAAACACCGGTACCTTTGTTGATGCTGGGTGGGAGGTTAGAGCTAGAAAT	7
CTACTCGGCC	GAAACACCGGTACCTTTGTTGAGGTTAGAGCTAGAAATAGCAAGTTAACC	6
CTACTCGGCC	GAAACACCGGTACCTTTGTTGATGCTGGGTGGAAGGAATTCTAGAAATAG	6
CTACTCGGCC	GAAACAAGTTAACCTAAGGCTAGTCCGTTATCAACTTGAAAAAGTGGCAC	5
CTACTCGGCC	GAAACACCGGTACCTTTGTTGATGCTGGGTGGAAGGAATTGTGGGGTTAG	5
CTACTCGGCC	GAAACACCGGTACCTTTGTTGATGCTGGGTGGAAGGTGGGTGGGGGTTAG	5
CTACTCGGCC	GAAACACCGGTACCTTTGTTGATGCTGGGTGGAAGGTTAGAGCTAGAAAT	5
CTACTCGGCC	GAAACACCGGTACCTTTGTTGATGGGGTTAGAGCTAGAAATAGCAAGTTA	5
CTACTCGGCC	GAAACACCGGTACCTTTGTGGGGTTAGAGCTAGAAATAGCAAGTTAACCT	4
CTACTCGGCC	GAAACACCGGTACCTTTGTTGATGCTGGGTGGAAGGAATGGGGTTAGAGC	4
CTACTCGGCC	GAAACACCGGTACCTTTGTTGATGCTGGGTGGAAGGGTTAGAGCTAGAAA	4
CTACTCGGCC	GAAACACCGGTACCTTTGTTGATGCTGGGTGGAAGGAATGCCTCGTGGGG	3
CTACTCGGCC	GAAACACCGGTACCTTTGTTGATGCTGGGTGGAAGGAATTAGAGCTAGAA	3
CTACTCGGCC	GAAACACCGGTACCTTTGTTGATGCTGGGTGGAAGGATGTGGAAGGATGT	3
CTACTCGGCC	GAAACACCGGTACCTTTGTTGATGCTGGGTGGAAGGTACCTTTGTTGATG	3
CTACTCGGCC	GAAACACCGGTACCTTTGTTGATGCTGGGTGGATTGTGGGGTTAGAGCTA	3
CTACTCGGCC	GAAACAAGTTAACCTAAGGCTAGTCCGTTATCAACTTGAAAAAGCGGCAC	2
CTACTCGGCC	GAAACACCGGTACCTTTGTTGATGCTGCGGTGCTTTTTTCCTGCAGGGGC	2
CTACTCGGCC	GAAACAAGCTAACCTAAGGCTAGTCCGTTATCAACTTGAAAAAGTGGCAC	1
CTACTCGGCC	GAAACAAGTTAACCTAAGGCTAGTCCGTTATCAACTTGAAAAACTGGCAC	1
CTACTCGGCC	GAAACACCGGACCTTTGTTGATGCTGGGTGGAAGGTACCTTTGTTGATGC	1
CTACTCGGCC	GAAACACCGGTAACTTTGTCGATGGGGCTAGCGCTAGACATAGCAAGTTA	1
CTACTCGGCC	GAAACACCGGTACCTTTGCTGATGCTGGGTGGAAGGTACCTTTGTTGATG	1
CTACTCGGCC	GAAACACCGGTACCTTTGTTGATGCTGGGTGGAAGGAATGGTGGGGTTAG	1
CTACTCGGCC	GAAACACCGGTACCTTTGTTGATGCTGGGTGGAAGGTGGAAGGTGGGGTT	1
CTACTCGGCC	GAAACACCGGTACCTTTGTTGATGGGGTTAGAGCCAGAAATAGCAAGTTA	1
CTACTCGGCC	GAAACACCGGTACCTTTGTTGATGGGGTTAGAGCTGGAAATAGCAAGTTA	1
CTACTCGGCC	GAAACACCGGTACCTTTGTTGATGTTGGGTGGAAGGAATGCCTCGTGGGG	1
CTACTCGGCC	GAAACACCGGTCGGGGCCACTCAGTGGTGGGGTTAGAGCTAGAAATAGCA	1
CTACTCGGCC	GAAACACCGGTTACATTGAGGGTTAGAGCTAGAAATAGCAAGTTAACCTA	1
CTACTCGGCC	GAAACACCGGTTCCTTTGTTGTCACTGGGTGGTTAGAGCGAGTAGTACTA	1
CTACTCGGCC	GAGACAAGTTAACCTAAGGCTAGTCCGTTATCAACTTGAAAAAGTGGCAC	1
CTAGCTCTGC	GAAACACCGGTTACATTGTGTGGGGTTAGAGCTAGAAATGGCAGGTTAAC	1
CTCAACGGTC	GAAACACCGGTTTGAACCGTTCGGGTTAGAGCTAGAAATAGCAAGTTCAC	1
CTCACTTGCA	GAAACACCGGTGTGGCTGAGAGTCCGGCAATGGTGTGGCTGTGGGGTTAG	1
CTCATCGGTC	GAAACACCGGTACCTTTGTTGATGCTGGGAGGAAGGAATGTGGGGTTAGA	1
CTCATCGTTT	GAAACACCGGTCTCGAGTGAGGTGTTCAGGGTGGGGTTAGAGCTAGAAAT	1
CTCCACAGAC	GAAACACCGGAACCTTTGTTGATGCTGGGTGGAAGGTGGGTGGGGGTTAG	1
CTCCCCTGCA	GAAACACCGGTGTGGCTGAGAGTCCGGCAATGGTGTGGCTGTGGGGTTAG	4
CTCCCCTGCA	GAAACACCGGTGTGGCTGAGAGTCCGGCAATGGTGTGGCTGGGGGGTTAG	1
CTCCCCTGCA	GAAACACCGGTGTGGCTGAGAGTCCTGCACTGTTGTTTCTTTTGGGTTAG	1
CTCCGCTCGA	GAAACACCGGTAAATTTGCGGCCACGGCATGCAGAGAGCCGTGGGGTTCG	1
CTCTAGACTC	GAAACACCGGTCCGTAGGAGACCCGTGTGGGATGTAAGTGTGAGGTTACA	1
CTGAAGGCTC	GAAACACCGGTTTGAACTACCTAGAGCTAGAAATAGCAAGTTAACCTAAG	1
CTGATCCTGT	GAAACACCGGTCTCGAGTGAGGTGTTCAGGGTGTGGTTAGAGCTAGAAAC	1
CTGATTAAAA	GAAACACCGGTTTACGTTGCATCGGTGTGGGGTTAGAGCTAGAAATAGCA	1
CTGATTGGCT	GAAACACCGGTTTACGTTACCTCGGTTGTGGGGTTAGAGCTAGAAATAGC	1
CTGCACGCCC	GAAACACCGGTTTGAACTACCTAGTTCAAACCGGTGGGGTTAGAGCTAGA	1
CTGCATTTTC	GAAACACCGGTTCCCGTCCAGTGGGGTTAGAGCTAGAAATAGCAAGTTAA	1
CTGCCGATCT	GAAACACCGGTTTACGCATCCTCGGCTTGTGCAGGTAGAGGTGGGGATAG	1
CTGCGGATAA	GAAACACCGGTTAAGCCGATGTGCTTTTTTCCTGCAGGTTATGCTCATGA	1
CTGCGGGCTC	GAAACACCGGTTCCCGTCCAGTGGGGTTAGAGCTAGAAATAGCAAGTTAA	1
CTGCTAGGTC	GAAACACCGGTACCTTTGTTGATGCTGGGGGGAAGGTGTGGGGTTAGAGC	1
CTGCTTCTCC	GAAACACCGGTTTACGTTGCATCGGTTGTGGGGTTAGAGCTAGAAATAGC	1
CTGGACATAA	GAAACACCGGTTAAGCCGAGTGGGGTTAGAGCTAGAAATAGCAAGTTAAC	1
CTTAGCGGCC	GAAACACCGGTATCCTTGTTGATGCTGGGTGGAGGGAATTTTTGTGGGGT	1
CTTATCGTGA	GAAACACCGGTCTCGAGTGAGGTGTTCAGGGTGGGGTTAGAGCTAGAAAT	1
CTTGACGTCT	GAAACACCGGTGACATTGGGTTCAGGGGTGGGGTTAGAGCTAGAAATAGC	1
CTTGTTATGT	GAAACACCGGTTACATTGAGGGGCTACAGCTAGAGATAGCAAGTTAACCT	1
GAAAAAGCTT	GAAACACCGGTAGCAAGTGCGAGACGTGTTTGTGGGGTTAGAGCTAGAAA	1
GAAAAAGGCC	GAAACACCGGTTTGAACTAGAAATAGCAAGTTAACCTAAGGCTAGTCCGT	1
GAAACCCTCG	GAAACACCGGTGCATTCGAAAGTCCGGTCGTAGTGTGGACGTGGGGTTAG	1
GAAACTATCA	GAAACACCGGTAGCAAGAGCGAAATAACAACGTCGCCTAAGTCTGGTCAG	1
GAACAAAGCC	GAAACACCGGTTTGAACCGGTGGGGTTAGAGCTAGAAATAGCAAGTTAAC	1
GAACGATGTC	GAAACACCGGTGCCCTTACTCTCACCTGATTACTTAATCCGTGGGGTTAG	1
GAACGCACTA	GAAACACCGGTGCCCTTACTCTCACCTGATTACTTAATCCGTGGGGTTAG	1
GAAGACCCGC	GAAACACCGGTCGGCGGCAATCGTGGGTGGGGTTAGAGCTAGAAATAGCA	437
GAAGACCCGC	GAAACACCGGTCGGCGGCAATCGTGCTTTTTTTCCTGCAGGGCGGGTCTT	165
GAAGACCCGC	GAAACACCGAAATAGCAAGTTAACCTAAGGCTAGTCCGTTATCAACTTGA	33
GAAGACCCGC	GAAACACCGGTCGGCTAGAAATAGCAAGTTAACCTAAGGCTAGTCCGTTA	32
GAAGACCCGC	GAAACCTAAGGCTAGTCCGTTATCAACTTGAAAAAGTGGCACCGAGTCGG	32
GAAGACCCGC	GAAACACCGGTCGGCGGCAATCGTGGGGTGGGGTTAGAGCTAGAAATAGC	31
GAAGACCCGC	GAAACACCGGTCGGCGGCAAAAAGTGGCACCGAGTCGGTGCTTTTTTTCC	30
GAAGACCCGC	GTGGGGTTAGAGCTAGAAATAGCAAGTTAACCTAAGGCTAGTCCGTTATC	30
GAAGACCCGC	GAAACACCGGTCGGCGGCAAGAAATAGCAAGTTAACCTAAGGCTAGTCCG	26
GAAGACCCGC	GAAACACCGGTCGGCGGCTAGAAATAGCAAGTTAACCTAAGGCTAGTCCG	26
GAAGACCCGC	GAAACACCGGTCGGCGGTGGGGTTAGAGCTAGAAATAGCAAGTTAACCTA	26
GAAGACCCGC	GAAACACCGGTCGGGGTTAGAGCTAGAAATAGCAAGTTAACCTAAGGCTA	25
GAAGACCCGC	GAAACACCGGTCGGCGTTAGAGCTAGAAATAGCAAGTTAACCTAAGGCTA	24
GAAGACCCGC	GAAACACCGGTCGGTGGGGTTAGAGCTAGAAATAGCAAGTTAACCTAAGG	24
GAAGACCCGC	GAAACACCGGTCGGCGGGGAAATAGCAAGTTAACCTAAGGCTAGTCCGTT	23
GAAGACCCGC	GAAACACCGGTCGGCGGCAATGGGGTTAGAGCTAGAAATAGCAAGTTAAC	22
GAAGACCCGC	GAAACACCGGTCGGCGGCGGGTTAGAGCTAGAAATAGCAAGTTAACCTAA	20
GAAGACCCGC	GAAACACCGGTCGGCGGCAACGTGGGGTTAGAGCTAGAAATAGCAAGTTA	15
GAAGACCCGC	GAAACACCGGTCGGCGGTTAGAGCTAGAAATAGCAAGTTAACCTAAGGCT	15
GAAGACCCGC	GAAACACCGGTCGGCGGAGAAATAGCAAGTTAACCTAAGGCTAGTCCGTT	14
GAAGACCCGC	GAAACACCGGTCGGCGGCAAGTTAACCTAAGGCTAGTCCGTTATCAACTT	13
GAAGACCCGC	GAAACACCGGTCGGCGGGGTGGGGTTAGAGCTAGAAATAGCAAGTTAACC	13
GAAGACCCGC	AGCTAGAAATAGCAAGTTAACCTAAGGCTAGTCCGTTATCAACTTGAAAA	12
GAAGACCCGC	GAAACACCGGGGTGGGGTTAGAGCTAGAAATAGCAAGTTAACCTAAGGCT	11
GAAGACCCGC	GAAACACCGGTCGGCGGAAATAGCAAGTTAACCTAAGGCTAGTCCGTTAT	11
GAAGACCCGC	GAAACACCGGTCGGCGGCAATCGTTAGAGCTAGAAATAGCAAGTTAACCT	11
GAAGACCCGC	GAAACACCGGTCGGCGGCAATCGTTTTGTGGGGTTAGAGCTAGAAATAGC	11
GAAGACCCGC	GAAACACCGGTCGGCGGCAATCCCCGTGGGGTTAGAGCTAGAAATAGCAA	10
GAAGACCCGC	GAAACACCGGTCGGCGGCAATCGTGGTATGAGCCACGTGGGGTTAGATCG	10
GAAGACCCGC	GAAACACCGGTCGGGTTAGAGCTAGAAATAGCAAGTTAACCTAAGGCTAG	10
GAAGACCCGC	GAAACACCGGTCGGCGGCAGCTAGAAATAGCAAGTTAACCTAAGGCTAGT	9
GAAGACCCGC	GAAACACCGGTCGGCGGCAATCGGTCGCCGACCGTCGGTGGGGTTAGAGC	8
GAAGACCCGC	GAAACACCGGTCGGCGGCAATCGTGGTGTTAGAGCTAGAAATAGCAAGTT	7
GAAGACCCGC	GAAACACCGGTCGGCGGCAGGTGGGGTTAGAGCTAGAAATAGCAAGTTAA	7
GAAGACCCGC	GAAACACCGGTCGGCGGCAATCCCGTGGGGTTAGAGCTAGAAATAGCAAG	6
GAAGACCCGC	GAAACGGTGGGGTTAGAGCTAGAAATAGCAAGTTAACCTAAGGCTAGTCC	6
GAAGACCCGC	GAAACACCGGTCGGCGGCAATCGTGGTTAGAGCTAGAAATAGCAAGTTAA	5
GAAGACCCGC	GAAACACCGGTCGGCGGCAATGTGGGGTTAGAGCTAGAAATAGCAAGTTA	5
GAAGACCCGC	GAAACACCGGTCGGCGGCAATCGTGGTAGCAAGTTAACCTAAGGCTAGTC	4
GAAGACCCGC	GAAACACCGGTCGGCGGCAATCGTTAAAGATGGGTTAGAGCTAGAAATAG	4
GAAGACCCGC	GAAACACCGGTCGGCGGCAATTTGGGGTTAGAGCTAGAAATAGCAAGTTA	4
GAAGACCCGC	GAAACACCGGTCGGCGGTTAGAGTGCCTTCGGGGTTAGAGCTAGAAATAG	4
GAAGACCCGC	GAAACACCGGTCGGCGGCAATAGATAGATAGAGTTAGAGCTAGAAATAGC	3
GAAGACCCGC	GAAACACCGGTCGGCGGCAATTGTTATTTCAGGTTAGAGCTAGAAATAGC	3
GAAGACCCGC	GAAACACCGGTCGGCGGCAATTTGGGGTTAGAGCTAGAGATAGCAAGTTA	3
GAAGACCCGC	AGGGTGGGGTTAGAGCTAGAAATAGCAAGTTAACCTAAGGCTAGTCCGTT	2
GAAGACCCGC	GAAAACACCGGTCGGCGGTGGGGTTAGAGCTAGAAATAGCAAGTTAACCT	2
GAAGACCCGC	GAAACACCGGTCGGCGGCAATCGTGGGGGTGGGGTTAGAGCTAGAAATAG	2
GAAGACCCGC	GAAACACCGGTCGGCGGCAATCGTGGGGTTAGAAAAAAAAAAAAAAAAGT	2
GAAGACCCGC	GAAACACCGGTCGGCGGGTTAGAGCTAGAAATAGCAAGTTAACCTAAGGC	2
GAAGACCCGC	GAAACACCGGTCGGCGGTTAGAGTGCCTTCGGGGGTAGAGCTAGAAATAG	2
GAAGACCCGC	CAAAACACCGGGGTGGGGTTAGAGCTAGAAATAGCAAGTTAACCTAAGGC	1
GAAGACCCGC	CAAAACACCGGTCGGCGGCAATCGTGGGTGGGGTCAGAGCTAGAAATAGC	1
GAAGACCCGC	CTAAACACCGGTCGGCGGCAATCGTGGGTGGGGTTAGAGCTAGAAATAGC	1
GAAGACCCGC	GAAACACCGGTCGGCGGCAACAGATAGATAGAGTTAGAGCTAGAAATAGC	1
GAAGACCCGC	GAAACACCGGTCGGCGGCAATAGCAAGTTAAACTTAGGCTAAGCCGGTTA	1
GAAGACCCGC	GAAACACCGGTCGGCGGCAATCGGGGTAGCAAGTTAACCTAAGGCTAGTC	1
GAAGACCCGC	GAAACACCGGTCGGCGGCAATCGTGCTTTTTCCTGCAGGGCGGGTCTTCG	1
GAAGACCCGC	GAAACACCGGTCGGCGGCAATCGTGCTTTTTTCCTGCAGGGCGGGTCTTC	1
GAAGACCCGC	GAAACACCGGTCGGCGGGTTAGAGCTAGAAATAGCAGGTTAACCTAAGGC	1
GAAGACCCGC	GAAACACCGGTCGGCGGTTAGAATGCCTTCGGGATTAGAACTAGAAATAT	1
GAAGACCCGC	GAAACACCGGTCGGCGGTTAGAGAGCCTTCGGGGGTAGAGCTAGAAAAAG	1
GAAGACCCGC	GAAACACCGGTCGGCGGTTAGAGGGCCTTCGGGGGTAGAGCTAGAAATAG	1
GAAGACCCGC	GAAACACCGGTCGGCGGTTAGAGTGGCATCGGGGGTAGAGCGAGAAATAG	1
GAAGACCCGC	GAAACACCGGTCGGCGTGTTAGAGCTAGAAATAGCAAGTTAACCTAAGGC	1
GAAGACCCGC	GAAACACCGGTCGGTGGGTTAGAGCTAGAAATAGCAAGTTAACCTAAGGC	1
GAAGACCCGC	GAAACACCGGTCTGCGGCAATCGTGGGGTTCGAAAAAAAATAACCATGCC	1
GAAGACCCGC	GAAACACCGGTGCATTCGAAAGTCCGGTCGTAGTGTGGACGTGGGGTTAG	1
GAAGACCCGC	GAAACACCGGTGCCCTTACTCTCACCTGATTACTTAATCCGTGGGGTTAG	1
GAAGACCCGC	GAAACACCGGTGTACGTATGGACTGAACCAGGGTGTGCAAGTGGGGTTAG	1
GAAGACCCGC	GAAACACCGGTTAAGCCGAGTGGGGTTAGAGCTAGAAATAGCAAGTTAAC	1
GAAGACCCGC	GAAACACCGGTTATATCTGTAAGTGTGTGGGGTTAGAGCTAGAAATAGCA	1
GAAGACCCGC	GAAACACCGGTTTACGTTGCATCGGGGTTGCATGGGGTTAGAGCTAGAAA	1
GAAGACCCGC	GAAACACTGGTCGGCGGCAATAGTGGGTGTCGTGTGACATACCAATAGAA	1
GAAGACCCGC	GACGAAACACCGGTCGGCGGCAAGAAATAGCAAGTTAACCTAAGGCTAGT	1
GAAGACGGTT	GAAACACCGGTCGGCGGCAATCGTGGGTGGGGTTAGAGCTAGAAATAGCA	1
GAAGATCTCC	GAAACACCGGTCGGCGGCAATCGTGGGTGGGGTTAGAGCTAGAAATAGCA	1
GAAGCCATGC	GAAACACCGGTCGGCGGCAATCGTGCTTTTTTTCCTGCAGGGCGGGTCTT	1
GAAGCCGTGC	GAAACACCGGTGCCCTTACTCTCACCTGATTACTTAATCCGTGGGGTTAG	1
GAAGCGCAGC	GAAACCCCGGTCGGCGGCACTCGTGCTTTTTTTCCTGCAGGGCGGGGCTT	1
GAAGCTTAGC	GAAACACCGGTTTACGTTGCATCGGTGTGGGGTTAGAGCTAGAAATAGCA	1
GAAGCTTCGC	GAAACACCGGTCGGCGGCAATGTGGGGTTAGAGCTAGAAATAGCAAGTTA	1
GAAGGCAGGC	GAAACCTCAGGCTAGTCCGTTATCAACTTGAAAAAGTGGCACCGAGACGG	1
GAATGGCGTA	GAAACACCGGTGCCCTTACTCTCACCTGATTACTTAATCCGTGGGGTTAG	1
GAATTTCTTT	GAAACACCGGTCTCGAGTAAGTTGTTCAGGGGGGGTTAGAGCTAGGATTG	1
GACACAATAC	GAAACACCGGTGTGGCTGAGAGTCCGGCAATGGTGTGGCTGTGGGGTTAG	1
GACACAGACA	GAAACACCGGTAGCAAGTGCGAGACGTGTTAAATAGCAAGTTAACCTAAG	265
GACACAGACA	GAAACACCGGTAGCAAGTGCGAGACGTGTTTGTGGGGTTAGAGCTAGAAA	201
GACACAGACA	GAAACACCGGTAGCAAGTGGGGTTAGAGCTAGAAATAGCAAGTTAACCTA	139
GACACAGACA	GAAACACCGGTAGCAAGTGCGAAATAGCAAGTTAACCTAAGGCTAGTCCG	110
GACACAGACA	GAAACACCGGTAGCAAGTTAACCTAAGGCTAGTCCGTTATCAACTTGAAA	89
GACACAGACA	GAAACACCGGTAGCAAGTGCGGGGTTAGAGCTAGAAATAGCAAGTTAACC	65
GACACAGACA	GAAACACCGGTAGCAAGTGCGAGCTAGAAATAGCAAGTTAACCTAAGGCT	50
GACACAGACA	GAAACACCGGTAGCAAGTGCGAGACCGGTAGCGGTGCTTTTTTTCCTGCA	28
GACACAGACA	GAAACACCGGTAGCAAGTGCGAGCGGTGCTTTTTTTCCTGCAGGTGTCTG	23
GACACAGACA	GAAACACCGGTAGCAAGTGCGAGACGTGTGCTTTTTTTCCTGCAGGTGTC	21
GACACAGACA	GAAACACCGGTAGCAAGTGCGAGACGTTGCTAGAAATAGCAAGTTAACCT	15
GACACAGACA	GAAACACCGGTAGCAAGTGCGAGACGTGTTTTTGTGGGGTTAGAGCTAGA	13
GACACAGACA	GAAACACCGGTAGCAAGTGCGAATGAAATAGCAAGTTAACCTAAGGCTAG	12
GACACAGACA	GAAACACCGGTAGCAAGTGCGAGACGTGTTAGAGCTAGAAATAGCAAGTT	12
GACACAGACA	GAAACACCGGTAGCAAGTGCGAGACGTTTGTTAGAGCTAGAAATAGCAAG	12
GACACAGACA	GAAACACCGGTAGCAAGTGCGAGACGTTAGCAAGTTAACCTAAGGCTAGT	11
GACACAGACA	GAAACACCGGTAGCAAGTGCGAGACGTTTTTTGTGGGGTTAGAGCTAGAA	9
GACACAGACA	GAAACACCGTTAGAGCTAGAAATAGCAAGTTAACCTAAGGCTAGTCCGTT	8
GACACAGACA	GAAACACCGGTAGCAAGTGCGAGCAAGTTTGGGGTTAGAGCTAGAAATAG	6
GACACAGACA	GAAACACCGGTAGCAAGTGCGAGACCGGTAGCGGTGCTTCTTTTCCTGCA	5
GACACAGACA	GAAACACCGGTAGCAAGTGCGTGGGGTTAGAGCTAGAAATAGCAAGTTAA	5
GACACAGACA	GAAACACCGGTAGCAAGTGCGAGACGGGGTGAGAGTGGGGTTAGAGCTAG	4
GACACAGACA	GAAACACCGGTAGTAAGTGCGAGCAAAAAAAGTGGGGTTAGAGCTAGAAA	3
GACACAGACA	GAAACACCGGTAAATTTGAGGCTCCGGCATGCAGGAGGCCGTGGGGCTAG	2
GACACAGACA	GAAACACCGGTAGCAAGTGCGAGCAAAAAAAGTGGGGTTAGAGCTAGAAA	2
GACACAGACA	GAAACACCGGTAGCAAGTGCGAGCGGTGCTTTTTTCCTGCAGGTGTCTGT	2
GACACAGACA	CAAAACACCGGTAGCAAGTGCGAGACGTGTTAAATAGCAAGTTAACCTAA	1
GACACAGACA	GAAACACCGGCAGCAAGTGCGTGGGGTTAGAGCTAGAAATAGCAAGTTAA	1
GACACAGACA	GAAACACCGGTAGCAAGTGCGAGACGGGGTGAGAGTGGGGCTAGAGCTAG	1
GACACAGACA	GAAACACCGGTAGCAAGTGCGAGACGTGTTAACGCTATTTCTAGCTCTAA	1
GACACAGACA	GAAACACCGGTAGCAAGTGCGAGACGTGTTTCGTCTCGCACTTGCTACGT	1
GACACAGACA	GAAACACCGGTAGCAAGTGCGAGACTTGCTACCGGTGTTTCGTCCGGTGG	1
GACACAGACA	GAAACACCGGTAGCAAGTGCGAGCCTGGTGCTTTTATTCCTGCAGGTAGC	1
GACACAGACA	GAAACACCGGTAGCAAGTGCGAGCGGTGCTTTTTCCTGCAGGTGTCTGTG	1
GACACAGACA	GAAACACCGGTAGCAAGTGCGTGGGGTTAGAGCTAGAAATAGCAAGTCAA	1
GACACAGACA	GAAACACCGGTAGCAAGTGGGTTAGAGCTAGAAATAGCAAGTTAACCTAA	1
GACACAGACA	GAAACACCGGTGTACCTAAGATTTCGACAATGGTGTGGCTGTGGGGTTAG	1
GACACAGACA	GAGACACCGGTAGCAAGTGCGAGACGTGTTAGAGCTAACGTGGGGTTAGA	1
GACACAGACA	GAGACACCGGTAGCAAGTGCGAGACGTGTTTCGTCTCGCACTTGCTACGT	1
GACACTGAAC	GAAACACCGGTAGCAAGTGCGAGACGTGTTAAATAGCAAGTTAACCTAAG	1
GACAGAGAAC	GAAACACCGGTAGCAAGTGCGAGACGTTTTTGTGGGGTTAGAGCTAGAAA	1
GACAGAGATC	GAAACACCGGTAGCAAGTGCGAGACGTGTTAAATAGCAAGTTAACCTAAG	1
GACATACGGT	GAAACACCGGTCGATTCATATCGAAACCTTCCCGTGACAGTGGGGTTAGA	1
GACATGCACT	GAAACACCGGTCTCGAGTGAGGGGTTCAGGGGGGGGTTAGAGCTAGAAAT	1
GACATTGGGT	GAAACACCGGTCGATTCATATCGAAACCTTCCCGTGACAAGTGGGGTTAG	1
GACCACGTTC	GAAACACCGGTTTGAACTACCGGGGTTAGAGCTAGAAATAGCAAGTTAAC	1
GACCCAGAAC	GAAACACCGGTAGCAAGTGCGAGACGTGTTTGTGGGGTTAGAGCTAGAAA	1
GACCCCGACC	GAAACACCGGTAGCAAGTGCGAAATAGCAAGTTAACCTAAGGCTAGTCCG	1
GACGAAACGC	GAAACACCGGTCGGTGGGGTTAGAGCTAGAAATAGCAAGTTAACCTAAGG	1
GACGCACTCC	GAAACACCGGTGCCCTTACTCTCACCTGATTACTTAATCCGTGGGGATAG	1
GACGCGATAC	GAAACACCGGTCCCCTTGCATACAGCTGTTGTGTGGTTAGAGCTAGATAT	1
GACGCGCCTC	GAAACACCGGTTCCCGTCCAGTGGGGTTAGAGCTAGAGATAGAAAGTTAA	1
GACGGTTTCT	GAAACACCGGTGGGTAGAGCGAAATATAGCATGTGAATAGAGGTAGAGAC	1
GACTACACGC	GAAACACCGGTCGGCGGCAATCGTGGGTGGGGTTAGAGCTAGAAATAGCA	1
GACTCATATA	GAAACACCGGTAGCAAGTTAACCTAAGGCTAGTCCGTTATCAACTTGAAA	1
GACTTCGCAC	GAAACACCGGCCGGCGGCTAGAAATAGCAAGTTAACCTAAGGCTAGTCCG	1
GACTTTACCG	GAAACACCGGTCGGGGCCACTCAGTGGTGGGGTTAGAGCTAGAAATAGCA	1
GAGAAAGAGA	GAAACACCGGTAGCAAGTTAACCTAAGGCTAGTCCGTTATCAACTTGAAA	1
GAGAACCCTT	GAAACACCGGTCTCGAGTGAGGCGTTCAGGGTGGGGTTAGAGCTAGAAAT	1
GAGAACGAGT	GAAACACCGGTCGGCGGAGAAATAGCAAGTTAACCTAAGGCTAGGCCGAT	1
GAGAAGATCC	GAAACACCGGTCGGCGGCAATCGTGGTATGAGCCACGTGGGGTTAGATCG	1
GAGACCCACG	GAAACACCGGTGCATTCGAAAGTCCGGTCGTAGTGTGGACGTGGGTTAGA	1
GAGACCCTAA	CAACACCGGGGCCCTTACTCTCACCTGATGGGTTTAGCGCTAGAAAAAGC	1
GAGACGCGCG	GAAACACCGGTGCATTCGAAAGTCCGGTCGTAGTGTGGACGTGGGGTTAG	1
GAGACTGCCT	GAAACACCGGTCCGTAGGAGACCCGTGTGGCATGTACCTGTGGGGTTAGA	1
GAGCAGCACA	GAAACACCGGTTCCCGTCCAGTGGGGTTAGAGCTAGAACTAGCAAGTTAA	1
GAGCATCCCC	GAAACACCGGTCGGCGGCAATCGGTCGCCGACCGTCGGTGAGGTTAGAGC	1
GAGCCACTAC	GAAACACCGGTAAATTTGAGGCTCCGGCATGCAGGAGGCCGTGGGGTTAG	1
GAGGAACTTC	GAAACACCGGTTCCCGTCCAGTGGGGTTAGAGCTAGAAATAGCAAGTTAA	1
GAGGACCAAC	GAAACACCGGTCGGCGGAGAAATAAGAAGTTAACCTAGCGCTGGGCCGTT	1
GAGGACCAGA	GAAACACCGGTCGGCGGCAACGCGTGGGGTTAGAGCTAGAGATAGCAAGT	1
GAGGACTTGC	GAAACACCGGTCGGCGGCAATCGTGGGTGGGGTTAGAGCTAGAAATAGCA	1
GAGGAGACCA	GAAACACCGGTTCCCGTCCAGTGGGGTTAGAGCTAGAAATAGCAAGTTAA	1
GAGGAGACGC	GAAACACCGGTTCCCGTCCAGTGGGGTTAGAGCTAGAAATAGCAAGTTAA	1
GAGGAGACTA	GAAACACCGGTTCCCGTCCAGTGGGGTTAGAGCTAGAAATAGCAAGTTAA	2
GAGGAGACTA	GAAACACCGGTTCCCGTCCAGTGGGGTTAGAGCTAGGAATAGCAAGTTAA	1
GAGGAGCACC	GAAACACCGGTTCCCGTCCAGTGGGGTTAGAGCTAGAAATAGCAAGTTGA	1
GAGGAGCCCA	GAAACACCGGTTCCTGTCCAGTGGGGTTAGAGCTAGAAATAGCAAGTTAA	1
GAGGAGCGTA	GAAACACCGGTTCCCGTCCAGTGGGGTTAGAGCTAGAAATAGCAAGTTAA	1
GAGGAGTCGA	GAAACACCGGTTCCCGTCCAGTGGGGTTAGAGCTAGAAATAGCAAGTTAA	1
GAGGCAACCA	GAAACACCGGAGTGGCTGAGAGTCCGGCAATGGTGTGGCTGTGGGGTTAG	1
GAGGCGACTA	GAAACACCGGTTCCCGTCCAGTGGGGTTAGAGCTAGAAATAGCAAGTTAA	1
GAGGCGACTC	GAAACACCGGTTCCCGTCCAGTGGGGTTAGAGCTAGAGATAGCGAGAGAA	1
GAGGCGCGTC	GAAACACCGGTTCCCGTCCAGTGGGGTTAGAGCTAGAAATAGCAAGTTAA	1
GAGTAACCGC	GAAACACCGGTCGGCGGCAATCGTGGTTAGAGCTAGAAATAGCAAGTTAA	1
GAGTAGCTAT	GAAACACCGGTTACATTGAGGGTTAGAGCTAGAAATAGCAAGTTAACCTA	1
GAGTCGCGCG	GAAACACCGGTGCATTCGAAAGTCCGGTCGTAGTGTGGACGTGGGGTTAG	1
GAGTCGGCCA	GAAACACCGGTCCGTAGGAGACCCGTGTGGCATGTACCTGTGGGGTTAGA	1
GAGTGTTGTT	GAAACACCAGTAACCTAAGGCTAGTCCGTTATCAACTTGAAAAAGTGGCA	1
GATACAAGGC	GAAACACCGGTACCTTTGTTGATGCTGGGTGGAAGGAATTTGTGGGGTTA	1
GATACCACCA	GAAACACCGGTCCAAAATGTCGCCACGTGGGGTTAGAGCTAGAAATAGCA	1
GATACCCCCA	GAAACACCGGTCCAAAATGTCGCCACGTGGGGTTAGAGCTAGAAATAGCA	8
GATATCGCGG	GAAACACCGGTTATATTTGTAAGTGTGTGGGGTTAGAGCTAGAAATAGCA	1
GATGCCTCGC	GAAACACCGGTCGGCGGCAATCGTGGGTGGGGTTAGAGCTAGAAATAGCA	1
GATGGGACGC	GAAACACCGGTCGGCGGCAATCGTGGGTGGGGTTAGAGCTAGAAATAGCA	1
GCAAAACCGC	GAAACACCGGTCGGCGGAAATCGCAAGTTAACCTAAGGCTAGTTCGTTAT	1
GCACGCCGTA	GAAACACCGGTGCCCTTACTCTCACCTGATTACTTAATCCGTGGGGTTAG	1
GCACTCGACT	GAAACACCGGTCAATTTGAGGCTCCGGCATGCAGGAGGCCGTGGGGATAG	1
GCACTTAGAC	GAAACACCGGTAACTATATTCATGCGATATCGCCGTATCAGTGGGGTTAG	1
GCAGAGAAGT	GAAACACCGGTGTACGTATGGACTGAACCAGGGTGTGCAAGTGGGGTTAG	1
GCAGCTATGC	GAAACACCGGTTACATTGAGGGTTAGAGCTAGAAATAGCAAGTTAACCTA	1
GCAGGCCAGC	GAAACACCGGTCGGCGGCAATCGTGCTTTTTTTCCTGCAGGGCGGGTCTT	1
GCATAGTAGT	GAAACACCGGTGTACGTATGGACTGAACCAGGGTGTGCAAAGTGGGGTTA	1
GCATAGTGCC	GAAACACCGGTCCAAAATGTCGCCACGCGGGGTTAGAGCTAGAAATAGCA	1
GCATCACCGC	GAAACACCGGTCGGCGGAGAAATAGCACGTTAACCTAAGGCTCGTCCGTT	1
GCATCGTGGT	GAAACACCGGTGTACGTATGGACTGAACCAGGGTGTGCAAGTGGGGTTAG	1
GCATTTACCG	GAAACACCGGTCGGGGCCACTCAGTGGTGGGGTTAGAGCTAGAAATAGCA	1
GCCAACGCTT	GAAACACCGGTTTGAACCTGTCGGGATAGACCCAGAAATAGCAAGTTAAC	1
GCCACGCTTC	GAAACACCGGTGTGGCTGAGGGTCCGGCAATGGTGTGGCTGTGGGGTTAG	1
GCCATACGGT	GAAACAACGGTCGATTCATATCGAAACCTTCCCGTGACAGTGGGGTTAGA	1
GCCCAACGCC	GAAACACCGGTTTGAACTAGAAATAGCAAGTTAACCTAAGGCTAGTCCGT	1
GCCCCAGACT	GAAACACCCGTAGCAAGTGCGAGACGTGTTTGTGGGGTTAGAGCTAGAAA	1
GCCCTCACGC	GAAACACCGGTGGAAGGTTGTATGTTGCTAGTGGGGATAGAGCTAGAAAT	1
GCCGCTGACA	GAAACACCGGTAGCAAGTGCGTGGGGTTAGGGCTAGAGATAGCAAGCTAA	1
GCCGTAGCCC	GAAACACCGGTCGTGGCCACTCAGTGGTGGGGTTAGAGCTAGAAATAGCA	1
GCCTCCGACT	GAAACACCGGTACAACCGTCTCACTTGGTCGTGGGGTTAGAGCTAGAAAT	1
GCCTCCTTGA	GAAACACCGGTTCTCGCACATGTGGGGTTAGAGCTAGAAATAGAATGTTA	1
GCGAAGCGTT	GAAACACCGGTTACCATCCAGTGGGGTTACAGCTAGAGATAGCAAGTTAA	1
GCGAATCGTT	GAAACACTAAGGCTAGTCCGTTATCAACTTGAAAAAGTGGCACCGAGTCG	1
GCGACAGAAA	GAAACACCGGTAGCAAGTGCGAGACGTGTTTGTGGGGTTAGAGCTAGAAA	1
GCGACTCCTT	GAAACACCGGTCTCGAGTGAGGTTAGAGCTAGAAATAGCAGGTTAACCTA	1
GCGACTCGGC	GAAACACCGGTACCTTTGTTGATGCTGGGTGGAAGGAATTTGGTGGGGTT	1
GCGATTGAGT	GAAACACCGGTTATATTTGTAAGTGGGGTTAGAGCTAGCAATAGCAAGCT	1
GCGGAACAGC	GAAACACCGGTCGGCGGCAATCGTGGGTGGGGTTAGAGCTAGAAATAGCA	1
GCGGACACGC	GAAACACCGGTCGGCGGCAATGTGGGGTTAGAGCTAGAAATAGCAAGTTA	1
GCGGATCCGC	GAAACACCGGTCGGCGGCAATCGTGGGTGGGGTTAGAGCTAGAAATAGCA	1
GCGGTGTCTC	GAAACACCGGTTCCCGTCCAGTGGGGCTAGAGCTAGAAATAGCAAGTTAA	1
GCGTCTGCCT	GAAACACCGGTCCGTAGGAGACCCGTGTGGCATATACCTGTGGGGTTAGA	1
GCGTGGTGTC	GAAACACCGGTGACATTGGGTACGTGGGGTTAGAGCTAGAAATAGCAAGT	1
GCGTGTTGGC	GAAACACCGGTGACATTGGGTACAGGGTGGGGTTAGAGCTAGAAATAGCA	1
GCTAACGAGT	GAAACACCGGTTATATTTGTAAGTGTGTGGGGTTAGAGCTAGAAATAGCA	1
GCTACCCCCA	GAAACACCGGTCCAAAAATGTCGCCACGTGGGGTTAGAGCTAGAAATAGC	1
GCTACCCTCA	GAAACACCGGTGTGGCTGAGAGTCCGGCAATGGTGTGGCTGTGGGGTTAG	1
GCTACTTGGC	GAAACACCGGTACCTTTGTTGATGCTGGGTGGAAGGAATGTGGGGTTAGA	1
GCTGTGCCGC	GAAACACCGGTCGGCGCCAAGCAGGGGTAGGGTTAGAGCTAGAAATAGCA	1
GGAAAACCCG	GAAACACCGGTCGGCGGCAATCGTGGGTGGGGTTAGAGCTAGAAATAGCA	1
GGAAAGCCCG	GAAACACCGGTCAGCGGCCATCGTGGGTGGGGTTAGAGCTAGAAATAGCA	1
GGAACCGACA	GAAACACCGGTAGCAAGTGCGGGGTTAGAGCTAGAAATAGCAAGTTAACC	1
GGAACCTATA	GAAACACCGGTAAATTTGAGGCTCCGGCATGCAGGAGGCCGTGGGGTTAG	1
GGAATCGTCG	GAAACACCGGTGTCGGTGCTTTTTTTCCTGCAGGGACGACGATGGAATTC	1
GGACACTACC	GAAACACCGGTAAATTTGAGGCTCCGGCATGCAGGAGGCCGTGGGGTTAG	1
GGACAGAGAC	GAAACACCGGTAGCAAGTGCGAGCTAGAAATAGCAAGTTAACCTAAGGCT	1
GGACCCTATT	GAAACACCGGTAAATTTGAGGCTCCGGCATGCAGGAGGCCGTGGGGTTAG	1
GGACGCCCTA	GAAACACCGGTGCCCTTACTCTCACCTGATTACTTAATCCGTGGGGTTAG	1
GGAGAGAAGC	GAAACACCGGTCGGCGGCAAGAAATAGCAAGTTAACCTAAGGCTAGTCCG	1
GGAGCAGACA	GAAACACCGGTAGCAAGTTAACCTAAGTCTAGTCCGTTATCAACTTGAAA	1
GGAGGATCAT	GAAACACCGGTTCCCGTCCAGTGGGGTTAGAGCTAGAAATAGCAAGCTAA	1
GGAGTCCTCC	GAAACACCGGTGTGGCTGAGAGTCCGGCAATGGTGTGGCTGTGGGGTTAG	1
GGCAAACTAC	GAAACACCGGTGTGGCTGAGAGTCCGGCAATGGTGTGGCTGTGGGGTTAG	1
GGCAAATACA	GAAACACCGGTAAATTTGAGGCTCCGGCATGCAGGAGGCCGTGGGGTTAG	1
GGCAAGCCTC	GAAACACCGGTCCGTAGGAGACCCGTGTGGCATGTAACTGTGGGGGTTGA	1
GGCAATTACA	GAAACACCGGTAAATTTGAGGCTCCGGCATGCAGGAGGCCGAAGGCTAGT	1
GGCACATAAA	GAAACACCGGTAAATTTGAGGCTCCGGCATGCAGGAGGCCGTGGGGTTAG	1
GGCACCCTCC	GAAACACCGGTGTGGCTGAGAGTCCGGCAATGGTGTGGCTGTGGGGTTAG	773
GGCACCCTCC	CAAAACACCGGTGTGGCTGAGAGTCCGGCAATGGTGTGGCTGTGGGGTTA	2
GGCACCCTCC	GAAACACCGGTAAATTTGAGGCTCCGGCATGCAGGAGGCCCGTGGGGTTA	1
GGCACCCTCC	GAAACACCGGTAAATTTGAGGCTCCGGCATGCAGGAGGCCGTGGGGTTAG	1
GGCACCCTCC	GAAACACCGGTAGCAAGTGCGAGACGTGTTAAATAGCAAGTTAACCTAAG	1
GGCACCCTCC	GAAACACCGGTAGCAAGTGCGAGACGTGTTTGTGGGGTTAGAGCTAGAAA	1
GGCACCCTCC	GAAACACCGGTCTCGAGTGAGGTGTTCAGGGTGGGGTTAGAGCTAGAAAT	1
GGCACCCTCC	GAAACACCGGTGACAGGTGGGGTTAGAGCTAGAAATAGCAAGTTAACCTA	1
GGCACCCTCC	GAAACACCGGTGACATTGGGTACAAGGGTGGGGTTAGAGCTAGAAACAGC	1
GGCACCCTCC	GAAACACCGGTGACATTGGGTAGGGGGTGGGGTTAGAGCTAGAAATAGCA	1
GGCACCCTCC	GAAACACCGGTGAGGTTGAGAGCCGGGCAATGGTGTGGGCTTGAGGTTGC	1
GGCACCCTCC	GAAACACCGGTGCCCTTACTCTCACCTGATTACTTAGTCCGTGGGGTTAG	1
GGCACCCTCC	GAAACACCGGTTTGGCTGAGAGTCTGGTAGGGGTGTGGCTGTGAGGTTAG	1
GGCACCCTCC	GAAGGAAACATTGGTGGGGCTGAGAGTCCGGCAATGGTGGGGCGGGGGGG	1
GGCACGTTGA	GAAACACCGGTGTGGCTGAGAGTCCGGCAATGGTGTGGCTGTGGGGTTAG	1
GGCACTGAAA	GAAACACCGGTAGCAAGTAAGAGACCGGAGGCGGCGCTTTTTTTCCTGCA	1
GGCACTGTAC	GAAACACCGGTGTGGCTGAGACACAGGCAATGGAGTGGCTGTGGGGTTAG	1
GGCACTTAGT	GAAACACCGGTAAATTTGAGGCTCCGGCATGCAGGAGGCCGTGGGGTTAG	1
GGCAGCATAA	GAAACACCGGTGTGGCTGAGAGTCCGGCAATGGTGTGGCTGTGGGGTTAG	1
GGCAGCCTTT	GAAACACCGGTGTGGCGGAGAGTGTAGCAATGGGGTGTCGAGCTAGGTAT	1
GGCCACCCCA	GAAACACCGGTGTGGCTGAGAGTCCGGCAATGGTGTGGCTGTGGGGTTAG	1
GGCCACTTAA	GAAACACCGGTAAATTTGAGGCTCCGGCATGCAGGAGGCCGTGGGGTTAG	1
GGCCATCACC	GAAACACCGGTAAATATGAGGCTCCGGCATGCAGGAGGCCGTGGGGTTAG	1
GGCCCCTACA	GAAACACCGGTAAATTTGAGGCTCCGGCATGCAGGAGGCCGTGGGGTTAG	557
GGCCCCTACA	GAAACACCGGTAAATTTGAGGCTCCGGCATGCAGGAGGCGTGGGGTTAGA	20
GGCCCCTACA	GAAACACCGGTAAATTTGAGGCTCCGGCATGCAGGAGGCCCGTGGGGTTA	11
GGCCCCTACA	GAAACACCAGAGCTAGAAATAGCAAGTTAACCTAAGGCTAGTCCGTTATC	7
GGCCCCTACA	GAAACACCGGTAAATTTGAGGCGTGGGGTTAGAGCTAGAAATAGCAAGTT	4
GGCCCCTACA	GAAACACCGGTAAATTTGAGGCTCCGGCATGCAGGAGGCCGAAGGCTAGT	4
GGCCCCTACA	CAAAACACCGGTAAATTTGAGGCTCCGGCATGCAGGAGGCCGTGGGGTTA	1
GGCCCCTACA	GAAACACCGGTAAATTTAAGACTCCGGCATGCAGGAGACCGTGGGGATTA	1
GGCCCCTACA	GAAACACCGGTAAATTTGAGGCCCGGCATGCAGGAGGCCGTGGGGTTAGA	1
GGCCCCTACA	GAAACACCGGTAATTTGAGGCTCCGGCATGCAGGAGGCCGTGGGGTTAGA	1
GGCCCCTACA	GAAACACCGGTACCTTTGTTGATGCTGGGTGGAAGGAATTTTGTGGGGTT	1
GGCCCCTACA	GAAACACCGGTAGCAAGTGCGAGCTAGAAATAGCAAGTTAACCTAAGGCT	1
GGCCCCTACA	GAAACACCGGTCGGCGGCAATCGTGGGTGGGGTTAGAGCTAGAAATAGCA	1
GGCCCCTACA	GAAACACCGGTTATATTTGTAAGTGTGTGGGGTTAGAGCTAGAAATAGCG	1
GGCCCCTACA	GAAACACCGGTTTGAACTACCGGGGTTAGAGCTAGAAATAGCAAGTTAAC	1
GGCCCCTACA	GAAGAAAACACCGGAAATTTTAAGCCCCGGCCTTCCGGGGGGCGTGGGGT	1
GGCCTCAAAA	GAAACACCGGTAAATTTGAGGCTCCGGCATGCAGGAGGCCGTGGGGTTAG	1
GGCCTCCATA	GAAACACCGGTCCATTTGAGACTCCTGCACCCTGTACGCCGTGGGGTTAG	1
GGCGCCATAC	GAAACACCGGTGTGGCTGAGAGTCCGGCAATGGTGTGGCTGTGGGGTTAG	1
GGCGTTGTCC	GAAACACCGGTGTGGCTGAGAGTCCGGCAATGGTGTGGCTGTGAGAGTAA	1
GGCTCACTCA	GAAACACCGGTGTGGCTGAGAGTCCGGCTATGGGGTGGCTGGCGGGTTAG	1
GGCTCTCACG	GAAACACCGGTGTGGCTGAGAGTCCGGCAATGGTGTGGCTGTGGGGTTAG	1
GGGAATACTT	GAAACACCGGTCTCGAGTGAGGTGTTCAGGGTGGGGTTAGAGCTAGAAAT	1
GGGACACTCA	GAAACACCGGTGTGGCTGAGAGTCCGGCAATGGTGTGGCTGTGGGGTTAG	1
GGGACTGCCA	GAAACACCGGTAACAAGGGGGGTTAGAGCTGGAAATAGCAAGTTAACCTA	1
GGGCAACCTC	GAAACACCGGTGTGGCTGAGAGTCCGGCAATGGTGTGGCTGTGGGGTTAG	1
GGGCACACTC	GAAACACCGGTGTGGCTGAGAGTCCGGCAATGGTGTGGCTGTGGGGTTAG	1
GGGCACTAAA	GAAACACCGGTAAATTTGAGGCTCCGGCATGCAGGAGGCCGTGGGGTTAG	1
GGGCCAAACA	GAAACACCGGTAAATTTGAGGCTACGGCATGCAGAAGGCCGTGGGGATAG	1
GGGCCATCCA	GAAACACCGGTAAATTTGAGGCTCCGGCATGCAGGAGGCCGTGGGGTTAG	1
GGGCCCGGCA	GAAACACCGGTAGTTTTGACGCCCCTTCAGGCAGGGGGACGTGGGGTAAT	1
GGGGAACGTC	GAAACACCGGTTCCCGTCCAGTGGGGTTAGAGCTAGAAATAGCAAGTTAA	1
GGGGACCGTA	GAAACACCGGTTCCGGTACAGCGGGGGTATAGCGAGATATAGCTAGTTAT	1
GGGGACGTTC	GAAACACCGGTTCCCGTGCGGTGGGGTTAAAGCTGGAAATAGCAAGTTAA	1
GGGGAGAATC	GAAACACCGGTTCCCGTCCAGTGGGGTTAGAGCTAGAAATAGCAAGTTAA	1
GGGGTACCTA	GAAACACCGGTTCCCGTCCAGTGGGGTTAGAGCTAGAAATAGCAAGTTAA	1
GGGTACCAGC	GAAACACCGGTGTGGCTGAGAGTCCGGCAATGGTGTGGCTGTGGGGTTAG	1
GGGTTACTTT	GAAACACCGGTCTCGAGTGAGGCGATCAGGGTGGGGCTCGAGCTAGAAAT	1
GGTAAACTCC	GAAACACCGGTGTGGCTGAGAGTCCAGCAATGGTGTGGCTGTGGGGTTAG	1
GGTAATCCTT	GAAACACCGGTCTCGAGTGAGGTGTTCAGGGTGGGGGTAGAGCTAGAAAT	1
GGTAGGCCTC	GAAACACCGGTCCGTAGGAGACCCGTGTGGCATGTACCTGTGGGGTTAGA	1
GGTGATGTCC	GAAACACCGGTGGGGTTAGAGCTAGAAATAGCAAGTTAACCTAAGGCTAG	1
GGTGGAGGCT	GAAACACCGGTTCCCGTCCAGTGGGGTTAGAGCTAGAAATAGCAAGTTAA	1
GGTGGTTTCA	GAAACACCGGTAAATTTGAGGCTCCGGCATGCATGAGGCCGTGGGGTTAG	1
GGTTTACTGA	GAAACACCGGTCGGGGCCAGAGCTAGAAATAGCAAGTTAACCTAAGGCTA	1
GTAACGATGA	GAAACACCGGTTACATTGAGGGGTTAGAGCTAGAAATAGCAAGTTAACCT	1
GTAACTGATT	GAAACACCGGTAACTACATTCATGCGATATCGCCGTATCAGTGGGGTTAA	1
GTACACAATA	GAAACACCGGTTAAACCGAAGTGTTAGAGCTGTTAGTGCTAGGTTTACCT	1
GTACACAATT	GAAACACCGGTTTACGTAACATCGGAGTGGGGTTAGAGCTAGAAATAGCA	1
GTAGATAGGT	GAAACACCGGTTACGATGAGGGTTAGAGCTAGAAATAGCAAGTTAACCTA	1
GTAGCCCAGC	GAAACACCGGTCGGCGGCAATCGTGGGTGGGGTTAGAGCTAGAAATAGCA	1
GTAGCCCTGC	GAAACACCGGTTACATTGAGGGTTAGAGCTAGAAATAGCAAGTTAACCTA	1
GTAGCGTCGC	GAAACACCGGTCGGCGGCAATCGTGCCTAGTGTTAGAGCTAGGAATAGCA	1
GTCACAGGCC	GAAACACCGGTAGCAAGTGCGAAATAGCAAGTTAACCTAAGGCTAGTCCG	1
GTCATTTACT	GAAACACCGGTGACTTTCGGAACAGGGGCGGGGGGAGAACTGGAAGTAGT	1
GTCCCCTCCC	GAAACACCGGTAAATTTGAGGCTCCGGCATGCAGGAGGCCGTGGGGTTAG	1
GTCCCTATGT	GAAACACCGGTTACCTTGAGTGGGGTTAGAGCTAGAAATAGCCAGTTAAC	1
GTCGAGCAAC	GAAACACCGGTTCCCGTCCTGTGGGGTTAGAGCTAGAAATAGCAAGTTAA	1
GTCTCCTCCA	GAAACACCGGTAAATTTGAGGCTCCGGCATGCAGGAGGCCGTGGGGTTAG	1
GTGAAAGCTC	GAAACACCGGTTCCCGTCCAGTGGGGTTAGAGCTAGAAATAGCAAGTTAA	1
GTGAATCCTT	GAAACACCGGTCTCGAGTGAGGTGTTCAGGGTGGGGTTAGAGCTAGAAAT	1
GTGAGCATGC	GAAACACCGGTTAAGCCGAGGGTTAGAGTTAGAAATAGCAAGTTAACCTA	1
GTGAGGATAC	GAAACACCGGTTAAGCCGAGTGGGGTTAGAGCTAGAAATAGCAAGTTAAC	1
GTGAGGTGTG	GAAACACCGGTTACATTGAGATCTAGCTAGAAATAGCAAGTTAACCTAAG	1
GTGATCAGCA	GAAACACCGGTTAAGCCGAGTGGGGTTAGAGCTAGAAATAGCAAGTTAAC	1
GTGATCATCT	GAAACACCGGTTTACGTTGCATCGGTGTGGGGTTAGAGCTAGAAATAGCC	1
GTGATGACTC	GAAACACCGGTTCCCGTCCAGTGGGGTTAGAGCTAGTAATAGCAAGTTAA	1
GTGATGCGCC	GAAACACCGGTTCCCGTCCAGTGGGGGTAGAGCTAGAAATAGCAAGTTAA	1
GTGCGCATTA	GAAACACCGGTTAAGCCGAGGAGTTAGAGCTAGAAATAGCAAGTTAACCT	1
GTGGAGCCTC	GAAACACCGGTTCCCGTCCAGTGGGGTTAGAGCTAGAAATAGCAAGTTAA	1690
GTGGAGCCTC	GAAACACCGGTTCCCGTCCAAGTGGGGTTAGAGCTAGAAATAGCAAGTTA	10
GTGGAGCCTC	CAAAACACCGGTTCCCGTCCAGTGGGGTTAGAGCTAGAAATAGCAAGTTA	2
GTGGAGCCTC	GAAACACCGGTTCCCGTCCAGTGGGTTAGAGCTAGAAATAGCAAGTTAAC	2
GTGGAGCCTC	CAAAACACCGGTTCCCGACCAGTGGGGTTAGAGCTAGAAATAGCAAGTTA	1
GTGGAGCCTC	CCAAACACCGGTTCCCGTCCAGTGGGGTTAGAGCTAGAAATAGCAAGTTA	1
GTGGAGCCTC	CTAAACACCGGTTCCCGTCCAGTGGGGTTAGAGCTAGAAATAGCAAGTTA	1
GTGGAGCCTC	GAAACAACGGTCCCGTCCAGTGGGGTTAGAGCTAGAAATAGCAAGTTAAC	1
GTGGAGCCTC	GAAACACCGGTAACTATATTCATGCGATATCGCCGTATCAGTGGGGTTAG	1
GTGGAGCCTC	GAAACACCGGTCCCGTCCAGTGGGGTTAGAGCTAGAAATAGCAAGTTAAC	1
GTGGAGCCTC	GAAACACCGGTCGATTCATATCGAAACCTTCCCGTGACAGTGGGGTTAGA	1
GTGGAGCCTC	GAAACACCGGTCGATTCATATCGAACCCTTCCCGTGACAGTGGGGTTAGA	1
GTGGAGCCTC	GAAACACCGGTCTCGAGTGAGGTGTTCAGGGGTGGGGTTAGAGCTAGAAA	1
GTGGAGCCTC	GAAACACCGGTGTACGTATGGACTGAACCAGGGTGTGCAAAGTGGGGTGA	1
GTGGAGCCTC	GAAACACCGGTGTGGCTGAGAGTCCGGCAATGGTGTGGCTGTGGGGTTAA	1
GTGGAGCCTC	GAAACACCGGTGTGGCTGAGAGTCCGGCAATGGTGTGGCTGTGGGGTTAG	1
GTGGAGCCTC	GAAACACCGGTTAAGCCGAGTGGGGTTAGAGCTAGAAATAGCAAGTTAAC	1
GTGGAGCCTC	GAAACACCGGTTCACGCACAGTGGGGTTAGCGGTAGGAACAGCAAGTTAG	1
GTGGAGCCTC	GAAACACCGGTTCCCGTACAGTGTGGGTAGAGCTAGAGCTAGAAAGATAA	1
GTGGAGCCTC	GAAACACCGGTTCCCGTCAGTGGGGTTAGAGCTAGAAATAGCAAGTTAAC	1
GTGGAGCCTC	GAAACACCGGTTCCCGTCCGGTGGGGTAAAGCCAGGAATAAGAAGGTTAC	1
GTGGAGCCTC	GAAACACCGGTTCCCTTCCGGGGTTAGTAGTGCAAATAATAGCATGTTAT	1
GTGGAGCCTC	GAAACACCGGTTCCTGTGCGGTTGGGTTAGGAGGAGAAAGAGCAAGTTAG	1
GTGGAGCCTC	GAAACACCGGTTTACGTTGCATCGGTGTGGGGTTAGAGCTAGAAATAGCA	1
GTGGAGCCTC	GAAACACCGGTTTACGTTGCATCGGTTGTGGGGTTAGAGCTAGAAATAGC	1
GTGGAGCCTC	GCTAGACCGGTATCAACTTAGAAATGGTGCACCGAGTCGGTGCTTTTTTT	1
GTGGAGTATA	GAAACACCGGTTCCCGTCCAGAGTGGTTAGAGCTAGAAATAGCAAGATAA	1
GTGGATAAAC	GAAACACCGGTTCCCGTCCAGTGGGGTTAGAGCTAGAAATAGCAAGCTAA	1
GTGGCGCTTT	GAAACACCGGTTATACGGAGGGCTAGAGCTAGCAATAGCTAGATAACCTA	1
GTGTAGAATC	GAAACACCGGTTCCCGTCCAGTGGGGTTAGAGCTAGAAATAGCAAGTTAA	1
GTGTCGCACC	GAAACACCGGTTCCCGTCCAGTGGGGTTAGAGCTAGAAATAGCAAGTTAA	1
GTGTTACCGC	GAAACACCGGTCGGGGGTTAGAGCTAGAAATAGCAAGTTAACCTAAGGAT	1
GTTGAGCACA	GAAACACCGGTTAAGCCGAGTGGGGTTAGAGCTAGAAATAGCAAGATAAC	1
GTTGTACCGC	GAAACACCGGTTCCCGTCCAGTGGGGGTAGGGCTAGAAATAGCAAGTTAA	1
GTTTAGCGTC	GAAACACCGGTTCCCGTCCAGTGGGGTTAGAGCTAGGAATAGCAAGTTAA	1
TAAAGTATCT	GAGCAAGTTAACCTAAGGCTAGTCCGTTATCAACTTGAAAAAGTGGCACC	1
TAAATCACAC	GAAACACCGGTAAATATTGTCGTGCCATATCGTTAGAGCTAGAAGTGGCT	1
TAAATTGATA	GAAACACCGGTAACTAGATTCTAGCGATATCGCCGGATCGGTAGGGTAAG	1
TAACGCAGAA	GAAACACCGGTGCCCTTACTCTCACCTGATTACTTAATCCGTGGGGTTAG	1
TAACGCTCTA	GAAACACCGGTGCCCTTACTCTCACCTGATTACTTAATCCGTGGGGTTAG	1
TAACTTATAC	GAAACACCGGTAACTATATTCATGCGATATCGCCGTATCAGTGGGGTTAG	425
TAACTTATAC	GAAACACCGGTAACTATATTCATGCGATATCGCCGTATCAAGTGGGGTTA	42
TAACTTATAC	GAAACACCGGTAACTATATTCATGCGATAGCGGGTTAGAGCTAGAAATAG	14
TAACTTATAC	GAAACACAGCTAGAAATAGCAAGTTAACCTAAGGCTAGTCCGTTATCAAC	11
TAACTTATAC	GAAACACCGGTAACTATATTCATGCGATATCGCCGAGCTAGAAATAGCAA	11
TAACTTATAC	GAAACACCGGTAACTATATTCATGCGATATCGCCTTAGAGCTAGAAATAG	10
TAACTTATAC	GAAACACCGGTAACTATATTCATGCGATATCGCCGTATGGGGTTAGAGCT	9
TAACTTATAC	GAAACACCGGTAACTATATTCATGCGATATCGCCGTGGGGTTAGAGCTAG	9
TAACTTATAC	GAAACACCGGTAACTATATTCATGCGATATAGCAAGTTAACCTAAGGCTA	8
TAACTTATAC	GAAACACCGGTAACTATATTCATGCGATATCGCCGTATCGTGGGGTTAGA	8
TAACTTATAC	GAAACACCGGTAACTATATTCATGCGATATCGCCGTATAGTGGGGTTAGA	7
TAACTTATAC	GAAACACCGGTAACTATATTCATGCGATATCGCCGTATCATGGGGTTAGA	6
TAACTTATAC	GAAACACCGGTAACTATATTCATGCGATATCGTAGAGCTAGAAATAGCAA	6
TAACTTATAC	GAAACACCGGTAACTATATTCATGCGATATCGTTAGAGCTAGAAATAGCA	6
TAACTTATAC	GAAACACCGGTAACTATATTCATGCGGTATCGCCGTATCAAAGTGGGGTT	6
TAACTTATAC	GAGCAAGTTAACCTAAGGCTAGTCCGTTATCAACTTGAAAAAGTGGCACC	6
TAACTTATAC	GAAACACCGGTAACTATATTCATGCGATATCGCCGTATCGGGGTTAGAGC	5
TAACTTATAC	GAAACACCGGTAACTATATTAGAGCTAGAAATAGCAAGTTAACCTAAGGC	4
TAACTTATAC	GAAACACCGGTAACTATATTCATGCGATATCGCCGTATGTGGGGTTAGAG	4
TAACTTATAC	GAAACACCGGTAACTATATTCATGCGATATCGCCGTAAAGTGGGGTTAGA	3
TAACTTATAC	CAAAACACCGGTAACTATATTCATGCGATATCGCCGTATCAAGTGGGGTT	1
TAACTTATAC	CAAAACACCGGTAACTATATTCATGCGATATCGCCGTATCAGTGGGGTTA	1
TAACTTATAC	GAAACACCGGTAACTATATCATGCGATATCGCCGTATCAAGTGGGGTTAG	1
TAACTTATAC	GAAACACCGGTAACTATATTCATGCTATATCGCCGTATCAAAGTGGGGTT	1
TAACTTATAC	GAAACACCGGTAACTATATTCATGCTGTGTCGCCGTATCAGTTAGGGTAA	1
TAACTTATAC	GAAACACCGGTACTATATTCATGCGATATCGCCTTAGAGCTAGAAATAGC	1
TAACTTATAC	GAAACACCGGTCACTTTATTCCTGCGATATCGCCGTATCGGGGGGTTTAG	1
TAACTTATAC	GAAACACCGGTGACATTGGGTACAGTTAGAGCTAGAAATAGCAAGTTAAC	1
TAACTTATAC	GAAACACCGGTTACTTTATGTAGGGTTAGAGCTAGAAATAGCAAGTTAAC	1
TAACTTATAC	GAAACACCGGTTCCCGTCCAAGTGGGGTTAGAGCTAGAAATAGCAAGTTA	1
TAACTTATAC	GTTGAAACACCGGTAACCATATTCATGCGATATCGCCGTATCAGTGGGGT	1
TAAGACAGCC	GAAACACCGGTGCCCTTACTCTCACCTGATTACTTAATCCGTGGGGTTAG	1
TAAGAGCAGT	GAAACACCGGTCGGCGGCAATGTGTGTAGATGTAGAAGTAGCAAGTTAAC	1
TAAGAGGCGT	GAAACACCGGTCGGCGGCAATCGTGGGTGGGGTTAGAGCTAGAAATAGCA	1
TAAGCAGACC	GAAACACCGGTAGCAAGTGCGAAATAGCAAGTTAACCTAAGGCTAGTCCG	1
TAAGGTATCT	GAAACACCGGTTACATTGAGGGTTAGAGCTAGATATGGCAAGTTAAACTA	1
TAATCTCTGT	GAAACACCGGTTACATTGAGATTGGGGTTAGAGCTAGAAATAGCGAGTTA	1
TAATGCCATA	GAAACACCGGTGCCCTTACTCTCACCTGATTACTTAATCCGTGGGGTTAG	1
TAATTAGGTT	GAAACACCGGTTCCGTTATCAACTTGAAAAGGTGGCACCGAGTCGGTGCT	1
TAATTTAGGC	GAAACACCGGTAACTATATTCATGCGATATCGCCGTATCAGTGGGGTTAG	1
TAATTTCGAC	GAGAAAGTTAACCTAAGGCTACTCCGTTGTCGACTTGGCAAAAAGGATCC	1
TACACCTGCA	GAAACACCGGTAAATTTGAGGCTCCGGCATGCAGGAGGCCGTGGGGTTAG	180
TACACCTGCA	GAAACACCGGTAAATTTGAGGCTCCGGCATGCAGGAGGCCCGTGGGGTTA	8
TACACCTGCA	GAAACACCGGTAAATTTGAGGCTCCGGCATGCAGGAGGCGTGGGGTTAGA	4
TACACCTGCA	GAAACACCGGTAAATTTGAGGCGTGGGGTTAGAGCTAGAAATAGCAAGTT	3
TACACCTGCA	GAAACACCGGTAAATTTGAGGCTCCGGCATGCAGGAGGCCGAAGGCTAGT	3
TACACCTGCA	GAAACACCAGAGCTAGAAATAGCAAGTTAACCTAAGGCTAGTCCGTTATC	2
TACACCTGCA	GAAACACCGGTAAATTTGAGGCTCCGGCATGCAGGAGGCCTGGGGTTAGA	2
TACACCTGCA	GAAACACCGGTAAATTTGAGGCTCCGGCGTGCAGGAGGCGTGGGGTTAGA	1
TACACCTGCA	GAAACACCGGTGTGGCTGAGAGTCCGGCAATGGTGTGGCTGTGGGGTTAG	1
TACACCTGCA	GAAACACCGGTGTGGCTGAGAGTCGGGCAATGGTGTGGCTGTGGGGTTAG	1
TACACCTGCA	GGAACACCAGAGCTAGAAATAGCAAGTTAACCTAAGGCTAGTCCGTTATC	1
TACACCTGCA	GGAACACCGGTTATATTTGTAAGTGTGTGGGGTTAGAGCTAGAAATAGCA	1
TACCCTAGGT	GAAACACCGGTGCACGTATGGACTGAACCAGGGTGTGCAAGGGGAGCTAG	1
TACCTGTCTT	GAAACACCGGTCGTCGCTATATCATTGTGGGGTTAGACTAGAAATAGCAA	1
TACCTTAACC	GAAACACCGGTAACTATATTCATGCGATATCGCCGTATCAGTGGGGTTAG	1
TACGATATGT	GAAACAGGGGTTAGAGCTAGAAATAGCATGTTAACTTAAGGCTAGTCCGT	1
TACGCACTAG	GAAACACCGGTTATATTTGTAAGTGTGTGGGGTTAGAGCTAGAAATAGCA	1
TACTCTCTAC	GAAACACCGGTAACTTTGTTCCAGCGATATCGCCGTATCAGTGGAGTTAG	1
TACTTTACCG	GAAACACCGGTCGGGGCCACTCAGTGGTGGGGTTAGAGCTAGAAATAGCA	1
TAGAAAGCAT	GAAACACCGGTTTGAACTACCTAGTTCAAACCGGTGGGGTTAGAGCTAGA	1
TAGAACCTCG	GAAACACCGGTGCATTCGAAAGTCCGGTCGTAGTGTGGACGTGGGGTTAG	1
TAGAACGACC	GAAACACCGGTTTGAACTACCGGGGTTAGAGCTAGAAATAGCAAGTTAAC	1
TAGAACGCGC	GAAACAACGGCTTGAACTACCTAGTTAAAACCGGTGGGGTTAGAGCTAGA	1
TAGAGAGACA	GAAACACCGGTAGCAAGTGGGGTTAGAGCTAGAAATAGCAAGTTAACCTA	1
TAGAGCGCAC	GAAACACCGGTTTGAACTAGAAATAGCAAGTTAACCTAAGGCTAGTCTGT	1
TAGAGCGTCC	GAAACACCGGTTAAGACTAGGATAGAGCTAGTAATATCAAGTTAACCTGT	1
TAGAGTCCTT	GAACCACCGGTCTCGAGTGAGGTGTTCAGGGGTGGGGTTAGAGCTAGAAA	1
TAGATCGGGA	GAAACACCGGTTATATTTGTATTAGAGCTAGAAATAGCAAGCTAACCTAA	1
TAGATGGGTG	GAAACACCGGTTATATTTGTAAGTGTGTGGGGTTAGAGCTAGAAGTAGCA	1
TAGCGCATAC	GAAACACCGGTTAAGCCGATGTGCTTTTTTCCTGCAGGTTATGCTCAAGA	1
TAGCGTTGTC	GAAACACCGGTGACACTGGGTAGAGCTAGAAATAGCAAGTTAACCTAAGG	1
TAGCTACTTT	GAAACACCGGTCTCGAGTGAGGTGTACAGGGTGGGGTTAGAGCTAGAAAT	1
TAGGGACTAC	GAAACACCGGTTAAGTCGCTGAGTTATAGTTAGTTATAGCAAGTTAACAT	1
TAGGTGAGCT	GAAACACCGGTGTACGTATGGACTGAACCAGGGTGTGCAAGTGGGGTTAG	1
TAGTCAGCCT	GAAACACCGGTCCGTAGGAGACCCGTGTGGCATGTACCTGTGGGGTTAGA	1
TAGTCTACAT	GAAACACCGGTCCGTAGGAGACCCGTGTGGCATGTACCTGTGGGGTTAGA	1
TATAGCAGGT	GAAACACCGGTTATATATGCAGGTGTGTGGGGCTAGAGCTAGAAATAGCA	1
TATATCACCA	GAAACACCGGTTCTATTTGTCGCCGCGTGGGGGGATAGCGAGAGATAGCG	1
TATCTTGTTC	GAAACACCGGTACCTATATTCATGCGATATCGCCGTATCAAGTGGGGTTA	1
TATGACGAGG	GAAACACCGGTTATATTTGTAAGTGTGTGGGGTTAGAGCTAGAAATAGCA	1
TATGATTAGC	GAAACACCGGTTTACGTTGCATCGGTTGTGGGGTTAGAGCTAGAAATAGC	1
TATGCTTAGA	GAAACACCGGTTTACGTTGCATCGGTTGTGGGGTTAGAGCTAGAAATAGC	1
TATGCTTGGG	GAAACACCGGTTTTATTTGCAAGGGTGTGGGGTTAGAGCTAGAAATAGCA	1
TCAACAGATT	GAAACACCGGTCGATTCATATCGAAACCTTCCCGTGACAGTGGGGTTAGA	1
TCAAGCGTGG	GAAACACCGGTTATATTTGTAAGTGTGTGGGGTTAGAGCTAGAAATAGCA	1
TCAATAATTT	GAAACACTAGGGCAAGTCCGTTATCAACTTGGAAAAGGGGCACAGAGGCG	1
TCAATTGTGC	GAAACACCGGTAATCAGAGGTGAACGTAAGGCGGGGTTAGAGCTAGAAAT	1
TCACAGCTTC	GAAACACCGGTTCCTGTCCAGATGGGTTATAGCTAGAAATAGCAAGTTAA	1
TCAGCTAAGG	GAAACACCGGCTACATTGAGGGTTGGAGCTAGAAATAGCAAGTTAACCTA	1
TCATAGTCGT	GAAACACCGGTGTACGTATGGACTGAACCAGGGTGTGCAAGTGGGGTTAG	2
TCATTGCCTC	GAAACACCGGTCCGTAGGCTACCCGTGTGGCATTTACCTGTGAGGTAAGA	1
TCCACAGACC	GAAACACCGGTAGCAAGTGCGAGAGTTAGAGCTAGAAATAGCAAGTTAAC	1
TCCTCGTCGT	GAAACACCGGTGTACGTATGGACTGAACCAGGGTGTGCAAGTGGGGTTAG	1
TCCTCGTCGT	GAAACACCGGTGTACGTATGGACTGAACCAGGGTGTGCAAGTGGGGTTGG	1
TCGAATACTT	GAAACACCGGTCTCGAGTGAGGTGTTCAGGGTGGGGTTGGAGCTAGAAAT	1
TCGAATGTTC	GAAACACCGGTCTCGAGTGAGGTGTTCAGGGTGGGGTTAGAGCTAGAAAT	1
TCGATCGCGT	GAAACACCGGTTATATTTGTAAGTGTGCTAGAAATAGCAAGTTAACCTAA	1
TCGATCGGCT	GAAACACCGGTTATATTTGTAAGGGTGTGGGGTTAGAGCTAGAAATAGCA	1
TCGCCCGGCA	GAAACACCGGTGCATTCGAAAGTCCGGTCGTAGTGTGGACGTGGGGTTAG	1
TCGCCCTACA	GAAACACCGGTAAATTTGAGGCTCCGGCATGCAGGAGGCCGTGGGGTTAG	1
TCGCCCTGCA	GAAACACCGGTGCATTCGAAAGTCCGGTCGTAGTGTGGACGTGGGGTTAG	3
TCGTGGTCGT	GAAACACCGGTGTACGTATGGACTGAACCAGGGTGTGCAAGTGGGGTTAG	1
TCGTGTCGTC	GAAACACCGGAGTGGGGTTAGAGCTAGAAATAGCAAGTTAACCTAAGGCT	1
TCGTTAACGC	GAAACACCGGTTATATTTGTAAGTGTGTGGGGTTAGAGCTAGAAATAGCA	1
TCTAGCGCGA	GAAACACCGGTTATATTTGTAAGTGTGTGGGGTTAGAGCTAGAAATAGCA	1
TCTATCGAGG	GAAACACCGGTTATATTTGTAAGTGTGTGGGGTTAGAGCTAGAAATAGCA	888
TCTATCGAGG	GAAACACCGGTTATATTTGTAAGTGGGGTTAGAGCTAGAAATAGCAAGTT	56
TCTATCGAGG	GAAACACCGGTTATATTTGTAAGTGTTTGTGGGGTTAGAGCTAGAAATAG	34
TCTATCGAGG	GAAACACCGGTGGGGTTAGAGCTAGAAATAGCAAGTTAACCTAAGGCTAG	28
TCTATCGAGG	GAAACACCGGTTATATTTGTAAGTGTTGTGGGGTTAGAGCTAGAAATAGC	26
TCTATCGAGG	GAAACACCGGTTATATTTGTGGGGTTAGAGCTAGAAATAGCAAGTTAACC	26
TCTATCGAGG	GAAACACCGGTTATGGGGTTAGAGCTAGAAATAGCAAGTTAACCTAAGGC	23
TCTATCGAGG	GGTTAGAGCTAGAAATAGCAAGTTAACCTAAGGCTAGTCCGTTATCAACT	21
TCTATCGAGG	GAAACACCGGTTATATTTGTAAGAGAGCTAGAAATAGCAAGTTAACCTAA	20
TCTATCGAGG	GAAACACCGGTTATATTAGGTTAGAGCTAGAAATAGCAAGTTAACCTAAG	16
TCTATCGAGG	GAAACACCGGTTATATTTGTTGTGGGGTTAGAGCTAGAAATAGCAAGTTA	13
TCTATCGAGG	GAAAACACCGGTTATATTTGTAAGTGTGTGGGGTTAGAGCTAGAAATAGC	12
TCTATCGAGG	GAAACACCGGTTATATTTGTAAGGGGTTAGAGCTAGAAATAGCAAGTTAA	12
TCTATCGAGG	GAAACACCGGTTATATTTGTAAGTGTGCTAGAAATAGCAAGTTAACCTAA	10
TCTATCGAGG	GAAACACCGGTTATATTTGTTAGAAATAGCAAGTTAACCTAAGGCTAGTC	9
TCTATCGAGG	GAAACACCGGTTGTATTTGTGGGGTTAGAGCTAGAAATAGCAAGTTAACC	9
TCTATCGAGG	GAAACACCGGTTATATTTAGAAATAGCAAGTTAACCTAAGGCTAGTCCGT	7
TCTATCGAGG	GAAACACCGGTTATATTTGTAAGTGTGTTAGAGCTAGAAATAGCAAGTTA	6
TCTATCGAGG	GAAACACCGGGGGGTTAGAGCTAGAAATAGCAAGTTAACCTAAGGCTAGT	5
TCTATCGAGG	GAAACACCGGTTATATTTGTATGGGGTTAGAGCTAGAAATAGCAAGTTAA	5
TCTATCGAGG	GAAACACCGGTTATATTTGTAAGTGGGGTTATATTTGTAAGTGGGGTTAG	4
TCTATCGAGG	GAAACACCGGTTATATTTGTAAGTGTGGGGTTAGAGCTAGAAATAGCAAG	4
TCTATCGAGG	GAAACACCGGTTATATTTGTAAGTGTAGTGTAGTGGGGTTAGAGCTAGAA	3
TCTATCGAGG	CAAAACACCGGTTATATTTGTAAGTGTGTGGGGTTAGAGCTAGAAATAGC	2
TCTATCGAGG	GAAACACCGGTTATATTTGTAAGTGTGTGGGTTAGAGCTAGAAATAGCAA	2
TCTATCGAGG	GAAACACCGATCTCGAGTGAGGTGTTCAGGGTGGGGTTAGAGCTAGAAAT	1
TCTATCGAGG	GAAACACCGGGGGGTTAGAGCTAGAAATAGCAAGTTATCCTAAGGCTAGT	1
TCTATCGAGG	GAAACACCGGTGCATTCGAAAGTCCGGTCGTAGTGTGGACGGGGGGATAG	1
TCTATCGAGG	GAAACACCGGTGTACGTATGGACTGAACCAGGGTGTGCAAGTGGGGTTAG	1
TCTATCGAGG	GAAACACCGGTTAAGCCGAGTGGGGTTAGAGCTAGAAATAGCAAGTTAAC	1
TCTATCGAGG	GAAACACCGGTTATATCTGTAAGTGTGTGGGTTAGAGCTAGAAATAGCAA	1
TCTATCGAGG	GAAACACCGGTTATATTAGAAATAGCAAGTTAACCTAAGGCTAGTCCGTT	1
TCTATCGAGG	GAAACACCGGTTATATTTGTAAGTGTGGGGTTAGAGCTAGAAACAGCAAG	1
TCTATCGAGG	GAAACACCGGTTATGTTTGTAAGTGGGGTTATATTTGTAAGTGGGGTTAG	1
TCTATCGAGG	GAAACGCCGGTTATATTTGTAAGTGTAGTGTAGTGGGGTTAGAGCTAGAA	1
TCTATCGAGG	GAAGCACCGGGGGGTTAGAGCTAGAAATAGCAAGTTAACCTAAGGCTAGT	1
TCTATCGTTT	GAAACACCGGTTATATTTGTAAGGGTGTGGGGTTAGAGCTAGCAATAGCT	1
TCTATGGCTG	GAAACACCGGTTCTATTTGTACGAGAGCTAGAAATAGCAAGTTAACCTAA	1
TCTCGCGCGG	GAAACACCGGTTATATTTGTAAGTGTGCGGGGTTAGAGCTAGAAATAGCA	1
TCTTAAGCGC	GAAACACCGGTCGGGACCACTCAGTGGCGGGGGGATAGTAAAAAAAACCA	1
TCTTCGTGGT	GAAACACCGGTGTACGTATGGACTGAACCAGGGTGTGCAATGGGGTTAGA	1
TCTTTTACGC	GAAACACCGGTCGGGGCCACTCAGTGGTGGGGTTAGAGCTAGAAATAGCA	1
TGAAGCCCCG	GAAACACCGGTCGGCGGCAATCGTGGGGTGGGGTTAGAGCTAGAAATAGC	1
TGAAGGCCCT	GAAACACCGGTCGGCGGCAATCGTGGGTGGGGTTAGAGCTAGAAATAGCA	1
TGAGCTACGA	GAAACACCGGTTACATTGAGGGGTTAGAGCTAGAAATAGCAAGTTAACCT	1
TGAGGAGCCT	GAAACACCGGTTCCCGTCCAGTGGGGTTAGAGCTAGAAATAGCAAGTTAA	1
TGAGGATCCA	GAAACACCGGTTCCTGTCCAGTGGGGTTAGTGCTAGAACTAGCAAGTTAG	1
TGCCTCCCTG	GAAACACCGGTCCGTAGGAGACCCGTGTGGCATGTACCTGTGGGGTTAGA	1
TGGAGATACA	GAAACACCGGTGAATTTGAGGCTCCGGCATGCAGGAGGCCGTGGGGTTAG	1
TGGCCCATCA	GAAACACCGGTAAATTTGAGGCTCCGGCATGCAGGAGGCCGTGGGGTTAG	1
TGGGCTATCT	GAAACACCGGTTACATTGAGGGTTAGAGCTAGAAATAGCAAGTTAACCTA	1
TGGGTTGACC	GAAACACCGGTGACATTGGGTACAGGTAGGGGTTAGAGCTAGAGATAGAG	1
TGGTCGGAGT	GAAACACCGGTGTACGTATGGACTGAACCAGGGTGTGCAAGTGGGGTTAG	1
TGGTTTCTCT	GAAACACCGGTGACTGTGTGGGGTTAGAGCTAGAAATAGCAAGTTAACCT	1
TGTGCTGCCT	TAGCCTTAGTCCGTTATCAACTTGAAAAAGTGGCACCGAGTCGGTGCTTT	1
TGTGTTATGT	GAAACACCGGTTACATTTGAGGGTTAGAGCTAGAAATAGCAAGTTAACCT	1
TGTGTTGGCC	GAAACACCGGTGACATTGGGTGGGGTTAGAGCTAGAAATAGCAAGTTAAC	1
TTAAATAAGT	GAAACACCGGTTACATTGAGGGTTAGAGCTAGAAATAGCAAGTTAACCTA	1
TTACGTGTCT	GAAACACCGGTACCTTTGTTGATGCTGGGTTGAAGGTTGGAGCTAGAAAT	1
TTAGATAGGA	GAAACACCGGTTACATTGAGGGTTAGAGCTAGAAATAGCAAGTTAACCTA	1
TTAGATCTGC	GAAACACCGGTTACATTGAGGGTTAGAGCTAGAAATAGCAAGTTAACCTA	1
TTAGCTATGT	GAAACACCGGTTACATTGAGGGTTAGAGCTAGAAATAGCAAGTTAACCTA	948
TTAGCTATGT	GAAACACCGGTTACATTGAGGGGTTAGAGCTAGAAATAGCAAGTTAACCT	590
TTAGCTATGT	GAAACACCGGTTACATTGAGTGGGGTTAGAGCTAGAAATAGCAAGTTAAC	109
TTAGCTATGT	GAAACACCGGTTACATTGAGATTAGAGCTAGAAAAGGCTAGTCCGTTATC	82
TTAGCTATGT	GAAACACCGGTTACATTGAGATTGGGGTTAGAGCTAGAAATAGCAAGTTA	61
TTAGCTATGT	GAAACACCGGTTACATTGGGGTTAGAGCTAGAAATAGCAAGTTAACCTAA	60
TTAGCTATGT	GAAACACCGGTTACATAGCAAGTTAACCTAAGGCTAGTCCGTTATCAACT	37
TTAGCTATGT	GAACCGGGGTTAGAGCTAGAAATAGCAAGTTAACCTAAGGCTAGTCCGTT	23
TTAGCTATGT	GAGGGTTAGAGCTAGAAATAGCAAGTTAACCTAAGGCTAGTCCGTTATCA	23
TTAGCTATGT	GAAACACCGGTTACTTGAGGGTTAGAGCTAGAAATAGCAAGTTAACCTAA	17
TTAGCTATGT	GAAACAGGGTTAGAGCTAGAAATAGCAAGTTAACCTAAGGCTAGTCCGTT	17
TTAGCTATGT	GAAACAGCTAGAAATAGCAAGTTAACCTAAGGCTAGTCCGTTATCAACTT	16
TTAGCTATGT	GAAACACCGGTTACATTGAGATCTAGCTAGAAATAGCAAGTTAACCTAAG	14
TTAGCTATGT	GAAACACCGGTTACATTGAGATCTCTTTTTGTGGGGTTAGAGCTAGAAAT	11
TTAGCTATGT	GAAACACCGGTTACTAGAGCTAGAAATAGCAAGTTAACCTAAGGCTAGTC	11
TTAGCTATGT	GAAACAGGGGTTAGAGCTAGAAATAGCAAGTTAACCTAAGGCTAGTCCGT	10
TTAGCTATGT	GTGTTTTGAGGGTTAGAGCTAGAAATAGCAAGTTAACCTAAGGCTAGTCC	9
TTAGCTATGT	GAAACACCGGTTACTGAGGGTTAGAGCTAGAAATAGCAAGTTAACCTAAG	8
TTAGCTATGT	GAAACACCGGTTTGAGGGTTAGAGCTAGAAATAGCAAGTTAACCTAAGGC	7
TTAGCTATGT	GAAACACCGGTTACATTGAGATCTCTTAGAGATCTAGAGCTAGAAATAGC	5
TTAGCTATGT	GAAACACCGGTTACATTGAGATCTCTTTAGAGCTAGAAATAGCAAGTTAA	4
TTAGCTATGT	GAAACACCGGTTACATTTGAGGGGTTAGAGCTAGAAATAGCAAGTTAACC	4
TTAGCTATGT	GAAACACCGGTTCTGAGGGTTAGAGCTAGAAATAGCAAGTTAACCTAAGG	4
TTAGCTATGT	GTGTGGAAAGGGTTAGAGCTAGAAATAGCAAGTTAACCTAAGGCTAGTCC	4
TTAGCTATGT	GAAACACCGGTGTGGCTGAGAGTCCGGCAATGGTGTGGCTGTGGGGTTAG	3
TTAGCTATGT	GAAACACCGGTTCCCGTCCAGTGGGGTTAGAGCTAGAAATAGCAAGTTAA	2
TTAGCTATGT	GACGAAACACCGGTTACATTGAGGGTTAGAGCTAGAAATAGCAAGTTAAC	2
TTAGCTATGT	GGAAAGGGTTAGAGCTAGAAATAGCAAGTTAACCTAAGGCTAGTCCGTTA	2
TTAGCTATGT	AGAGGTCGAAACACCGGTTACATTGAGGGTTAGAGCTAGAAATAGCAAGT	1
TTAGCTATGT	AGGTGTTTTGAGGGTTAGAGCTAGAAATAGCAAGTTAACCTAAGGCTAGT	1
TTAGCTATGT	CAAAACACCGATTACATTGAGGGGTTAGAGCTAGAAATAGCAAGTTAACC	1
TTAGCTATGT	CAAAACACCGGTTACATTGAGGGTTAGAGCTAGAAATAGCAAGTTAACCT	1
TTAGCTATGT	GAAACACCGGTGTACGTATGGACTGAACCAGGGTGTGCAAGTGGGGTTAG	1
TTAGCTATGT	GAAACACCGGTGTGGCTGAGAGTCCGGCAATGGTGTGGCTGTGGGGTCAG	1
TTAGCTATGT	GAAACACCGGTTAAATATCAAGTTAACCTAAGTCAAATCCAGTAACAGCA	1
TTAGCTATGT	GAAACACCGGTTACATCGAGATCTCTTTAGAGCTAGAAATAGCAAGTTAA	1
TTAGCTATGT	GAAACACCGGTTACATTAGGCTAGTCCGGTATCTACTTGTAGAAATAGCA	1
TTAGCTATGT	GAAACACCGGTTACATTGAGAGTTAGTGCTAGAAATAGCAGGATTAGCTA	1
TTAGCTATGT	GAAACACCGGTTACATTGAGATCTCTTAGAGATCTAGAGCTAGTAATAGC	1
TTAGCTATGT	GAAACACCGGTTACGTTGAGGAGTTAGACCTCAAGATAACAAGTTAACAG	1
TTAGCTATGT	GAAACACCGGTTACTTTGAGGGTTGGAACTAGAATTGGAAGTTTACCTAA	1
TTAGCTATGT	GAAACACCGGTTCTGAGGGTTAGAGCTAGAAATAGCGAGTTAACCTAAGG	1
TTAGCTATGT	GAAACGCCGGTTACATTGAGATCTCTTTAGAGCTAGAAATAGCAAGTTAA	1
TTAGCTATGT	GAAACGCCGGTTACATTTGAGGGGTTAGAGCTAGAAATAGCAAGTTAACC	1
TTAGCTATGT	GAACACCGGTTACATTGAGGGGTTAGAGCTAGAAATAGCAAGTTAACCTA	1
TTAGCTATGT	GGTAAGGGTTAGAGCTAGAAATAGCAAGTTAACCTAAGGCTAGTCCGTTA	1
TTAGGCATGA	GAAACACCGGTTACGCCGAGGAGTTAGAGCTAGAAATAGCAAGTTAACCT	1
TTATCAACGT	GAAACACCGGTTACATTGAGGGTTAGGGCTAGAAATAGCAAGTTAACCTA	1
TTATCGCGAC	GAAACACCGGTTACATGGAGGGTCAGAGCTAGAAATAGCAAGTTAACATA	1
TTATGACGCC	GAAAAACCGGTTTGAACTAGAAATAGCAAGTTAACCTAAGGCTAGTCCGT	1
TTCACTATGC	GAAACAGGGTTAGAGCTAGAAATAGCAAGTTAACCTAAGGCTAGTCCGTT	1
TTCACTATGC	GAAACACCGGTTACATTGAGGGTTAGAGCTAGAAATAGCAAGTTAACCTG	1
TTCCGCAGAA	GAAACACCGGTTAAGCCGAGTTTAGAGCTAGAAATAGCAAGTTAACCTAA	1
TTGAGCATAA	GAAACACCGGTTAAGCCGAGGAGTTAGAGCTAGAAATAGCAAGTTAACCT	608
TTGAGCATAA	GAAACACCGGTTAAGCCGATGTGCTTTTTTCCTGCAGGTTATGCTCAAGA	479
TTGAGCATAA	GAAACACCGGTTAAGCCGAGTGGGGTTAGAGCTAGAAATAGCAAGTTAAC	439
TTGAGCATAA	GAAACACCGGTTAAGCCGAGGTTAGAGCTAGAAATAGCAAGTTAACCTAA	317
TTGAGCATAA	GAAACACCGGTTAAGCCGAGGGTTAGAGCTAGAAATAGCAAGTTAACCTA	73
TTGAGCATAA	GAAACACCGGTTAGAGCTAGAAATAGCAAGTTAACCTAAGGCTAGTCCGT	51
TTGAGCATAA	GAAACACCGGTTAAGCCGAGGTGGGGTTAGAGCTAGAAATAGCAAGTTAA	49
TTGAGCATAA	GAAACACCGGTTCGGTGCTTTTTTCCTGCAGGTTATGCTCAAGAATTCGG	37
TTGAGCATAA	GAAACACCGGTTAAGCCGAGGGGGTTAGAGCTAGAAATAGCAAGTTAACC	22
TTGAGCATAA	GAAACACCGGTTAAGCTAGAAATAGCAAGTTAACCTAAGGCTAGTCCGTT	15
TTGAGCATAA	GAAACACCGGTTAAATAGCAAGTTAACCTAAGGCTAGTCCGTTATCAACT	13
TTGAGCATAA	GAAACACCGGTTAAGCCGGTGGGGTTAGAGCTAGAAATAGCAAGTTAACC	13
TTGAGCATAA	GAAACACCGGTTAGAAATAGCAAGTTAACCTAAGGCTAGTCCGTTATCAA	13
TTGAGCATAA	GAAACACCGGTTAAGCCGGTTAGAGCTAGAAATAGCAAGTTAACCTAAGG	11
TTGAGCATAA	GAAACACCGGTTAAGCCGAGGAGTTAATTAGAGCTAGAAATAGCAAGTTA	5
TTGAGCATAA	GAAACACCGGTTAAGCCGAGGTGTTTAGAGTGTGGGGTTAGAGCTAGAAA	3
TTGAGCATAA	GAAACACCGGTTAAGCCGAGGTTAACCGGGTGGGGTTAGAGCTAGAAATA	3
TTGAGCATAA	AGAGGGCGAAACACCGGTTAAGCCGAGGAGTTAGAGCTAGAAATAGCAAG	1
TTGAGCATAA	AGGAACGAAACACCGGTTAAGCCGAGTGGGGTTAGAGCTAGAAATAGCAA	1
TTGAGCATAA	AGGGATGAAACACCGGTTAAGCCGAGTGGGGTTAGAGCTAGAAATAGCAA	1
TTGAGCATAA	CAAAACACCGGTTAAGCCGATGTGCTTTTTTCCTGCAGGTTATGCTCAAG	1
TTGAGCATAA	CAAAACACCGGTTAAGCCGTGGAGTTAGAGCTAGAAATAGCAAGTTAACC	1
TTGAGCATAA	GAAACACCGGTCGATTCATATCGAAACCTTCCCGTGACAGTGGGGTTAGA	1
TTGAGCATAA	GAAACACCGGTGAAGCCGATGTGCCTTTTTTCCTGCAGGTTATGCTCAAG	1
TTGAGCATAA	GAAACACCGGTTAAGCATAGTGGGGATAGAGTGAGAAATGGCAAGTTAAT	1
TTGAGCATAA	GAAACACCGGTTAAGCCGAGGAGTTAGAGCTAGAATAGCAAGTTAACCTA	1
TTGAGCATAA	GAAACACCGGTTAAGCCGATGTGCTTTTTCCTGCAGGTTATGCTCAAGAA	1
TTGAGCATAA	GAAACACCGGTTAAGCCGATGTGCTTTTTTCCCTGCAGGTTATGCTCAAG	1
TTGAGCATAA	GAAACACCGGTTAAGCCGTGGAGTTAATTAGAGCTAGAAATAGCAAGTTA	1
TTGAGCATAA	GAAACACCGGTTAAGCCTTGTATGTTGCTAGAGATATCAGAGTAACAAAT	1
TTGAGCATAA	GAAACACCGGTTAAGTTGATCGGAGCTAAATCTATAAATAGCAAGGTAAG	1
TTGAGCATAA	GAAACACCGGTTAGGCCGAGGAGTTAATTAGAGCTAGAAATAGCAAGTTA	1
TTGAGCATAA	GAAACACCGGTTAGGCCGAGGTGTTTAGAGTGTGGGGTTAGAGCTAGAAA	1
TTGAGCATAA	GAAACACCGGTTAGGGGGAATGGTGGTAGAGCTAGGAATAGCAAATTAAA	1
TTGAGCATAA	GAAACACCGGTTCGGTGCTTTTTACCAGCACGAAAGGATCAAAAAATCGG	1
TTGAGCATAA	GAAACACGGGTTAAGCCGAGGTTAACCGGGTGGGGTTAGAGCTAGAAATA	1
TTGAGCATAA	GACGAAACACCGGTTAAGCCGAGGTTAGAGCTAGAAATAGCAAGTTAACC	1
TTGAGCATAA	GCGGAGAGGACGAAACACCGGTTAAGCCGAGGAGTTAGAGCTAGAAATAG	1
TTGAGCATAA	GTAGCGCCGGTTAAACCAAGGAGTTAGAGCTATAAATATCAAGTTATACT	1
TTGAGGCGAA	GAAACACCGGTTAAGCCGATGTGCTTTTTTCCTGCAGGTTATGCTCAAGA	1
TTGCGCATGG	GAAACACCGGTTAAAACGATGTGCTTTTTTCCTGCAGGTTATGCTCAAGA	1
TTGGATACGT	GAAACACCGGTTCCCGTCCAGTGGGGTTAGAGCTAGAAATAGCAAGTTAA	1
TTGGCGCCTA	GAAACACCGGTTCCCGTCCAGTGGGGTTAGAGCTAGAAATAGCAAGTTAA	1
TTGGGCCCTG	GAAACACAGGTTAAGCCGAGGAGTTAGAGCTAGAAATAGCACGTTAACCT	1
TTGGTGGCTC	GAAACACCGGTTCCCGTCCAGTGGGGTTAGAGCTAGAAATAGCAAGATAA	1
TTGTGCAGCA	GAAACACCGGTTAAGCCGGGAGGGAAGACTGCTGGGATAGAGATGGTAAT	1
TTGTGCATCC	GAAACACTGGTTAAGCCGAGTGGGGTTAGAGCTAGAATTAGCAAGTTAAC	1
TTGTGCCTAC	GAAACACCGGTTAAGCCGAGTGGGGTTAGAGCTATAAATAGCAAGTTAAC	1
TTGTGCCTAC	GAAACACCGGTTAAGCCGAGGTTAGAGCTAGAAATAGCAAGTTAACCTAA	1
TTGTGCGTCA	GAAACACCGGTTAAGCCGAGTGGGGTTAGAGCTAGAAATAGCAAGTTAAC	1
TTGTGTTTAA	GAAACACCGGTTAAGCCGAGTGTTAGAGCTAGATATAGCAAGTTAACCTA	1
TTTAACGCAC	GAAACACCGGTTTGAACTAGAAATAGCAAGTTAACCTAAGGCTAGTCCGT	1
TTTAGAGAGG	GAAACACCGGTTATATTTGTAAGTGTGTGGGGTTAGAGCTAGAAATAGCA	1
TTTAGCTACG	GAAACACCGGTTACATTGAGGGTTAGGGCTAGAAATAGCAAGTTAACCTA	1
TTTAGGATCA	GAAACACCGGTTAAGCGGTGGTTAGAGCTATAAATAGATAGTTAACCTAG	1
TTTCGTAGCC	GAAACACCGGTGTATGTATGGACTGAACCAGGGTGTGCAAGTGGGGTTAG	1
