CACTCTCAAG	GAAACACCGGTGCTCTCGGATCATCAGTGGGGTTAGAGCTAGAAATAGCA	2	bc
CATTCCTTAC	GAAACACCGGTTTACGTTGCATCGGTGTGGGGTTAGAGCTAGAAATAGCA	1	bc
ATTTATCGTT	GAAACACCGGTTACATTTGAGGGGTTAGAGCTAGAAATAGCAAGTTAACC	1	bc
AAGACCCACG	GAAACACCGGTGCATTCGAAAGTCCGGTCGTAGTGTGGACGTGGGGTTAG	1	bc
GTGCAGAGCC	GAAACACCGGTTTACGTTGCATCGTAACCGGTGGGGTTAGAGCTAGAAAT	1	bc
AACCCCCGCC	GAAACACCGGTGTAACTTAAAACCCGGCAATGGTGTGGCTGGGAGGATAA	1	bc
AGACCTACTC	GAAACACCGGTTCGTAGGAGACCCGCGTGGCATGAACGTGAGAGGTAACA	1	bc
CGTAGGGCCC	GAAACACCGGTGGTAATTTAGAGGTACAAAGTGGGTTAGAGCTAGAAATA	1	bc
CTCTTTCGAG	CAAAACACCGGTTATATTTGTAAGTGTGTGGGGTTAGAGCTAGAAATAGC	1	bc
ATGGCGCCTA	GAAACACTGGTGTCTCGTTGGTACGTTCTGGTGGGGTTAGAGCTAGAAAT	1	bc
GGGAGCCCCC	GAAACACCGGTGTGGCTGAGAGTCCGGCAATGGTGGGGCTGGGGGGATAG	1	bc
GGAGGACCGC	GAAACACCGGTCGGCGGCAATCGTTAATCGGTTAATCGTGGGGTTAGAGC	1	bc
ACTCGGTTAC	GAAACACCGGTGAGGACTTGCGCAGTGCGAGTGGGGTTAGAGCTAGAAAT	1	bc
ATGAAGACTC	GAAACACCGGTTCCCGTCCAGTGGGGTTAGAGCTAGAAATAGCAAGTTAA	1	bc
GAATGCTTAG	GAAACACCGGTTTACGTTGCATCGGTGTGGGGTTAGAGCTAGAAATAGCA	1	bc
CCCCTCACTT	GAAACACCGGTGGAAGGTTGTATGTTGCTAGTGGGGTTAGAGCTAGAAAT	1	bc
AGTCTATCGC	GAAACACCGGTGCATTCCACACTGCGGTGGGGTTAGAGCTATGAGGCTAG	1	bc
CGAGATGTAT	GAAACACCGGTGACATTGGGTGGGGTTAGAGCTAGAAATAGCAAGTTAAC	1	bc
AAGGCGGCTC	GAAACACCGGTGCCTTTCACAGCGCGGTCGTAGGGGGTAGAGCTGGATAT	1	bc
TTTCCTGCAG	GAAACACCGGTCTCGAGTGAGGTGTTCAGGGTGGGGTTAGAGCTAGAAAT	1	bc
GCCGCAGCCA	GAAACACCGGTAGCAAGTGGGGTTAGAGCTAGAAATAGCAAGTTAACCTA	1	bc
AAGTCGGCCT	GAAACACCGGTCCGTAGGAGACCCGTGTGGCATTGTGGGGTTAGAGCCAG	1	bc
ACAAATCCTG	GAAACACCGGTAGGAGAGTGGTCACCGTATTCATTATAGGTGGGGTTAGA	1	bc
TCCATTCTAC	GAAACACCGGTTACTATCCTAATGCGTTACCGCTGTATCAGTGGGGTTAG	1	bc
GTCTATCGTG	GAAACACCGGTTATAATTGTAAGTGTGTGGGGTTAGAGCTAGAAATAGCA	1	bc
GTACACAGCT	GAAACACCGGTACCTTTGTTGATGCTGGTTAGAGCATCAACATTGGTTAG	1	bc
GAGTTTTGTC	GAAACACCGGTGACATGGGGTACAAGTCCGCTATCAACTTGAAAAAGTGG	1	bc
CACGCCAGAC	GAAACACCGGTGACCTTACTCTCACCTGATTACTTAATCGTGGGGATAAA	1	bc
TTCGTTATGC	GAAACACCGGTTAAGGGTTAGAGGTAGAAATAGTAAGTTAAGATATAGCT	1	bc
CATTGGAGGT	GAAACACCGGTGACAGAAGCTGCGTGGTTGGGTTAGAGCTAGAAATAGCA	1	bc
TAACTATCCC	GAAACACCGGTAACTATATTCATGCGATATCGCCGTATCAGTGGGGTTAG	1	bc
