TCTATTCAGT	GAAACACCGGTTATCTTTGTAAAGTTAATCTAAGGCTAATACGTTATCAT	1	bc
CCTTTCATGA	GAAACACCGGTTGGGGCCACTCTATGGCTAGGTTAAAGCTAGTAATCGCA	1	bc
TAAGCCGCGC	GAAACACCGGTCATCGGGGGTTGGGGCTGGGATTAGCGCTATAACCTGCG	1	bc
TTTTGCATAT	GAAACACCGGTTACGCCGAGGGTTAGAGCTAGAAATAGCAAGTTAACCTA	1	bc
CATCTGCCTT	GAAACACCGGTCCGTAGGTGACCCGTGTGGCATGAACTTAGTGAGGTTAG	1	bc
ACCACCCCCC	GAAACACCGGTTTGAACTAGAAATAGCAAGTTAACCTAAGGCTAGTCCGT	1	bc
GAGGATTCTT	GAAACACCGGTTCCCGTCATGGGCGGTTAGAGCTAGAAATAGCAAGTTAA	1	bc
GCCACACAGA	GAAACACCGGTAGCAAGCGCGAGACGGGTTAGAGCCAGCAATAGCACCGA	1	bc
TAAAACGCCT	GAAACACCGGTTTGAACTAGAAATAGCAAGTTAACCTAATGCTAGTCAGT	1	bc
TTAGCCATAC	GAAACACCGGTTATATTACGCGCAACAGCTAGAAATATCAAGGTAACCAA	1	bc
GGGGCCCCCC	GAAACACCGGTAAATTTGAGGCTCCGGCATGCAGGAGGCCGTGGGGATAG	1	bc
GAAAGCCTGC	GAAACACCGGTGTGGCTGAGAGTCGGCAATGGTGTGGCTGTGGGGTTAGA	1	bc
TTGCCACCTC	GAAACACCGGTTCGCGTCCAATGGGGCTAGAGCTAGACGTGGCGAGTTAA	1	bc
ATCACGGCTC	GAAACACCGGTTCACGTAAAGTAGGGTTAGACCTCGATATAGCAAGTTAA	1	bc
TAAAAACCGC	GAAACACCGGTCGGCGGGGTGGGGTTAGAGCTAGAAATAGCAAGTTAACC	1	bc
ATAGACGCGC	GAAACACCGGTGCTTTCTAAATTCCGTTCGTAGTGTAGTAGTGGGGTTAG	1	bc
TTATCGTTCA	GAAACACCGGTGGGTAGCTGGGTGCCCTTCTGACCTAATTGTGGGGTTAG	1	bc
GGAAGGCCCC	GAAACACCGGTGTGGCTGAGAGTTCGGCAATGGTGTGGCTGTGGGGTTAG	1	bc
GCCACAACAC	GAAACACCGGTTTGGCTGATTGTCCGGCAATGGAGTGGCTGTGGGGTTAG	1	bc
AACCATGCCC	GAAACACCGGTTTGCACTAGAAATAGCAAGTTAACCTAAGGCTAATCCGT	1	bc
TGGGGTGTCT	GAAACACCGGTGACATTGGGTACAGGGGGGGGATAGAGCTAGAAATAGCA	1	bc
CGTGGCGACT	AAGGCGAAACACCGGTGACATTGGGTATAGGTTGGGGTTAGAGCTAGAAA	1	bc
GGCGACCGCA	GAAACACCGGTCCCGGTAGAACCAAAGGCTGTGGGGTTAGAGCTAGAAAT	1	bc
TAGAACCCCC	GAAACACCGGTGCATTCGAAAGTCCGGTCGTAGTGTGGACGTGGGGTTAG	1	bc
TTTTCTTTTT	GAAACACCGGTTACATTGGGGTTAGAGCTAGAAATAGCAAGTTAACCTAA	1	bc
TATGCGTTAC	GAAACACCGGTTTACGTTGCATCGGTGTGGGGTTAGAGCTAGAAATAGCA	1	bc
CCGTACTTCA	GAAACACCGGTACTCCGGAAGGCCAAGTGGGGTTAGAGCTAGAAATAGCA	1	bc
GTGCGCATAT	GAAACACCGGTTAAGCCGAGGCGTTAGAGCTAGAAATAGCAAGTTAACCT	1	bc
TGAAAACCCG	GAAACACCGGTCGGCGGCAATCGTGGGTGGGGTTAGAGCTAGAAATAGCA	1	bc
TCCCCTCACT	GAAACACCGGTGGAAGGTTGTATGTTGCTAGTGGGGTTAGAGCTAGAAAT	1	bc
ACAATAGATT	GAAACACCGGTCGCTAGATATCGAAACCTTTCTGTGACTGTAGCGATAGA	1	bc
AACGTTCGGT	GAAACACCGGTACCTTTGTTGATGCTGGGTGGGGTTAAAGCTAGAAATAG	1	bc
AAAACCCCGC	GAAACACCGGTGCATTCGAAAGTCCGGTCGTAGTGTGGACGTGGGGTTAG	1	bc
CTTTTCCATC	GAAACACCGGTTGAGGCCACTTAGTGGTGGGGTTAGAGCTAGAAATAGCA	1	bc
TGGGACCCTC	GAAACACCGGTGTGGCTGAGAGTCCGGCAATGGTGTGGCTGTGGGGTTAG	1	bc
CACGAATCCT	GAAACACCGGTCTCGAGTGAGGTGTCCAGGGTGGGGTTAGAGCTAGAAAT	1	bc
TACGCTTAGC	GAAACACCGGTTTACGTTGCATCGGTGTGGGGTTAGAGCTAGAAATAGCA	1	bc
TGGGGAGCCT	GAAACACCGGTTCCCGTCCAGTGGGGTTAGAGCTAGAAATAGCAAGTTAA	1	bc
CTGATAATAA	GAAACACCGGTTAAGACGAGGAGAGTTAGAGGTAGAAATAGCAAGTTAAC	1	bc
GCTCCAGGCC	GAAACACCGGTGCCTTTGTTGTTGCGGCATGGGAGGATCTAGATAGTAAT	1	bc
TCTTCGTCGT	GAAACACCGGTGTACGTATGGACTGAACCAGGGTGTGCAAGTGGGGTTAG	1	bc
AAACCTCGCC	GAAACACCGGTGCATTCGAAAGTCCGGTCGTAGTGTGGACGTGGGGTTAG	1	bc
TGAAGACCAG	GAAACACCGGTCGGCGGCAATCGTGGGTGGGGTTAGCGCTAGAAATAGCA	1	bc
CACCGCGAAC	GAAACACCGGTTTGAACTACCTAGTTCAAACCGGTGTGGATAGAGCTAGA	1	bc
ACCCAAAAAC	GAAACACCGGTAGCAAGTGCGAGACGTGTTTGTGGGGTTAGAGCTAGAAA	1	bc
ATAACTGGCT	GAAACACCGGTACCTGAGTTGATGGTGTGGGTGGGTGTAGAGCTAGATAT	1	bc
CCGGTGGCTC	GAAACACCGGTCGCAGTCACGCAGGGATGGGGTTAGATAGAGCTTGAGCA	1	bc
CGCATGATGC	GAAACACCGGTTCGTTTCATGCTCATGACTTAATTGACATGTGGGGTTAG	1	bc
TTGGGCCTAC	GAAACACCGGTTAAGCCGATGTGGGGTTAGAGCTAGAAATAGCAAGTTAA	1	bc
CCCTTCACCC	GAAACACCGGTCGGGGCCACTCAGTGGTGGGGTTAGAGCTAGAAATAGCA	1	bc
TGTATCCTGG	GAAACACCGGTGTGATTGAGAGGCGGGTAAGGGTGTGGCTGTGGGTATAG	1	bc
GGAACCGACT	GAAACACCGGTAGCAAGTGCGAGATGTTTTTGTGGGGTTAGAGTTAGAAT	1	bc
TCGCCCTGCA	GAAACACCGGTGCATTCGAAAGTCCGGTCGTAGTGTGGACGTGGGGTTAG	1	bc
CAGGCCTGCT	GAAACACCGGTCCGTAGGAGACCCGTGTGGCATGTACCTTTGTGGGGTTA	1	bc
AGCACCTAAC	GAAACACCGGTTCATTTAAGACATACTTATACGGCGGGCCGTGGGGTTAG	1	bc
CTACTTATCC	GAAACACCGGTAACTATATTCATGCGATATCGCCGTATCAGTGGGGTTAG	1	bc
AGACAGTCAC	GAAACACCGGTGCATTCGAAAGTCCGGTCCGAGTGTGGACATGGGGATAG	1	bc
TTTTTACTGC	GAAACACCGGTCAGGGTCACTCAGTGGAGGGGTTAGAGCTAGAAATAGAA	1	bc
TTAACTTTTA	GAAACACCGGTAACTATATTCATGCGATATCGCCGTATCAGTGGGGTTAG	1	bc
CTTGTGGGCC	GAAACACCGGTGCATTCGAAAGTCCGGTCGTAGTGTGGACGTGGGGTTAG	1	bc
ATTGGCCGCC	GAAACACCGGTGTACGTATGGACTGAACCAGGGTGTGCAAGTGGGGTTAG	1	bc
ACAAACCCCC	GAAACACCGGTTTGAACTACCGGGGTTAGAGCTAGAAATAGCAAGTTAAC	1	bc
GTACACAATT	GAAACACCGGTCATGTCAATGCGGTGTGGGGTTAGAGCTAGAAATAGCAA	1	bc
TCCTTTTACG	GAAACACCGGTCGGGGCCACTCAGTGGTGGGGTTAGAGCTAGAAATAGCA	1	bc
ATTAACTATG	GAAACACCGGTTACATTGAGGGTTAGAGCTAGAAATAGCAAGTTAACCTA	1	bc
TAACTAAACC	GAAACGCCGGTAACTGCATTCACAAGATATCGCCGGAGCAGTGGGGTTAG	1	bc
