TCGCCCTGCA	GAAACACCGGTGCATTCGAAAGTCCGGTCGTAGTGTGGACGTGGGGTTAG	4	bc
AAACGACCTA	GAAACACCGGTGCCCTTACTCTCACCTGATTACTTAATCCGTGGGGTTAG	2	bc
TTGTGACATA	GAAACACCGGTCGTTATCAACTCATGGAACGTGGGGTTAGAGCTAGAAAT	2	bc
CTCCCCTGCA	GAAACACCGGTGTGGCTGAGAGTCCGGCAATGGTGTGGCTGTGGGGTTAG	2	bc
GATACATGTT	GAAACACCGGTAGCAAGTGGGGTTAGAGCTAGAAATAGCAAGTTAACCTA	1	bc
GCAGTCCCAC	GAAACACCGGTCGGCGGCAATCTGGGGTTAGAGCTAGAAATAGCAAGGTA	1	bc
GGGGGCCCGC	GAAACACCGGTCGGCGCCAATCGGGGTTAGATCTGGAAATGGCAAGGTAA	1	bc
GAGGCAGACC	GAAACACCGGTAGCAACGTGGGGTTAGAGCTAGAAATAGCAAGTTAACCT	1	bc
GCAACCGCGC	GAAACACCGGTCAGCGGCAATCGGGGTTGGGCTTAGAGCTGGAAGTATAG	1	bc
TCGTGATGGC	GAAACACCGTAAACTACGGCTTAGAAGTTACGATAGAAAAAGGAATCACC	1	bc
AACGGACTGC	GAAACACCGGTGCCCTTACTCTCACCTGATTACTTAATCCGTGGGGTTAG	1	bc
GCGTTAGCGC	GAAACACCGGTCGGGGCCACTCAGTGGTGGGGTTAGAGCTAGAAATAGCA	1	bc
AACAACTCTC	GAAACACGGGTTAGAGCTAGAAATAGCAAGTTAACCTAAGGCTAGTCCGT	1	bc
AAACGCGCTA	GAAACACCGGTGCCCTTACTCTCACCTGATTACTTAATCCGTGGGGTTAG	1	bc
CTGCTTAGAC	GAAACACCGGTTTACGTTGCATCGGTGTGGGGTTAGAGCTAGAAATAGCA	1	bc
TGAACACTCC	GAAACACCGGTTACACTGAGAGTTAGACATAGGTGTAGCTGGGTAGCCTA	1	bc
ACCTGCGGCT	GAAACACCGGTCGATTCATATCGAAACCTTCCCGTGACAGTGGGGTTAGA	1	bc
CAAGAGTCGC	GAAACACCGGTCGGAGTTTAGATGTACATAGAGCGAGAGATCTCGAGTTA	1	bc
AATTGGTGGC	GAAACACCGGTGACATAAGCAGCGTGGTGGGGTTAGAGCTAGAAATATCA	1	bc
GACGACCTCC	GAAACACCGGTCGGCGGGAGGGTTTAGAACTGGAGATACCGAGTTGATCT	1	bc
AGAGGAGCCT	GAAACACCGGTTCCCGTCCAGTGGGGTTAGAGCTAGAAATAGCGAGTTAA	1	bc
TAGCCGCCTC	GAAACACCGGTTCCCGTCCAGTGGGGTTAGAGCTAGAAATAGCAAGTTAA	1	bc
GAAACAGCAA	GAAACACCGGTTATCAACTTGAAAAAGTGGCACCGAGTCGGTGCTTTTTT	1	bc
CACTAAGCGC	GAAACACCGGTTTGAACTAGAAATAGCAAGTTATCCTAAGGCTAGTCCGT	1	bc
AGAATGACGC	GAAACACCGGTGCATTCGAAAGTCCGGGCGTAGTGTGGACGGGGGGGTAG	1	bc
CTAGCTACTG	GAAACACCGGTTACATTGGGGTTAGAGCTAGAAATAGCAAGTTAACCTAA	1	bc
AAGATCGAGG	GAAACACCGGTTATAATTGTAAATGTCTGGTGTTCGTGATAGAAGTAGGA	1	bc
GGTGGCGCCT	GAAACACCGGTTCCCGTCCAGTGGGGTTAGAGCTAGAAATAGCAAGTTAA	1	bc
GTACACAATT	GAAACACCGGTTAAAGTAAATTGCGAGTGGGGTTAGAGCTAGAAATAGCA	1	bc
GAGGTCACGC	GAAACACCGGTCGGCGGCAATCGTGGGAGCTAGAAGTAGCAAGTTAACCT	1	bc
TACGCTCTGT	GAAACACCGGTTACCTTGAGGGATCGAGCTAGAAATAGCAAGTTAAACTA	1	bc
ACACAAAGCC	GAAACACCGGTTTGAACTAGAAATAGCAAGTTAACCTAAGGCTAGTCCGT	1	bc
AAAGCACCAA	GAAACACCGGTGCCCTTACTCTCACCTGATTACTTAATCCGTGGGGTTAG	1	bc
AGAGGAGACT	GAAACACCGGTTCCCGTCCAGTGGGGTTAGAGCTAGAAATAGCAAGTTAA	1	bc
GAAAGCCATG	GAAAAACCGGTGCCCTTACTCTCACCTGATTACTTAATCCGTGGGGTTAG	1	bc
GTGGTGCGTT	GGAACACCGGTTCCTGTCCATCGGAGTTAGAGCTAGAAATAGCAAGTTAA	1	bc
GAAGACTTAC	GAAACACCGGTTCGGGTAGAGCTAGAAATAGCAAGTTAACCTAAGGCTAG	1	bc
GCAGAAGAGC	GAAACACTAGAAATAGCAAGTTAACCTAAGGTTAGACCTTTATCAACATG	1	bc
TCACTAATCA	GAAACACCGGTAACTATATTCATGCGATATCGCCGTATCAGTGGGGTTAG	1	bc
CAACGTGGAC	GAAACACCGGTGTACGTATAGACTGAACCAGGGTGTGCAAGTGGGGGTAG	1	bc
TTCGCGCATA	GAAACACCGGTTAAGCCGAGGAGTTAGAGCTAGAAATAGCAAGTTAACCT	1	bc
GAGGCTCCAC	GAAACACCGGTTCCCGTCCAGTGGGGTTATAACTTGATATAGCAAGTTAA	1	bc
TGGAACCTCC	GAAACACCGGTGTGGCTGGAAGCCGGGCGATGGTGTGGCTGTTGGGTTAG	1	bc
GTGGATAGCC	GAAACACCGGTTTACGTTCAGTGGGGTTAGAGCTAGAAATAGCAAGTTAA	1	bc
CGCGGCGTCC	GAAAAACCGGTTTGATTGGGTACTGGGTTGTTGCTAGAGCTATAGATAGC	1	bc
CACGCACCTC	GAAACACCGGTGCCCTTACTCTCACCTGATTACTTAATCCGTGGGGTTAG	1	bc
AGGCAACCTC	GAAACACCGGTGTGGCTGAGAGTCCGGCAATGGTGTGGCTGTGGGGTTAG	1	bc
AAGCATCGTT	GAAACACCGGTTTACGGCGCATCAGGGTGGGAATAGAGGTATAGATATCA	1	bc
GCGGAGAATC	GAAACACCGGTTCCCGTCCAGTGGGGTTAGAGCTAGAAATAGCAAGTTAA	1	bc
TACGATCTAC	GAAACACCGGTGCCCTTACTCTCACCTGATTACTTAATCCGTGGGGTTAG	1	bc
CAAGATCCTC	GAAACACCGGTGGTCTCGGATCGTGGGTGGTGTTAGAGGTAGAATTAGCA	1	bc
AACTAGCTAC	GAAACACCGGTGCCCTTACTCTCACCTGATTACTTAATCCGTGGGGTTAG	1	bc
ACAGCTCTGT	GAAACACCGGTTACTTTGAAAGTGCAGAGCTAGTAATGGCGTGGGGATAG	1	bc
ATTTGGCATA	GAAACACCGGTTAAGCCGAGTGGGGTTAGAGCTAGAAATAGCAAGTTAAC	1	bc
TAAATCCTAG	GAAACACCGGTGCATTCGAAAGTCCGGTCGTAGTGTAGACATGGGGATCG	1	bc
GCATAGTCGT	GAAACACCGGTGTACGTATGGACTGAACCAGGGTGTGCAAGTGGGGTTAG	1	bc
ATAATCGGAC	GAAACACCGGTCCCTTTATTACTGATTGAGACGAGGATTTGTGGCGATAG	1	bc
GGAAGGCTCC	GAAACACCGGTCTGGGTGAGAGGGCAGCGGGGTTAGAGCAGTAAGAGTAA	1	bc
GCAGCTGCGC	GAAACACCGGTCGGCGGCAATCGTGGGGTGGGGTTAGAGCTAGAAATAGC	1	bc
CGCGTCATTT	GAAACACCGGTCTCGTTGGGGTTGGTCATAGAGCTGGTAATGCCAGGTTA	1	bc
ATGATCGTCC	GAAACACCGGTGGGGCTGAGAGTCCGGCAATGGTGTGGCTGTGGGGATAG	1	bc
TCGTGACCTA	GAAACACCGGTCGTTATCAACTCATGGAACGTGGGGTTAGAGCTAGAAAT	1	bc
AGAGGAGCGC	GAAACACCGGTGCATTCGCAAGTCCGGTCGTGGTATGGACGTGGAGTTAG	1	bc
TCTAGTGATC	GAAACACCGGTGAACTTTGTAAGTGAGTGAGGGTGGGGATAGGGATAGCG	1	bc
TGGAGATGCT	GAAACACCGGTGAAACTTGGAGAGAAGTGATGTTAGAGCTAGAAATATCA	1	bc
GGCACGGACC	GAAACACCGGTAGCAAGTGCGAGACATGTTAAATAGCAAGTTAACCTAAG	1	bc
GTAGAGGAGC	GAAGCCCCGGTGGGGTTAGAGCTAGAAATAGCAAGTTAACCTAAGGCTAG	1	bc
GTGGTCGACC	GAAACACCGGTTCCCTTGTTGATGCTGTGTGGAGCTAGAAATAAAGATAA	1	bc
TGAGCCATCC	GAAACACCGGTGTGGCTGAGAGTCCGGCAATGGAGTGGCTGTGGGGTCAG	1	bc
TGATCCCTCC	GAAACACCGGTGTGGCTGAGAGTCCGGCAATGGTGTGGCTGTGGGGTTAG	1	bc
ACCTTTACAG	GAAACACCGGTCGGGGCCACTCAGTGGTGGGGTTAGAGCTAGAAATAGCA	1	bc
GCGTGGCGTC	GAAACACCGGTTCCCGTCCAGTGGGGTTAGAGCTAGAAATAGCAAGTTAA	1	bc
TTGTTCATTA	GAAACACCGGTTAAGCCGAGTGGGGTTAGAGCTAGAAATAGCAAGTTAAC	1	bc
GAGAACGCCG	ATGGGGGGTTAGACCTAGAAATAGCAAGTTAACCTAAGGCTAGCCCGTTA	1	bc
ATGATTGGGT	GAAACACCGGTTTACGTTGCATCGGTGTGGGGTTAGAGCTAGAAATAGCA	1	bc
GCGAAGCGTC	GAAACACCGGTTCCCATCCAGTGGGGTTAGAGCTAGAAATAGCAGGTTAA	1	bc
GTTGAGTGTA	GAAACACCGGTTAAGCCGAGTGGGGTTAGAGCTAGAAATAGCAAGTTAAC	1	bc
ACGTGTTGTG	GAAACACCGGTGACATTGGGTACAGGGGGGTGGGGTTAGAGCTAGAAATA	1	bc
CGTGATGGCC	GAAACACCGGTGACATTGGGTAGTGGGGTTAGAGCTAGAAATAGCAAGTT	1	bc
ACATTTACCG	GAAACACCGGTCGGGGCCACTCAGTGGTGGGGTTAGAGCTAGAAATAGCA	1	bc
AGACACGGAC	GAAACACCGGTAGCAAGGTGCTTTTTTTCCTGCAGGTGTCCGTGTCGAAT	1	bc
GCCACAAAAC	GAAACACCGGTTGCAAGTGTTAGATCGGTTAAGTAGCGAGATAACTTGCA	1	bc
GGGGGGACTC	GAAACACCGGTTCCCGTCCAGTGGGGTTAGAGCTAGAAATAGCAAGTCAA	1	bc
AATACTCGGC	GAAACACCGGTACCTTTGTTGATGCTGGGTGGAAGGAATGTGGGGTTAGG	1	bc
CCTAAAGACC	GAAACACCGGTTTGAACTACCTAGTAGCAAGTTAACCTAAGGCTAGTCCG	1	bc
AGAACTTATA	GAAACACCGGTAACTATATTCATGCGATATCGCCGTATCAGTGGGGTTAG	1	bc
CTGTCTAGAG	GAAACACCGGTGTACGTTGCATTGGTGGGGGGTTAGAGCTAGAAATAGCA	1	bc
CACAGTCTTG	GAAACACCGGTCTCGAGTGAGGTGTTCAGGGGGGGGGTAGAGCTAGAAAT	1	bc
GGTGACGCTC	GAAACACCGGTCGGCGGCAATCGTTAATCGGTTAATCGTGGGGTTAGAGC	1	bc
AATTTTCGTC	GAAACACCGGTTTACGTATGGACTGAACCAGGGTGTGCAAGTGGGGTTAG	1	bc
GTGGACACGC	GACCGGTGTTTCGTGGGGTTAGAGCTAGAAATAGCAAGTTAAACTAAGGC	1	bc
GAATTCGGTC	GAAACACCGGTCGATTGCTATCGAAAGCTTCCCGTAACAGGGTGATTAGA	1	bc
AGGGTCCCTC	GAAACACCGGTGTGGCTGAGATTCCGTCAGGGGTGTGGATGGGGGGTTAG	1	bc
CGGCTCTGCT	GAAACACCGGTCTTTGGAGCAACCTATCGGGTGGGGTTAGAGCTAGAAAT	1	bc
AATGCTTTGC	GAAACACCGGTTTACGTTGCATCGGTGTGGGGTTAGAGCTAGAAATAGCA	1	bc
ACGGCCCTAA	GAAACACCGGTGACCCTACTCTCACCTGATTACTTAATCCGTGGTGTTAG	1	bc
ATGATTAACA	GAAACACCGGTTTACGCTGCATCGGTGTGGGGTTAGAGCTAGAAATAGCA	1	bc
CTGCTTCGTT	GAAACACCGGTTTCGGGTGAATCGGTCTGGGGTGAGTTCTAGCAATAGAT	1	bc
ACTTTCGCGC	GAAACACCGGTCAGATTCGCTCAGTGGTGGGGTTAGAGCTAGAAATAGCA	1	bc
TGTGGCGCCT	GAAACACCGGTTCCCGTCCAGTGGGGTTAGAGCTAGAAATAGCAAGTTAA	1	bc
AGGACCCTAC	GAAACACCGGTAAATTTGAGGCTCCGGCATGCAGGAGGCCGTGGGGTTAG	1	bc
GGCTGCCGGC	GAAACACCGGTGACGCTGAGAGTCCGGCGATGGTGTGGCTGGGGGGATAG	1	bc
CTCCCCTGAA	GAAACACCGGTGTGGCTGAGAGTCCGGCAATGGTGTGGCTGTGGGGTTAG	1	bc
GAAATTCGGG	GAAACACCGGTCGATTCATATCGAAACCTTCCCGTGACAGTGGGGTTAGA	1	bc
GGAGAGCCGA	GACCGGCGTTTCGTGGGGTTAGAGCTAGAAATAGCAAGTTAACCTAAGGC	1	bc
GGCAGCCGCT	GAAACACCGGTAAATATGAGGCTCCGGCATGCAGGAGGCCGTGGGGTTAG	1	bc
ACACTCTGTC	GAAACACCGGTCCATTCGAAACGCCAGCCGTCGTGTAGACGGGGGGTTAG	1	bc
CACATCGAGC	GAAACACCAGTTTAGAGCTAGAAATAGCAAGTTTACCTATGGCTATTCCG	1	bc
ACTAGCGTAC	GAAACACCGGTTAGATTTTGAGGAGTGTGGGGTTAGAGCTAGCTAGAGAA	1	bc
GACGAGCTAC	GAAACACCGGTGCCCTTACTCTCACCTGATTACTTAATCCGTGGGGTTAG	1	bc
AAATTTAGCT	GAAACACCGGTCGGGGCCACTCAGTGGTGGGGTTAGAGCTAGAAATAGCA	1	bc
GGAGGCTCGC	GAAACACCGGTCAGCGGCAATCGTGGGTGGGGTTAGAGCTAGAAATAGCA	1	bc
CTTGAATCGT	GAAACACCGGTCTCGAGTGAGGTGTTCAGGGTGGGGTTAGAGCTAGAAAT	1	bc
TTAGGTATAA	GAAACACCGGTTACGCTGGGGGTTAGAGCTAGAAATAGCCAGTTAAACCA	1	bc
TACCCACTCC	GAAACACCGGTGTGGCTGAGAGTCCAGCAATGGTGTGGCTGTGGGGTTAG	1	bc
AAACTTCGAC	GAAACACCGGTAACTATATTCATGCGATATCGCCGTATCGTGGGGTTAGA	1	bc
GAACACACGT	GAAACACCGGTCGACGGCACTCGTGGGGTGGGGTTAGAGCTAGAAAAAGC	1	bc
AATCGGGGTC	GAAACACCGGTGTACGTATGGACTGACCAGGGTGTGCAAGTGGGGTTAGA	1	bc
AGCTTGACCG	GAAACACCGGTCGGGGCCACTCAGTGGTGGGGTTAGAGCTAGAAATAGCA	1	bc
AGATTCTGGC	GAAACACCGGTTTATTCGAAAGTCCGGTCGTAGTGTGGCCGTGGATATAG	1	bc
AAGGCATGCC	GAAACACCGGTCCCTTTACTCTCACCTGATTACTTAATCCGTGGGGTTAG	1	bc
TTGGAGATGC	GAAACACCGGTTACCTTCCAGTGGGGTTATTGCTAGTAATAACAAGTCAT	1	bc
AGCAGATCCG	GACCGGTGTTTCGTGGGGTTAGAGCTAGAAATAGCAAGTTAACCTAAGGC	1	bc
AGAGCCTCTA	GAAACACCGGTGCATTCGAAAGTCCGGTCGGAGTGTGGACGTGGGGTTAG	1	bc
TCGAATCCGC	GAAACACCGGTCTCGAGTGAGGTGTTCAGGGTGGGGTTAGAGCTAGAAAT	1	bc
AAACGCCATA	GAAACACCGGTGCCCTTACTCTCACCTGATTACTTAATCCGTGGGGTTAG	1	bc
GAGGTGAGTC	GAACCACCGGTTCCCGTCCTGTGGGGTTAGAGCTAGAAATAGCAAGTTAA	1	bc
AGAACCGCGA	GAAACACCGGTGCATTCGAAAGTCCGGTCGTAGTGTGGACGTGGGGTTAG	1	bc
AACTTTACCG	GAAACACCGGTCGGGGCCACTCAGTGGTGGGGTTAGAGCTAGAAATAGCA	1	bc
TGTCTGCTTA	GAAACACCGGTCCGTAGGAGACCCGTGTGGCATGTACCTGTGGGGTTAGA	1	bc
AAGCGAAGTT	GAAACACCGGTTTACGTTTCATCGGTGTGGGGTTAGAGCTAGAAATAGCA	1	bc
AGAATACAAC	GAAACACCGGTAAATTTGAGGCTCCGGCATGCAGGTGGCCGTGGGGTTAG	1	bc
AAGACCCCCG	GAAACACCGGTGCATTCGAAAGTCCGGTCGTAGTGTGGACGTGGGGTTAG	1	bc
TAACTCGTGT	AGCTAGAACTGGCAAGTTAACCTACGGGTAGTCCGTTGTCAACTGGGACA	1	bc
CGGAACCTTG	GAAACACCGGTCTCGAGCGAGGTGTTCAGGGTGGGGTTAGAGCTAGGAAT	1	bc
AGACACGGAC	GAAACACCGGTAGCAAGTGCGAGACGTGTTAAATAGCAAGTTAACCTAAG	1	bc
GTGATCCTTT	GAAACACCGGTCTCGAGTGAGGTGTTCAGGGTGGGGTTAGAGCTAGAAAT	1	bc
ACCTTCACGT	GAAACACCGGTCTATGAATATACTAATCCAGCTGGGGCAGTGCGGGAAAG	1	bc
CCCCAAGGCA	GAAACACCGGTTTGAACTAGAAATAGCAAGTTAACCTAAGGCTAGTCCGT	1	bc
GCACAGCGCA	GAAACATAGCAAGTTAACCTAAGGCTAGTCCGTTATCAACTTGAAAAAGA	1	bc
TAACCCTGCC	GAAACACCGGTAAATTTGAGGCTCCGGCATGCAGGAGGCCGTGGGGTTAG	1	bc
AGGCCCCCTC	GAAACACCGGTGTGGCTGAGAGTCCGGCAATGGTGTGGCTGTGGGGTTAG	1	bc
GGTATGCTCC	GAAACACCGGTGTGGCTGAGAGTCCGGAAATGGTGTGGCTGTGGGGCTAG	1	bc
TCCCTTTCCG	GAAACACCGGTCGGGGCCACTCAGTGGTGGGGTTAGAGCTAGAAATAGCA	1	bc
ACGAGAGAGG	GAAACACCGGTTATATTTGTTAGTGCGTGGGGTTAGAGCTAGAAATAGCA	1	bc
CGACACTTAC	GAAACACCGGTGCCTTCGCAAATACGTGCGTAGTGGGTACAGGGAGTTAT	1	bc
AAGCTGGGGG	GAAACACCGGTTATATTTAACACTGAGTGGGGTTAGAGCTAGAAATAGCA	1	bc
CAGAATACCC	GAAACACCGGTTTCCATTACCTAGTTGAAAGAGCTGGGATTAGAACGATA	1	bc
GCATTTACAG	GAAACACCGGTCGGGGCCACTCAGTGGTGGGGTTAGAGCTAGAAGTAGCA	1	bc
TTAGATCTTT	GAAACACCGGTTACATTGCAATTGGGGTAAGAGTTAGAAATAGCAAGTTA	1	bc
AGGCAGTCTC	GAAACACCGGTCCGTAGGAGACCCGTGTGGCATGTACCTGTGGGGTTAGA	1	bc
TTAGCCACGC	GAAACACCGGTTCCCTCGAGAATCCCGTCGTGTTGGGGATGGGAGGATAG	1	bc
TCTACCGGTT	GAAACACCGGTTATATTTTTGGGGTTAGAGCTAGAAATAGCACTTTAACC	1	bc
AAACGCTCTA	GAAACACCGGTGCCCTTACTCTCACCTGATTACTTAATCCGTGGGGTTAG	1	bc
ACAGAGCCGC	GAAACACCGGTCGGTGGCAATCGCGGGAGCTAGAAATAGCAAGTTAACCT	1	bc
ACTTGACCGA	GAAACACCGGTTAGAGCTAGAAATAGCAAGTTAACCTAAGGATAGTCCGT	1	bc
TAACTGCTCT	GAAACACCGGTTCATTGGAACGTCGGGACGTGGCTGGGACGTGGGGCTAG	1	bc
GAAGAAATGC	GAAACACCGGTCGGCGGCCGGTTAGAGCTAGAAATAGCGAGTTAACCTAA	1	bc
CACAGCATAA	GAAACACCGGTTAAGCCGAGGAGTTAGAGCTAGAAATAGCAAGTTAACCT	1	bc
AATGATTAGG	GAAACACCGGTTTACGTTGCATCGGTGGGGGGTTAGAGCTAGAAATAGCA	1	bc
TGCCCATACC	GAAACACCGGTAAATTTGAGGCCTCGGCATGCATGAGGCCGGGGGGATCG	1	bc
GAAGTAGCGC	GAAACACCGGTCGGTGGGGTTAGAGCTAGAAATAGCAAGTTAACCTAAGG	1	bc
AAGGAACCGC	CAAAACACCGGTCGGCGGCAATCGTGCTAGAAATAGCAAGTTAACCTAAG	1	bc
GCTTCAGCCC	GAAACACCGGTAGCAAGCTAACCTAAGGCTAGTCCGTTCTCAACTTGACA	1	bc
CGTATTGTGG	GAAACACCGGTGATATTGGGTAAAATATCAAGTTAACCTAAGGCTAGTCC	1	bc
CACGCACTCC	GAAACACCGGTGCCCTTACTCTCACCTGATTACTTAATCCGTGGGGTTAG	1	bc
ACACTGCATA	GAAACACCGGTAAGTATGTGCCCCGGGTGACATGTACCTGTGGGGTTAAA	1	bc
ATAAGGATAA	GAAACACCGGTTAAGCCGAGTGGGGTTAGAGCTAGAAAAAACAAGGTAAC	1	bc
TCCAATCCTT	GAAACACCGGTCTCGAGTGAGGTGTTCAGGGTGGGGTTAGAGCTAGAAAT	1	bc
CAGTGGAGCC	GAAACACCGGTTCCCGTCCAGTGGGGTTAGAGCTAGAAATAGCAAGTTAA	1	bc
GTGAGCGTCA	GAAACACCGGTTCAGCCGAGTGCGGGTAGAGCTAGAAGTAGCAAGTTAAC	1	bc
ACGAGTTGGC	GAAACACCGGTACCTTTGTTGATGCTGGGTGGAAGGATGCTGGGTGGGGT	1	bc
CCCAACGCTT	GAAACACCGGTTTGAACTAGAAATAGCAAGATAACCTAAAGCGAGTCCGT	1	bc
CACGACCTAT	GAAACACCGGTGCCCTTACTCTCACCTGATTACTTAATCCGTGGGGTTAG	1	bc
CACAAGGGGG	GAAACACCGGTTTGAACTGGATATAGCAAGGTAACCTAAGACTAGTCCGA	1	bc
CATAGGCGGC	GAAACACCGGTGTGCGTATGGACTGAACCAGGGTGTGCAAGTGGGGTTAG	1	bc
CGCATCATCT	GAAACACCGGTCTCGAGTGAGGTGTTCAGGGGTGGGGTTAGAGCTAGAAA	1	bc
GAATTCCGTT	GAAACACCGGTCGATTCATATCGAAACCTTCCCGTGACAGTGGGGTTAGA	1	bc
GACCCCCTTC	GAAACACCGGTGCCCTTACTCTCACCTTATTACTTAATCCATGGAGATAG	1	bc
TCCTTTATCG	GAAACACCGGTCGGGGCCACTCAGTGGTGGGGTTAGAGCTAGAAATAGCA	1	bc
GAGACCCACG	GAAACACCGGTGCATTCGAAAGTCCGGTCGTAGTGTGGACGTGGGGATAG	1	bc
ACCCAACGCC	GAAACACCGGTTTGAACTACCTAGTTAGAGCTAGAAATAGCAAGTTAACC	1	bc
AGTGGAGCTT	GAAACACCGGTTCCCGTCCAGTGGGGTTAGAGCTAGAAATAGCAAGTTAG	1	bc
ACCTCTACCG	GAAACACCGGTTGGGGCCACTCAGCGGGGGGGCTAGAGCTAGAAATAGCA	1	bc
AAATACTTGC	GAAACACCGGTGCGTACCAAAGTGCGCTAGTAGCGTAGTTGTGGGGTTAG	1	bc
GACAACCCAC	GAAACACCGGTCGGCGGCAATCGTTAATCGGTTAATCGTGGGGTTCGAGC	1	bc
GTGGCGTCGC	GAAACACCGGTTGTGGCACCTTCAGGGTAGGGCTAGAAATAGCAATATAA	1	bc
ACTCGGTGTC	GAAACACCGGTGTACGTATGGACTGAACCAGGGTGTGCAAGTGGGGTTAG	1	bc
ACACAACGCA	GAAACACCGGTTTGAACTAGAAATAGCAAGTTAACCTAAGGCTAGTCCGT	1	bc
ACTTTAGCGT	GAAACACCGGTCGGTGCCACTCAGTGGTGGGGTTAGAGCTAGAAATAGCA	1	bc
CGATAGTTGT	GAAACACCGGTTAGAGCTAGAAATAGCAAGTTAACCTAAGGCTAGTCCGT	1	bc
GCCAGCCGCT	GAAACACCGGTGAACGGATAGATTGAACCATGGTGGACAAGTGGGGTTAG	1	bc
TATTTATGGC	GAAACACCGGTCGGTGCCACTCAGTGGCGGGGGTAGAGCTAGCAATAGCA	1	bc
TCTTGACTGC	GAAACACCGGTCGGGGCCACTCAGTGGTGGGGTTAGAGCTAGAAATAGCA	1	bc
AACAACGGTC	GAAACACCGGTTTGAACTACCTAGTTCAAACGGTGGGGTTAGAGCTAGAA	1	bc
AGTGTAGCCT	GAAACACCGGTTCCCGTCCAGTGGGGTTAGAGCTAGAAATAGCAAGTTAA	1	bc
GAGGAGGATC	GAAACACCGGTTCCCGTCCAGTGGGGTTAGAGCTAGCAATAGCAAGTTAA	1	bc
TGGACCCATG	GAAACACCGGTGTGTTTGAGAGTCCGGTAGTGGTGTGGCTGTGGGGTTAG	1	bc
CATAGCTGTC	GAAACACCGGTGTACGTATGGACTGAACCAGGGTGTGCAAGTGGGGTTAG	1	bc
AGTCGATCGC	GAAACACCGGTGCATTCGAAAGTCCGGTCGTAGTGGGGATGGGGGGTTAA	1	bc
ACTTTTGCGC	GAAACACCGGTTGGTGCCACTCAGAGGTGGGGGTAGAGCTAGAAAGAGCG	1	bc
TTGCGCTTAC	GAAACACCGGTTAAGCCGAGTGGGGTTAGAGCTAGAAATAGCAAGTTAAC	1	bc
CTGCTTCGGT	GAAACACCGGTTTACGTTGCATCAGATAGAGCTTGGAGTAAGAAGTTGAC	1	bc
AAAAGCCCTA	GAAACACCGGTGCCCTTACTCTCACCTGATTACTAGAAGCTAGAAATAGC	1	bc
AGTCGGACGC	GAAACACCGGTCCGTAGGAGACCCGTGTGGCATGTACCTGTGGGGTTAGA	1	bc
GGAGCCGCGC	GAAACACCGGTGCATTCGACATCCCGGTCGTAGTGTGGACGGGAGGATAG	1	bc
CTACTGAGGC	GAAACACCGGTACCTGTGGTGGTGCTGGGTGGGTATAGAGCTAGATATAG	1	bc
GGACGCAGAC	GAAACACCGGTAGCAAGTGCGAGACGTGTTTTTGTGGGGTTAGAGCTAGA	1	bc
AATAACGCTC	GAAACACCGGTACCTTTCTTGATGCTGGGTGGCAGGGCATGAGCTAGTAA	1	bc
CAGAGCACCC	GCTAGAAATAGGATTAAAACCTAAGGCTAGTCCGGTTACAACTTGAAATA	1	bc
TGAGAGCCCC	GAAACACCGGTCGGCGGCAATCGTGGGTGGGGTTAGAGCTAGAAATAGCA	1	bc
GGCGCCATCA	GAAACACCGGTGTGGCTGAGAGTCCGGCAATGGTGTGGCTGTGGGGTTAG	1	bc
ACATTATGGT	GAAACACCGGTAGACCCTGTTGCTTCGTGGGGTTAGAGCTAGAAATAGCA	1	bc
GATGGCCGGC	GAAACACCGGTCGGCGGCAATCGTGGGAGCTAGAAATAGCAAGTTAACCT	1	bc
AGATCGTCGT	GAAACACCGGTGTACGTATGGACTGAACGAGGATGTGCAAGTGGGGTTAG	1	bc
GGGACCCGCA	GAAACACCGGTGTGGCTGAGAGTCCGGCAATGGTGTGGCTGTGGGGTTAG	1	bc
CGTCATGTCC	GAAACACCGGTGCCTTTGGATGGAGCTAGCGCTAGAATTGGGATAGTAAC	1	bc
TCCTTTACCT	GAAACACCGGTCGGGGCCACTCAGTGGTGGGGTTAGAGCTAGAAATAGCA	1	bc
AACAAAGCAC	GAAACACCGGTTTGAACTAGAAATAGCAAGTTAACCTAAGGCTAGTCCGT	1	bc
ACTCTTCGCT	GAAACTAACCTAAGGCTAGTCCGTTCTCAACTTTAAAGATTGGCACCGAG	1	bc
CACCGTGGCC	GAAACACCGGTGCCCTTATGGACTGAAGCAGGGAGGGAAAGTGGGGTTAG	1	bc
AGCCTCTAGC	GAAACACCGGTGCATTCGAAAGTCCGGTCGTAGTGTGGACGTGGGGTTAG	1	bc
TCGGGTTGTT	GAAACACCGGTGACATTGGGTACCCCTACCCTAGAAATAGCAAGTTAACC	1	bc
CTCCCCTGCA	GAAACACCGGTGTGGCCGAGAGTCCGGCAATGGTGTGGCTGCGGGGTTAG	1	bc
CATAGTAGGC	GAAACCCCGGTGTACGTATGGACTGACCCAGGGTGTGCAAGTGGGATTAG	1	bc
TGTCGTCCTC	GAAACACCGGTCCGTAGGAGACCCGTGTGGCATGTACCTGTGGGGTTAGA	1	bc
GCATCCGCTT	GAAACACCGGTCGAATCATATCGAAACCTTCCCGTGACAGTGGGGTTAGA	1	bc
CACAGTGCTC	GAAACACCGGTTTGAACTAGAAATAGCAAGTTAACCTAAGGCTAGTCCGT	1	bc
ATACGCACTA	GAAACACCGGTGCCCTTACTCTCACCTGATTACTTAATCCGTGGGGTTAG	1	bc
ACACTTCCTC	GAAACACCGGTAACTATATTCATGCGATATCGGTTAGAGCTAGAAATAGC	1	bc
GAGACAGGCT	GAAACACCGGTAGCAAGTGCGAGCAAGTTTTTGGGGTTAGAGCTAGAAAT	1	bc
TCTACTCGGT	GAAACACCGGTACCTTCGTTGATGCTGGGTGGAAGGAATTTTTGTGGGGT	1	bc
CATCTCGAGG	GAAACACCGGTTATATATATAATAGCAAGTTAACCTAAGGCTAGGCCGGT	1	bc
CGACACCTTC	GAAACACCGGTCTCGGGTGAGGCGTTCAGGGTGGGGTTGGAGCTAGAAAT	1	bc
AGACAGTCGT	GAAACACCGGTGCATTCGAAAGTCCGGTCGTAGTGTGGACGTGGGGTTAG	1	bc
AGACTCAGAC	GAAACACCGGTAGCAAGTGCGAGACGTGTTTGTGGGGTTAGAGCTAGAAA	1	bc
TCTACCGAAC	GAAACACCGGTTCTCTTACTCGCACTTGAGTTCTAAATCGCAAGGTAAAC	1	bc
ACCCTGGGCC	GAAACACCGGTAAATTTGAGGCTCCGGCATGCAGGAGGCCGTGGGGTTAG	1	bc
CAGAGCAGAA	GAAACACCGGTTAAGCCGAGGACTGGAGCTAGCGATAGCACGTCAACCTA	1	bc
GGCGGGGGCT	GAAACACCGGTTCCCGTCCAGTGGGGTTAGAGCTAGAAATAGCAAGTTAA	1	bc
GTCAGCGTTA	GAAACACCGGTAGAGAGGGCGAGAGGTGTTTGTGGGGATAGCGCTAGAAC	1	bc
GAAGTCGGGT	GAAACACCGGTCGGTTCATATCGAAACCTTCCCGTGACAGTTGGGGTAGA	1	bc
ACTGAGCATA	GAAACACCGGTTAAGCCGAGGAGTTTCGTTAGAGCTAGAAATAGCAAGTT	1	bc
AAAGCAATAC	GAAACACCGGTGCCCTTACTCTCACCTGATTACTTAATCCGTGGGGTTAG	1	bc
CTAATCGGAA	GAAACACCGGTACCTTTGTTGATGCTGGGAGGAAGGAATTTTGTGGGGTT	1	bc
GAGCGTATAC	GAAACACCGGTAACTATATTCATGCGATATCGCCGTATCAGTGGGGTTAG	1	bc
AGAATGGAGG	GAAACACCGGTTATATTTATGCGCGGGGTTTGATCTAGATATAGCAAGTT	1	bc
ATCGCCATAT	GAAACACCGGTTAACTTGCTCTCACTAGAGTTATTAATAGGAGGGTAAAC	1	bc
ACCTCTACCG	GAAACACCGGTCGGGGCCACTCAGTGGTGGGGTTAGAGCTAGAAATAGCA	1	bc
CACCTTTAAC	GAAACACCGGTCGGGGCCACTCATGGGGTTAGAGCTAGAAATAGCAAGTT	1	bc
GATAAAGACC	GAAACACCGGTAGCAAGTGCGAGACGTGTTTGTGGGGTTAGAGCTAGAAA	1	bc
GCTATAGACA	GAAACACCGGTAGCAAGTGCGAGACGTGTTAAATAGCAAGTTAACCTAAG	1	bc
GCTCACGAGG	GAAACACCGGTTATATTTGTAAGTGTGTGGGGTTAGAGCTAGAAATCGCA	1	bc
ATTGCGCATA	GAAACACCGGTTAAGCCGAGGAGTTTCGTTAGAGCTAGAAATAGCAAGTT	1	bc
TAGCTATTTC	GAAACACCGGTTACATTGAGATTGGGGTTAGAGCTAGAAATAGCAAGTTA	1	bc
TCGAATCCCC	GAAACACCGGTCTCGAGTGAGGTGTTCAGGGTGGGGTTAGAGCTAGAAAT	1	bc
AGTCTGATAC	GAAGCACCGGTGCGTAGGAGACCCGTGCGGCATGGAGCTGGGGGGGTAGA	1	bc
CTCCCTTGCA	GAAACACCGGTGTGGCTGAGAGTCCGGCAATGGTGTGGCTGTGGGGTTAG	1	bc
CACGCACTTC	GAAACACCGGTGCCCTTACTCTCACCTGATTACTTAATCCGTGGGGTTAG	1	bc
CCACTACGGC	GAAACACCGGTCGGGGCCACTCAGTGGTGGGGTTAGCGCTAGAAATAGCA	1	bc
GTAGATCGGC	GAAACACCGGTCGGCGGCAATCGTGGTATGAGCCACGTGGGGTTAGATCG	1	bc
ACCTTCTGTA	GAAACACCGGTCGATTCATATCTACACCATCCAGTGAGCCGTGGGGTTAG	1	bc
CGCCACCTCC	GAAACACCGGTGTGGCTGAGAGTCCGGCAATGGTGTGGCTGTGGGGTTAG	1	bc
AGGGGAGCCT	GAAACACCGGTTCCCGTCCAGTGGGGTTAGAGCTAGAAATAGCAAGTTAA	1	bc
GAAATCAACC	GAAACACCGGTAACTATATTCATGCGATATCGCCGTATCAGTGGGGTTAG	1	bc
GTGGGGCATA	GAAACACCGGTTCCTGTCCAGTGGGGGTAGAGCGAGATATAGCAAGTTAA	1	bc
AACAGAGCCC	GAAACACCGGTTTGAACTAGAAATAGCAAGTTAACCTAAGGCTAGTCCGT	1	bc
CTAATCGGTT	GAAACACCGGTCTCGTTGGTGGTGCTCAGGGGGGGGATTTAGCTATAGAG	1	bc
GGTACACTTC	GAAACACCGGTTTGGCTGAGAGTCCGGCAAGGGTGTGGCTGTGAGGTTAG	1	bc
GTCAGCGTCA	CAAAACACCGGTTAAGCCGAGGAGTTAGAGCTAGAAATAGCAAGTTAACC	1	bc
ACTCGCAGTC	GAAACACCGGTGTACGTATGGACTGAACCAGGGTGTGCAAGTGGGGTTAG	1	bc
TGTGGAGCAT	GAAACACCGGTTCCCGTCCAGTGGGGTTAGAGCTAGAAATAGCAAGTTAA	1	bc
GAACGCACTA	GAGACACCGGTGCCCTTACTCTCACCTGATTACTTAATCCGTGGGGTTAG	1	bc
CGACTCTGTT	GAAACACCGGTCTCGAGTGAGGTGTTCAGGGTGGGGTTAGAGCTAGAAAT	1	bc
ACCTGTACGG	GAAACACCGGTCGGGGCCACTCAGTGGTGGGGTTAGAGCTAGAAATAGCA	1	bc
CGTGACGCCA	GAAACACCGGTGACATTGGGAGTGGGGTAAGAACTAGAAATAGCAAGTTA	1	bc
AGACACGAGA	GAAACACCGGTGCATTCGAAAGTCCGGTCGTAGTGTGGACGTGGGGTTAG	1	bc
GACTTTACCG	GAAACACCGGTCGGGGCCACTCAGTGTGGTGGGGTTAGAGCCAGAAATAG	1	bc
GTATACAGGC	GAAACACCGGTTAAGGGCATATGAGGGCGGGAATTGATGTGTGGGGTTAG	1	bc
TCCTTTAACG	GAAACACCGGTCGGGGCCACTCAGTGTGGGGTTAGAGCTAGAAATAGCAA	1	bc
AACGATTTAC	GAAACACCGGTCCCCTTACTCTCACCTGATTACTTAATCCGGGGGGTTAG	1	bc
GCAGAATCGC	GAAACACCGGTCTGCGGCAATCGTGGGTGGGGGTAGAGCTAGAAATAGCA	1	bc
TGGCTTCTAG	GAAACACCGGTAACTATATTCATGCGATATCGCCGGATCAGTGGGGTTAG	1	bc
AGGCACTCTC	GAAACACCGGTGTGGCTGAGAGTCCGGCAATGGTGTGGCTGTGGGGTTAG	1	bc
CATATAGCTC	GAAACACCGGCTTGAACTCGAAATAGCAAGTTTACCTAAGGCTAGTCCGT	1	bc
TGTATCCTGC	GAAACACCGGTTATATTGGTAATTGGGGTTTGAGCTAGAAATAGCAATTT	1	bc
TGAAGACCAG	GAAACACCGGTCGGCGGCAATCGTGGTATGAGCCACGTGGGGTTAGATCG	1	bc
GAACGCACTA	GAAACACCGGTGCCCTTACTCTCACCTGATTACTTAATCCGTGGGGTTAG	1	bc
AGTGTTTGCT	GAAACACCGGTGACATTGGGTGTGGGGTTAGAGCTAGAAACAGCAAGTTA	1	bc
TTGCGCATCT	GAAACACCGGTTTACCCGAGGAGGTAGAGCTAGAAGTAGCAGGTTAACCT	1	bc
TGACGCCATA	GAAACACCGGTATCAGGAGCGGGACGCGTTAGAGGTAGAAATCGCAAGTT	1	bc
GCCACAGCCC	GAAACACCGGTAGCAAGTGCGAGACGTGTTTGTGGGGTTAGAGCTAGAAA	1	bc
GACAATGCTC	GAAACACCGGTTTGAACTAGAAATAGCAAGTTAACCTAAGGCTAGGCTGT	1	bc
TAACGCTCCA	GAAACACCGGTGCCCTTACTCTCACCTGATTACTTAATCCGTGGGGTTAG	1	bc
CTACTCGCGA	GAAACACCGGTACCTTTGTTGATGCTGGGGGGAAGGAGTTATGTGGGGTT	1	bc
GCACTCCGCC	GAAACACCGGTGCATTCGAAAGTCCGGTCGTAGTGTGTACGGGCGGTTAG	1	bc
CCGTTACGCC	GAAACACCGGTCGGGGCCACTCAGTGGTGGGGTTAGCGCTAGAAATAGCA	1	bc
ACGAATACTT	GAAACACCGGTCTCGAGTGAGGTGTTCAGGGTGGGGTTAGAGCTAGAAAT	1	bc
ATACTGGGGC	GAAACACCGGTACCTTTGTTGATGCTGGGTGGAAGGATTTTTGTGGGGTT	1	bc
CCTATAGCGG	GAAACACCGGTCGGGGCCACTCAGTGGTGGGGTTAGAGCTAGAAATAGCA	1	bc
GAATACCACC	GAAACCCCGGTCGGCGGCAATCGTGGTAGAGCTAGAAATAGCAAGTTAAC	1	bc
CCCTAAGCAC	GAAACACCGGTTTGAACTACCTAGGGGGAAATAGCAAGTTAACCTAAGGC	1	bc
TGTAGACCCG	GAAACACCGGTCGGCGGCACGGTGGGGTTAGAGCTAGAAATAGCAGGTTA	1	bc
GCACAATGCC	GCTAGAAATAGCAAGTTAACCTAAGGCTAGTCCGTTATCAACTTGAAAAA	1	bc
ATGCAGTCTC	GAAACACCGGTTCCCGTCCAAGGGGGGTAGAGCTAGAAATAGCAAGTTAA	1	bc
CAGTGGTGCT	GAAACACCGGTTCCCGTCCAGTGGGGTTAGAGCTAGAAATAGCAAGTTAA	1	bc
CCCTTAGGTA	GAAACACCGGTCGATTCATATCCAAACCTTCCCGAGACAGAGGGGATGCA	1	bc
AGACTGGGTC	GAAACACCGGTACCTTTGTTGATGCTGGGTGGGGTTAGAGCTAGAAATAG	1	bc
AAACCTCGGC	GAAACACCGGTGCATTCGAAAGTCCGGTCGTAGTGTGGACGTGGGGTTAG	1	bc
ACTCCTCGGC	GAAACACCGGTACCTTTGTTGATGCTGGGTGGAAGGGCTAGAAATAGCAA	1	bc
AGACACGGAC	GAAACACCGGTAGCAAGTGCGAGCAAGTGTGGGGTTAGAGCTAGAAATAG	1	bc
TGTAGAAACG	GGCAAGTTAACCTAAGGCTAGTCCGTTATCAACCTGAAAAAGTGGCACCG	1	bc
GTCACAATCA	GAAACACCGGTAGCAAGTGCGAGACTTTTGTGGGGTTAGAGCTAGAAATA	1	bc
ACACCACGCC	GAAACACCGGTTTGAACTAGAAATAGCAAGTTAACCTAAGGCTAGTCCGT	1	bc
GGCCGCTGCT	GAAACACCGGTTAATTTGAGACTCCGGCATGCATAAGGGCGTGGGGTTAG	1	bc
TCTATAGGCG	GAAACACCGGTTATATTTGTAAGTGGGGTTAGAGCTAGAAATAGCAAGTT	1	bc
AAAACCATCT	GAAACACCGGTGCATTCGAAAGTCCGGTCGTAGTGGGGACGTGGGGTTAG	1	bc
AGACTGAATC	GAAACACCGGTCCGTAGGAGACCCGTGTGGCATGTACCTGTGGGGTTAGA	1	bc
AAACGTATCC	GAAACACCGGTAACTATATTCATGCGATATCGCCGTATCAGTGGGGTTAG	1	bc
ACCTTTCCCG	GAAACACCGGTCGGGGCCACTCAGTGGGTGGGGTTAGAGCTAGAAATAGC	1	bc
ACACACTGGC	GAAACACCGGTGCATTCGAAAGTCCGGTCGTAGTGTGGACGTGGGGTTAG	1	bc
ACGGGTTGTC	GAAACGCCGGTGACATTGGGTACGGGTTAGAGCTAGAAATAGCAAGTTAA	1	bc
CTTTAACGCC	GAAACACCGGTCGGGGCCACTCAGTGGTGGGGTTAGAGCTAGAAATAGCA	1	bc
CTATGGAGGT	GAAACACCGGTAACTTAGTTTACGCTGGGGGGATGGGCTTGAAATAACAA	1	bc
CCGTTACTGT	GAAACACCGGTCGGGGCCACTCAGCGGTGGGGTTAGAGCTAGAAAGAGCA	1	bc
CGGGTTAGCT	GAAACACCGGTTTACTTTGCATCGGTGTGGGGGTAGAGCTATAATTTGCA	1	bc
GAACCAGACC	GAAACACCGGTAGCAAGTGCGAGACGTGCTTTTGTGGGGTTAGAGCTAGA	1	bc
TGGGCGCCTT	GAAACACCGGTGTGGCTGAGAGTCCGGCAATGGTGTGGCTGTGGGGTTAG	1	bc
GCGGATCGAT	GAAACACCGGTCTTGTGTGAGGGGTTCAGGGTGGGGATAGAGCTAGAAAT	1	bc
AGACCGATGC	GAAACACCGGTGCATTCGAAAGTCCGTTCGTAGTGTGGACGTGGGGTTAG	1	bc
TCGCTCGCGG	GAAACACCGGTTATATTTGTAAGTGTGTGGGGTTAGAGCTAGAAATAGCA	1	bc
TAGGGCATAC	GAAACACCGGTTAAGCCGGGGAGTTAGAGCTAGAAATAGCAAGTTAACCT	1	bc
ATCTACCGAG	GAAACACCGGTTATATTTGTAAGTGTGTGGGGTTAGAGCTAGAAATAGCA	1	bc
TAGAACATCG	GAAACACCGGTTCATTCGAAAGACCGGTCGTAGTGTGGCCGTGGGGTTAG	1	bc
CAAGTACCGC	GAAACACCGGTCGGCGCCACTCGGTGGTGGGGTTAGAGCTAGAAATAGCA	1	bc
GGAAGACGCG	GAAACACCGGTCGGCGGCAATCGTGGGTGGGGTTAGAGCTAGAAATAGCA	1	bc
AGCCAGTCTC	GAAACACCGGTGCATTCGAAAGCCCGGTCGTAGTGTGGATGTGGGGTTAG	1	bc
AGGATCTGCA	GAAACACCGGTAAATTTGAGTCTCCGGCATGCAGGAGCCCGAGGCGTTAG	1	bc
TCCTTGCCGC	GAAACACCGGTTTAGAGCTAGAAATAGCAAGTTAACCTAAGGCTAGTCCG	1	bc
GATGGAGTCT	GAAACACCGGTTCCCGTCCAGTGGGGTTAGAGCTAGAAGTAGCAAGTTAA	1	bc
AAGACCATCG	GAAACACCGGTGCATTCGAAAGTCCGGTCGTAGTGTGGACGTGGGGTTAG	1	bc
CGGGGTGGCA	GAAACACCGGCAGGTGGAGAGAGCTAGAGATAGGAGGTAAAGCTAAAGAT	1	bc
GGGAAGGCTC	GAAACACCGGTTCCCGTCCAGTGGGGTTAGAGCTAGAAATAGCAAGTTAA	1	bc
GACTCCGGTT	GAAACACCGGTAGCATGTTCTGGGTTAGATCTAGAAATAGCAAGTTAAGC	1	bc
AGGACACTAC	GAAACACCGGTAAATTTGAGGCTCCGGCATGAAGGAGGCCGTGGGGTTAG	1	bc
CATTTAGAGC	GAAACACCGGTCGGAGCCTGGGGGATAGAGCTAGAGATAGCAAGTTAACC	1	bc
AACGTCGAGC	GAAACACCGGTGACCTTACTCTCACCTGATTACTTGATCTGTGGGGTTAG	1	bc
AGAAAATCGC	GAAACACCGGTGCCTTCGAAAGTCCGGTCGTAGTGTGGACGTGGGGTTAG	1	bc
TACATTCTCC	GAAACACCGGTAACTCTATTCATGCGATATCGCCGTATCAGTGGGGTTAG	1	bc
ATTAGTTATG	GAAACACCGGTTACATTGAGGGGTTAGAGCTAGAAATAGCAAGTTAACCT	1	bc
GGCGTATAAT	GAAACACCGGTGATATTGGAGCTACAGCGAGGATTAACATGGTAACCGCA	1	bc
AATACCGAAC	GAAACACCGGTGCCCTTACTCTCACCTGATTACTTAATCCGTGGGGTTAG	1	bc
CAACCCCCGC	GAAACACCGGTGCATTCGAAGGTCCGGTCGTAGTGTGGACGTGGGGTTAG	1	bc
CCATTCCTGT	GAAACACCGGTCTCGAGCGCGGAGTTCAGGGTGGGGTTAGAGATAGAAAT	1	bc
GAAGGCCGCC	GAAACACCGGTCGGCGGCAATCGTGGGTGGGGTTAGAGCTAGAAATAGCA	1	bc
CAGAACGGCT	GAAACACCGGTTAAAGCTAGAAATAGCAAGTTAACCTAAGGCTAGTCCGT	1	bc
CTTTACCACC	GAAACACCGGTCGGGGCCACTCAGTGGTGGGGTTAGAGCTAGAAATAGCA	1	bc
GCCTTGCCCG	GAAACACCGGTCGGGGCCACTCAGTGGTGGGGTTAGAGCTAGAAATAGCA	1	bc
AAAGTCACGC	GAAACACCGGTCGGCGGCAATCTGTGGTTAGAGCTAGAAATAGCAAGTTA	1	bc
ACATAGGCGT	GAAACACCGGTGTACGTATGGACTGAACCAGGGTGTGCAAGTGGGGTTAG	1	bc
AGGTACCCTC	GAAACACCGGTGTGGCTGAGAGTCCGGCAATGGTATGGCTGGGGGGTTAA	1	bc
TGGATCCTTG	GAAACACCGGTTCGGAGTGTGGAGTTCAGGGGGTGGTTAGAGCAATAGAT	1	bc
CGTTGAGCTC	GAAACACCGGCTCCCGCCCCTTGGGTGTAGAGCTAGAAATAGAAAGAGAA	1	bc
TCGGATACGT	GAAACACCGGTCTCGAGTGAGGTGTTCAGGGTGGGGTTAGAGCTAGAAAT	1	bc
GCGTGCTGTC	GAAACACCGTAGAGCTAGAAATAGCAAGTTAACCTAAGGCTAGTCCGTTA	1	bc
AATAAGGCCC	GAAACACCGGTTTGAACTAGAAATAGCAAGTTAACCTAAGGCTAGTCCGT	1	bc
TGCCCCATCC	GAAACACCGGTAAGTCTGTTCATCCGGTATCGCCGTGTCTGTGGGGCTAG	1	bc
ACATCACCGC	GAAACACCGGTAGGGACCGCTCTGGTGGGGGTAGAGCTAGAGATAGCAAG	1	bc
ACGCATCCTT	GAAACACCGGTCTCGAGTGAGGTGTTCAGGGTGGGGTTAGAGCTAGAAAT	1	bc
GAGACCGAAA	GAAACACCGGTAGCAAGTGCGAGACGTGTTAAATAACAAGATAACATCAG	1	bc
GACGAGCCAC	GAAACACCGGTGCCCTTACTCTCACCTGATTACTTAATCCGTGGGGTTAG	1	bc
GAGTCTGCGT	GAAACACCGGTCCGTAGGAGACCCGTGTGGCATGTACCTGTGGGGTTAGA	1	bc
CGACTCTCTC	GAAACACCGGTTGTGTCACCTTCACAGTGGGGTTAGTGCTAGAAATAGCA	1	bc
CGCGACCTAC	GAAACACCGGTGCCCTTACTCTCACCTGATTACTTAATCCGTGGGGTTAG	1	bc
CTAATCGGGG	GAAACACCGGTTATATTTGTAAGTGGGGTTGTAGGTATAAATCGAGAGAT	1	bc
TTATCTCTGC	GAAACACCGGTTACATTTGAGGGTTAGAGCTGGTAATAGCAAGTTAACCT	1	bc
AGGCACCTAC	GACACACCGGTAAATTTGAGGCTCCGGCATGCAGGAGGCCGTGGGGTTAG	1	bc
GTAGTCCGGT	GAAACACCGGTCGGCGGCAATTGTTAGAGCTAGAAATAGTAAGTTTACCT	1	bc
ACCGTTACCG	GAAACACCTTAACCTAAGGCTAGTCCGTTACAACTTGAAAAAGTGGCACC	1	bc
AATCGACGTT	GAAACACCGGTGTACGTATGGACTGAACCAGGGTGTGCAAGTGGGGTTAG	1	bc
GACGAATCCT	GAAACACCGGTCTCGAGTGAGGTGTTCAGGGTGGGGTTAGAGCTAGAAAT	1	bc
GAACCAGACC	GAAACACCGGTAGCAAGTGCGAGACGTGTTTTTGTGGGGTTAGAGCTAGA	1	bc
TGAGCTACGC	GAAACACCGGTGAATTCGAGAGTCCCGTCGGAGTATGGACGGGGGGATCG	1	bc
CACTGTAGTA	GAAACACCGGTGTACGTATGGACTGAACCAGGGTGTGCAAGTGGGGTTAG	1	bc
GGGATACTCC	GAAACACCGGTGTGGCTGAGTGTCCGGCAATGGTGTGGCTGTGGGGTTAG	1	bc
TACATTTGGT	GAAACACCGGTCGATTCATATCGAAACCTTCCCGTGACAGTGGGGTTAGA	1	bc
AGCATACTTT	GAAACACCGGTCTCGAGTGAGGTGTTCAGGGTGGGGTTAGAGCTAGAAAT	1	bc
GCCAAATAGC	GAAACACCAGCCGGCCTCTAGAAAAGACCCGTTAGCCTAGAGCTAGAACG	1	bc
AAACACTCTA	GAAACACCGGTGCATTCGATAGTCCGGTCGTAGTGAGTACGTGGGGTTAG	1	bc
GACATACGGT	GAAACACCGGTCGATTCATATCGAAACCTTCCCGTGACAGTGGGGTTAGA	1	bc
CGACGCAAGC	GAAACACCGGTGCATTCGAAAGTCCGGTCGTAGTGTGGTCGTGGGGATAG	1	bc
GCGAACGAGG	GAAACACCGGTTATATTTGAAGTGGGGTTAGAGCTAGTAATAGCAGATTA	1	bc
ATCTATTGAG	GAAACACCGGTTATATTTGTAAGTGTGTGGGGTTAGAGCTAGAAATAGCA	1	bc
GCTATCCTCC	GAAACACCGGTTATATTTGTAATCGTGCGGGGTTAGAGCTAGAAGTAGCA	1	bc
TCTCACGCGG	GAAACACCGGTTATATTTGTAAGTGTGTGGGGTTAGAGCTAGAAATAGCA	1	bc
GAGCCCTGCA	GAAACACCGGTGTGGCTGAGAGCCCGGCAAGGGTGGGGAGGGGGAGTAAG	1	bc
CTACGGCGCC	GAAACACCGGTACCTTTAATGATGCTGGGGGGATGGAGTTATTGTGGGGA	1	bc
GTGGACGGAC	CAAAACACCGGTCGGCGGCAATCTGGGGTTAGAGCAAGATATAGCAAGTT	1	bc
GATCGTGGAC	GAAACACCGGTGTACGTATGGACTGAACCAGGGTGTGCAAGTGGGGTTAG	1	bc
TTGGAGCTGT	GAAACACCGGTTACATTGAGGGGTTATCGCTAGAAATAGCAAGTTGAACT	1	bc
GGGTGCCTCC	GAAACACCGGTGAAACTGAGATTCCGGCAATGGTGTGGCTGGGGAGTTAG	1	bc
AGATGCTGGC	GAAACACCGGTGCACTCGAAAGTCCGGTCGTAGTGTGGACGTGGGGTTAG	1	bc
CAACTAGGCA	GAGTCGGCGCTTTTTTTCCTGCAGGGGCCGAGTAGGAATTCGGGCCCATT	1	bc
ACGTTAAACG	GAAACACCGGTCGGTGCCTGTCAGGCGGGGGCAAGGCTAGGTAGAGCTAG	1	bc
GACCGCCCTA	GAAACACCGGTGCCCTTACTCTCACCTGATTACTTAATCCGTGGGGTTAG	1	bc
ACGTCAGGTT	GAAACACCGGTCGATTCATAACGAAATCTTCCCGTGACAGTGGGGGTAGA	1	bc
CCTCTCTGTC	GAAACACCGGTACTCGGGTGGACTGAACCAGGGTGGGCATGGGGGTTTAG	1	bc
GGAGACCTTT	GAATCACGGATCGGCTGCAATCTTGGGTGGCGTTAGAGCTGCAAATAGCA	1	bc
GAAACGCCCC	GAAACACCGGTCAGCGGGGGGGTTAGAGCTAGAAATAGCAAGTTAACCTA	1	bc
AACGTACCAC	GAAACACCGGTGCCCTTAATTCAACCTGATTACTTAATCCGTGGGGTTAG	1	bc
GAATACCGTT	GAAACACCGGTCGGTTGCAATCGTGGTATTAGCCACGCGGGGGTATATCG	1	bc
TTGAGCGTTC	GAAACACCGGTTAAGCCGGGAGGGGTTAGAGCTAGGAGTAGCAAGTTAAA	1	bc
ACTGAGCATA	GAAACACCGGTTAAGCCGAGTGGGGTTAGAGCTAGAAATAGCAAGTTAAC	1	bc
CTGCGTAGCG	GAAACACCGGTTTACGTTGCATCGGTGTGGGGTTAGAGCTAGAAATAGCA	1	bc
TGGGAGTTTT	GAAACACCGGTGTGGCTGAGAGTCCGGCAATGGTGTGGCTGTGGGGTTAG	1	bc
CTTATCGGTT	GAAACACCGGTACCTTTGTTGATGCTGGGTGGAAGGATGCTGGGTGGGGT	1	bc
AGTAGGCTTC	GAAACACCGGTCCGTAGGAGACCCGTGTGGCATGTACCTGTGGGGTTAGA	1	bc
CGACCCGAGC	GAAACACCGGTGCATTCGAAAGTCCGGTCGTAGTGTGGACGTGGGGTTAG	1	bc
ACCGACCTCC	GAAACACCGGTGCCCTTATTCTCACCTGATTACTTAATCCGTGGGGTTAG	1	bc
GGGCCCTCCC	GAAACACCGGTGTGGCTGAGAGTCCGGCAATGGTGTGGCTGTGGGGTTAG	1	bc
AGTGTTGTAC	GAAACACCGGTGACATTGGGTACAAATAGCAAGTTAACCTAAGGCTAGTC	1	bc
AAACGCCGTC	GAAACACCGGTGCCCTTACTCTCACCTGATTACTTAATCCGTGGGGTTAG	1	bc
