CTCCCCTGCA	GAAACACCGGTGTGGCTGAGAGTCCGGCAATGGTGTGGCTGTGGGGTTAG	6	bc
AAACGCACTA	GAAACACCGGTGCCCTTACTCTCACCTGATTACTTAATCCGTGGGGTTAG	2	bc
GACTATCTAC	GAAACACCGGTGCCCTTAATATCACCTGATTACTTAATCCGTGGGGTTAG	1	bc
CGAAACCCCT	GAAACACCGGTCTCGAACGAGGTGACGAGGGTGTGGAGAGAGCTAGAAAT	1	bc
ACTTTGCGGC	GAAACACCGGTCGGGGCCACTCCGTGGTGGGGTTAGAGCTAGAAATAGCA	1	bc
GTGGCTATGC	GAAACACCGGTTACATTGAGTAGTTAGAGCTAGAAAACGGAATTTAACCT	1	bc
TACGTCCTGC	GAAACACCGGTTCTCTTACTCTGACCTGATTACTTAATCCTTGGAGTTAG	1	bc
TCGGTAGCTT	GAAACACCGGTACTCAGGAGACCCGAGTGGCATTAGCGTTAGAGGTAGCA	1	bc
AGAAGACCAG	GAAACACCGGTCGGCGAAGAGCTAGAAATAGCAAGTTAACCTAAGGCTAG	1	bc
GTGGTGGCTG	GAAACACCGGTTCTCGTTCAGTGGGGTTAGAGCTAGAGATAGCAAGATAA	1	bc
GGCTTCGTCC	GAAACACCGGTCGGTTCGTGTCGCCGGCTTTGCGGTGGAGGGGGGGTTAG	1	bc
TGTATCGCGC	GAAACACCGGTTCTATTTGTAACTGTGTGGGATTAGCCCTAGGAGTAGCA	1	bc
ATTGAGAATA	GAAACACCGGTTAAGCCGAGTGGGGTTAGAGCTAGAAATAGCAAGTTAAC	1	bc
AAATAGCGCC	AGGGCTAGAAATAGCAAGTTAACCTAAGGCTAGTCCGTTATCAACTTGAA	1	bc
CCACCATCCG	GAAACACCGGTGGCAATAGGATGAGTGGAGTGGGGTTAGAGCTAGAAATA	1	bc
GTCTATAGAG	GAAACACCGGTTATATTTGTAAGTGTGTGGGGTTAGAGCTAGAAATAGCA	1	bc
AAACTAAGCC	GCTAGAAATAGCAAGTTAACCTAAGGCTAGTCCGTTTTCAACTTGAAAAA	1	bc
AGAACCCCCC	GAAACACCGGTGTATTCGAAAGTCCGGTCGTAGTGTGGACGTGGGGTTAG	1	bc
AAAGCTCTCC	GAAACACCGGTGCCCTTACTCTCACCTGATTACTTAATCCGTGGGGTTAG	1	bc
GACGAAGCGC	GAAACACCGGTCGGCGGCAATCGTGGGTGGGGTTAGAGCTAGAAATAGCA	1	bc
GGCGACCGCA	GAAACACCGGTTAAGCCGAGGAGTTTCGTTAGAGCTAGAAATAGCAAGTC	1	bc
CACGCTCTCC	GAAACACCGGTGCCCTTACTCTCACCTGATTACTTAATCCGTGGGGATAG	1	bc
GTGTCGTCTC	GAAACACCGGTTACCGTCCAGCGGGGTTAGGGCTAGAAATAGCAAGTTAA	1	bc
ACAGTCCCGC	GAAACACCGGTCGGCGGCGGTGGGGTTAGAGCTAGAAATAGCAAGTTAAA	1	bc
ACATTGTCGT	GAAACACCGGTGTACGTATGGACTGAACCAGGGTGTGCAAGTGGGGTTAG	1	bc
AGTGTGACTT	GAAACACCGGTCCGTAGGAGACCCGTGTGTCATGTTCCTGTTGGGTTAGT	1	bc
ACGACTCGGC	GAAACACCGGTACCTTTGTTGATGCTGGGTTGAAGGAATGTGGGGTTAGA	1	bc
ATCCCCTGCA	GAAACACCGGTGTGGCTGAGAGTCCGGCAATGGTGTGGCTGTGGGGTTAG	1	bc
CACGACCTAA	GAAACACCGGTGCCCTTACTCTCACCTGATTACTTAATCCGTGGGGTTAG	1	bc
ATAGCTCTAT	GAAACACCGGTTACCTTACTGTTTCGAGCTTGCAATAGCCGGTTGGCCTG	1	bc
TAGACCCCCG	GAAACACCGGTGCATTCGAAAGTCCGGTCGTAGTGTGGACGTGGGGTTAG	1	bc
TTTGCGCTGT	GAAACACCGGTTACATTGAGGGGTTAGAGCTAGAAATAGCAAGTTAACCT	1	bc
TGCAGACCCG	GAAACACCGGTCGGCGGCAATCGTGGTTAGAGCTAGAAATAGCAAGTTAA	1	bc
AGAGCCTTGT	GAAACACCGGTGCATTCGAAAGTCCGGTCGTAGTGTGGACGTGGGGTTAG	1	bc
ATGTGCGTTT	GAAACACCGGTCGATTCATATCGAAACCTTCCCGTGACAGTGGGGTTAGA	1	bc
AAACGCCCGA	GAAACACCGGTGCCCTTACTCTCACCTGATTACTTAATCCGTGGGGTTAG	1	bc
TTTAGAATAC	GAAACACCGGTTAAGCCGAGGTTAGAGCTAGAAATAGCAAGTTAACCTAA	1	bc
TTCAGCCTCC	GAAACACCGGTTTGGCTGAGAGTCCGGCAATGGTGTGGCTGTGGGGTTAG	1	bc
GAAGCGCTGC	GAAACACCGGTCGGCGGCGGGGGGGCTTAATGTACTAATAGCAAGGTTAG	1	bc
AAGAATCCTT	GAAACACCGGTCTCGAGTGAGGTGTTCAGGGTGGGGTTAGAGCTAGAAAT	1	bc
AAGTCTGACT	GAAACACCGGTCTGTAGGAGACCCGTGTGGCATGTACCTGTGGGGTTAGA	1	bc
TTGTGCGGAT	GAAACACCGGTTAATTCATGTCGAAACTTTCCCTTGACAGAGCGAGTTGA	1	bc
GGCAACTAAA	GAAACACCGGTAAATTTGAGGCTCCGGCATGCAGGAGGCCGTGGGGTTAG	1	bc
CGAATCACTC	GAAACACCGGTCTACAGGGTGGGGTTCTGGGGGTGGATATAGATAGAAGT	1	bc
AGTTGGCTCC	GAAACACCGGTCCGTAGGAGACCCGTGTGGCATGTACCTGTGGGGTTAGA	1	bc
CCCTTCGGAT	GAAACACCGGTCGATTCATATCGAAACCTTCCCGTGACAGTGGGGTTAGA	1	bc
AGGCTCTGCT	GAAACACCGGTTTACGTTGCATCGGTGTGGGCTTAGAGCTAGAAATAGCA	1	bc
GGGATGCATA	GAAACACCGGTCGGTAGGAGACGCGTGTGGCGTGTAACTAGGGGGTTAGA	1	bc
AGGCACCCTT	GAAACACCGGTGTGGCTGAGAGTCCGGCAATGGTGTGGCTGTGGGGTTAG	1	bc
GACACCGCCT	GAAACACCGGTAGCAAGTGCGAGACGTGTTTGTGGGGTTAGAGCTAGAAA	1	bc
AACATCGTCG	GAAACACCGGTGTACGTATGGACTGAACCAGGGTGTGCAAGAGGGGTTAG	1	bc
GCTTCGGACA	GAAACACCGGTTACATTGAGGGGTTAGAGCTAGAAATAGCAAGTTAACCT	1	bc
AGAAGAACCG	GAAACATAGAGCTAGAAATAGCAAGTTAACCTAAGGCTAGTCCGTTATCA	1	bc
GATTTCCCGC	GAAACACCGGTCGGGGCCACTCCGTGGTGGGGTTAGAGCTAGAAATAGCA	1	bc
TCCTCGTCGT	GAAACACCGGTGTACGTATGGACTGAACAGAGCTAGAAATAGCAAGTTAA	1	bc
TACGGCTGGC	GAAACACCGGTTACCTCTCGCTAGACGTAGTACTTAATCCGGAAGTCGAA	1	bc
ACGAATCAGT	GAAACACCGGTCTCGAGTGAGGTGTTCAGGGTGGGGTTAGAGCTAGAAAT	1	bc
GTAGACGCCC	GAAACACCGGTGTGTGTATCGACCTATCGGGAGCGGGTTGAGCTAGAGAT	1	bc
AGGCAACCTC	GAAACACCGGTGTGGCTGAGAGTCCGGCAATGGTGTGGCTGTGGGGTTAG	1	bc
GAATACCGGT	GAAACACCGGTCGGTTCCAATCGAGGGTTGGGTTAGAGCTAGAAATAACA	1	bc
ACATCGTGGT	GAAACACCGGTGTACGTATGGACTGAACCAGAGTGTGCAAGTGGGGTTAG	1	bc
GTGGGGCGTA	GAAACACCGGTTCCCGTCCAGTGGGGTTAGAGCTAGAAATAGCAAGTTAA	1	bc
TGTGCTATGG	GAAACACCGGTTACATTGAGGGGTTAGAGCTAGGAATAGCAAGTTAACCT	1	bc
CCTGTCCTGC	GAAACACCGGTCGGGGTCACTCAGCGGTGGGGCTAGATCTAGAAATAGCA	1	bc
TAATCTATTT	GAAACACCGGTTACATTTTGGATAAAGCTAGACATATCAAGCTAACCCTA	1	bc
GCGGTGAGTC	GAAACACCGGTTCCCGTCCAGTGAGGCTAGAGCTAGACATAGCAAGTTAA	1	bc
GAGAAGCCCC	GAAACACCGGTAGGCGGCGATCGTGGGGGGGGTTAGGGCTAGTAATAGCA	1	bc
ACATCGTCGG	GAAACACCGGTGTACGTATGGACTGAACCAGGGTGTGCAAAGTGGGGTTA	1	bc
GAGAGCAACA	GAAACACCGGTTACACGGGCGAGCCTTTTTTGTGCGGGTTAAGCTCAAGA	1	bc
CGAACGCACT	GAAACACCGGTGCCCTTACTCTCACCTGATTACTTAATCCGTGGGGTTAG	1	bc
GCGTTGCCGC	GAAACACCGGTCGCCGCCACGCAGTGGTGGGGTTAGAGCTAGAAATAGCA	1	bc
GAGGCGTCTC	GAAACACCGGTTCCCGTCCAGTGGGGTTAGAGCTAGAAATAGCAAGTTAA	1	bc
TCGCCCTGCA	GAAACACCGGTGCATTCGGAAGTCCGGTCGTAGTGTGGACGTGGGGTTAG	1	bc
GAAGTTCGGC	GAAACACCGGTCGACGGCAAACTTGAATAAGGGTCACCGTGGCGGTGCCT	1	bc
AACGCCTCAA	GAAACACCGGTGCCCTTACTCTCACCTGATTACTTAATCCGTGGGGTTAG	1	bc
ACTTTATCGA	GAAACACCGGTCGGGGCCACTCAGTGGTGGGGTTAGAGCTAGAAATAGCA	1	bc
GAACCAGCCA	GAAACACCGGTAGCAAGTGGGGTTAGAACTAGAAATAGCAAGGTAACCTA	1	bc
GGGGCGATTA	GAAACACCGGTTACCGTACAGTGGGGATAGAGATATAAATAGCAGGTTAA	1	bc
GGACGGTCGC	GAAACACCGGTGCGGTCTTGCGCAGGGCGGTAGTGGGTAGGGGTGGATAG	1	bc
CAAATTATGC	GAAACACCGGTCACTATATCCATGCGATATCGCCGTATCAGTGAGGATAG	1	bc
CTACTCAGTT	GAAACACCGGTACCTTTGTTGATGCTGGGTGGAGGGATTGGGGTTAGAGC	1	bc
GGACCGTAGA	GAAACACCGGTAAATTCGAGGCTCCGGCATGCAGGAGGCCGTGGGGTTAG	1	bc
CGACTATCGC	GAAACACCGGTGCATTCGAAAGTCCGGTCGTAGTGTGGACGTGGGGTTAG	1	bc
ACCTTTAACG	GAAACACCGGTCGGGGCCACTCAGTGGTGGGGTTAGAGCTAGAAATAGCA	1	bc
ATGACTAGTT	GAAACACCGGTTTACGTTGAATCGGTGTGGGGTTAGATCTAGAAATAGCA	1	bc
ATGACTAGCA	GAAACACCGGTTTACGTTGCATCGGTGTGGGGTTAGAGCTAGAAATAGCA	1	bc
ATCACTTATA	GAAACACCGGTAACTATATTCATGCGATATCGCCGTATCAGTGGGGTTAG	1	bc
TTGCGCAGCA	GAAACACCGGTTAAGTGGGGTTAGAGCTAGAAATAGCAAGTTAACCTAAG	1	bc
TAAACCGCCC	GAAACACCGGTTTGAACTACCTGGCAGGTTAACCTGAGGCTGAACCGTTA	1	bc
TGAGCTGTGC	GAAACACCGGTTAAATTGAAGGGTTAGAACTAGAAATAGCAAGTTGACAG	1	bc
ACGACTGGAT	GAAACACCGGTTTACGTTGCATCGGTTATATGGGTTATATGGGGTTATAT	1	bc
AAACCACGGC	GAAACACCGGTGCATTCGAAAGTCCGGTCGTAGTGTGGACGTGGGGTTAG	1	bc
TACGTCGCCC	GAAACACCGGTTTGAACTACCTAGTTCAAACCGGAGGGGTTAGAGCTAGA	1	bc
CCTTTAAAGA	GAAACACCGGTCGGGGCCACTCAGTGGTGGGGTTAGAGCTAGAAATAGCA	1	bc
AGAACTTATA	GAAACACCGGTAACTATATTCATGCGATATCGCCGTATCAGTGGGGTTAG	1	bc
ACAGCCCTTC	GAAACACCGGTCCCCTTACTCTCACCTGATTACTTAATCCGTGGGGTTAG	1	bc
AGAAAAGAAC	GAAACACCGGTAGCAAGTGCGAGACGTGTTTGTGGGGTTAGAGCTAGAAA	1	bc
TTAGACATGG	GAAACGCCGGTTACATTGAGGGGTTAGAGCTAGAATTAGCAGGTTAACCT	1	bc
AAGACGCCCG	GAAACACCGGTGCATTCGAAAGTCCGGTCGTAGTGTGGACGTGGGGTTAG	1	bc
GTGGCGCACC	GAGACACCGGTTCCCGTCCAGTGGGGTTAGAGCTAGTAATAGCAAGTTAA	1	bc
CACCCTTCCT	GAAACACCGGTGTACGAATGGAATGAACCAGGGGGTGCAAGGGGGGTTAG	1	bc
AAAGACCTCC	GAAACACCGGTGCCCTTACTCTCACCTGATTACTTAATCCAGTGGGGTTA	1	bc
AAAGTCATAC	GAAACACCGGTACCCTTACTCACACCTGATTACTTAATCCGTGGGGTTAG	1	bc
AATGCTCAGC	GAAACACCGGTTTACGTTGGTGTGGTGGTAGAGCTAGAAATAGCAAGTTA	1	bc
AGTAGGGCTC	GAAACACCGGTCCGTAGGAGACCCGTGTGGCATGTACCTGAGGGGTTAGA	1	bc
CGTCACCCTC	GAAACACCGGTTTGAACTAGATAGTTGTGGCATAGAGCTAGAGATATCAA	1	bc
GTAGCCAGCT	GAAACACCGGTTACATTGAGGGTTAGAGCTAGAAATAGCAAGTTAACCTA	1	bc
TTGCGCCTAC	GAAACACCGGTTAACCCATGGGTTAAAGCTGGGAGTAGCAGTTTAGCCAG	1	bc
GAAGCTGTGT	GAAACACCGGTTACATTGAGATTGGTGTTAGAGCTAGAAATAGCAAGTTA	1	bc
AGGCCGCCCA	GAAACACCGGTCGGTAGGAGACCCGTGTGGCATGTACCAGAGGGGGTAGA	1	bc
AACGATCGAC	GAAACACCGGTAACCTTCCTCTGACCTGATTAATTGATGCGTGGGGTTAG	1	bc
AGGGGAGCCT	GAAACACCGGTTCCCGTCCAGTGGGGTTAGAGCTGGAAATAGCAAGTTAA	1	bc
AACGATATAC	GAAACACCGGTGCCCCTACTCTCACCTGATTACTTAATCCGTGGGGTTAG	1	bc
TTTAGATATG	GAAACACCGGTTACATTGAGATTAGAGCTAGAAAAGGCTAGTCCGTTATC	1	bc
ATGCGCCTAA	GAAACACCGGTTAAGCCGGGTGGGGTCAGAGCTAGAACTAGCAAGTTAAA	1	bc
ACGGGTTGTC	GAAACACCGGTGACATTGGGTGTGGGGTTAGAGCTAGAAATAGCAAGTTA	1	bc
CAACCGCGTC	GAAACACCGGTGTACGTATGGACTGAACCAGGGTGTGCAAAGTGGGGTTA	1	bc
AACTTTACCG	GAAACACCGGTCGGGGCCACTCAGTGGTGGGGTTAGAGCTAGAAATAGCA	1	bc
GACGGCCGGC	GAAACACCGGTCGGCGGCAATCGTTTTAGGTTGTGGGGTTAGAGCTAGAA	1	bc
TATAGGCGTC	GAAACACCGGTGTACGTATGGACTGAACCAGGGTGTGCAAGTGGGGTTAG	1	bc
TAACGCGCTA	GAAACACCGGTGCCCTTACTCTCACCTGATTACTTAATCCGTGGGGTTAG	1	bc
ATGCGTATAT	GAAACACCGGTTTACGTTGCATCGGTGTGGGGTTAGAGCTAGAAATAGCA	1	bc
CAACACTCGC	GAAACACCGGTCGGCGGCAATCGTGGGTGGGGTTAGAGCTAGAAATAGCA	1	bc
GAGAGAGATA	GAAACACCGGTAGCAAGTGCGAGACGTGTTAAATAGCAAGTTAACCTAAG	1	bc
ATAGCGACGT	GAAACACCGGTTACATTGAGGGGTTAGAGCTAGAAATAGCAAGTTAACCT	1	bc
TATAGCGACG	GAAACACCGGTTATATTTGTAAGTGTGTGGGGTTAGAGCTAGAAATAGCA	1	bc
GCCTTTAGCG	GAAACACCGGTCGGGGCCACTCAGTGGTGGGGTTAGAGCTAGAAATAGCA	1	bc
ATATATCGAG	GAAACACCGGTTATATTTGTAAGTGTGTGGGGTTAGAGCTAGAAATAGCA	1	bc
TACCTTAGCC	GAAACACCGGTAACTATATTCATGCGATATCGCCGTATCAGTGGGGTTAG	1	bc
GGGAACCCCC	GAAACACCGGTGTGGCTGAGAGTCCGGCAATGGTGTGGCTGTGGGGTTAG	1	bc
TCTACCGACA	GAAACACCGGTTATATTTGTAAGTGCTGCGGGGTTAGAGCTAGAAATAGC	1	bc
AGACATAGAC	GAAACACCGGTAGCAAGTGCGAGACGTGTTAAATAGCAAGTTAACCTAAG	1	bc
AGAGCCATAC	GAAACACCGGTGCCCTTACTATCACCTGATTACTTAATACGTGGGGTTAG	1	bc
GCGAGCCTCC	GAAACACCGGTTCCCGTCCAGTGGGGTTAGAGCTAGAACTAGCAAGTTAA	1	bc
CTACTGCTCT	GAAACACCGGTAACTTTGTTGACACGGGGTGGACTGGATTTTGTGGGGAG	1	bc
AAACACCGCA	GAAACACCGGTTTGAACTAGAAATAGCAAGTTAACCTAAGGCTAGTCCGT	1	bc
GGCCCACTGC	GAAACACCGGTGTGGCTGAGAGTCCGGCAATGGTGTGGCTGGGGGGTTAG	1	bc
GTCCACTGCA	GAAACACCGGTGTGGCTGAGAGTCCGGCAATGGTGTGGCTGTGGGGTTAG	1	bc
GGCTCACTGC	GAAACACCGGTGTGGCTGAGAGTCCGGCAGTGGTGTGGCTGTGGGGATCG	1	bc
GTAGTACCGC	GAAACACCGGTCGGCGGCAATCGTGGGTTAGAGCTAGAAATAGCAAGTTA	1	bc
AAGACCCACG	GAAACACCGGTTAAGCCGAGTGGGGTTAGAGCTAGAAATAGCAAGTTAAC	1	bc
CCTTATCGCC	GAAACACCGGTCGGGGCCACTCAGTGGTGGGGTTAGAGCTAGAAATAGCA	1	bc
AGTGTTTGCC	GAAACACCGGTGACATTGGCTAGTCCGTTATCTACCTGAAAAAGAGGCCC	1	bc
GAGTGTTGTC	GAAATACCGGTGACATTGGGTACAGGTGTGGGGTTAGAGCTAGAAATAGC	1	bc
ACACACCGCC	GAAACACCGGTTTGAACTACCTAGAGCTAGAAATAGCAAGTTAACCTAAG	1	bc
AAGGTCCTAT	GAAACACCGGTTCCCTTACCCTCACCTGATTACTTAATCCGGGGGGTTAG	1	bc
ATGAACGCCT	GAAACACCGGTTTGAACTAGAAATAGCAAGTTAACTAGAGGGTAGTCCGT	1	bc
GTCGACGCCC	GAAACACCGGTTTGAACTAGAAATAGCAAGTTAACATATGGCTAGTCCGT	1	bc
AAACAACGCC	GAAACACCGGTTGAACTACCTAGTTCAAACCGGTGGGGTTAGAGCTAGAA	1	bc
AAGGCCAGAC	GAAACACCGGTGCCCTTACTCTCACCTGATTACTTAATCCGTGGGGTTAG	1	bc
TCGAATCCCT	GAAACACCGGTCTCGAGTGAGGTGTTCAGGGTGGGGTTAGAGCTAGAAAT	1	bc
AAAATTCGGT	GAAACACCGGTCGATTCATATCGAAACCTTCCCGTGACAGTGGGGTTAGA	1	bc
GAGCCCGACA	GAAACACCGGTAGCAAGTGCGAGACGTGTTTGTGGGGTTAGAGCTAGAAA	1	bc
CGTAGAAGTG	GAAACACCGGTGTACGTATGGACTGAACCAGGGTGTAGAAATAGCAAGTT	1	bc
ACAGACGGGC	GAAACACCGGTCGACTGATATCGAGGGCTTGGTGAGAGCGTGGGATTAGA	1	bc
CGACACTCTT	GAAACACCGGTCTCGAGTGAGGTGTTCAGGGTGGGGTTAGAGCTAGAAAT	1	bc
AGAAAATCGC	GAAACACCGGTGCATTCGAAAGTCCGGTCGTAGTGTGGACGTGGGGTTAG	1	bc
CAACGTGGAC	GAAACACCGGGGTACGTATGGACTGAACCAGGGTGAGCAAGTGGGGTTAG	1	bc
TTAGGTCTGC	GAAACACCGGTTACATTGAGGGTTAAAGCTGGGAATGCCAGGTTGGCCTA	1	bc
TAAGCTATTC	GAAACACCGGTTACTTTGTGGGGTTAATGCTAGAGATAGAAAGTTAACCT	1	bc
AAACAACGCT	GAAACACCGGTTTGAACTAGAAATAGCAAGTTAACCTAAGGCTAGTCCGT	1	bc
TAGCCACGAC	GAAACACCGGTGGCCTTACTATCCCATGGTTACTTGTTACATCGGGATAT	1	bc
GAAGCAGTCA	GAAACACTGTGGGGTTTGAGCTAGAAATAGCAAGTTAACCTAAGGCTCGT	1	bc
CCTCGTTTTC	GAAACACCGGTGTACGTATGGACTGAACCAGGGTGTGCAAGTGGGGTTAG	1	bc
TCTGGTGAGT	GAAACACCGGTTATATTTGTAAGTGTGTGGTGTTAGAGCTAGAAATAGTA	1	bc
GGACGAAGGA	GAAACACCGGTGGCCTGTCCGACACCGGATTTGTGAGGCGAGCTATAGCT	1	bc
AACACCGCAC	GAAACACCGGTTTGAACTACCGGGGTTAGGGCTAGAAATAGCAAGTTAAC	1	bc
TCTTCATCGC	GAAACACCGGTCGGGGCCACTCAGTGGTGGGGTTAGAGATAGAAATAGCA	1	bc
GGCTTCGATT	GAAACACCGGTAAATTTGAGTCTCCGGCATGCAGGAGGCCGTGGGGTTAG	1	bc
ACCGCCCGCC	GAAACACCGGTGCCCTTACTCTCACCTGATTACTTAATCCGTGGGGTTAG	1	bc
CACAAATCTC	GAAACACCGGTTTGAACTACCTAGCAAGTTAACCTAAGGCTAGTCCGTTA	1	bc
AAGTCAGCCT	GAAACACCGGTCCGTAGGAGACCCGTGTGGCATGTACCTGTGGGGTTAGA	1	bc
AGTGTAGTGT	GAAACACCGGTCGGGGCCAGTCCGTGGTGGGGTTAGAGCTAGAAATAGCA	1	bc
ATGTGCGGCC	GAAACACCGGTACCTTTGTTGATGCTGGGTGGAAGGAATGAGGGGGTAGA	1	bc
AGAAGCTAGC	GAAACAACGGTGCATTCGAAAGTCCGGTCGTAGTGTGGACGTGGGGTTAG	1	bc
TCAAAACGCC	GAAACACCGGTTTGAACTACCGGGGTTAGAGCTAGAAATAGCAAGTTAAC	1	bc
AGACTCTATC	GAAACACCGGTGCATTCGAAAGTCCGGTCGTAGGGTGGACGTGGGGTTAG	1	bc
ACTAATCGGC	GAAACACCGGTACCTTTGTTGATGCTGGGTGGAAGGAATTTTGTGGGGTT	1	bc
ATGCTCTGGC	GAAACACCGGTTTACGTGGAGGGCGGGTAGTGGTGTGAACGGCAGGTTAA	1	bc
ATAAAATATA	GAAACGCCGGTAACTATATTCATTCTACCACTCCTAATGATTTGGGCTAG	1	bc
TCTGTTGTGG	GAAACACCGGTTATATTTGTAAGTGGTGTTAGAGCTAGAAATAGCAATTT	1	bc
CACCGACGTA	GAAACACCGGTGTACGTATGGACTGAACCAGGGTGTGCAAGTGGGGTTAG	1	bc
AGGCCCACGT	GAAACACCGGTGCATTCGAAAGTCCGGTCGTAGTGTGGACGTGGGGATAG	1	bc
AGCAGACCCG	GAAACACCGGTCGGCGGCAATCGTGGGTGGGGTTAGAGCTAGAAATAGCA	1	bc
CGCGGTCTCT	GAAACACCGGTGACATTGGGAATGGGGTTCGAGCTAGAAATAGCAAGTAA	1	bc
GGATTCCTCC	GAAACACCGGTGTGGCTGAGAGGCCGGCAATGGTGTGGCGGGGGGGTTAG	1	bc
ACTATCGCTG	GAAACACCGGTTATATTTGTAAGTGTGTGGGGTTAGAGCTAGAAATAGCA	1	bc
AAGTCTCCCC	GAAACACCGGTCCGTAGGAGACCCGTGTGGCATGTACCTGTGGGGTTAGA	1	bc
ATTAGATATG	GAAACACCGGTTACATTGGGGTTAGAGCTAGAAATAGCAAGTTAACCTAA	1	bc
GATGACCGGG	GAAACACCGGTCGGCGGCGGTGGACGTAGAGCTAGAACTAGCAAGATAAC	1	bc
AGAACAGCGC	GAAACACCGGTGCATTCGAAAGTCCGGTCGGAGTGTGGACGTGGGGATAG	1	bc
AGGACAGAGA	GAAACACCGGTAGCAAGTGCGAGACGTGTTAAATAGCAAGTTAACCTAAG	1	bc
GTAGAACGGA	GAAACACCGGTGGGCGGCGATCGTGGCTGGGTTTCGAGGTAGGGGTAGAG	1	bc
CCATAAGGTT	GAAACACCGGTCGATTCATATCGAAACCTTCCCGTGACAGTGGGGTTAGA	1	bc
TTAGGTCTTT	GAAACACCGGTTACATTGAGTGGGGTTAGAGCTAGAAATAGCAAGTTAAC	1	bc
GGCACGCACA	GAAACACCGGTAGCAAGTGCGAGAGTGTTTTGTGGGGTTAGGGCTATAAA	1	bc
AGCCACAGAC	GAAACACCGGTAGCAAGTGCGAGACGTGTTTGTGGGGTTAGAGCTAGAAA	1	bc
AAATCGTCGT	GAAACACCGGTGTACGTAGAGCTAGAAATAGCAAGCTAACCTAAGGCTAG	1	bc
ACGGGTTGTC	GTGTGGGGTTAGAGCTAGAAATAGCAAGTTAACCTAAGGCTAGTCCGTTA	1	bc
GCGTTTACCG	GAAACACCGGTCGGGGCCACTCAGTGGTGGGGTTAGAGCTAGAAATAGCA	1	bc
AGGCCGCTAC	GAAACACCGGTAAATTTGAGGCTCCGGCATGCAGGAGGCCGTGGGGTTAG	1	bc
GGTCGCGACA	GAAACGCCGGTAAATTTGAGGCTCCGGCATGCAGGAGGCCGTGGGGTTAG	1	bc
ACGAAGCCTT	GAAACACCGGTCTCGAGGCTAGTCCGTTATCAACTTGAAAAAGAGGCACC	1	bc
CAAAAAGTCC	GAAACACCGGTTTGAACTACCTAGTTCAAACCGGTGGGGTTAGAGCTAGA	1	bc
GACGATCCTA	GAAACACCGGTGCATTCGAAAGTCCGGTCGTAGTGTGGACGTGGGGTTAG	1	bc
TGGAGCAGAG	GAAACACCGGTTAATCCGACGAGTTAGAGCGAGGGATTACAAGTTAACCT	1	bc
CTCCCCTGCA	GAAACACCGGTGAGGCTGAGAGTCCGGCAATGGTGTGACTGTGGGGTTAG	1	bc
GTGGATATTT	GAAACACCGGTTACATTGCGGGGTTAGTGCTAGAAGTAGCAAGTTGACCT	1	bc
ATCGCCTTAT	GAAACACCGGTTCCCTTACTCTCACCTGATTACTTAATCCGTAGGGTTAG	1	bc
AATTTACCGT	GAAACACCGGTCGGGGCCACTCAGTGGTGGGGTTAGAGCTAGAAATAGCA	1	bc
AGGCTGGCTT	GAAACACCGGTCCGTAGGAGACCCGTATGGCATGTACCTGTGGGGTTAGA	1	bc
TTGATCGTGT	GAAACACCGGTTATATTTGTAAGTGGGGTTAGAGCTAGAAATAGCAAGTT	1	bc
GATACTCGGC	GAAACACCGGTACCTTTGTTGATGCTGGGTGGAAGGATGCTGGGTGGGGT	1	bc
AAGTCTGACT	GCAACACCGGTCCGTAGGAGACCCGTGTGGCATGTACCTGTGGGGTTAGA	1	bc
CTCATCGGCA	GAAACACCGGTACCTTTGTTGATGCTGGGTGGAAGGTGGGGCTAGAGCTA	1	bc
CGAATCTCGC	GAGACACCGGTGCATTCGAAAGTCCGGTCGTAGTGTGGACGTGGGGTTAG	1	bc
TTGATTGACG	GAAACACCGGTTAACGTTGCATTAGAAATAGGATTAACAAGTTAATCTAA	1	bc
GAAGAACGGA	GAAACACCGGTCGGCGGCAATCGTGGAGGGTGGGGTTAGAGCTAGAAATA	1	bc
GTGGCAAGCT	GAAACACCGGTCTGTGTGGGGTTAGAGCTAGAAATAGCATGTTAACCTAA	1	bc
ACTCGTAGTC	GAAACACCGGTGTACGTATGGACTGAACCAGGGTGTGCAAGTGGGGTTAG	1	bc
ACAGACACGC	GAAACACCGGTCGGCGGCTAGAGCTAGAAATATCAAGTTAACCAAAGGCT	1	bc
CATTTACAGA	GAAACACCGGTCGGGGCCACTCAGTGGTGGGGTTAGAGCTAGAAATAGCA	1	bc
AGGTGCCAGC	GAAACACCGGTTCATTCGAAAGCACGGTAGAAGTGGGGACGCGGGGTTAG	1	bc
ATAGCGGGGT	GAAACACCGGTTACATTGAGGGTTAGAGCTATAACTAGCAGGGTAGCCTA	1	bc
CACATGGCTC	GAAACACCGGTTTGAACTAGAAATAGCAAGTTAACCTAAGGCTAGTCCGT	1	bc
AAGCTTAGAC	GAAACACCGGTTTCTATATTCGTACGATAACGTCGGGCTAGTAGATCTAG	1	bc
GGCAAGATGC	GACACACCGGTGGGGTTAGAGCTAGAAATAGCAAGTTAACCTAAGGCTAG	1	bc
GTGGAACATG	GAAACACCGGTTCCCGTCCAGTGGGGTTAGAGCTAGAACTAGCAAGTTAA	1	bc
TAGCTATGGA	GAAACACCGGTTACATTGAGGGTTAGAGCTAGAAATAGCAAGTTAACCTA	1	bc
GAGGACCTTC	GAAACACCGGTGCCCTTACTCTCACCTGATTACTTAATCCGGGGGGTTAG	1	bc
CGTAAGCCTC	GAAACACCGGTCCGTAGGAGACCCGTGTGGCATGTACCTGTGGGGTTAGA	1	bc
ACCTCGTCGT	GAAACACCGGTGTACGTATGGACTGAACCAGGGTGTGCAAAGCGGGGTTA	1	bc
AAATTTGGGG	GAAACACCGATCGAAACATATTGGACCCTTGCCGAGACAGAGGGGTTAGA	1	bc
ACAATCGTGT	GAAACACCGGTCAATTCATATCGAAACCTTCCCGTGACAGTGAGGATATA	1	bc
CGCAACGCTG	GAAACACCGGTTTGAACTACCTAGTTCAAACCGGTGGGGTTAGAGCTAGA	1	bc
ATTAGATATG	GAAACACCGGTTACATTGAGGGTTAGAGCTAGAAATAGCAAGTTAACCTA	1	bc
GTGTTGACTC	GAAACACCGGTTCCCGTCCAGTGGGGTTAGAGCTAGAAATAGCAAGTCTA	1	bc
ATTGCGCATA	GAAACACCGGTTAAGCCGTGGGGTTAGAGCTAGAAATAGCAAGTTAACCT	1	bc
ACTCTCGCGG	GAAACACCGGTTCTATTGAGAAGCGTTAGATTTGTAAGTGTAGGTAAGGG	1	bc
CATTTAACTC	GAAACACCGGTCGGGGCCACTCAGTGGTGGGGTTAGAGCTAGAAATAGCA	1	bc
AACGTTCGGT	GAAACACCGGTCGATTCATATCGAAACCTTCCCGTGACAGTGGGGTTAGA	1	bc
ACCTTTACTG	GAAACACCGGTCGGGGCCACTCAGTGGTGGGGTTAGAGCTAGAAATAGCA	1	bc
AACATGGCCC	GAAACACCGGTTTGAACTAGAAATAGCAGGTTAACCTAAGGCTAGTCCGT	1	bc
CACCTTTACC	GAAACACCGGTCGGGGCCACTCAGTGGTGGGGTTAGAGCTAGAAATAGCA	1	bc
AGGTTCGTCT	GAAACACCGGTGTGGCTGAGAGTCCGGCAATGGTGTGGCTGTGGGGTTAG	1	bc
AGTGGTGCAT	GAAACACCGGTTCCCGTCCAGTGGGGTTAGAGCTAGAAATAGCAAGTTAA	1	bc
CATATCGAGC	GAAACACCGGTTTTATTTACCAGGGTTGTGGGGTTAGGGCTAGAAATAGC	1	bc
GGCATACTAC	GAAACACCGGTGTGGCTGAGAGTCCGGCAATGGTGTGGCTGTGGGGTTAG	1	bc
CGCCTTTACC	GAAACACCGGTCGGGGCCACTCAGTGGTGGGGTTAGAGCTAGAAATAGCA	1	bc
GCGGCCCCGC	GAAACACCGGTCGGCGGGTTAGAGCTAGAAATAGCAAGTTAACCTAAGGC	1	bc
GGCACCGAAA	GAAACACCGGTAAATTTGAGGCTCCGGCATGCAGGAGGCCGTGGGGTTAG	1	bc
ACACAACGAC	GAAACACGGGTTAGAGCTAGAAATAGCAAGTTAACCTAAGGCTAGTCCGT	1	bc
ACGAATGCTT	GAAACACCGGTCTCGAGTGAGGTGTTCAGGGTGGGGTTAGAGCTAGAAAT	1	bc
CGTAGAGCAT	GAAACACCGGTTAAGCCGAGTGGGGTTAGAGCTAGAAATAGCAAGTTAAC	1	bc
ACACAACGCG	GAAACACCGGTTTGAACTACTGGGGTTAGAGCTAGAAATAGCAAGTTAAC	1	bc
GCACAGTCGC	GAAACACCGGTCAACGGCAATCGCGGGTGGGGTTAGAGCTAGAAATAGCA	1	bc
TCGTTACGGC	GAAACACCGGTCGGGGCCACTAAGTGGTGGGGTTAGATCTAGAAAGAGCA	1	bc
GGGACCGGCC	GAAACACCGGTGTGGCTGAGAGTCCGGCAATGGTGTGGCTGGGGGGGTAG	1	bc
AACGAACTGC	GAAACACCGGTGCCCTTACTCTCACCTGATTACTTAATCCGTGGGGTTAG	1	bc
TCTTTCTTGG	GAAACACCGGTTATATTTGTAAGTGTTGTGGGGTTAGAGCTAGAAATAGC	1	bc
TGGCCCCCTC	GAAACACCGGTGTGGCTGAGAGTCCGGCAATGGTGTGGCTGTGGGGTTAG	1	bc
TTAGAAATTT	GAAACACCGGTTAGAGCTAGAAATAGCAAGTTAACCTAAGGCTAGTCCGT	1	bc
GAAAGCACGA	GAAACACCGGTCAGCGGCAAGCGTGGAGCGAGTTAGAGCTAGTTAACGTA	1	bc
AGAGGAGCCT	GAAACACCGGTTCCCGTCCAGTGGGGTTAGAGCTAGAAATAGCAAGTTAA	1	bc
GGTGGGGCCT	GAAACACCGGTTCCCGTCCAGTGGGGTTAGAGCTAGAAATAGCAAGTTAA	1	bc
ACACAGAATG	GAAACACCGGTGTGGCTGAGAGTCAGACAAAGGAAGTGAAGTGAAGGTTG	1	bc
TAATACCAGC	GAAACACCGGTCGGGGATAGAGCTAGAAATAGCGAGTTAACCTAAGGCTA	1	bc
CGCTCCTCGC	GAAACACCGGTGCATTCGAAAGTCCGGTGGTAGTGTGGACGTGGGGTTAG	1	bc
AAGGCTGCCT	GAAACACCGGTCCGTAGGAGACCCGTGTGGCATGTACCTGTGGGGTTAGA	1	bc
ATGAGAATAC	GAAACACCGGTTAAGCCGAGTGGGGTTAGAGCTAGAAATAGCAAGTTAAC	1	bc
AGTAGACTTG	GGAACACCGGTCGGCGGCAATCGTGGATGGGGATAGAGCTAGAGATAGCA	1	bc
GCATTTACCG	GAAACACCGGTCGGGGCCACTCAGTGGTGGGGTTAGAGCTAGAAATAGCA	1	bc
ATGACTTATT	GAAACACCGGTAACTATATTCATGCGATATCGCCGTATCAGTGGGGTTAG	1	bc
ATAATCGGTC	GAAACACCGGTACCTTTGTTGATGCTGGGTGGAAGGAATGTGGGGTTAGA	1	bc
CCACGCGGCA	GAAACACCGGTACCTTTGTTGATGCTGGGTGGAAGGAATTTATGTGGGGT	1	bc
AGGCTCAGGT	GAAACACCGGTTTACGTTGCATCGGTGTGGGGTTAGAGCTAGAAATAGCA	1	bc
GGAAGAACCG	GAAACACCGGTCGGCGGCAAGTGGGGGTAGAGCTAGAGCTAGCAAGTTAA	1	bc
GACATGCGGT	GAAACACCGGTCGATTCATATCGAAACCTTCCCGTGACAGTGGGGTTAGA	1	bc
CAGAGTCTTC	GAAACACCGGTGTACGTATGGACTGAACCAGGGTGTGCAAGTGGGGTTAG	1	bc
GGCACATAAA	GAAACACCGGTAAATTTGAGGCTCCGGCATGCAGGAGGCCGTGGGGTTAG	1	bc
GACACGGCTA	GAAACACCGGTAGCAAGTGCGAGCAAGCTTTTGTGGGGTTAGAGCTAGAA	1	bc
GCAACCGATA	GAAACACCGGTAGCAAGTGCGAGACGTGTTAAATAGCAAGTTAACCTAAG	1	bc
GAGGTCCCTC	GAAACACCGGTCGGCAGCAAACGTGGGTGGGGTTAGAGCTAGAGGTAGCA	1	bc
AACTTTACCG	GAAACACCGGTCGAGGCCACTCAGTGGTGGGGTTAGAGCTAGAAATAGCA	1	bc
AAGGCACTCC	GAAACACCGGTTTCCTTACTCTCACCTTATTACTTTATCCGTGGAGTTAG	1	bc
GCAGAACTGC	GAAACACCGGTCGGTGGGGTTAGAGCTAGAAATAGCAAGTTAACGTAAGG	1	bc
GGTGTTGGCG	GAAACACCGGTGACATTGGGGTTAGAGCTAGAAATAGCAATAACAAGTTA	1	bc
GGCTACCTAC	GAAACACCGGTGTGGCTGAGAGTCCGGCAATGGTGTGGCTGTGGGGTTAG	1	bc
ATTGCGCATA	GAAACACCGGTTAAGCCGAGGGTGGGGTTAGAGCTAGAAATAGCAAGTTA	1	bc
GGTATACTCC	GAAACACCGGTGCGGCTGAGGGTCCGACAATGGGGGTGCTGGGTGGTTAT	1	bc
ACTGAGCATA	GAAACACCGGTTAAGCCGAGGGTTAGAGCTAGAAATAGCAAGTTAACCTA	1	bc
TCAATCATAC	GAAACACCGGTAACTATATTCATTCGATATCGCCGTATCAAGAGGTATAA	1	bc
TCGCCCTGCA	GAAACACCGGTGCATTCGAAAGTCCGGTCGTAGTGTGGACGTGGGGTTAG	1	bc
GCAGACGTGC	GAAACACCGGTCGGCGGCAATCGTGGGTGGGGTTAGAGCTAGAAATAGCA	1	bc
GCAACAGAGC	GAAACACCGGTAGCAAGTGCGAGACGTGTTTGTGGGGTTAGAGCTAGAAA	1	bc
TAACCCTGAC	GAAACACCGGTAGCAAGTGGGGTTAGAGCTAGAAATAGCCAGTTAACCTA	1	bc
CTCACCTACG	GAAACACCGGTGCCCTTACTCTCACCTGATTACTTAATCCGTGGGGTTAG	1	bc
AACGCCCCCT	GAAACACCGGTTTGAACTACCTAGTTCAAACCGGTGGGGTTAGAGCTAGA	1	bc
GACTAATCGG	GGAACACCGGTACCTTTGTTGATGCTGGGTGGAAGGAATTCCACCCAGCA	1	bc
TTATTTGTTT	GAAACACTGGTCGATTCATATCGAAACCTTCCCGTGACAGTGGGGTTAGA	1	bc
CGTCTTTGCT	GAAACACCGGTGAACTTAGGGATTGAACCAGGCATAGCAAGTTGGCCTAG	1	bc
ACGTACCCGC	GAAACACCGGTCGGGGCCACTCAGTGGTGGGGTTAGAGCTAGAAATAGCA	1	bc
CAAGACGGGC	GAAACACCGGTCGGCGGCAGTCGTGGGTGGGGTTAGAGCTAGAAATAGCA	1	bc
AGAGGACACG	GAAACACCGGTCCGCGGCAATCGTGGGTGGGGTTAGAGCTAGAAATAGCA	1	bc
ATAAAGTAGA	GAAACACCGGTTACTAGATTCATGCGATGTCGCCGGAGCAGGGGGGGTTA	1	bc
GAGGCTGCCT	GAAACACCGGTCCGTAGGAGACCCGTGTGGCATGTACCTGTGGGGTTAGA	1	bc
AATTGAGCAT	GAAACACCGGTTAAGCCGTGGGGTTAGAGCTAGAAATAGCAAGTTAACCT	1	bc
AGATACAGAC	GAAACACCGGTAGCAAGTGGGGTTAGAACTAGAAATAGCAAGTTAACCTA	1	bc
GCATTCGGGC	GAAACACCGGTCGATTCATATCGAGACCTTCCCCTCGCGGGGGGGGTAGA	1	bc
CATTTTCTGC	GAAACACCGGTCGGGGCCACTCAGTGGTGGGGTTAGAGCTAGAAATAGCA	1	bc
GTAGGCACGC	GAAACACCGGTCGGCGGCAATCGAGGGGGGGGTTAGAACTAGAAATAGCA	1	bc
GGCCCACGTC	GAAACACCGGTGTGGCTGAGGGTTCGACCATGGTGTGGCTGTGGGGTTAG	1	bc
GACAGCCCTA	GAAACACCGGTGCCCTTACTCTCACCTGATTACTTAATCCGTGGGGTTAG	1	bc
ACTAATCGGT	GAAACACCGGTACCTTTGTTGATGCTGGGTGGAAGGAATTTTGTGGGGTT	1	bc
ACGAAGTCTT	GAAACACCGGTCTCGAGGGATGTGTTCAGGGTGGGGTTAGAGCTAGAAAT	1	bc
ACTAATCGGC	GAAACACCGGTACCTTTGTTGATGCTGGGTGGAAGTGGGGTTAGAGCTAG	1	bc
AAACTCCCTA	GAAACACCGGTGCCCTTACTCTCACCTGATTACTTAATCCGTGGGGTTAG	1	bc
AAAACCCCTC	GAAACACCGGTGCCCTTACTCTCACCTGATTACTTAATCCGTGGGGTTAG	1	bc
GGGACCATCA	GAAACACCGGTGTGGCTGAGAGTCCGGCAATGGTGTGGCTGTGGGGTTAG	1	bc
GAAGGAGCGC	GAAACACCGGTCGGCGGCAATCGTGGGTGGGGTTAGAGCTAGAAATAGAA	1	bc
AAATCTGCCT	GAAACACCGGTCCGTAGGAGACCCGTGTGGCATGTACCTGTGGGGTTAGA	1	bc
