ACGTCGCGGA	GAAACACCGGTAGAACATGGTCGACATATAGTGGGGTTAGAGCTAGAAAT	10	bc
AAGACACTCG	GAAACACCGGTGCATTCGAAAGTCCGGTCGTAGTGTGGACGTGGGGTTAG	3	bc
CTCCCCTGCA	GAAACACCGGTGTGGCTGAGAGTCCGGCAATGGTGTGGCTGTGGGGTTAG	3	bc
ACATAGTCGT	GAAACACCGGTGTACGTATGGACTGAACCAGGGTGTGCAAGTGGGGTTAG	2	bc
ACGTCGCGGA	GAAACACCGGTAGAACATGGTCGACATATAGTGGGGTTAGAGCTATAAAT	2	bc
ACCTTTAGCG	GAAACACCGGTCGGGGCCACTCAGTGGTGGGGTTAGAGCTAGAAATAGCA	2	bc
AGTGGAGCAT	GAAACACCGGTTCCCGTCCAGTGGGGTTAGAGCTAGAAATAGCAAGTTAA	2	bc
ACGTCGCGGA	GAAACACCGGTAGAACATGGTCGACATACAGTGGGGTTAGAGCTAGAAAT	1	bc
ACGTCGCGGA	GAAACACCGGTAGAACATGGTTGACATATAGTGGGGTTAGAGCTAGAAAT	1	bc
AGAAGAGCCG	GAGACACCGGTCGGCGGCAATCGGGTTAGAGCTAGAAATAGCAAGTTAAC	1	bc
TTAGCGCCTT	GAAACACCGGTTACATTGAGGGGTTAGAGCTATAAATAGCAAGGTAAACT	1	bc
TAAGATAAGT	GAAACACCGGTTACAGTGAGATCTCTTTTGTGGTGGTAGAGGTAGAAATA	1	bc
AGGAACCCTC	GAAACACCGGTGTGGCTGAGAGTCCGGCAATGGTGTGGCTGTGGGGTTAG	1	bc
AGAAGAAGCG	GAAACACCGGTCGGCGGCAATCGAGGGTGGGGATAGAGCTAGAAATAGCA	1	bc
TATAACGCCA	GAAACACGGGTTAGAGTTAGAAATAGCAAGTTAACCTAATACTAGTCCGT	1	bc
ACGACCCGCG	GAAACACCGGTGCATTCGAAAGTCCGGTCGTAGTGTGGACGTGGGGTTAG	1	bc
ACACCCGGCC	GAAACACCGGTAGCTTGTTCGAGACGGGTTAAATAGCAAGTTAAGGTAAT	1	bc
CTAATATGTT	GAAACACCGGTCGATTCATATCGAAACCTTCCCGTGACAGTGAGGTTAGA	1	bc
GGCCACTAAC	GAAACACCGGTAAATTTGAGGCTCCGGCATGCAGGAGGCCGTGGGGTTAG	1	bc
AGCATCGTTT	GAAACACCGGTCTCGAGAGGGGTGTTCAGGGCGGGGTTAGAGCTAGAAGT	1	bc
GCAGTCCCTC	GAAACACCGGTCGGCGGCAATCGTGGGTGGGGTTAGAGCTAGAAATAGCA	1	bc
CAGATCGTTT	GAAACACCGGTCTCGAGTGAGGTGTTCAGGGTGGGGTTAGAGCTAGAAAT	1	bc
AGACGCTAGA	GAAACACCGGTGCATTCGAAAGTCCGGTCGTAGTGTGGACGTGGGGTTAG	1	bc
GAACAACGCC	GAAACACCGGTTTGAACTAGAAATAGCAAGTTAACCTAAGGCTAGCCCGT	1	bc
GTAGCTTCGT	GAAACACCGGTTACATTGAGTGGGGTTAGAGCTAGATATAGCAAGTTAAC	1	bc
GAATCCCCTC	GAAACACCGGTCGGCGGTTATCGCTAGAAATAGCAAGTTAACCTAAGGCT	1	bc
AGGATAGGTT	GAAACACCGGTCGATTCATATCGAAACCTTCCCGTGACAGTGGGGTTAGA	1	bc
GTGTGGCTTC	GAAACACCGGTTACCCCGCTGTGCGTTTATCGCTAGAGATATCAAGATAA	1	bc
AGAAGCATGA	GAAACACCGGTGAATTCGAAAGTCCGGTCGTAGTGTGGACGAGGGGATAG	1	bc
AATTAGCTAT	GAAACACCGGTTACATTGAGATTGGGGTTAGAGCTAGAAATAGCAAGTTA	1	bc
AATCGGTGAC	GAAACACCGGTGAGGACTTGCGCAGTGCGAGTGGGGTTAGAGCTAGAAAT	1	bc
TAGTGTTGTA	GAAACACCGGTGACATTGGGTATTGGGTACAGGGAGAGGTTAGAGCTAGA	1	bc
CCTTGGCTTC	GAAACACCGGTGTACGTATGGACTGAACCAGGGTGTGCAAGTGGGGTTAG	1	bc
GCAGAGACGC	GAAACACCGGTCGGCGGCAATCGTGGGTGGGGTTAGAGCTAGAAATAGCA	1	bc
CCTCGTCTTA	GAAACACCGGTGTACGTATGGACTGAACCAGGGTGTGCAATTAGAGCTAG	1	bc
GCATCGAGGT	GAAACACCGGTGTACGTATGGACTGAACCAGGGTGTGCAAGTGGGGTTAG	1	bc
AAATAAGTCT	GAAACACCGGTTACAACTACCACGAGCTAGGAATAGAACGATAAACTACA	1	bc
AAATGTCCTA	GAAACACCGGTGCCCTTACTCTCACCTGATTACTTAATCCGTGGGGTTAG	1	bc
ATACCTTATA	GAAACACCGGTAACTATATTCATGCGATATCGCCGTATCAGTGGGGTTAG	1	bc
CATGTTGAAG	GAAACACCGGTGACATTGGGTACGAGGGTGGGGTTAGAGCTAGAAATAGC	1	bc
ACCTTTCCCG	GAAACACCGGTCGGGGCCACTCAGTGGTGGGGTTAGAGCTAGAAATAGCA	1	bc
GGCCCATCCC	GAAACACCGGTAACTTTGAGTCTCCGGCATGCAGGAGGCCGTGGGGTTAG	1	bc
CTACTCATAC	GAAACACCGGTAACTATGTTGATGCTAGGTGGCCGTATCAGTTGGGGTAG	1	bc
TCTACCCCGG	GAAACACCGGTTATATTTGTAAGTGTGTGGGGTTAGAGCTAGAAATAGCA	1	bc
GAAACTGATA	GAAACACCGGTAGCAAGTGCGAGACGTGTTGGGGGGGTTAGAGATAGAAA	1	bc
ATACTTGGCG	GAAACACCGGTACATTTGTTGATGCTGGGTGGAAGGAATTTGTGGGGTTA	1	bc
ATAATCGGAC	GAAACACCGGTACCTTTGTTGATGCTGGGTGTGGTTAGAGCTAGAAATAG	1	bc
CTGATCACTT	GAAACACCGGTCTCGAGTGAGGCGTTCAGGGGGGGGTTAGAGCTAGAAAT	1	bc
CCCAACGACT	GAAACACCGGTTTGAACTAGAAATAGCAAGTTAACCTAAGGCTAGTCCGT	1	bc
ACTTTCCCAC	GAAACACCGGTCGGGGCCGAGCTAGAAATAGCAAGTTAACCTAAGGCTAA	1	bc
AAGGCCCCTC	GAAACACCGGTGCCCTTACTCTCACCTGATTACTTAATCCGTGGGGTTAG	1	bc
GTAGATATGC	GAAACACCGGTTACATTGAGGGTTAGAGCTAGAAATAGCAAGTTAACCTA	1	bc
ACGTGGTGTC	GAAACACCGGTGACATTGGGAGTGGGGTTAGAGCTAGAAATAGCAAGTTA	1	bc
TTTGACCATA	GAAACACCGGTTAAGCCGAGGAGTTAGAGCTAGAAATAGCAAGTTAACCT	1	bc
ACATCGTAGT	GAAACACCGGTGTACGTATGGACTGAACCAGGGTGTGCAAGTGGGGTTAG	1	bc
GCCTTTACCT	GAAACACCGGTCGGGGCCACTCAGTGGTGGGGTTAGAGCTAGAAATAGCA	1	bc
CATTTGCCCC	GAAACACCGGTCTGGGCCACTCAGTGGTGGGGTTAGAGCTAGAAATAGCA	1	bc
TTGCCACTGT	GAAACACCGGTTACATTGAGAGGGGTTAGAGCTAGAAATAGCAAGTTAAC	1	bc
AAGAAGGCCC	GAAACACCGGTTTGAACTAGAAATAGCAAGTTAACCTAAGGCTAGGCCGT	1	bc
AAACCCCCGG	GAAACACCGGTGCAATCTAACATCCGGTCGTAGTGTGGCCGTGGGGATCG	1	bc
ATAATCGGAC	GAAACACCGGTACCTTTGTTGATGCTGGGTGGAAGGAGCTGGGTGGGGTT	1	bc
CTCCCCTGCA	GAAACACCGGTGTGGCTGAGAGTCCGGCAATGGTGTGGCTGAGGGGTTAG	1	bc
AAAGCCCTTA	GAAACACCGGTGCCCTTACTCTCACCTGATTACTTAATCCGTGGGGTTAG	1	bc
TTAGCAAGGA	GAAACACCGGTTACATTGAGGGTTAAAGCTAGAAATAGCAAGTTAACCTA	1	bc
GCACAACTTC	GTGTGGGGTTAGAGCTAGAAATAGCAAGTTAACCTAAGGCTAGTCCGTTA	1	bc
AGAGACCCTC	GAAACACCGGTGCATTCGAAAGTCCGGTCGTAGTGTGGACGTGGGGTTAG	1	bc
GACGACGAGC	GAAACACCGGTAGGCGGCAATCGGATTAGAGGTAGAAGTTACAAGTTACA	1	bc
AGGTACCCTC	GAAACACCGGTGTGGCTGAGAGTCCGGCAATGGTGTGGCTGTGGGGTTAG	1	bc
GCGGAGAATC	GAAACACCGGTTCCCGTCCAGTGGGGTTAGAGCTAGAAATAGCAAGTTAA	1	bc
TACGATATCT	GAAACACCGGTTTCATTTACCTCTCTGTTGGGGTAGTAGAGCTAGTAGTA	1	bc
CCCGACGCTC	GAAACACCGGTTTGAACTACCTGGGGCTATAGCTAGAACTAGCAAGTTAA	1	bc
GCTACTCTGA	GAAACACCGGTACCTTTGTTGATGCTGGGTGGAAGGAATTTGGTGGGGTT	1	bc
GCGAATGCTT	GAAACACCGGTCTCGAGTGAGGGGTTCATTCAGGTGGGGTTAGAGCTAGA	1	bc
CTATGTCTAG	GAAACACCGGTTTACGTTTCATCGGTGTGGGGTTAGAGCTAGAAATAGCA	1	bc
AAGTCTGCAT	GAAACACCGGTCCGTAGGAGACCCGTGTGGCATGTACCGGTGGGGTTAGG	1	bc
TCTCTAATTC	GAAACACCGGTTACATTAAGCTTGGGATAACGCAAGATCAGTCCGGTTAG	1	bc
AAGCCATGCT	GGAACACCGGTTTACGTTGCGGGTTAGAGCTAGAGGTAGCAAGTTAACCT	1	bc
TAGATCGTAA	GAAACACCGGTTAAGCCGAGGAGTTAGAGCTAGAAATAGCAAGTTAACCT	1	bc
ATTGAGCATC	GAAACACCGGTTAAGCCGAGTGGGGTTAGAGCTAGAAATAGCAAGTTAAC	1	bc
CGCCACTCGC	GAAACACCGGTGCATTCGAAAGTCCGGTCGTAGTGTGGACGTGGGGTTAG	1	bc
TGTGTCGTGG	GAAACACCGGTTATATTTGGGATAGGGGTTGGAGTTAGAAATAGCAATAT	1	bc
CAAACCGCAC	GCTAGAAATAGCAAGTTAACCTAAGGCTAGTCCCTTATCAACTTGAAAAA	1	bc
AGTCGTAGTC	GAAACACCGGTGTACGTATGAACTGATCCAAGGTGTGCAAGTGGGGTTAG	1	bc
ATCAACGCTC	GAAACACCGGTTTGAACTACCTAGTTCAAAGAGCTAGAAATAGCAAGTTA	1	bc
ACTACTCGGA	GAAACACCGGTACCTTTGTTGATGCTGGGTGGGGTTAGAGCTAGAAATAG	1	bc
GGCCTCATCC	GAAACACCGGTAAATTTGAGGCTCCGGCATGCAGGAGGCCGTGGGGTTAG	1	bc
ACGCCTACCT	GAAACACCGGTTTACGTTGCATCGTTGTGGGGTTAGAGCTAGAAATAGCA	1	bc
ATATCGTCGT	GAAACACCGGTGTACGTATGGACTGAACCAGGGTGTGCAAGTGGGGTTAG	1	bc
CAATGCTTAG	GAAACACCGGTTTACGTTGCATCGGTGTGGGGTTAGAGCTAGAAATAGCA	1	bc
GCGGCGACTA	GAAACACCGGTTCCCGTCCAGTGGGGTTAGAGCTAGAAATAGCAAGTTAA	1	bc
ATATACTCGC	GAAACACCGGCGCATTCGAAAGTCCGGTCGTAGTGTGGACGTGGGGTTAG	1	bc
TATGACACGC	GAAACACGGGTCGGCGGCAATCGTGGGTGGGGTTAGAGCTAGAAATAGCA	1	bc
ACCTTTAACG	GAAACACCGGTCGGGGCCACTCAGTGGTGGGGTTAGAGCTAGAAATAGCA	1	bc
ACGAATCGTT	GAAACACCGGTCTCGAGTGAGGTGTTCAGGGTGGGGTTAGAGCTAGAAAT	1	bc
AGTGATGTCA	GAAACACCGGTGACATTGGGTACAGGGTGGGGTTAGAGCTAGAAATAGCA	1	bc
AGACCATCTA	GAAACACCGGTGCATTCGAAAGTCCGGTCGTAGTGTGGACGTGGGGTTAG	1	bc
AACATCGTCG	GAAACACCGGTGTACGTATGGACTGAACCAGGGTGTGCAAGTGGGGTTAG	1	bc
ATTGAGCATC	GAAACACCGGTTAAGCCGAGGTTAGAGCTAGAAATAGCAAGTTAACCTAA	1	bc
ATAGCTTATA	GAAACACCGGTAACTATATTCATGCGATATCGCCGTATCAGTGGGGTTAG	1	bc
TATCCCGCTC	GAAACACCGGTCAGTAGGAGATCCGTGTGGCATTTACCTTAGGGGTCACA	1	bc
CAACACGGCA	GAAACACCGGTACCTTTGTTGATGCTGGGTGGAAGGAATTTTGTGGGGTT	1	bc
ACAGAACGCC	GAAACACCGGTTTGAACTAGAAATAGCAAGTTAACCTAAGGCTAGTCCGT	1	bc
ATGGGTATCT	GAAACACCGGTTTACGTTGCATCGGTTGTGGGGTTAGAGCTAGAAATAGC	1	bc
TAGGTGCCGC	GAAACACCGGTTCCCGTCCAGTGGGGTTAGAGTTAGAAATAGAAAGTTAA	1	bc
GAACCAGAAA	GAAACACCGGTAGCAAGTGCGAGACGTGTTTTTGTGGGGTTAGAGCTAGA	1	bc
CGCCACTCAA	GAAACACCGGTTTATTTGAGTCTCCGGCATGCAGGAGGCGTGGGGTTAGA	1	bc
CGGAACCTTA	GAAACACCGGTATCGAGTGAGGTGTTCAGGGTGGGGTTAGAGCTAGAAAT	1	bc
GACGGCGACC	GAAACACCGGTAGCAAGTGCGGGGGGGTTAGAGCTAGAAATACCAAGTTA	1	bc
TGGCACCTTC	GAAACACCGGTGTGGCTGAGAGTCCGGCAATGGTGTGGCTGTGGGGTTAG	1	bc
ACGTCGCGGC	GAAACACCGGTAGAACATGGTCGACATATAGTGGGGTTAGAGCTAGAAAT	1	bc
ACCATTCGGG	GAAACACCGGTCGATTCATATCGAAACCTTCCCGTGGGGTTAGAGCTAGA	1	bc
ACGTTTGTTC	GAAACACCGGTCGATTCATATCGAAACCTGGGCGAGAGAGTGGGATAAGA	1	bc
CGCGTGGGCT	GAAACACCGGTTTGATAGAAATAGCAAGTTAACCTAAGGCTAGTCCGTTA	1	bc
GCCACAGATC	GAAACACCGGTAAAGCGTTAGCGTCATATTACGCCGATAGCGAGTTGGAG	1	bc
AAGAATCCTT	GAAACACCGGTCTCGAGTGAGGTGTTCAGGGGTGGGGTTAGAGCTAGAAA	1	bc
GCGGGCACGC	GAAACACCGGTCGGCGGCAATCGTGGGTGGGGTTAGAGCTAGAAATAGCA	1	bc
TATCGCTGTC	GAAACACCGGTGAACGAATGGACTGAACCAGGGCGTGCAAGTGGGGTTAG	1	bc
ATAGCGATTT	GAAACACCGGTTACATTGGGGTTAGAGCTAGAAATAGCAAGTTAACCTAA	1	bc
GTAGCTCTTT	GAAACACCGGTTCCCTTCCAGTTAGAGTAAGACAAAGAATAGCAACCTAA	1	bc
TGAACTGTGT	GAAACACCGGTTCCTTTTGAGGGTATAGAGCTGGAAATAGCTAGTTAACC	1	bc
ACAGACGCTT	GAAACACCGGTCGCTGCATGTCGAACCCTTCCCGGGACAGTGAGGTTAAC	1	bc
TGTGGCGCCT	GAAACACCGGTTCCCGTCCAGTGGGGTTAGAGCTAGAAATAGCAAGTTAA	1	bc
GTAGCTCCGC	GAAACACCGGTTGGCGGTTAGGGCTAGAGATAGAAAGATCAACTAAAGCT	1	bc
ACTACTCGGA	GAAACACCGGTACCTTTGTTGATGCTGGGTGGAAGGAATTTTGTGGGGTT	1	bc
GGTGCCATCC	GAAACACCGGTGTGGCTGAGAGTCCGGCAATGGTGTGGCTGTGGGGTTAG	1	bc
CAATACTCGG	GAAACACCGGTACCTTTGTTGATGCTGGGTGGAAGGAGCTAGATGCTGGT	1	bc
CGAGTTTCCT	GAAACACCGGTGACATTAGGTTAAGGCTAGAAGTATTAAGTTAACCTAAA	1	bc
TGCTATCGAT	GAAACACCGGTTATATTTGTAAGTGTGTGGGGTTAGAGCTAGAAATAGCA	1	bc
ATAACTTATT	GAAACACCGGTAACTATATTCATGCGATATCGCCGTATCAGTGGGGTTAG	1	bc
AACACAGCCC	CCACGGGTTAGAGCTAGAAATAGCAAGTTAACCTAAGGCTAGTCCGTTAT	1	bc
GAATATCGAG	GAAACACCGGTTATATTTGTAAGTGTGTGGGGTTAGAGCTAGAAATAGCA	1	bc
CCCTTAGGTT	GAAACACCGGTCGATTCATATCGAAACCTTCCCGTGACAGTGGGGTTAGA	1	bc
CTAACAGGCA	GAAACACCGGTACCTTTGTTGATGCTGGGTGGGGTTAGAGCTAGAAATAG	1	bc
TTAATTATAA	GAAACACCGATAACTATATTCATGCGATATCGCCGTATCAGTGGGGTTAG	1	bc
ATGTTGCGTC	GAAACACCGGTTGCCTTACAGTGAGATTATAGCGAGAAAGCGCGATTTGA	1	bc
ACCGCCCCCC	GAAACACCGGTGCCCTTACTCTCACCTGATTACTTAATCCGTGGGGTTAG	1	bc
CTGAGTAGAT	GAAACACCGGTTTACGTTGCATCGGTGTGGGGTTAGAGCTAGAAATAGCA	1	bc
AGTCCCCTAC	GAAACACCGGTAAATTTGAGGCTCCGGCATGCAGGAGGCCGTGGGGTTAG	1	bc
AGGGACTCTC	GAAACACCGGTTCATTCGAAAGTCCGGTCGTAGTGTGGACGTGGGGTTAG	1	bc
GACGTCCTAA	GAAACACCGGTGCCCTTACTCTCACCTGATTACTTAATCCGTGGGGTTAG	1	bc
TTTATCGCCC	GAAACACCGGCTCGCTTGGTGTTTTTATCAAGTTAGCGCTAGACATAGCC	1	bc
TCCTTTCGGT	GAAACACCGGTCGATTCATATAGAAACCTTCCCGTGACAGTGAGGTTAGA	1	bc
ACGGGTTGTC	GAAACACCGATGACATTGGGTATAGGGTGGGGTTAGAGCTAGAAATAGCA	1	bc
GACCTTCAAC	GAAACACCGGTAACTATATTCATGAGTTCTCGCCGTGTCCGTGGGGTTAG	1	bc
GGTATCCTTC	GAAACACCGGTGTGTCTGAGAGTCCGGCAACGGGGTGGCTGGGGGGTTAG	1	bc
CCTTGATAGC	GAAACACCGGTCGGGGCCACTCAGTGGTGGGGTTAGAGCTAGAAATAGCA	1	bc
AGAGGAGACA	GAAACACCGGTTCCCGTCCAGTGGGGTTAGAGCTAGAAATAGCAAGTTAA	1	bc
ACGAATGCTT	GAAACACCGGTCTCGCGTGAGGTGTTCAGGGTGGGGTTAGAGCTAGAAAT	1	bc
CGCAAGGTCT	GAAACACGGGTTAGAGCTAGAAATAGCAAGTTAACCTAATGCTAGTCTGT	1	bc
GAGCCATACA	GAAACACCGGTAGCAAGAGCGGGTTAGAGCTAGAAATAGCAAGTTAACCT	1	bc
CCCCGCGCCC	GAAACACCGGTTTGAACTACCTAGTTCAAACCGGTGGGGTTAGAGCTAGA	1	bc
ACTACTTGGA	GAAACACCGGTACCTTTGTTGATGCTGGGTGGAAGGAAATAGCAAGTTAA	1	bc
AAACGCCGTA	GAAACACCGGTGCCCTTACTCTCACCTGATTACTTAATCCGTGGGGTTAG	1	bc
AATGTCGTAC	GAAACACCGGTGCCCTTACTCTCACCTGATTACTTAATCCGTGGGGTTAG	1	bc
CCTTTTAGGC	GAAACACCGGTTGGGGTCACACAGTGGTGGGGTTAGAGCTAGAAATAGCA	1	bc
ATTAGCCATT	GAAACACCGGTTACATTGAGGGGTTAGAGCTAGAAATAGCAAGTTAACCT	1	bc
TGGGTCGTCT	GAAACACCGGTGACATTGGGTACAGGGTGGGGTTAGAGCTAGAAATAGCA	1	bc
AGATTCTCTC	GAAACACCGGTGCATTCGAAAGTCCGGTCGTAGTGTGGACGTGGGGTTAG	1	bc
ATACTTTGGT	GAAACACCGGTGCATTCGAAAGTCCGGTCGTAGTGTGGACGTGGGGTTAG	1	bc
TTCCGCTACA	GAAACACCGGTAAATTTGAGGCTCCGGCATGCAGGATGCCGTGGGGTTAG	1	bc
CGCAAAGCCA	GAAACACCGGTTAGAGCTAGAAATAGCAAGTTAACCTAAGGCTAGTCCGT	1	bc
CGTCTGTCTA	GAAACACCGGTACGCAGGAGACCCGAGTGGCATGAACGTGTGGGGTAACA	1	bc
CAACTTGTAA	GAAACACCGGTAACTATATTCATGCGATATCGCCGTATAAGTGGGGTTAG	1	bc
GGGGCGCCCC	GAAACACCGGTTCCCGTGCAGTTGGGGTAAAGCTAGAGATAGCAAGTTAA	1	bc
CGACTCAGTT	GGAACACCGGTTTCGAGTGACGTGTTCAGGGTGGGGTTAGAGCTAGAAAT	1	bc
GCCTTTACGG	GAAACACCGGTCGGGGCCACTCAGTGGTGGGGTTAGAGCTAGAAATAGCA	1	bc
ACGCACTCGC	GAAACACCGGTGCATTCGAAAGTCAAGTCGGAGTATGGACAGAGGGTTCG	1	bc
GATAAATCTT	GAAACACCGGTTTGAACTAGAAATAGCAAGTTAACCTAAGGCTAGTCCGT	1	bc
AGAAACAGAC	GAAACACCGGTAGCAAGTGCGAGACGTGTTTGTGGGGTTAGAGCTAGAAA	1	bc
AGTGGTGCCT	GAAACACCGGTTCCCGTCCAGTGGGGTTAGAGCTAGAAATAGCAAGTTAA	1	bc
CAACGTCGGT	GAAACACCGGTGAACGTATGGACTGAACCAGGGTGGGCAAGTGGGGTTAG	1	bc
TTGCTTACTC	GAAACACCGGTTTACGTTGCATCGGTGTGGGGTTAGAGCTAGAAATAGCA	1	bc
GTTATCGGCC	GAAACACCGGTACCCGGTGGGGTTAGAGCTAGAAATAGCAAGTTAACCTA	1	bc
AGGCCCCCTC	GAAACACCGGTGTGGCTGAGAGTCCGGCAATGGTGTGGCTGTGGGGTTAG	1	bc
AGTAGCAATG	TTAACCTAAGGCTAGTCCGTTATCAACTTGAAAAAGTGGCACAGAGTCGG	1	bc
GGAACACACC	GAAACACCGGTGCATTCGACAGTCCGGGCGTGGTGTGGACGTGGGGTTAG	1	bc
AAGGGTCTAC	GAAACACCGGTGCCCTTACTCTCACCTGATTACTTAATCCGTGGGGTTAG	1	bc
CCGATTAGCC	GAAACACCGGTTTACGGGGCTTCGGCGTGGGGTTAGAGCTAGAAATAGCA	1	bc
AGATTGGGTC	GAAACACCGGTCGGTAGATATCGAAACCTTCCAGTGACAGTGGGGTTAGA	1	bc
GAGCGCGGCC	GAAACACCGGTACCTTTGTTGATACAACAAAGAGCTAGAAATAGCAAGTT	1	bc
AGCAACGGCC	GAAACACCGGTTTGAACTAACTAGTTCCAACCGGTGGGGTTAGAGCTAGA	1	bc
AGTGTTGGGT	GAAACACCGGTGACATGGGGTTAGAGCTAGAGATAGCGAGATAACCTAAG	1	bc
GTGGCGGATA	GAAACACCGGTTCCAGTCCAGTGGGACTAGAGCTAGAAATAGCAAGTTCA	1	bc
ACCTCGTCGT	GAAACACCGGTGTACGTATGGACTGAACCAGGGTGTGCCTGTGGGTTAGA	1	bc
AAGACGCTCG	GAAACACCGGTGCATTCGAAAGTCCGGTCGTAGTGTGGACGTGGGGTTAG	1	bc
ACATTGCCTC	GAAACACCGGTCCGTAGGAGACCCGTGTGGCATGTACCTGTGGGGTTAGA	1	bc
GCAGATCGGC	GAAACACCGGTCGGCGGCAATGTGGGGTTAGAGCTAGAAATAACAAGTTA	1	bc
AATAGGCGTC	GAAACACCGGTGTACGTATGGACTGAACCAGGGTGTGCAAGTGGGGTTAG	1	bc
ACGTCGCGGA	GAAACTCCGGTAGAACATGGTCGACATATAGTGGGGTTAGAGCTAGAAAT	1	bc
ACGGCCTTCT	GAAACACCGGTGCCCTTACTCTCACCTGATTACTTAATCCGTGGGGATAG	1	bc
GACTAATCGG	GAAACACCGGTACCTTTGTTGATGCTGGGTGGAAGGAATGTGGGGTTAGA	1	bc
GTCACCATCA	GAAACACCGGTGTGGCTGAGAGTCCGGTAATGGTGTGGCTGTGGGGTTAG	1	bc
GATTACCGGC	GAAACACCGGTCGGCGGCAATCGTGGGTGGGGTTAGAGCTAGAAATAGCA	1	bc
ACCTTACAGC	CAAAACACCGGTCGGGGCCACTCAGTGGTGGGGTTAGAGCTAGAAATAGC	1	bc
GTGAATCACC	GAAACACCGGTTCCCGTCCAGTGGGGTTAGAGCTAGAAATAGCAAGTTAA	1	bc
GGTGAGCATA	GAAACACCGGTTAAGCCGAGTGGGGTTAGAGCTAGAAATAGCAAGTTAAC	1	bc
AACTTTAGCG	GAAACACCGGTCGGGGCCACTCAGTGGTGGGGTTAGAGCTAGAAATAGCA	1	bc
TGGTAATCCA	GAAACACCGGTCGTAGAGCTAGAAATAGCAATTTAACCTAAGGCTAGTCC	1	bc
AGAAGCCCCG	GAAACCTAGAAATAGCAAGTTAACCTAAGGCTAGTCCGTTATCAACTTGA	1	bc
GTGCCAGACA	GAAACACCGGTAGCAAGTGCGTGGGGTTAGAGCTAGAAATAGCAAGTTAA	1	bc
ACCAAACGCC	GAAACACGGGTTAGAGCTAGAAATAGCAAGTTAACCTAAGGCTAGTCCGT	1	bc
ACCCCCCTCC	GAAACACCGGTGTGGCTGAGAGTCCGGCAATGGTGTGGCTGTGGGGTTAG	1	bc
TCCTGGGGCC	GAAACACCGGTACCTTTGTTGATGCTGGAGCTAGAAATAGCAAGTTAACC	1	bc
ACACGCACTA	GAAACACCGGTGCCCTTACTCTCACCTGATTACTTAATCCGTGGGGTTAG	1	bc
TTGACCCTCC	GAAACACCGGTGTGGCTGAGAGTCCGGCAATGGTGTGGCTGTGGGGTTAG	1	bc
GAGGCTCGTC	GAAACACCGGTTCCCGTCCAGTGGGGGTAGAGCTAGAGATAGCAAGTTAA	1	bc
ACCCACGCCC	GCAACACCGGTTTGAACTAGAAATAGCAAGTTAACCTAAGGCTAGTCCGT	1	bc
GATACCCTCG	GAAACACCGGTGCATTCGAAAGTCCGGTCGTAGTGTGGACGTGGGGTTAG	1	bc
GATGTTTAGC	GAAACACCGGTTTACGTTGCATCGGTGTGGGGTTAGAGCTAGAAATAGCA	1	bc
TGAATCATGT	GAAACACCGGTCACGAGTGGGGCGTTCAGGGGGGAGTTAGAGCTAGAAAT	1	bc
GACAGCGGAA	GGGGTTAGAGCTAGAAATAGCAAGTTAACCTAAGGCTAGTCCGTTATCAA	1	bc
GGCACACTGA	GAAACACCGGTGTGGCTGAGAGTCCGGAAATGGTGTGGCTGTGGGGTTAG	1	bc
AAACACGCTC	GAAACACCGGTTTGAACTAGAAATAGCAAGTTAACCTAAGGCTAGTCCGT	1	bc
ACACCATGGC	GAAACACCGGTGTATTCGAAAGTCCTGTCGTAGTGTGGACGTGGGGTTAG	1	bc
GAGGTCTCGC	GAAACACCGGTCGGCGGCACTCGTGGGTGGGGTTAGAGCTAGAAATAGCA	1	bc
ATGTCGAGCT	GAAACACCGGTTTACGTTGCATCGGTTTGTGGGGTTAGAGCTAGAAATAG	1	bc
CACCGCCGAC	GAAACACCGGTGTCCTTACTCTCACCTGATTACTTAATCCGTGGGGTTAG	1	bc
ATGCGTAGGA	GAAACACCGGTTTACGTTGCATCGGGGTTAGAGCTAGAAATAGCAAGTTA	1	bc
ACACACCGCC	GAAACACCGGTTTGAACTACCTGGGGTTAGAGCTAGAAATAGCAAGTTAC	1	bc
CCAACACCCC	GAAACACCGGTGTGGCTGGGAGGCGGGCAGTGGTGTGGCTGCGGGGATAG	1	bc
AAGTTTAGTT	GAAACACCGGTTTAGGTTGCATCGGTGTGGGGTTAGAGCTAGAAATAGCA	1	bc
ACCCAACGCC	GAAACACCGGTTTGAACTACCTAGTTCAAACCGGTGGGGTTAGAGCTAGA	1	bc
AGGACATGCA	GAAACACCGGTAACTTTGAGTCTCCGGGATGCGGGTCGTCGTGGGGGTAG	1	bc
ATAAATTATA	GAAACACCGGTAACTATATTCATGCGATATCGCCGTCTCAGTGGGGTTAG	1	bc
TAAACCCTCG	GAAACACCGGTGCATTCGAAAGTCCGGTCGTAGTGTGGGCGTGGGGTTAG	1	bc
GCAGACCCCT	GAAACACCGGTCGGCGGCTAGTTATGGGGAGCTAAGCGAAGGGTGGTCAG	1	bc
CCGTGGACGC	GAAACACCGGTCGTGGCTATTCAGTGGTGGGGTTAGAGCTAGAAATAGCA	1	bc
ACGTAGTCGG	GAAACACCGGTGTACGTATGGACTGAACCAGGGTGTGCAAGTGGGGTTAG	1	bc
TACGCTATAC	GAAACACCGGTTACATTGAGGGTTAGAGCTAGCAATAGCAGGGTGACCTA	1	bc
CTAAGCTCGC	GAAACACCGGTGCATTCGGAATTTCGGGAGTGGTATGCGCGTGGGTTTAG	1	bc
CGCCCCGGCA	GAAACACCGGTCCCGGTGTTGATACTGGGTGGGAGGTATGAGCTGTTAGT	1	bc
ACAACACGCC	GCTAGAAATAGCAAGTTAACCTAAGGCTAGTCCGTTATCAACTTGAAAAA	1	bc
ACACAACGCA	GAAACACCGGTTTGAACTAGAAATAGCAAGTTAACCTAAGGCTAGTCCGT	1	bc
AAAAGTCGGT	GAAACACCGGTCGATTCATATCGAAACCTTCCCGTGACAGTGGGGGTAGA	1	bc
ACGTGTTGGC	AGAGTTAACCTAAGGCTAGTCCGTTATCAACTTGAAAAAGTGGCACCGAG	1	bc
GGAGTTCTGC	GAAACACCGGTCGGCGGCAATCGTGGGTGGGGTTAGTGCTAGAAATAGCA	1	bc
CCCACAATAC	GAAACACCGGTTAAGTGGGTTAGATCTAGGGGTAGGAAGTTAACCTAACA	1	bc
CGAACCGCGC	GAAACACCGGTGCATTCGAAAGTCCGGTCGTAGTGTGGACGTGGGGCTAG	1	bc
GCACACCGCC	GAAACACCGGTTTGAACTACCTAGTTCAAACCGGTGGGGTTAGAGCTAGA	1	bc
TGAAACCTTC	GAAACACCGGTGTGGCTGAGAGTCCGGCAATGGTGTGGCTGTGGGGTTAG	1	bc
CACGACCTCC	GAAACACCGGTGCCCTTACTCTCACCTGATTACTTAATCCGTGGGGTTAG	1	bc
CCAGACCTAC	GAAACACCGGTGCCCTTACTCTCACCTGATTACTTAATCCGTGGGGTTAG	1	bc
CCACTCGGAA	GAAACACCGGTACCTTTGTTGATGCTGGGTGGGGTTAGAGCTAGAAATAG	1	bc
TCGAATCCCT	GAAACACCGGTCTCGAGTGAGGTGTTCAGGGTGGGGTTAGAGCTAGAAAT	1	bc
ACCTCGTCGA	GAAACACCGGTGTACGTATGGACTGAACCAGGGTGTGCAAGTGGGGTTAG	1	bc
GGTATCTAGG	GAAACACCGGTAAATTTTATGCTCCGGCATGCAGGAGGCCGTGGGGTTAG	1	bc
ATAGCAAAGT	GAAACACCGGTTACATTGAGGGTTAGAGCTAGAAATAGCAAGTTAACCTA	1	bc
ACCTCTACGG	GCACCAGTCGTGGCCACTCGGTGGTGGGGTTAGAGCTAGAAATAGCAAGT	1	bc
GTTCCTCCCT	GAAACACCGGTTTACGTTGCATCGGTTGTGGGGTTAGAGCTAGAAATAGC	1	bc
ACGTGGTGTC	GAAACACCCGGTGGGGTTAGAGCTAGAAATAGCAAGTTAACCTAAGGCTA	1	bc
CGTCTGATTC	GAAACACCGGTCCGAAGGAGACCCGTGTGGCATGTACCTGTGGGGATAGA	1	bc
GGAACCATCA	GAAACACCGGTGTGGCTGAGAGTCCGGCAATGGTGTGGCTGTGGGGTTAG	1	bc
AAACAACGCA	GAAACACGGGTTAGAGCTAGAAATAGCAAGTTAACCTAAGGCTAGTCCGT	1	bc
CGAATACGTC	GAAACACCGGTCTCGCGTGAGGTGTTCAGGGCGGGGCTAGAGCTAGAAAT	1	bc
ACATAACGCC	GAAACACGGGTTAGAGCTAGAAATAGCAAGTTAACCTAAGGCTAGTCCGT	1	bc
ACTAATCGGC	GAAAAACCGGTACCCGGTGGGGTTAGAGCTAGAAATAGCAAGTTAACCTA	1	bc
GGGCTCTACT	GAAACACCGGTTTACGTTGCATCGCGTCATGCGGTAGGCGGTTAGGTGGG	1	bc
AAGTCTGCAT	GAAAAACCGGTCCGTAGGAGACCCGTGTGGCATGTACCTGTGGGGTTAGA	1	bc
GGCTGCCTCA	GAAACACCGGTGTGGCTGAGAGTCCGGCAATGGTGTGGCTGTGGGGTTAG	1	bc
TGAGTGATGT	GAAACACCGGTTACATTGAGGGTTAGAGCTAGAAATAGCAAGTTAACCTA	1	bc
GCCTTGACCG	GAAACACCGGTCGGGGCCACTCAGTGGTGGGGTTAGAGCTAGAAATAGCA	1	bc
GACGCGGAGG	GAAACACCGGTAGCAAGTGCGAGTGTTAGAGCTAGAAATAGCAAGTTAAC	1	bc
GCGTGATGGC	GAAACACCGGTTACCACACCTTGAAAAAGGGGTTAGGACTAGGAATATTA	1	bc
AGGCGCCTAC	CCGGTAAATTTGAGGCTCCGGCATGCAGGAGGCCGTGGGGTTAGAGCTAG	1	bc
AGTATTAGCT	GAAACACCGGTTTACGTTGCTTCGGTGTGGGGTTAGAGCTAGAAATAGCA	1	bc
ATGCCTCGGT	GAAACACCGGTTTGCGTGGGGGGGTTAGAGCTAGAAATAGCAAGTTAACC	1	bc
CAACTATGCT	GAAACACCGGTACCTTTGTTGATGTTGGGTGGGAGGATTGGGTGGGGATA	1	bc
ACGAAGCCTT	GAAACACCGGTCTCGAGTGAGGTGTTCAGGGTGGGGTTAGAGCTAGAAAT	1	bc
TTAGCTCGGC	GAAACACCGGTCACATTTAGAGTTATAGCTGGATATAGTAGGTTAACCTA	1	bc
AAACGTCGTT	GAAACACCGGTGTACGTATGGACTGAACCAGGGTGTGCAAGCGGGGTTAG	1	bc
AGGCCGTCTC	GAAACACCGGTCCGTAAGAGCCCCGTTTGGCATGTAGCTGGGGGGGTAAA	1	bc
TATACTCGGC	GAAACACCGGTACCTTTGTTGATGCTGGGTGGGGTTAGAGCTAGAAATAG	1	bc
TTGAACCAAA	GAAACACCGGTTAAGTTGTGCAGCTATAGCTGCGGATAGCAAGTTAGCCT	1	bc
GCGAAGCCAT	GAAACACCGGTCTCGAGTGAGGTGTTCAGGGTGGGGTTAGAGCTAGAAAT	1	bc
CCTTACAGCC	GAAACACCGGTCGGGGCCACTCAGTGGTGGGGTTAGAGCTAGAAATAGCA	1	bc
TGAGGTGTCT	GAAACACCGGTGGGGGTATGGCTAGAAATAGCAAGTTAACCTAAGGCTAG	1	bc
CGCCCCCCTC	GAAACACCGGTCCGTAGGAGACCCGTGTGGCATGTACCTGTGGGGTTAGA	1	bc
CCATTTGGAC	GAAACACCGGTCGATTCATATCGAAACCTTCCCGTGACAGTGGGGTTAGA	1	bc
GTCAGTATGT	GAAACACCGGTTACATTGAGGGGGTAGAGCTCGTAATAGCAAGTTAACCT	1	bc
TGTCTGATTC	GAAACACCGGTCACTATATTCATGCGATATCGCCGTATCAGTGGGGTTAG	1	bc
ATAGTCCTAC	GAAACACCGGTGCCCTTACTCTCACCTGATTACTTAATCCGTGGGGTTAG	1	bc
GTGGCGACTA	GAAACACCGGTTTCCGGCTAGTGGGGTTAGAGCTAGAAATAGCAAGTTAA	1	bc
CGAGTGGACT	GAAACACCGGTGACATTGGGTGGGGTTAGAGCTAGAAATAGCAAGTTAAC	1	bc
CAAAAAGCAC	GAAACACCGGTTTGAACTAGAAATAGCAAGTTAACCTAAGGCTAGTCCGT	1	bc
TGACCCTTGT	GAAACACCGGTAAATTTGAGGCTCCGGTATGCAGGAGGCTGTGGGGTTAG	1	bc
TTGCGCCTCA	GAAACACCGGTTAAGCCGAGTGGGGTTAGAGCTAGAAATAGCAAGTTAAC	1	bc
AAGCATGCCT	GAAACACCGGTCCGTAGGAGACCCGTGTGGCATGTACCTGTGGGGTTAGA	1	bc
CATCTATCGA	GAAACACCGGTTATATTTGTAAGTGTGTGGGGTTAGAGCTAGAAATAGCA	1	bc
AAGACTATCG	GAAACACCGGTGCATTCGAAAGTCCGGTCGTAGTGTGGACGTGGGGTTAG	1	bc
GTAGATCTGT	GAAACACCGGTTACATTGAGGAGATCGAGCTAGAAATAGCAAGTTAACCT	1	bc
TTCGTTCGAG	GAAACACCGGTTATATTTGTAAGTGTGTGGGGTTAGAGCTAGAAATAGCA	1	bc
GGCGCTCTAC	GAAACACCGGTGCCCTTACTCTCACCTGATTACTTAATCCGTGGGGTTAG	1	bc
GGCGCACGCC	GAAACACCGGTGTGGCTGAGAGTCCGGCAATGGTGTGGCTGTGGGGGTAG	1	bc
ATAGCTGTGC	GAAACACTGGTTACATTGAGTGGGGTTAGAGCTAGAAATAGCAAGTTAAC	1	bc
AGACGCAGAC	GAAACACCGGTAGCAGGTTAGAGCTAGAAATAGCAAGATAACCTAAGGCT	1	bc
TGCAACACAC	GAAACACCGGTTAAGCCGAGGAGTTAGAGCTAGAAATAGCAAGTTAACCT	1	bc
GAAATCGACA	GAAACACCGGTAGCAAGAGGGGTTAGAGCTAGCAATAGCAAGTTAACATA	1	bc
GAAATTCGGT	GAAACACCGGTCGATTCATATCGAAACCTTCCCGTGACAGTGGGGTTAGA	1	bc
ATAATCGAAC	GAAACACCGGTACCTTTGTTGATGCTGGGTGGAAGGAATGGGTGGGGTTA	1	bc
CTGTTACCTC	GAAACACCGGTCGGGGCCACTCAGGGGTGGGGTTAGAGCTAGAAATAGCA	1	bc
AAGAGTCGTC	GAAACACCGGTGTACGTATGGACTGAACCAGGGTGTGCAAGTGGGGCTAG	1	bc
GCGTTGCCGC	GAAACACCGGTCGGGGCCACTCAGTGGTGGGGTTAGAGATAGAAATATAA	1	bc
GCAGTCGGTA	GAAACACCGGTCGCGGCATAACCAAACCTTGCCGGGACAGTGGTGGTAGA	1	bc
GATACTCGGC	GAAACACCGGTACCTTTGTTGATGCTGGGTGGAGGGGTTAGAGCTAGAAA	1	bc
GCCTTACAGC	GAAACGGTCGGGGCCACTCAGTGGTGGGGTTAGAGCTTGGAATAGCAAGT	1	bc
TTGAGCTCAC	GAAACACCGGTTAAGCAGAGCGGGGTTAGAGGTAGAAATAGCAAGTTAAC	1	bc
AGGGTTGGCT	GAAACACCGGTGACAGGGGGGTTAGCGCTAGAGATAGCTAGTTAACCTAA	1	bc
TTGAGAAGAC	GAAACACCGGTTAAGCCGAGTGGGGTTAGAGCTAGAAATAGCAAGTTAAC	1	bc
AAAATTATAA	GAAACACCGGTAACTATATTCATGCGATATCGCCGTATCAGTGGGGTTAG	1	bc
CGGGGTGTTT	GAAACACCGGTGACATTGGGTACGGGGTTAGAGCTAGAAATAGCAAGTTA	1	bc
GGGGAACGGC	GAAACACCGGTCGGCGGCAATCGTGGGTGGGGTTAGAGCTAGAAATAGCA	1	bc
ACACAACGCA	GTGTGGGGTTAGAGCTAGAAATAGCAAGTTAACCTAAGGCTAGTCCGTTA	1	bc
CGTTTCGGTT	GAAACACCGGTCGATTCATATCGAGACATTGCCGTGACTGTGAGGTTGGA	1	bc
AGAAGCCGTT	GAAACACCGGTCTCGAGTGAGGTGTTCAGGGTGGGGTTAGAGCTAGAAAT	1	bc
AGAGAAGCCT	GAAACACCGGTTCCCGTCCAGTGGGGTTAGAGCTAGAAATAGCAAGTTAA	1	bc
ACATATACTG	GAAACACCGGTCGGGGCCGCTCCGTGGTGGGGTTAGAGCTAGGAATAGCA	1	bc
CACGCCATCC	GAAACACCGGTGCCCTTACTCTCACCTGATTACTTAATCCGTGGGGTTAG	1	bc
CGGTACGCCT	GAAACACCGGTACCTTTGTTGATGCGGGGTGGTAGGGGTGGGGGGGTTGA	1	bc
CATTTAAGGC	GAAACACCGGTCGGGGCCACTCAGTGGTGGGGTTAGAGCTAGAAATAGCA	1	bc
TTGCGCTTCA	GAAACACCGGTAAATTTGAGGCTCCGGTATGCATGAGGCTGTGGGGTTAG	1	bc
GTCAACGACC	GAAACACCGGTTTGAACCGGTGGGGTTAGAGCTAGAAATAGCAAGTTAAC	1	bc
GCGTAATGCA	GAAACACCGGTTTGAACTACCGGGGTTAGAGCTAGAAATAGCAAGTTAAC	1	bc
ATATTCGTTC	GAAACACCGGTCGATTCATATCGAAACCTTCCCGTGACAGTGGGGTTAGA	1	bc
CTGCTCCGCT	GAAACACCGGTTTACGTTGCATCGGTGTGGGGTTAGAGCTAGAAATAGCA	1	bc
ATGAATCCTT	GAAACACCGGTCTCGAGTGAGGTGTTCAGGTGGGGTTAGAGCTAGAAATA	1	bc
AAGCGTCGCG	GAAACACCGGTGTACGTATGGACTGAAACAGCGTGAACAAGTGGGGTAAG	1	bc
ACGTAGCGGA	GAAACACCGGTAGAACACGGTTGACATAAAGCGGGGTTAGAGCTAGAAAT	1	bc
GTAAGCTATG	GAAACACCGGTTACATTGAGGGTTAGAGCTAGAAATAGCAAGTTAACCTA	1	bc
CACGCGATAC	GAAACACCGGTGCCCTTACTCTCACCTGATTACTTAATCCGTGGGGTTAG	1	bc
GAGGACGCTC	GAAACACCGGTTAGAGCTAGAAATAGCAAGTTAACCTAAGGCTAGTCCGT	1	bc
AGCAGACCCG	GAAACACCGGTCGGCGGCAATCGTGGGTGGGGTTAGAGCTAGAAATAGCA	1	bc
AAAATTCGTC	GAAACACCGGTGTACGTATGGACTGAACCAGGGTGTGCAAGTGGGGTTAG	1	bc
AGACCAGCAC	GAAACACCGGTGGATTCCAAATTCTGGACGTAGTGGGGACGTGTGGATAG	1	bc
CGAGATGTAT	GAAGCACCGGTGACATTGGGTACAGGGTGGGGTTAGAGCTAGAAATAGCA	1	bc
AGGGATGTCT	GAAACACCGGTGACATTGGGTACAAAAATAGCATGTTGACCTAAGGCTAG	1	bc
GAGAATCCTT	GAAACACCGGTCTCGAGCGAGGGGTTCAGGGTGTGGGTATAGCTATAACT	1	bc
GTGCACAGCT	GAAACACCGGTTTACGTTGCATCGGTGTGGGGTTAGAGCTAGAAATAGCA	1	bc
ATCTATCGCG	GAAACACCGGTTATATTTGTAAGTGTGTGGGGTTAGAGCTAGACATAGCA	1	bc
ACTGCTCGGC	GAAACACCGGTACCTTTTTTGTTGCTGGGTGGAAGGAATGGTAGGGTTAG	1	bc
AAGACCCTGG	GAAACACCGGTGCATTCGAAAGTCCGGTCGTAGTGTGGACGTGGGGTTAG	1	bc
CAGAGGGACC	GAAACACCGGTTTGAACTACCTAGTTCAAAGAGCTAGAAATAGCAAGTTA	1	bc
ACGTCGCGGA	GAAACACCGGTAGAACGTGGTCGACATATAGTGGGGTTAGAGCTAGAAAT	1	bc
ATCTATAGAG	GCCTAAGGCTAGTCCGTTATCAACTTGAAAAAGTGGCACCGAGTCGGTGC	1	bc
GATGGACAGC	GAAACACCGGTCGGCGGCAATCGTGGGTGGGGTTAGAGCTAGAAATAGCA	1	bc
CCGTTTAGCC	GAAACACCGGTTTACGTTACTCAGGTGTGGGGTTAGAGCTAGAAATAGCA	1	bc
AAAGGTCCAT	GAAACAACGGTGCCCTTACTCTCACCTGATTACTTAATCCGTGGGGTTAG	1	bc
GCAGCGTCGT	GAAACACCGGTGTACGTATGGACTGAACCAGGGTGTGCAAGTGGGGTTAG	1	bc
GTGGAGTCCG	GAAACACCGGTTCCCGTAGAGTGGGTGTAGAGCGAGAAAAACTAGAATAA	1	bc
GCGAATCGTT	GAAACACCGGTCTCGGGTGAGGTGTTCAGGGTGGGGTTAGAGCTAGAAAT	1	bc
AGAATCGAGG	GAAACACCGGTGCATTCGAAAGGCGGGTCGGAGTGGGGACGGAGGGATAA	1	bc
CACAAAGGAG	GAAACACCGGTTTGAACTACCTGTGGTTAGAGCTAGAAATAGCAAGTTAA	1	bc
AAGAACACCA	GAAACACCGGTTTGAACTAGAAATAGCAAGTTAACCTAAGGCTAGTACGT	1	bc
GATGATTAGC	GAAACACCGGTTTACGTTGCATCGGTGTGGGGTTAGAGCTAAAAATAGCA	1	bc
ACTATCGCTG	GAAACACCGGTTATATTTGTAAGTGGGGTTAGAGCTAGAAATAGCAAGTT	1	bc
ACTTTATGGT	GAAACACCGGTAGGAGAATCTCAGTGCATGGGTTAGAGATAGCAAGAGAA	1	bc
GTGGAAACGC	GAAACACCGGTCGGCGGCAATCGTGGGTGGGGTTAGAGCTAGAAATAGCA	1	bc
GATGAACCGA	GAAACACCGGTAGGCGGCAAGATATAGCAAGTCAACCTAAGGCTAGTCCG	1	bc
TAGCGGTTTT	GAAACACCGGTCAACCTAGGATCTGAACGAGGTTGTGCCAGTGGGTTTCG	1	bc
AAGACACGCG	GAAACACCGGTGCATTCGAAAGTCCGGTCGTAGTGTGGACGTGGGGTTAG	1	bc
TCAGCAACGC	GAAACACCGGTCGGGGTGACTCAGTAGTGGGGTTAGGGTTAGAAATAGCA	1	bc
CGGCGACATC	GAAACACCGGTTGGCGCATGGGCTAGATCCGTGATGGGAAGTGGGGTTAG	1	bc
AATGAGCATA	GAAACACCGGTTAAGCCGAGGTTAGAGCTAGAAATAGCAAGTTAACCTAA	1	bc
GGAGTTGACA	GAAACACCGTTAGCAAGTGCGAGCTAGAAATAGCAAGTTAACCTGAGGCT	1	bc
CGCCAATACA	GAAACACCGGTAAATTTGAGGCTCCGGCATGCAGGAGGCCGTGGGGTTAG	1	bc
ACTAATCTGC	GAAACACCGGTACCTTTGTTGATGCTGGGTGGAAGGAATTTTGTGGGGTT	1	bc
CTAATGGGCA	GAAACACCGGTACCTTTGTTGATGCTGGGTGGGGTTAGAGCTAGAAATAG	1	bc
GGGTGCCACC	GAAACACCGGTAAATTTGAGGCTCCGGCATGTAGTACGCCGTGGGGTTAG	1	bc
GTAACCGGCC	GAAACACCGGTACCTTTGTTGATGCTGGGTGTAGGGGTTACAGCTAGAAA	1	bc
AAAGCTATAT	GAAACACCGGTTCCCTTACTCTCACCTGATTACTTAATCCGTGCGGTTAG	1	bc
GAAAAAGCCA	GAAACACCGGTTTGAACTAGAAATAGCAAGTTAACCTAAGGCTAGTCCGT	1	bc
GGCAGAGAAT	GAAACACCGGTAGCAAGTGCGAGACGTGTTTTTGTGGGGTTAGAGCTAGA	1	bc
CAAATAGCCC	GAAACACCGGTTAGAGCTAGAAATAGCAAGTTAACCTAAGGCTAGTCCGT	1	bc
CAATACTCCC	GAAACACCGGTTTGAACTAGAAATAGCAAGTTAACCTAAGGCTAGTCCGA	1	bc
ACTAGTCGTC	GAAACACCGGTGTACGTATGGACTGAACCAGGGTGTGCAAGTGGGGTTAG	1	bc
GGCATCTATA	GAAACACCGGTAAATTTGAGGCTCCTGCATGCAGGGGCACCGTGGGGTTA	1	bc
ACGTTACCGA	GAAACACCGGTCGGGGCCACTCAGTGGTGGGGTTAGAGATAGAAATAGAA	1	bc
TCTTGACGCC	GAAACACCGGTCGGGGCCACTCAGTGGGACTAGTGGGGTTAGAGCTAGAA	1	bc
ATGATCGGGT	GAAACACCGGTTTACTTTGCATGGGTGGGTAGATACAGAAATAGCAAGTT	1	bc
AACATGCGGT	GAAACACCGGTCGATTCATATCGAAACCTTCCCGTGACAGTGGGGTTAGA	1	bc
AGGAACATCT	GAAACACCGGTGTGGCTGAGAGTCCGGCAATGGTGTGGCTGGGGGGTTAG	1	bc
AGACAAAGGC	GAGACACCGGTAGCAGGTTAGAGCTAGAAATAGCAAGTTAACCTAAGGCT	1	bc
GGTGCACCCC	GATACACCGGTGTGGCTGAGAGTCCGGCAATGGTGTGGCTGGGGGGATCA	1	bc
TTTTTGCTTC	GAAACACCGGTCCGTAGGTGACCCGCGTGGCGTGTTAATGGGGGGGTTAA	1	bc
TTTCCTGCAG	GAAACACCGGTCTCGAGTGAGGTGTTCAGGGTGGGGTTAGAGCTAGAAAT	1	bc
ACCGCCGGAC	GAAACACCGGTGCCCTTACTCTCACCTGATTACTTAATCCGTGGGGTTAG	1	bc
ACTATCAATC	GAAACACCGGTTATATTTGTAAGTGTGTGGGGTCAGAGCTAGAAATAGCA	1	bc
ATGTCGGCCT	GAAACACCGGTCCGTAGGAGACCCGTGTGGCATGTACCTTTTGTGGGGTT	1	bc
ATTCGGCGTC	GAAACACCGGTGTACGTATGGACTGAACCAGGGTGTGCAAGTGGGGTTAG	1	bc
TAGACCCACG	GAAACACCGGTGCATTCGAAAGTCCGGTCGTAGTGTGGACGTGGGGTTAG	1	bc
AAAATAGGAA	GAAACACCGGTAGCAGGAGCGAGTGGAGTTGGTGGGGTAAGAGCTGGAAA	1	bc
AGGCAGTCCC	GAAACACCGGTTCCTTTCCAGTGGGGTTAGAGCTAGAGATAGCAAGTTAA	1	bc
GGTCATCACA	GAAACACCGGTAAATTTGAGGCTCCGCCATGCAGGAGGCCGTGGGGTTAG	1	bc
GAGGTCCGGC	GAAAACGTGGGGTTAGAGCTAGAAATAGCAAGTTAACCTAAGGCTAGTCC	1	bc
AACTTCGCCC	GAACCACCGGCGTACGTATGGACTGAACCAGGGAGTGCAAGTGGGGTTAG	1	bc
AGAGTCTGCC	GAAACACCGGTCAGTAGGAGACCAGTGTGGCATGGACCTAGGGGGTTAGA	1	bc
CGAGACTCGC	GAAACACCGGTGCATTCGAAAGTCCGGTCGTAGTGTGGACGTGGGGTTAG	1	bc
ATGGCTATGC	GAAACACCGGTTACATTGAGTGGGGTTAGAGCTAGTACTAGAAAGTTAAC	1	bc
GAGACACCCA	GAAACACCGGTAGCACGTGCGAACCGTGTTTGTGGGGTTGAGCCTGGAAA	1	bc
AAGAAACTCG	GAAACACCGGTGCATTCGAAAGTCCGGTCGTAGTGTGGACGTGGGGTTAG	1	bc
AAAAACTTCG	GAAACACCGGTGCATTCGAAAGTCCGGTCGTAGTGTGGACGTGGGGTTAG	1	bc
GGAAAACCCG	GAAACACCGGTCGGCGGCAATCGTGGGTGGGGTTAGAGCTAGAAATAGCA	1	bc
GTGAGGATAC	GAAACACCGGTTCCGGTGCGGAGGTGGTAGTGCTAGAAGTAACTTGATAT	1	bc
GGAACGCCCT	GAAACACCGGTGCCCTTACTCTCACCTGATTACTTAATCCGTGGGGTTAG	1	bc
ATACGCTTGC	GAAACACCGGTGCATTCGAAAGTCCGGTCGTAGTGTGGACGTGGGGTTTG	1	bc
TCATTCATTC	GAAACACCGGTAACTACATACCTGCGATATCGCCGTACCAGTGGGGTTAG	1	bc
TTCGCTCTGC	GAAACACCGGTTACATGGGGGTTAGAGCTAGAAATAGCAAGTTAACCTAA	1	bc
ATAGACTTAC	GAAACACCGGTGCCCTTACTCTCACCTGATTACTTAATCCGTGGGGTTAG	1	bc
GGCACGCTGT	GAAACACCGTTTTCGCTGAGAGCTTCGCAATGGTGTAGCTAGGGGTATCG	1	bc
AACAAGGCCA	GAAACACCGGTTTGAACTAGAAATAGCAAGTTAACCTAAGGCTAGTCCGT	1	bc
GAGATTAGCT	GAAACACCGGTTTACGTTGCATCGGCGTGGGGTTAGAGCTAGAAATAGCA	1	bc
ATGAGCATCC	GAAACACCGGTTAAGCCGAGTGGGGCTAGAGCTAGAAATAGCAAGTTAAC	1	bc
GCGGAGAATC	GAAACACCGGTTACCGTCCAGTGGGGCTAGAGCTAGATATAGCAAGTTAA	1	bc
AACGTTGTAC	GAAACACCGGTGCCCTTACTCTCACCCGATTACTTAATCCGTGGGGTTAG	1	bc
ACGCAACGCT	GAAACACCGGTTTGAACTAGAAATAGCAAGTTAACCTAAGGCTAGTCCGT	1	bc
AGCTCTTAGC	GAAACACCGGTGCTTTCGAAAGATCAGTGGTAGTAGGGCTGGGAGGATCG	1	bc
GAAGATGTGC	GAAACACCGGTCGGCGGCAATCGTGGGGGGGGTTAGAGCTAGAAATAGCA	1	bc
ATGCCCTACC	GAAACACCGGTAAATTTGAGGCTCCGGCATGCAGGAGGCAGTGGGGTCAG	1	bc
AAACGCGCTC	GAAACAACGGTGCCCTTACTCTCACCTGATTACTTAATCCGTGGGGTTAG	1	bc
TCCAACGCGC	GAAACACGGGTTAGAGCTAGAAATAGCAAGGTAAACTAAGGCTAGTACGT	1	bc
TACGCGGATT	GAAACACCGGTCCGTAGGAGACCCGTGTGGCATGTATCTGTGGGGTTAGA	1	bc
AGGAACACTC	GAAACACCGGTGTGGCTGAGAGTCCGGCAATGGTGTGGCTGTGGGGTTAG	1	bc
AATGCTGTAT	GAAACACCGGTGCCCTTACTCTCACCTTATTACTTGATCCGTGGGGTTAG	1	bc
GTCGCCTATA	GAAACACCGGTAAATTTGAGGCGCCGGCATGCAGGAGGCCGTGGGGTTAG	1	bc
CATATCGCCT	GAAACACCGGTCCCAAATAAAGCGCTGTGGGGTTAGAGCTAGAAATAGCA	1	bc
ACTCCTCGGC	GAGACACCGGTCCCTTTGTTGATGATGGGGGGTAGGAATTTGTGGGGTTA	1	bc
CGTCTCTTTT	GAAACACCGGTCTCGAGTGAGGCGTTCAGGGGGGGGTTAGAGCTAGTAAT	1	bc
ACCTTTACCT	GAAACACCGGTCGGGGCCACTCAGTGGGTGGGGTTAGAGCTAGAAATAGC	1	bc
GGTCGTCGTA	GAAACACCGGTGTACGTATGGACTGAACCAGGGTGTGCAAGTGGGGTTAG	1	bc
AACCACGCTC	CCAAGGGTTCGAGCTAGAAATAGCAAGTTAACCTAAGGCTAGTCCGTTAT	1	bc
GACAAAAACC	GAAACACCGGTAGCAAGTTAACCTAAGGCTAGTCCGTTATCAACTTGAAA	1	bc
CCGTACTTCA	GAAACACCGGTGCTCCGAACAGCCAAGTGGGGTTAGAGCTAGAAATAGCA	1	bc
CCTGGACTGC	GAAACACCGGTCGGGGCCACTCAGTGGTGGGGTTAGAGCTAGAAATAGCA	1	bc
TGGATTGACT	GAAACACCGGTGACATTGAGTGGGGTTAGAGCTAGAAATAGCAAGTTAAC	1	bc
GCGGAGACTT	GAAACACCGGTTCCCGTCCAGTGGGGTTAGAGCTAGAAATAGCAAGTTAA	1	bc
AATTTATCGC	GAAACACCGGTCGGGGCCACTCAGTGGTGGGGGTAGAGCTAGAAATAGCA	1	bc
GTACGCTCGC	GAAACACCGGTTCATTCGAAAGTCCGGTCGTAGTGTGGACGTGGGGTTAG	1	bc
GGCCAGCCCC	GAAACACCAGTCCGGGGAAGACCAGCAGGTGATGTGCTTGAGCTATTAGA	1	bc
TGGACAACTC	GAAACACCGGTGTGGCTGAGAGTCCGGCAATGGTGTGGCTGTGGGGATAT	1	bc
TAGTCTTCCT	GAAACACCGGTCGGGGCCACTCCGTGGTGGGGTTAGCGCTAGAAATAGCA	1	bc
GTCATCGTAA	GAAACACCGGTAAATTTGAGGCGCCAGCATGCAAGATGGCGAGGGGATAG	1	bc
GGGAGCAGAA	GAAACACCGGTTAAGCCGAGGCGTTAGAGCTAGAAATAGCAAGTTAACCT	1	bc
GGTATACAGC	GAAACACCGGTCGGGGCCACTCAGTGGTGGGGTTAGAGCTAGAAATAGAA	1	bc
AGCCTCGCTC	GAAACACCGGTCCGTAGTAGAAATGTGTAGCTTACACATGGCGAGTCAGA	1	bc
ATTCTTCGCA	GAAACACCGGTTTACGTTGCATCGGTGTGGGGTTAGAGCTAGAAATAGCA	1	bc
AGGTTAGGTT	GAAACACCGGTCGCTTCATATCGAAACCTTCCCGAGACAGTGGGGTTAGA	1	bc
AGGCTTCGTT	GAAACACCGGTTTACGTTGCATCGGTGTGGGGTTAGAGCTAGAAATAGCA	1	bc
GACCCGGCCC	GAAACACCGGTAGCAAGTGCGAGACGTGTTAAATAGCAAGTTAACCTAAG	1	bc
ACCTTGACCG	GAAACACCGGTCGGGGCCACTCAGTGGTGGGGTTAGAGCTAGAAATAGCA	1	bc
ACGTATCCTT	GAAACACCGGTCTCGAGTGAGGTGTTCAGGGTGGGGTTAGAGCTAGAAAT	1	bc
AGGCTCCTTT	GAAACACCGGTCTCGAGTGAGGTGTTCAGGGTGGGGTTAGAGCTAGAAAT	1	bc
GCGTGGTGTC	GAAACACCGGTGACAGGGGTTAGAGCTAGAAATAGCAAGTTAACCTAAGG	1	bc
GAAGGCCTAC	GAAACACCGGTGCCCTTACTCTCACCTGATTACTTAATCCGTGGGGTTAG	1	bc
AGCATCCTTC	GAAACACCGGTGTCCTTACTCTCACTTGATTACTTAATCCGTCTGGATAG	1	bc
AAGGCACTAA	GAAACACCGGTGCCCTTACTCTCACCTGATTACTTAATCCGTGGGGTTAG	1	bc
CGAGTCAGTC	GACGAAACACCGGTGCATTCGAAAGTCCGGTCGTAGTGTGGACGTGGGGT	1	bc
ACTAGCTATG	GAAACACCGGTTACATTGAGGGTTAGAGCTAGAAATAGCAAGTTAACCTA	1	bc
ATGTTTGGCC	AGTTAACCTAAGGCTAGTCCGTTATCAACTTGAAAAAGTGGCACCGAGTC	1	bc
GTCGGGCATC	GAAACACCGGTTCCCGTCCAGTGGGGTTAGAGCTAGAAATAGCAAGTTAA	1	bc
GAACCAGCCC	GAAACACCGGTAGAAAGTGGGGTTAGAGCTAGAAATGGCCAGTTAACCTA	1	bc
ATCGTTTGTC	GAAACACCGGTGACATCTGGTACAGGGTGGGGTTAGAGCTAGAAATAGCA	1	bc
TCACAACGCA	GAAACACCGGTTTGAACTACCTAGGAATAGCAAGTTAACCTAAGGCTAGT	1	bc
AGCCACAGCC	GAAACACCGGTAGCAGGTTAGAGCTAGAAATAGCAAGTTAACCTAAGGCT	1	bc
AGCACCTCTC	GAAACACCGGTGCATTCGAAAGTCCGGTCGTAGTGTGGACGTGGGGTTAG	1	bc
GATAAGTACC	GAAACACCGGTCGGCGGTGGGGTTAGAGCTAGAAATAGCAAGTTAACCTA	1	bc
AAGTATGCAT	GAAACACCGGTCCGTAGGAGACCCGTGTGGCATGTACCTGTGGGGTTAGA	1	bc
AGGCCACTAC	GAAACACCGGTAAATTTGAGGCTCCGGCATGCAGGAGGCCGTGGGGTTAG	1	bc
AACAAAGGCC	GAAACACCGGTTTGAACTACCTAGAGCTAGAAATAGCAAGTTAACCTAAG	1	bc
CTATTCGAAA	GAAACACCGGTACCTTAGAGCTAGAAATAGCAAGTTAACCTAAGGCTAGT	1	bc
AGCATCCTTA	GAAACACCGGTATCGAGTGAGGTGTTCAGAGCTAGAAATAGCCAGTTAAC	1	bc
CACAGTGGTC	GAAACACCGGTGTACGTATGGACTGAACCAGGGTGTGCAAGTGGGGTTAG	1	bc
GCATTGTCGT	GAAACACCGGTGTACGTATGGACCGAACCAGGGTGTGCAAGTGGGGATAG	1	bc
AGACCCAGAC	GAAACACCGGTAGCAAGTGCGAGACGCGTTTGTGGGGTTAGAGCTAGAAA	1	bc
TATATCTCGG	GAAACACCGGTTATATTTGTAAGTGTGTGGGGTTAGAGCTAGAAATAGCA	1	bc
GAGCGAGACA	GAAACACCGGTAGCAAGTGGGGTTAGAGCTAGAAATAGCAAGTTAACCTA	1	bc
CAATTCGAGT	GAAACACCGGTCCGACCGTCTCAGTGGGTGGGGTAGAGAGAGCTATAGAT	1	bc
GGAACCTGCC	GAAACACCGGTGTGGCTGAGAGTCCGGCAATGGTGTGGCTGTGGGGTTAG	1	bc
ACTAATCCTT	GAAACACCGGTCTCGAGTGAGGTGTTCAGGTGGGGTTAGAGCTAGAAATA	1	bc
ACATTACAGC	GAAACACCGGTCGGGGCCACTCAGTGGTGGGGTTAGAGCTAGAAATAGCA	1	bc
CCTTGATGGC	GAAACACCGGTCGGGGCCACTCAGTGGTGGGGTTAGAGCTAGAAATAGCA	1	bc
AGAAGCCCTA	GAAACACCGGTGCCCTTACTCTCACCTGGTTACTTAATCCGTGGGGTTAG	1	bc
TAGTGTTGTC	GAAACACCGGTGACATTGGGTGGGGTTAGAGCTAGAAATAGCAAGTTAAC	1	bc
ATGTCGGCGC	GAAACACCGGTCGACGCGAAAGTCTGGTGGGGGTAGAGTCGTAAGGTTAA	1	bc
GTGTAGTCGC	GAAACACCGGTTCCCGTGCAGTGGGGGTAGAGCTAGAAATAGCAAGTTAA	1	bc
CTGGGTGTAT	GAAACACCGGTTAAGCCGAGTGGGGTTAGAGCTAGAAATAGCAAGTTAAC	1	bc
TTTAGGCGAA	GAAACACCGGTTAGAGCTAGAAATAGCAAGTTAACCTAAGGCTAGTCCGT	1	bc
ACGTGTTATC	GAAACGGGTTTTAGCTAGAAATAGCAAGTTAACCTAAGGCTAGTCCGTTA	1	bc
GGCAGTCTCG	GAAACACCGGTGAGGCTGAGAGTCCGGCAATGGTGTGGCTGTGGGGTTAG	1	bc
TGAATCGGGT	GAAACACCGGTCTCGAGTGAGGTGTTCAGGTGGGGTTAGAGCTAGAAATA	1	bc
GATGCTTATA	GAAACACCGGTTTACGTTGCATCGGGGTTAGAGCTAGAAATAGCAAGTTA	1	bc
GGCACACTGA	GAAACACCGGTGTGGCTGAGAGTCCGGCAATGGTGTGGCTGGGGGGATAG	1	bc
ACACTCCCGC	GAAACACCGGTGCCTTCGAGAGTGCGTCCTTTGGGTGTAGAGGGAGTTAT	1	bc
GGCTTACCGC	GAAACACCGGTCGGGGCCACTCAGTGGTGGGGTTAGAGCTAGAAATAGCA	1	bc
TCCCAACGCC	GAAACACCGGTTTGAACTAGAAATAGCAAGTTAACCTAAGGCTAGTCCGT	1	bc
ATGCTGCGTT	GAAACACCGGTCCGTAGGAGACCCGTGTGGCATGTACCTGTGGGGTTAGA	1	bc
CAGAGTAGTC	GAAACACCGGTGTACGTATGGACTGAACCGGGGTGTGCAAGTGGGGTTAG	1	bc
CCAATTGGGT	GAAACACCGGTCGATTCATATCGAAACCTTCCCGTGACAGTGGGGTTAGA	1	bc
CTGGCGGTCA	GAAACACCGGTGACCCACGGTGGGGTTAGAGCTAGAAATAGCAAGTTAAC	1	bc
AAGAATCCTT	GACACACCGGTCTCGAGTGAGGTGTTCAGGTGGGGTTAGAGCTAGAAATA	1	bc
CAAAACTCAC	GAAACACGGTTTGAACCGGTTCGAGCTATTAATAGCAAGTTAACCTAAGG	1	bc
AGTAAGCGTC	GAAACACCGGTCCGTAGGAGACCCGTGTGGCATGTACCTGTGGGGTTAGA	1	bc
CCATTAGGTA	GAAACACCGGTCGATTCATATCGAAACCTTCCCGTGACAGTGGGGTTAGA	1	bc
ACCATCGGTA	GAAACACCGGTCTATTCATATCGCAACCTTCCGGGGACAGGGGGGTTAGA	1	bc
GATTAGCTAT	GAAACACCGGTTACATTGAGGGTTAGAGCTAGAAATAGCAAGTTAACCTA	1	bc
CATAGCGGCA	GAAACACCGGTGTACGTATGGCCTGAACCAGGGTGTGCATGTGGGGTTAG	1	bc
CTAGCTCTTT	GAAACACCGGTTACATTGAGGGGTTAGAGGTAGAAATAGCAAGTTAACCT	1	bc
AGGCTGCCCA	GAAACACCGGTCCGTAGGAGACCCGTGTGGCATGTACCTGTGGGGTTAGA	1	bc
GCGAATCGTT	GAAACACCGGTACCGAGTGAGATGTTCGGGGTGGGGTTAGAGCTAGATAT	1	bc
CTTTCAACGC	GAAACACCGGTCGGGGCCACTCAGTGGTGGGGTTAGAGCTAGAAATAGCA	1	bc
TTGAGTGTAG	GAAACACCGGTTAAGCCGAGGAGTTAGAGCTAGAAATAGCAAGTTAACCT	1	bc
AAGTCAGCCA	GAAACACCGGTAGCAAGTGCGGGTCGTTTTTGTTGGGTTAGGGATAGACA	1	bc
GGCATCCACA	GAAACACCGGTCAATTTGAGGCTCCGGCATGCAGGAGGCCGTGGGGTTAG	1	bc
GTAATGCCTC	GAAACACCGGTCCGTAGGAGACCCGTGTGGCATGTACCTGTGGGGTTAGA	1	bc
TCTACTAGGA	GAAACACCGGTACCTTTGTTGATGCTGGGTGGAAGGATGCTGGGTGGGGT	1	bc
CCTTGCTGTC	GAAACACCGGTATTCCGGCAGACCAAGCCAGGGTGTACCTAGAGATAGAG	1	bc
AATGATTAGC	GAAACACCGGTTTACGTTGCATCGGTGTGGGGTTAGAGCTAGAAATAGCA	1	bc
CGAGCTGTGT	GAAACACCGGTGACATGGAGTTAGAGCGCGAAATAGCACGTTAACCTAAG	1	bc
GAGGCAGACC	GAAACACCGGTAGCAAGTGCGAGACGTGTTTGTGGGGTTAGAGCTAGAAA	1	bc
AACATGCGGG	GAAACACCGGTCGATTCATATCGAAACCTTCCCGTGACAGTGGGGATAGA	1	bc
GCCCCCACCT	GAAACACCGGTAGCAAGTGCGATACGGTGTGGGGTTAGAGCTCGAGAAAT	1	bc
ACGACGCGCG	GAAACACCGGTGCATTCGAAAGTCCGGTCGTAGTGTGGACGTGGGGTTAG	1	bc
GCATTTAAAG	GAAACACCGGTCGGGGCCACTCAGTGGGGGGGTTAGAGCTAGAAGTAGCA	1	bc
ATCAACGCCT	GAAACACCGGTTAGAGCTAGAAATAGCAAGTTAACCTAAGGCTAGTCCGT	1	bc
AAGTCCATAC	GAAACACCGGTGCCCTTACTCTCACCTGATTACTTAATCCGTGGGGTTAG	1	bc
AGTAATCGGC	GAAACACCGGTACCTTTGTTGATGCTGGGTGGGGTTAGAGCTAGAAATAG	1	bc
TTATATCGTG	GAAACACCGGTTATATTTGTAAGTGTGTGGGGTTAGAGCTAGAAATAGCA	1	bc
GAAAGTAGGT	GAAACACCGGTTACATTGAGGGGTTAGAGCTAGAAATAGCGAGTTAACAT	1	bc
ACATACACCG	GAAACACCGGTCGGGGCCACTCAGTGGGGTTAGAGCTAGAAATAGCAAGT	1	bc
ACGACTCCGT	GAAACACCGGTCTAGAGTGAGGTGTTCAGGGTGGGGTTAGAGCTAGAAAT	1	bc
GGTATCGTCC	GAAACACCGGTTAGGTTGAGAGGCGGGCGATGGTGTGGCTGGAGGTATCG	1	bc
GAGTCTGTCT	GAAACACCGGTCCGTAGGAGACCCGTGTGGCATGTACCTGTGGGGTTAGA	1	bc
ACTACTCGAC	GAAACACCGGTACCTTTGTTGATGCTGGGTGGAAGGAATTTCCGTGGGGT	1	bc
AAGTGTTGTC	GAAACACCGGTGACAGTGGGGTTAGAGCTAGAAATAGCAAGTTAACCTAA	1	bc
TTTGTTTTGT	GAAACACCGGTTACATTGGGATTGGGGTTAGAGCTAGAAATAGCAAGTTA	1	bc
GAATACGCTC	GAAACACCGGTCGGCGGCAAGTCATAGCAAGTTAACCTATAGCTAGACTG	1	bc
GAGGGGCCGC	GAAACACCGGTTACCGTCCAGTGGGGTTAGGGCTAGAACTAGCAAGTTAA	1	bc
ACGTGTAGTC	GAAACACGGTTAGAGCTAGAAATAGCAAGTTAACCTAAGGCTAGTCCGTT	1	bc
GAGTGTGCCG	GAAACACCGGTCCGTAGGAGACCCGTGTGGCATGTACCTGTGGGGTTAGA	1	bc
TAAATTGTAA	GAAACACCGGTAACTATATTCATGCGATATCGCCGTATCAGTGGGGTTAG	1	bc
GAACAACGCC	GAAACACGGGTTAGAGCTAGAAATAGCAAGTTAACCTAAGGCTAGTCCGT	1	bc
CGGCTTGGCT	GAAACACCGGTTTGCGTGGTGGGGTTAGAGCTAGAAATAGCAAGTTAACC	1	bc
ACCTTAGGCT	GAAACACCGGTAGCAAGATCGAGACGTGTTCCATAGCAAGTTAACCTAAG	1	bc
AGCCCATGCA	GAAACACCGGTAAATTTGAGGCTCCGGCATGCAGGCGGCCGTGGGGTTAG	1	bc
AGACGCACGT	GAAACACCGGTGCATTCGAAAGTCCGGTCGTAGTGTGGACGTGGGGTTAG	1	bc
AAAGAGCTAC	GAAACACCGGTGCCCTTACTCTCACCTGATTACTTAATCCGTGGGGTTAG	1	bc
AAGAACCTCG	GAAACACCGGTGCATTCGAAAGTCCGGTCGTAGTGTGGACGTGGGGTTAG	1	bc
AGATACAGCG	GAAACACCGGTAGCAAGTGCGAGACGTGTTAAATAGCAAGTTAACCTACG	1	bc
TGACACCGAC	GAAACACCGGTAGCAAGTGTGAGACGTGTTAAATAGCAAGTTAACCTAAG	1	bc
CAAGTTGGTT	GAAACACCGGTCGATTCATATCGAAACCTTCCCGTGACCGTGGGGTTAGA	1	bc
GATAATCATT	GAAACACCGGTCTCGAGTGAGGTGTTTAGGTGGGGTTAGAGCTAGAAATA	1	bc
AAACCCGCGA	GAAACACCGGTGCATTCGAAAGTCCGGTCGTAGTGTGGACGTGGGGTTAG	1	bc
ATGGTCCTAC	GAAACACCGGTTCCCTTTCTCTCACCTGATTACTTAATCCGTGGGGTTAG	1	bc
ATACTGATCT	GAAACACCGGTTTACGGTACAGCAGGTAGTTGTTTGGGATGGAGAGATAG	1	bc
AATGACCTCC	GAAACACCGGTGCCCTTACTCTCACCTGATTACTTAATCCGTGGGGTTAG	1	bc
ATTAGCGATG	GAAACACCGGTTACATTGAGGGGTTAGAGCTAGAAATAGCAAGTTAACCT	1	bc
CGATGCTTAG	GAAACACCGGTTTACGTTGCATCGGTGTGGGGTTAGAGCTAGAAATAGCA	1	bc
AGAGTTGGCT	GAAACACCGGTGACATTGGGTGGGGTTAGAGCTAGAAATAGCAAGTTAAC	1	bc
AGGCCTACCT	GAAACACCGGTTTACGCTGTTGTGGGGTTAGAGCTAGAAATAGCAAGTTA	1	bc
ACTGTAGCGC	GAAACACCGGTCGGGGCCACTCAGTGGTGGGGTTAGAGCTAGAAATAGCA	1	bc
TAGCCAGGTA	GAAACACCGGTCGATTTATCTCCAAACCTTCCCGTGATAAGTGGGGATAG	1	bc
AGCGCGCTCC	GAAACACCGGTGCCCTTACTCTCACCTGATTACTTACTCCGTGGGGTTAG	1	bc
TCTCTCGGGC	GAAACACCGGTTATATTTGATAGTGAGCGGGGATCGAGCTAGAGATATCA	1	bc
GGGGGGGCTT	GAAACACCGGTTCCCGTCCAGTGGGGTTAGAGCTAGAAATAGCAAGTTAA	1	bc
TTGTGAATGC	GAAACACCGGTTAAGGCCACTCGGTGGAGGGGTTAGAGGTAGAAAGAGCA	1	bc
TTAGAGATGC	AGTTGGGGTTAGAGCTGGAACTAGGGAGTTAGCCTAAGGCTAGAAAGATC	1	bc
