CCAATGTCAC	GAAACACCGGTGACATTGGGTATTCGGGCCCATTGGTATGGCAGATCGGA	11	bc
CTCCCCTGCA	GAAACACCGGTGTGGCTGAGAGTCCGGCAATGGTGTGGCTGTGGGGTTAG	10	bc
GTACACAATT	GAAACACCGGTTAAAGTAAATTGCGAGTGGGGTTAGAGCTAGAAATAGCA	9	bc
AGGCACACTC	GAAACACCGGTGTGGCTGAGAGTCCGGCAATGGTGTGGCTGTGGGGTTAG	5	bc
ACCTTTACAG	GAAACACCGGTCGGGGCCACTCAGTGGTGGGGTTAGAGCTAGAAATAGCA	4	bc
AGAGGAGCCT	GAAACACCGGTTCCCGTCCAGTGGGGTTAGAGCTAGAAATAGCAAGTTAA	4	bc
AAACGCCCGA	GAAACACCGGTGCCCTTACTCTCACCTGATTACTTAATCCGTGGGGTTAG	3	bc
AATTTAACGC	GAAACACCGGTCGGGGCCACTCAGTGGTGGGGTTAGAGCTAGAAATAGCA	3	bc
AAATCGTCGT	GAAACACCGGTGTACGTATGGACTGAACCAGGGTGTGCAAGTGGGGTTAG	3	bc
AGGAACCCTC	GAAACACCGGTGTGGCTGAGAGTCCGGCAATGGTGTGGCTGTGGGGTTAG	2	bc
AAACGACCTA	GAAACACCGGTGCCCTTACTCTCACCTGATTACTTAATCCGTGGGGTTAG	2	bc
AGAAGAACCG	GAAACACCGGTCGGCGGCAATCGTGGGTGGGGTTAGAGCTAGAAATAGCA	2	bc
ACCTTTAACG	GAAACACCGGTCGGGGCCACTCAGTGGTGGGGTTAGAGCTAGAAATAGCA	2	bc
AAGACTGCCT	GAAACACCGGTCCGTAGGAGACCCGTGTGGCATGTACCTGTGGGGTTAGA	2	bc
TCACGCCCTA	GAAACACCGGTGCCCTTACTCTCACCTGATTACTTAATCCGTGGGGTTAG	2	bc
ACACAACGCA	GAAACACCGGTTTGAACTAGAAATAGCAAGTTAACCTAAGGCTAGTCCGT	2	bc
ACGACTCCTT	GAAACACCGGTCTCGAGTGAGGTGTTCAGGGTGGGGTTAGAGCTAGAAAT	2	bc
GGCACATATA	GAAACACCGGTAAATTTGAGGCTCCGGCATGCAGGAGGCCGTGGGGTTAG	2	bc
ACGAATTCTT	GAAACACCGGTCTCGAGTGAGGTGTTCAGGGTGGGGTTAGAGCTAGAAAT	2	bc
ACATCGTGGT	GAAACACCGGTGTACGTATGGACTGAACCAGGGTGTGCAAGTGGGGTTAG	2	bc
AGGCACCCTA	GAAACACCGGTGTGGCTGAGAGTCCGGCAATGGTGTGGCTGTGGGGTTAG	2	bc
GCGACCCTCG	GAAACACCGGTGCATTCGAAAGTCCGGTCGTAGTGTGGACGTGGGGTTAG	2	bc
AAACAACGCC	GAAACACCGGTTTGAACTACCTAGTTCAAACCGGTGGGGTTAGAGCTAGA	2	bc
AACCTTCGGT	GAAACACCGGTCGATTCATATCGAAACCTTCCCGTGACAGTGGGGTTAGA	2	bc
GCGAATCATT	GAAACACCGGTCTCGAGTGAGGTGTTCAGGGTGGGGTTAGAGCTAGAAAT	2	bc
AAGAACCTCG	GAAACACCGGTGCATTCGAAAGTCCGGTCGTAGTGTGGACGTGGGGTTAG	2	bc
GATCGTCGAA	GAAACACCGGTGTACGTATGGACTGAACCAGGGTGTGCAAGTGGGGTTAG	1	bc
CGGTGGAGCC	GAAACACCGGTTCCCGTCCAGTGGGGTTAGAGCTAGAAATAGCAAGTTAA	1	bc
GCGTACGCTT	GAACCACCGGTCCGTAGGAGACCCGTGTGGCATGTACCTGTGGGGTTAGA	1	bc
GAAGAATGCA	GAAACACCGGTCCGTAGGAGACCCGTGTGGCATGTACCTGTGGGGTTAGA	1	bc
GTGGCTCCTA	GAAACACCGGTTCCCGTCACGTTAGAGCTAGAATTAGCAAGTTAATATAA	1	bc
AGAAGACGCG	GAAACACCGGTCGGCGGCAAGTGGGGTTAGAGCTAGAAATAGCAAGTTAA	1	bc
TCGGGTTGCC	GAAACACCGGTGACATTAGGTTAGAGCTGGAAATAGCAAGTTAACCTAAG	1	bc
AACATGCGGT	GAAACACCGGTCGATTCATATCGAAACCTTCCCGTGACAGTGGAGTTAGA	1	bc
GGAGTGTGGG	GAAACACCGGTCCGTAGGAGACCCGTGTGGCATGTACCTGTGGGGTTAGA	1	bc
AGAAGCCCCG	GAAACACCGGTCGGCGGCAACGTGGGGTTAGAGCTAGAAATAGCAAGTTA	1	bc
GTTGAGGCTA	GAAACACCGGTTCCCGTCCAGTGGGGTTAGAGCTAGAAATAGCAAGTTAA	1	bc
AGTGGACCCT	GCAACACCGGTCGGCGCCACCTGTCGGGGGATATAGCTATAAATAGCAAG	1	bc
GCTACGCGGC	GAAACACCGGTACCTTTGTTGATGCTGGGTGGAAGGAATTTTGTGGGGTT	1	bc
CATATATTCC	GAAACACCGGTGTCGCATCCATTCCGGCGGTGGTGTGGCTGTAGGTAGCG	1	bc
GGTGCACCTC	GAAACACCGGTTCCCGTCCAGTGGGGTTAGAGCTAGAAATAGCAAGTTAA	1	bc
AACGGAATAG	GAAACACCGGTGCCCTTACTCTCACCTGATTACTTAATCCGTGGGGTTAG	1	bc
GTCCCAGGCA	GAAACACCGGTAGCACGTGCGAGACGTGTTAGAGCTAGAAATAGCAAGAT	1	bc
TAAACCGCGT	GAAACACCGGTTACAACGAGGTTTATGGCTGGATATAGCAAGTAAAAGTA	1	bc
TTGAGGTCAA	GAAACACCGGTTAAGCCGAGGAGTTAGAGCTAGAAATAGCAAGTTAACCT	1	bc
GTCTAGCGAG	GAAACACCGGTTATATTTGTAAGTGTGTGGGGTTAGAGCTAGAAATAGCA	1	bc
AAAAACAGTG	GAAACACCGGTCTCGAGTGAGGTGTTCAGGGTGGGGTTAGAGCTAGAAAT	1	bc
GGGGCGGCTC	GAAACACCGGTGTGGCTGAGAGTCCGGCAGTGGTGTGGCTGGGGGGTTAG	1	bc
GTGACTCCTC	GAAACACCGGTTCCCGTCCAGTGGGGTTAGAGCTAGAAATAGCAAGTTAA	1	bc
ACATTTGTAT	GAAACACCGGTCGATTCATATCGGACCTGCAGGAACCGAATGTGAATTCG	1	bc
AGGTACCCAC	GAAAACACCGGTGTGGCTGAGAGTCCGGCAATGGTGTGGCTGTGGGGTTA	1	bc
GGCAACGACA	GAAACACCGGTAAATTTGAGGCTCCGGCATGCAGGAGGCCGTGGGGTTAG	1	bc
TTATCTAAAG	GAAACACCGGTTACATTGAGGTACAGAGCTAGAAAGAGCAAGGAAACCTA	1	bc
AAAGAGTATA	GAAACACCGGTTAAGCCGAGGTTAGAGCTAGAAATAGCAAGTTAACCTAA	1	bc
GATAAACCTG	GAAACACCGGTAAATTTGAGGCTCCGGCATGCAGGAGGCCGTGGGGTTAG	1	bc
GAACTCGGCA	GAAACACCGGTACCTTTGTTGATGCTGGGTGGAAGGAATTTTTGTGGGGT	1	bc
GGTACGCCCC	GAAACACCGGTGTGGCTGAGAGTCCGGCAATGGTGTGGCTGTGGGGTTAG	1	bc
CATCGCGGTG	GAAACACCGGTGTACGTAGGGACTGAGCCAAGGTGTGCAAGTGGGAATAG	1	bc
GGCCTCTTCC	CCGGTAAATTTGAGGCTCCGGCATGCAGGAGGCCTGGGGTTAGAGCTAGA	1	bc
CCAAACGCTC	GAAACACCGGTTTGAACTAGAAATAGCAAGTTAACCTAAGGCTAGTACGT	1	bc
AGATACAGAC	GAAACACCGGTAGTTAGAGCTAGAAATAGCAAGTTAACCTAAGGCTAGTC	1	bc
AACTATACAG	GAAACACCGGTCGGGGCCACTCAGTGGTGGGGTTAGAGCTAGAAATAGCA	1	bc
ATTGCTCTAT	GAAACACCGGTGCCCTTACTCTCACCTGATTACTTAATCCGTGGGGTTAG	1	bc
GAGACGGACC	GAAACACCGGTAGCAAGTGCGAGACGTGTTTGTGGGGTTAGAGCTAGAAA	1	bc
AAACAACGCC	GGGTTAAAGCTAGAAATAGCAAGTTAACCTAAGGCTAGTCCGTTATCAAC	1	bc
GGAACCAATT	GAAACACCGGTTAAAGTAAATTGCGAGTGGGGTTAGAGCTAGAAATATCG	1	bc
TACCCTATAT	GAAACACCGGTAACTATATTCATGCGATATCGCCGTATCAGGGGGGTTAG	1	bc
AGAAGGCCCG	GAAACACCGGTCGGCGGCAATCGTGGGTGGGGTTAGAGCTAGAAATAGCA	1	bc
GTGCTAAGCC	GAAACACCGGTTTACGTTGCATCGGTGTGGGGTTAGAGCTAGAAATAGCA	1	bc
AATGCCCACC	GAAACACCGGTGCCCTTACTCTCGCCTGATTACTTAATCCGTGGGGTTAG	1	bc
GTAGAGGGTC	GAAACACCGGTACCTTTGTTATGGCTTGAAATCGCGAGATAGCCAGATAC	1	bc
ACATTGTCGT	GAAACACCGGTGTACGTATGGACTGAACCAGGGTGTGCAAGTGGGGTTAG	1	bc
AACGCTATAT	GAAACACCGGTGGCCCTGCTGTCACCTCATTACTTAATCAGTGTGGTTAG	1	bc
AAGAGACAAA	GAAACACCGGTTAAGCCGAGTGGGGTTAGAGCTAGAAATAGCAAGTTAAC	1	bc
ACCAACGCTC	GAAACACGGGTTAGAGCTAGAAATAGCAAGTTAACCTAAGGCTAGTCCGT	1	bc
GCACTACGCC	GAAACACCGGTGGGGTTAGAGCTAGAAATAGCAAGGTAACCTAAGGCTAG	1	bc
TACGATATTT	GAAACACCGGTTACTATATTCTGGCGTTAGAACCAGGAATAGAGAGCTAG	1	bc
GGCCCATAAC	GAAACACCGGTAAATTTGAGGCTCCGGCATGCAGGAGGCGTGGGGTTAGA	1	bc
GTGAGCTATC	GAAACACCGGTTAAGCCGAGGGGATAGAGCGAGAAATAGCAAGTTAACCT	1	bc
ACACAACGCA	GCTAGAAATAGCAAGTTAACCTAAGGCTAGTCCGTTATCAACTTGAAAAA	1	bc
GTGGCCCCTA	GAAACACCGGTAAATTTGAGGCTCCGGCATGCAGGAGGCCGTGGGGTTAG	1	bc
AGTGGAGTCG	GAAACACCGGTTCCCGTCCAGTGGGGTTAGAGCTAGAAATAGCAAGTTAA	1	bc
AGTGTTGCAT	GAACCTAAGGCTAGTCCGTTATCAACTTGAAAAAGTGGCACCGAGTCGGT	1	bc
ACACCATCGA	GAAACACCGGTGCATTCGAAAGTCCGGTCGTAGTGTGGACGTGGGGTTAG	1	bc
TTGGTTACGT	GAAACACCGGTTACATTACGGGCTAAAGCTAGTTATAGCTAGATAACCTA	1	bc
CCCACCGCCA	GAAACACCGGTTTGTGGGGTTAGAGCTAGAAATAGCAAGTTAACCTAAGG	1	bc
ACCACACCCC	GAAACACCGGTACCTTTGTTGATGCTGGGTGGAAGGAGCTAGATGCTGGT	1	bc
TAGCGTCGCC	GAAACACCGGTGTACGTATGGACTGAACCAGGGTGTGCAAGTGGGGTTAG	1	bc
AGAGACAGAC	GAAACACCGGTAGCAAGAGGGGTTAGAGCTAGATATAGCAAGGTGACCTA	1	bc
AGGATGTGTA	GAAACACCGGTCCGTAGGAGACCCGTGTGGCATGTACCTGTGGGATTAGA	1	bc
TCTTTCGCGC	GAAACACCGGTTATATTTGTATGTGTGTGGGGTTAGAGCTAGAAATAGCA	1	bc
AGATCCTACA	GAAACACCGGTAAATTTGAGGCTCCGGCATGCAGGAGGCCGTGGGGTTAG	1	bc
GTGCAGAGTT	GAAACACCGGTTTCCGTCCAGTGGGGTTAGAGCTAGAAATAGCAAGTTAA	1	bc
TTGCCTGTGC	GAAACACCGGTTACATTGAGGGTTAGAGCTAGAAATAGCAAGTTAACCTA	1	bc
AAGAACGCGC	GAAACACCGGTTTGAACTAGAAATAGCAAGTTAACCTAAGGCTAGTCCGT	1	bc
CCTAGACGTC	GAAACACCGGTGTACGTATGGACTGAACCAGGGTGTGCAAGTGGGGTTAG	1	bc
AGGCGCCTAA	GAAACACCGGTAAATTTGAGGCTCCGGCATGCAGGAGGCCGTGGGGTTAG	1	bc
GCCACCGACC	GAAACACCGGTAGCAAGTGGGGTTAGAGCTAGAAATAGCAAGTTAACCTA	1	bc
TAGTCTGAAT	GAAACACCGGTCCGTAGGAGACCCGTGTGGCATGTACCTGTGGGGTTAGA	1	bc
TCAAAACGCC	GAAACACCGGTTTGGACTAGAAATAGCAAGTTAACCTAAGGCTAGTCCGT	1	bc
TAGCTGCTCA	GAAACACCGGTACTATATTCATGAGATATCGCAGTATCAGTGGGGTTAGA	1	bc
TCGATAGGGG	GGAACACCGGTTATATTTGTAAGTTTGTGGGGTTAGAGCTAGAAATAGCA	1	bc
AGAAACATTT	GAAACACCGGTCTCGAGGTGGGGTTAGAGCTAGAAATAGCAAGTTAATCT	1	bc
GCCAGAGTGA	GAAACACCGGTAGCAAGTGGGGTTAGAGCTAGAAATAGCAAGTTAACCTA	1	bc
ACACAATGCC	GCTAGAAATAGCAAGTTAACCTAAGGCTAGTCCGTTATCAACTTGAAAAA	1	bc
AACTTTACCG	GAAACACCGGTCGGGGCCACTCAAGTGGGGTTAGAGCTAGAAATAGCAAG	1	bc
GAGACTGCCT	GAAACACCGGTCCGTAGGAGACCCGTGTGGCATGTACCTGTGGGGTTAGA	1	bc
GGTGACGTGC	GAAACACCGGTCGGCGGCAATCGTGGGTGGGGTTAGAGCTAGAAATAACA	1	bc
ACTTGCGGAT	GAAACACCGGTCGATTCATATCGAAACCTTCCCGTGACAGTGGGGTTAGA	1	bc
GCGTCGCCCT	GAAACACCGGTGTCCGCTGCCAGCTCCATTGTGGGGTTAGAGCTAGAAAT	1	bc
CCCGCCCCCT	GAAACACCGGTTACATTGAGGGGTTAGAGCTAGAAATAGCAAGTTAACCT	1	bc
GCGGAGACTA	GAAACACCGGTTCCCGTCCAGTGGGGTTAGAGCTAGAAATAGCAAGTTAA	1	bc
GGCGCGCTTC	GAAACACCGGTGTGTCTGTGAGTCCGGCTATGGTGTGGCTGTGGGGTCAG	1	bc
ACTACTAGGC	GAAACACCGGTACCTTTGTTGATGCTGGGTGGGGTTAGAGCTAGAAATAG	1	bc
GAGGAGAGTC	GAAACACCGGTTCCAGTACCTGGGGGTTAGAGCTAGAAATAGCAAGTTAA	1	bc
GACTACGCGC	GAAACACCGGTTTGAACTACCTAGTTCAATCCGTGGGGTTAGAGCTAGAC	1	bc
GAGGGGCGTC	GAAACACCGGTTCCCGTCCAGTCTGGATAGAGCTAGAAATAGCAAGTTAA	1	bc
CGAGACCTTA	GAAACACCGGTCTCGAGAGAGGCAATCAGTGGGGGGTAGAGCTAGAAATA	1	bc
GCAAAACGCC	GAAACACCGGTTTGTGGGGTTAGAGCTAGAAATAGCAAGTTAACCTAAGG	1	bc
AGAAGACGCG	GAAACACCGGTCGGCGGGGTTAGAGCTAGAAATAGCAAGTTAACCTAAGG	1	bc
GCAGAATCGA	GAAACACCGGTCGGCGGCAATCGTGGGTGGGGTTAGAGCTAGAAATAGCA	1	bc
ACATCGTAGT	GAAACACCGGTGTACGTATGGACTGAACCAGGGTGTGCAAGTGGGGTTAG	1	bc
GAATCTTCGT	GAAACACCGGTGTACGTATGGACTGAACCAGGGTGTGCAAGTGGGGTTAG	1	bc
AACCTAGACA	GAAACACCGGTAGCAAGTGCGGGGTTAGAGCTAAAAATAGCAAGTTAAAC	1	bc
GGCAACGCCA	GAAACACCGGTAATTTTGAGGCTCCGGTATGCATGGGGGTGGAGTTAGAG	1	bc
CATGGTAGTA	GAAACACCGGTGTACGTATGGACTGAACCAGGGTGGGCAAGTGGGGTTAG	1	bc
ATTAACTATG	GAAACACCGGTTACATTGAGGGTTAGAGCTAGAAATAGCAAGATAACCTA	1	bc
AACTTTACCG	GAAACACCGGTCGGGGCCACTCAGTGTGGGGTTAGAGCTAGAAATAGCAA	1	bc
AGACAGTCAA	GAAACACCGGTGCATTCGAGAGTCCGGTCGTGGTGTGGAAGTGGGGTTAG	1	bc
TTGCCCTTCT	GAAACACCGGTTACTTTAAGGGTTTATGGGGTGGGTTTAGAGCTAGAATA	1	bc
TAATCTGGCT	GAAACACCGGTTACATTGAGATTATTGCTCGAAGGGGCAGAGCCGGTATC	1	bc
ATATCTGTGC	GAAACACCGGTGCATTCGAAAGTCCGGTCGTAGTGTGTACGTGGGGTTAG	1	bc
ACATCGTCGA	GAAACACCGGTGTACGTATGGACTGAACCAGGGTGTGCAAGTGGGGTTAG	1	bc
GTGGGCACGC	GAAACACCGGTTCCCGTCCAGTGGGGTTAGAGCTAGAAATAGCAAGTTAA	1	bc
TAGCTAGCGG	GAAACACCGGTTATATTTGTAAGTGTGTGGGGTTAGAGCTAGAAATAGCA	1	bc
TTTCGCATAT	GAAACACCGGTTAAGCCGAGGGTTAGAGCTAGAAAGAGCAAGTTAACCTA	1	bc
AAAAAAAGCC	GAAACACCGGTTTGAACTACCTAGTTCAAACCGGTGGGGCTAGAGCTAGA	1	bc
GAAGATTCGA	GAAACACCGGTCGGCGGCAATGGGGTTAGAGCTAGAAATAGCAAGTTAAC	1	bc
ACGAATCGTT	GAAACACCGGTCTCGAGTGAGGGGTTAGAGCTAGAAATAGCAAGTTAACC	1	bc
CCCCCCCTCC	GAAACACCGGTGCCCTTACTCTCACCTGATTACTTAATCCGTGGGGTTAG	1	bc
AGTGAGCATA	GAAACACCGGTTAAGCCGTGGGGTTAGAGCTAGAAATAGCAAGTTAACCT	1	bc
TCTAGCGAAA	GAAACACCGGTTATATTTGTATGTGGGGTTAGAGCTAGAAATAGCAAGTT	1	bc
AACGTGTTGT	GAAACACCGGTGACATTGGGTACAGGGTGGGGTTAGAGCTAGAAATAGCA	1	bc
AAAAGAGCCG	GAAACACCGGTCGGCGGCATTCGCGGGTGGGGTTAGAGCTAGAAATAGCA	1	bc
AACGGGCTTC	GAAACACCGGTGCCCTTACTCTCACCTGATTACTTAATCCGTGGGGTTAG	1	bc
AAGTCTGACT	GAAACACCGGTCCGTAGGAGACCCGTGTGGCATGTACCTGTGGGGTTAGA	1	bc
AGTCTTTCTA	GAAACACCGGTCCGTAGGAGACCCGTGTGGCATGTACCTGTGGGGTTAGA	1	bc
AAGTGTTGTC	GAAACACCGGTGACATTGGGTACAGGGTGGGGTTAGAGCTAGAAATAGCA	1	bc
CACAAAGAGC	GCTAGAAATAGCAAGTTAACCTAAGGCTAGTCCGTTATCAACTTGAAAAA	1	bc
CACCAAGCCA	GAAACACCGGTTTGAACTAGAAATAGCAAGTTAACCTAAGGCTAGTCCGT	1	bc
AGCCCTTATA	GAAACACCGGTAAATTTGAGGCTCCGGCATGCAGGAGGCCGTGGGGTTAG	1	bc
GGACCCCTGC	GAAACACCGGTGTGGCTGAGAGTCCGGCAATGGTGTGGCTGTGGGGATAG	1	bc
GCCTTTAACG	GAAACACCGGTCGGGGCCACTCAGTGGTGGGGTTAGAGCTAGAAATAGCA	1	bc
CTCTACTCGG	GAAACACCGGTACCTTTGTTGATGCTAGGTGGAAGGAATGTGGGGTTAGA	1	bc
GATACCAGCA	GAAACACCTGTTTACATTGACTTAACCTGAGGCTAGTGCGATATCAACTT	1	bc
AAGTCTCTAG	GAAACACCGGTGCATTCGAAAGTCCGGTCGTAGTGTGGACGTGGGGTTAG	1	bc
GTATATCGAG	GAAACACCGGTTATATTTGTAAGTGTTGTGGGGTTAGAGCTAGAAATAGC	1	bc
ACGGCCCACC	GAAACACCGGTGCCCTTACTCTCACCTGATTACTTAATCCGTGGGGTTAG	1	bc
GCACTTCTAC	GAAACACCGGTAACTATATTCATGCGATATCGACGTATCAGTGGGGTTAG	1	bc
TCATTTACCG	GAAACACCGGTCGGGGCCACTCAGTGGTGGGGTTAGAGCTAGAAATAGCA	1	bc
TTGGCAAGTT	GAAACACCGGTTACATTGAGGGGTTAGAGCTAGAAATAGCAAGTTAACCT	1	bc
TCTACGCGGA	GAAACACCGGTACCTTTGTTGATGCTGGGTGGAAGGAATGGGTGGGGTTA	1	bc
ATCATCGGCC	GAAACACCGGTACCTTTGTTGATGCTGGGTGGTGGGGTTAGAGCTAGAAA	1	bc
CCCGACGTAC	GAAACACCGGTGCCCTTACTCTCACCTGATTACTTAATCCGTGGGGTTAG	1	bc
AAGTAAGGTT	GAAAAACCGGTCGATTCATATCGAAACCTTCCCGTGACAGTGGGGTTAGA	1	bc
AGAAGACACG	GAAACACCGGTCGGCGGCAATCGTGGGTGGGGTTAGAGCTAGAAATAGCA	1	bc
ACGTGATGTC	GAAACACCAGTGGGGTTAGAGCTAGAAATAGCATGTTAACCTAAGGCTAG	1	bc
ATTACTAGGC	GAAACACCGGTACCTTTGTTGATGCTGGGTGGAAGGAATTGCTAGAAATA	1	bc
CGAGTGGTCC	GAAACAACAGTGGGGTTAGAGCTAGAAATAGCAAGTTAAACTAAGGCTAG	1	bc
GCTAGCGCGG	GAAACACCGGTTATATTTGTAAGTGTGTGGGGTTAGAGCTAGAAATAGCA	1	bc
ACATCGTCGG	GAAACACCGGTGTACGTATAGACTGAACCAGGGTGTGCAAGTGGGGTTAG	1	bc
GCTACTAGGC	GAAACACCGGTACCTTTGTTGCTGGGGTTAGAGCTAGAAATAGCAAGTTA	1	bc
ATCACTTAGC	GAAACACCGGTTTACGTTGCATCGGTGTGGGGTTAGAGCTAGAAATAGCA	1	bc
GAAATAGGCC	GAAACACCGGTAGCAAGGGTGATACGTGTTAAATAGCATGTTAACCTTAG	1	bc
ACCTTTATCG	GAAACACCGGTCGGGGCCACTCAGTGGTGGGGTTAGAGCTAGAAATAGCA	1	bc
ACTACTCGTT	GAAACACCGGTACCTTTGTTGATGCTGAAATAGCAAGTTAACCTAAGGCT	1	bc
AACCGTGGTC	GAAACACCGGTGTACGTATGTACTGAACCTGGGGGTGCAAGTGGGGTTAG	1	bc
ACACAACGCT	GAAACACCGGTTTGAACTACCTAGTTCAAACCGGTGGGGTTAGAGCTAGA	1	bc
TAACGGACTA	GAAACACCGGTGCCCTTACTCTCACCTGACTACTTAATCCGTGGGGTTAG	1	bc
TGAATAACCG	GAAACACCGGCCGGCGGGGTTAGAGGTAGAAATAGCAAGTTAACCTAAGG	1	bc
AACTCATATA	GAAACACCGGTAGATTCTGTTGCTTCGTATGGTTAGAGCCGTGAATAGCA	1	bc
TGACTCCTTG	GAAACACCGGTTCCCGTCCAGTGGGGTTAGAGCTAGAACTAGCAAGTTAA	1	bc
CGAACGATTT	GTAACACCGGTCTCGAGTGAGGTGTTCAGGTGGGGTTAGAGCTAGAAATA	1	bc
GCATAGTCGT	GAAACACCGGTGTACGTATGGACTGAACCAGGGTGTGCAAGTGGGGTTAG	1	bc
AGTCTGAGTT	GAAACACCGGTCCATAGTAGACGCGTGTGGCATGTACCGGGGGATAGAGC	1	bc
ACTACGCGGC	GAAACACCGGTACCTTAGAGCTAGAAATAGCAAGTTAACCTAAGGCTAGT	1	bc
TTAGTTGTGC	GAAACACCGGTTACATTGAGGGTTAGAGCTAGAAATAGCAAGTTAACCTA	1	bc
AGACGCTGCG	GAAACACCGGTCGGCGGCAATCGTGGTTAGAGCTAGAAATAGCAAGTTAA	1	bc
AGTGCGCCTT	GAAACACCGGTCCGTAGGAGACCCGTGTGGCATGTACCTTGTGGGGTTAG	1	bc
GCAGAAACGC	GAAACACCGGTCGGCGGCAATTAGAGCTAGAAATAGCAAGTTAACCTAAG	1	bc
AGAGCTGTCT	GAAACACCGGTGACGGTGGGGTTAGAGCTAGAAATAGCAAGTTAACCTAA	1	bc
AAAAGACCTG	GAAACACCGGTCGGCGGCAATCCCCCCCGTGGGGTTAGAGCTAGAAATAG	1	bc
ACCGTTACCG	GAAACACCGGTCGGGGCCACTCAGTGGTGGGGCTAGAGCTAGAAATAGCA	1	bc
GCGAATCCCT	GAAACACCGGTCTCGAGCGAGGTGTTCAGGGTGGGGTTAGAGCTAGAAAT	1	bc
CCTCCCCCCC	GAAACACCGGTGTACGTATGGACTGAACCAGGGTGTGCAAGTGGGGTTAG	1	bc
AGAATGTCGC	GAAACACTGGTCCGTAGGAGACCCGTGTGGCATGTACCTGTGGGGTTAGA	1	bc
AGTGGAGCGT	GAAACACCGGTCCCCGTCCAGTGGGGTTAGAGCTAGAAATAGCAAGTTAA	1	bc
TTGGCGGCTC	GAAACACCGGTTCCCGTCCAGTGGGGTTAGAGCCAGAAATAGCAAGTTAA	1	bc
TGAGCGATGC	GAAACACAGGTTATTGGGGTTAGAGCTAGAAATAGCAAGTTAACCTAAGG	1	bc
AATACGCGGG	GAAACACCGGTACCTTTGTTGATGCTGGGTGGAAGGAATTTGTGGGGTTA	1	bc
ACCGCACGTC	GAAACACCGGTGCCCTTACTCTCACCTAATTACTTAATCCGTGGGGTTAG	1	bc
ATCTTTAGAG	GAAACACCGGTTATATTTGTAAGTGGGTGGTGTTAGAGCTAGAAATAGCA	1	bc
ACGATCAGCT	GAAAAACCGGTTTACGTTGCATCGGTTGTGGGGTTAGAGCTAGAAATAGC	1	bc
AGAAGACACG	GAAACACCGGTCGGCGGCAATCGTGGGTGGGGTTGGAGCTAGAAATAGCA	1	bc
GTACACATTT	GAAACACCGGTTTCGAGTGAGTGGTTCAGGGGGTAGAGCGAGATAGAAAT	1	bc
AGGGTGCCAC	GAAACACCGGTCCTTAGGATACGCGTGTGGGGTGAGCCTAGGGGGATAAA	1	bc
CATACTTGCA	GAAACACCGGTAAATTTGAGGCTCCGGCATGCAGGAGGCCGTGGGGTTAG	1	bc
GTGGTTCGCC	GAAACACCGGTTCCCGTCCAGTGGGGTTAGAGCTAGAAACAGCAAGTTAA	1	bc
TGGTTAGATA	GAAACACCGGTGACATTGTTTAGAGCTAGAAATAGCAAGTTAACCTAAGG	1	bc
ACATAGTCGT	GAAACACCGGTGTACGTATGGACTGAACCAGGGTGTGCAAGTGGGGTTAG	1	bc
AATAGTTGTC	GAAACACCGGTGTACGTATGGACTGAACCAGGGTGTGCAAGTGGGGTTAG	1	bc
AAGAACATCG	GAAACACCGGTGCATTCGAAAGTCCGGTCGTAGTGTGGACGTGGGGTTAG	1	bc
GTACTATACT	GAAACACCGGTGCCTTCGAAAGTCCGGTCTCAGCGTGGAAGTGGGGTTAG	1	bc
GCCTTTCGAG	GAAACACCGGTTATATTTGTAAGTGTGCGGGGTTAGAGCTAGAAATAGCA	1	bc
AGGCTTCTTC	GAAACACCGGTGTACGTATTGACTTAACCAGGGTGTGCAAGTGGGGATAG	1	bc
AGGTATCGTC	GAAACACCGGTGTGGCTGAGAGTCCGGCAATGGTGTGGCTGGGGGGTTAG	1	bc
CAGTTTCCCG	GAAACACCGGTCGGGGCCACTCAGTGGTGGGGTTAGAGCTAGAAATAGCA	1	bc
ATGAGGAGGT	GAAACACCGGTTTACGTTGCATCGGTTGTGGGGTTAGAGCTAGAAATAGC	1	bc
AGAAGATACG	GAAACACCGGTCGGCGGCAATCGTGGTTAGAGCTAGAAATAGCAAGTTAA	1	bc
AGCCTGGATC	GAAACACCGGTACGCAGGGGACACGGTAGGCATGTATCAGAGGGGGAAGT	1	bc
GAAAACACAC	GAAACACCGGTCGGCGGCAATCGTGGAGAGCTAGAAATAGCAAGTTAACC	1	bc
TCAATCGGGT	GAAACACCGGTTATATTTTTACGAGTGCTGGGTTAGACCTAGAAATAGCA	1	bc
AATACTGCGC	GAAACACCGGTACCTTTGTTGGTGCTGGTTGGAAGGATTGGGCTGGGTTA	1	bc
TCTAGAGCGG	GAAACACCGGTTATATTTGTAAGTGTGTGGGGTTAGAGCTAGAAATAGCA	1	bc
GTATACTCGC	GAAACACCGGTAGCTAGAAATAGCAAGTTAACCTAAGGCTAGTCCGTTAT	1	bc
CGAATTATTC	GAAACACCGGTCTCGAGTGAGGTGTTCAGGGTGGGGTTAGAGCTAGAAAT	1	bc
TCGAATACTT	GAAACACCGGTCTCGAGTGAGGTGTTCAGGGTGGGGTTAGAGCTAGAAAT	1	bc
AACATCGTCG	GAAACACCGGTGTACGTATGGACTGAACCAGGGTGTGCAAGTGGGGTTAG	1	bc
AGAGCACTAC	GAAACACCGGTGCGCTTACTCTCACCTGATTACTTAATCCGGGGGGTTAG	1	bc
ATGAGCACCT	GATAAACCGGTTAAGCCGAGTGGGGATAGAGCTAGAAATAGCAAGTTAAC	1	bc
ACTGCTATGT	GAAACACCGGTTACATTGAGGGTTAGAGCTAGAAATAGCAAGTTAACCTA	1	bc
TGAATCATGT	GAAACACCGGTCTCGAGTGAGGTGTTCAGGGTGGGGTTAGAGCTAGAAAT	1	bc
ACACAATGCC	GAAACACCGGTTTGAACTAGAAATAGCAAGTTAACCTAAGGCTAGTCCGT	1	bc
CACCTTACAT	GAAACACCGGTGACTATATTCATGCTGTATCTCCGGATAGGTCTAGTTAG	1	bc
ATGAACAAAA	GAAACACCGGTTAAGCCGAGTGGGGTTAGAGCTAGAAATAGCAAGTTAAC	1	bc
AACCAATGTC	GAAACACCGGTGACATTGGGTATTCGGGCCCATTGGTATGGCAGATCGGA	1	bc
AACATTCGGG	GAAGCACCGGTCGATTCATATCGAAACCTTCCCGTGACAGTGGGGTTAGA	1	bc
ACTCTAGCTC	GAAACACCGGTCGGGGCCACTCAGTGGTGGGGTTAGAGCTAGAAATAGCA	1	bc
TGGGGTGGCT	GAAACACCGGTTCCCGTCCAGTGGGGTTAGAGCTAGAAATAGCAAGTTAA	1	bc
ACAGAACGCC	GAAACACCGGTTTGAACTAGAAATAGCAAGTTAACCTAAGGCTAGTCCGT	1	bc
CAGGGCCTAA	GAAACACCGGTGCCCTTACTCTCACCTGATTACTTAATCCGTGGGGTTAG	1	bc
GGCACACGCT	GAAACACCGGTGTGGCTGAGAGTCCGGCAATGGTGTGGCTGTGGGGTTAG	1	bc
CAAGATGTGC	GAAACACCGGTGGGGTTAGAGCTAGGAATAGCAAGTTAACCTAAGGCTAG	1	bc
AGTAAGCAGG	GAAACACCGGTCCGTAGGAGACCCGTGTGGCATGTACCTTGTGGGGGTAG	1	bc
ATACCATTGC	GAAACACCGGTGCATTCGAAAGTCCGGTCGTAGCGTGGTCGTGGGGTTAG	1	bc
GAAGACGCTA	GAAACACCGGTCGGCGCTAGTCCGTTATCAACTTGAAAAAGTGGCACCGA	1	bc
TCTATAGATC	GAAACACCGGTTAGAGCTAGAAATAGCAAGTTAACCTAAGGCTAGTCCGT	1	bc
ATTGAGCCTA	GAAACACCGGTTAAGCCGAGTGGGGTTAGAGCTAGAAATAGCAAGTTAAC	1	bc
GAACGCCATT	GAAACACCGGTGCCCTTACTCTCACCTGATTACTTAATCCGTGGGGTTAG	1	bc
AACGCTCGAT	GAAACACCGGTGCCCTTACTCTCACCTGATTACTTAATCCGTGGGGTTAG	1	bc
CGAGCTGACT	GAAACACCGGTGACATTGGGTATGGGGTTAGAGCTAGAAATAGCAAGTTA	1	bc
GTCCCATCCA	GAAACACCGGTAAATTTGAGGCTCCGGCATGCAGGAGGCGTGGGGTTAGA	1	bc
AACCAAGCCC	GAAACACCGGTTTGGACTACCTAGAGCTAGAAATAGCAAGTTAACCTAAG	1	bc
ATACGCGGCT	GAAACACCGGTACCTTTGTTGATGCTGGGTGGACGAAACACCGGTACCTT	1	bc
CGGCTGCATC	GAAACACCGGTCCGTAGGAGACCCGTGTGGCATGTACCTGTGGGGTTAGA	1	bc
CTAGACACGC	GAAACACCGGTCGGCGGCAATCGTGGGTGGGGTTAGAGCTAGAAATAGCA	1	bc
TCATAGTCGT	GAAACACCGGTGTACGTATGGACTGAACCAGGGTGTGCAAGTGGGGTTAG	1	bc
ACATAACGCC	GAAACACGGGTTAGAGCTAGAAATAGCAGGTTAACCTAAGGCTAGTCCGT	1	bc
CGTATGCATC	GAAACACCGGTACGTAGGAGACCCGTGTGGCATGTACCTGTGGGGTTAGA	1	bc
AGGCTGACCC	GAAACACCGGTCTGTAGGAGACCCGTGTGGCATGTACCTGTGGGGGTAGC	1	bc
ATTAAGCAGT	GAAACACCGGTTAAGCCGAGTGGGGTTAGAGCTAGAAATAGCAAGTTAAC	1	bc
AGAAACCGAC	GAGACAGCAAGTTAACCTAAGGCTAGTCCGTTATCAACTTGAAAAAGTGG	1	bc
ACGTGTTGTA	GAAACAATAGCAAGTTAACCTAAGGCTAGTCCGTTATCAACTTGAAAAAG	1	bc
CACGCATCAC	GAAGCACCGGTGCCCTTACTCTCACCTGATTACTTAATCCGTGGGGTTAG	1	bc
ATTCCCTCTG	GAAACACCGGTTACATTGAGGGGTTAGAGCTAGAAATAGCAAGGTAACCT	1	bc
AGAATATTTT	GAAACACCGGTCTCGAGTGAGGTGTTCAGGGTGGGGTTAGAGCTAGAAAT	1	bc
CGTGGTGGCC	GAAACACCGGTGACATTGGGTACAAAGTGGGGTTAGAGCTAGAAATAGCA	1	bc
TCGGCTACGG	GAAACACCGGTTACATTTGAGGGGTTAGAGCTAGAAATAGCAAGTTAACC	1	bc
ACGAAGCCTT	GAAACACCGGTCTCGAGTGAGGTGTTCAGGTGGGGTTAGAGCTAGAAATA	1	bc
AGGCCGCTCA	GAAACACCGGTAAATTTGAGGCTCCGGCATGCAGGAGGCCGTGGGGTTAG	1	bc
ATTGAGCATT	GAAACACCGGTTAAGCCGAGGAGTTAGAGCTAGAAATAGCAAGTTAACCT	1	bc
TAGCCTAGCA	GAAACACCGGTTTACGTTGCATCGGAGCGGGGGTAGATCTAGAAATAGCA	1	bc
CACCACGACA	GAAACGGGTTAGAGCTAGAAATAGCAAGTTAACCTAAGGCTAGTCAGTTA	1	bc
GCAGACAGGC	GAAACACCGGTCGGCGGCAATCGTGGGTGGGGTTAGAGCTAGAAATAGCA	1	bc
AAAAGCCTTA	GAAACACCGGTGCCCTTACTCTCACCTGATTACTTAATCCGTGGGGTTAG	1	bc
AGGATTCTCC	GAAACACCGGTGACATTGGGTTTAGCGCTAGAAATAGCTGAATAACCTAC	1	bc
AGGATTTCTT	GAAACACCGGTCTCGAGCGTGGTGTTCAGGGTGGGGGTAGAGCTAGAAAT	1	bc
CAGCGTATTC	GAAACACCGGTGTACGTATGGACTGAACCAGGGTGTGCAAGTGGGGTTAG	1	bc
TACAAAGGAC	GAAACACCGGTTTGAACTAGAAATAGCAAGTTAACCTAAGGCTAGTCCGT	1	bc
AAGACGCCCG	GAAACACCGGTGCATTCGAAAGTCCGGTCGTAGTGTGGACGTGGGGTTAG	1	bc
ATGATTGGTT	GAAACACCGGTTTACGTTGCATCGGTGTGGGGTTAGAGCTAGAAATAGCA	1	bc
ACGTGACCGC	GAAACACCGGTCGGGGCCACTCAGTGGTGGGGTTAGAGCTAGAAATAGCA	1	bc
ATAAGCTCTC	GAAACACCGGTGCATTCGAAAGTCCGGTCGTAGTGTGGACGTGGGGTTAG	1	bc
GCGTTTAGCG	GAAACACCGGTCGGGGCCACTCAGTGGAGGGGTTAGAGCTAGAAATAGCA	1	bc
GGCTCCGCCA	GAAACACCGGTAGCAAGGGCGAGACGTGTTTGTGGGGTTAGAGCTAGAAA	1	bc
CCTTTCCACC	GAAACACCGGTCGGGGCCACTCGGTGGCAGGGTTATAGCTGGGAGGAGCA	1	bc
AGACAAAGAC	GAAACACCGGTAGCAAGTGGGGTTAGAGCTAGAAATAGCAAGTTAACCTA	1	bc
AAGATCGCCC	GGAACACGGGTTAGAGCTAGAAATAGCAAGTTAACCTAAGGCTAGTCCGT	1	bc
TGACTCAGAC	GAAACACCGGTAGCAAGTGGGGTTAGAGCTAGAAATAGCAAGTTAACCTA	1	bc
GATCCACCCA	GAAACACCGGTCGGCGACCGGTTAGAGCTAGAAATAGTAAGTTAACCTAA	1	bc
AGTCTTAGCC	GAAACACCGGTCCGTAGGAGACCCGTGTGGCATGTACCTGTGGAGTTAGA	1	bc
AAGCACGCAC	GAAACACCGGTTTGAACCGGTGGGGTTAGAGCTAGAAATAGCAAGTTAAC	1	bc
TACGACGTTC	GAAACACCGGTTTGAACTACCGGGGTTAGAGCTAGAAATAGCAAGTTAAC	1	bc
CGTACCTCGC	GAAACACCGGTGCATTCGAAAGTCCGGTCGAAGTGTGGACGTGGGGTTAG	1	bc
CGGGATGATT	GAAACACCGGTGACATTGGGTACATGGGTGGGGTTAGAGCTAGAAATAGC	1	bc
TTAGCTCGGG	GAAACACCGGTTTCCTTATGGACTTCACGGGGGTAGAGCTAGAAATAGCA	1	bc
CACGCTCAAC	GAAACACCGGTGCCCTTACTCTCACCTGATTACTTAATCCGTGGGGTTAG	1	bc
GTGAAAGTCC	GAAACACCGGTGTGGCCGAGAGTCTGGCAGTGGTGTAGCTGTAGATATCG	1	bc
ATGGTAAGGC	GAAACACCGGTTTACGGTGCATCGGGGTGGGGTTAGAGCTAGAAATAGCA	1	bc
TCTCTCGCGA	GAAACACCGGTTATATTTTTAAGTGGGTGGGGATAGAGCTAGAAATAGCA	1	bc
CGAATCTTCA	GAAACACCGGTCTCGAGTGAGGTGTTCAGGTGGGGTTAGAGCTAGAAATA	1	bc
AATCGTAGCC	GAAACACCGGTGTACGTAGCGCCTGAACTTAGGGCTGCAAATGGCAATAT	1	bc
AAGTATGCCT	GAAACACCGGTCCGTAGGAGACCCGTGTGGCATGTACTTGTGGGGTTAGA	1	bc
AAGTATGACT	GAAACACCGGTCCGTAGGAGACCCGTAATAGCAAGTTAACCTAAGGCTAG	1	bc
ATGCTACGCC	GAAACACCGGTTTACGTTGCATCGGTTGTGGGGTTAGAGCTAGAAATAGC	1	bc
GGACTCAGAC	GAAACACCGGTAGCAAGTGCGAGACGTGTTAAATAGCAAGTTAACCTAAG	1	bc
CCTCTACGCC	GAAACACCGGTGTACGTATGGACTGAACCAGGGTGTGCAAGTGGGGTTAG	1	bc
GCTATGCCGA	GAAACACCGGTAGCAAGTGGGGTTAGAGCTAGAAATAGCAAGTTAACCTA	1	bc
CCTAGTGGTC	GAAACACCGGTTTAAGTAGGGAGTGAGTCGGGGTATGCAAGTGGGTTGAG	1	bc
AATGCTTCGC	GAAACACCGGTTTACGTTGCATCGGGGTTAGAGCTAGAAATAGCAAGTTA	1	bc
AGGATTAACT	GAAACACCGGTTTACGTTGCATCGGTGTGGGGTTAGAGCTAGAAATAGCA	1	bc
CGTCAGACTC	GAAACACCGGTCCGTAGGAGACCCGTGTGGCATGTACCTGTGGGGGTAGA	1	bc
TCAATTATGC	GAAACACCGGTAACTATATTCATGCGATATCGCCGTATCAGTGGGGTTAG	1	bc
GGACGCATGC	GAAACACCGGTTAATTCGAAAGTCCGGTCGTAGCGTGGACGTGGAGGTAG	1	bc
AAGAAGAACC	GAAACACCGGTCGGGCGGGGTTAGAGCTAGAAATAGCAAGTTAACCTAAG	1	bc
GCCTCCGACA	GAAACACCGGTAGCAAGTGCGAGACGTGTTTTTGTGGGGTTAGAGCTAGA	1	bc
AGACAATGGC	GAAACACCGGTGCATTCGAAAGTCCGGTCGTAGTGTGGACGTGGGGTTAG	1	bc
GAGTGGAGCC	GAAACACCGGTTCCCGTCCAGTGGGGTTAGAGCTAGAAATAGCAAGTTAA	1	bc
AGGCTCTCCC	GAAACACCGGTGCATTCGAAAGTCCGTTCATAGTGTGGACGTGGGGTTAG	1	bc
TCGATCAACT	GAAACACCGGTTATATTTGTAAGTGTGTGGGGTTAGAGCTAGAAATAGCA	1	bc
GGGAGCTACA	GAAACACCGGTAAATTTGAGGCTCCGGCATGCAGGAGGCCGTGGGGTTAG	1	bc
GATCACCAGC	GAAACACCGGTCGGGCGGGGTTAGAGCTAGAAATAGCAAGTTAACCTAAG	1	bc
AAGTCTTCCT	GAAACACCGGTCCGTAGGAGACCCGTGTGGCATGTACCTGTGGGGTTAGA	1	bc
TGACGCGTAT	GAAACACCGGTCCCGAGTGAGGTGTTCAGGGGTGGGGTTAGAGCTAGAAA	1	bc
TACATTAGGT	GAAACACCGGTCGATTCATATCGAAACCTTCCCGTGACAGTGGGGTTAGA	1	bc
GACTCTGCCA	GAAACACCGGTCCGTAGGAGACCCGTGTGGCATGTACCTGTGGGGCTAGA	1	bc
TAATGCCCTA	GAAACACCGGTGCCCTTACTCTCACCTGATTACTTAATCGTGGGGTTAGA	1	bc
ACCCAACGCC	GAAACACCGGTTTGAACTACCGGGGTTAGAGCTAGAAATAGCAAGTTAAC	1	bc
TCGATCGTAA	GAAACACCGGTTATGTTCGGGAGTTAGTGGTAGAAATAGTAAGATAAGCA	1	bc
CCACTCCGTT	GAAACACCGGTCGATTCATATCGAAACCTTCCCGTGACAGTGGGGTTAGA	1	bc
GTGGCGCGTT	GAAACACCGGTTCCCGTCCGGTGGGGTTAGAGCTAGAAATAGCAAGTTAA	1	bc
AGACACAGAG	GAAACACCGGTAGCAAGTGCGAGACGTGTTAAATAGCAAGTTAACCTAAG	1	bc
GACATATCCA	GAAACACCGGTAGTTAGAGCTAGAAATAGCAAGTTAACCTAAGGCTAGTC	1	bc
CACGCTGTAC	GAAACACCGGTGCCCTTACTCTCACCTGATTACTTAATCCGTGGGGTTAG	1	bc
GCACAACGCA	GAAACACCGGTTTGAACTACCTAGTTCAAACCGGTGGGGTTAGAGCTAGA	1	bc
AGCAAAAGCC	GAAACACCGGTAGCAAGTGCGAGACGTGTTTGTGGGGTTAGAGCTAGAAA	1	bc
ATACGCGGAC	GAAACACCGGTACCTTTGTTGATGCTGGGTGGAAGGATTTTCGTGGGGTT	1	bc
AGCGGCGCCT	GAAACACCGGTTCCCGTCCAGTGGGGTTAGAGCTAGAAATAGCAAGTTAA	1	bc
TATGATTAGC	GAAACACCGGTTTACGTTGCATCGGTGTGGGGTTAGAGCTAGAAATAGCA	1	bc
AGGCCGCTAC	GAAACACCGGTAAATTTGAGGCTCCGGCATGCAGGAGGCCGTGGGGGTAG	1	bc
ACCGCCGCAC	GAAACACCGGTGCCCTTACTCTCACCTGATTACGTATTCCGTGGTGTTAT	1	bc
GGCAACTCCT	GAAACACCGGTAAATTTGAGGCCCCGGCATGCAGGAGGCCGTGGGGTTAG	1	bc
AGGCTGATGC	GAAACACCGGTCCGTAGGAGACCCGTGTGGCATGTACCTTGTGGGGTTAG	1	bc
ACGTGTTGGC	GAAACACCGGTGACATTGGAGTGGGGTTAGAGCTAGAAATAGCAAGTTAA	1	bc
GAACGCCATA	GAAACACCGGTGCCCTTACTCTCACCTGATTACTTAATCGTGGGGTTAGA	1	bc
GAGGAACCGA	GAAACACCGGTCGGCGGCACTCGAGGGTGGGGTTAGAGCTAGAAATAGCA	1	bc
ACGTGTCGTC	GAAACACCGGTGACATTGGGTACAGGGTGGGGTTAGAGCTAGAAATAGCA	1	bc
AGGCTTCGCG	GAAACACCGGTTTACGTTGCACCGGGGGTAGAGCTAGAAATAGCAAGTTA	1	bc
GCAGCCATGT	GAAACACCGGTTGAGGGTTAGAGCTAGAAATAGCAAGGTAACCTAAGGCT	1	bc
AGGAAAAGTC	GAAACACCGGTGTGGCTGAGAGTCCGGCAATGGTGTGGCTGTGGGGTTAG	1	bc
AGTCTAGATC	GAAACACCGGTCCGTAGGAGACCCGTGTAGCATGTACCTGTGGGGTTAGG	1	bc
AGTACACGAT	GAAACACCGGTTAAAGTAAATTGCGAGTGGGGTTAGAGCTAGAAATAGCA	1	bc
AATAACGCTA	GAAACACCGGTTAGAGCTAGAAATAGCAAGTTAACCTAAGGCTAGTCCGT	1	bc
ATGCCCAGCA	GAAACACCGGTTTACGTTGCATCGGTGTGGGGTTAGAGCTAGAAATAGCA	1	bc
TCCTTTACAG	GAAACACCGGTCGGGGCGACTCAGTGGTGGGGTTAGAGCTAGAAATAGCA	1	bc
AGCCACGTCC	GAAACACCGGTGTGGCTGAGAGTCCGGCAATGGTGTGGCTGTGGGGTTAG	1	bc
ACACAGTCGC	GAAACACCGGTGCATTCGAAAGTCCGGTCGTAGTGTGGACGTGGGGTTAG	1	bc
AGACATAGAC	CAAAACACCGGTAGCAAGTGCGAGACGTGTTTGTGGGGTTAGAGCTAGAA	1	bc
ATGTTTGGTT	GAAACACCGGTTTACGCTGCATCGGTTGTGGGGGTAGAGCTAGAAATAGC	1	bc
ACCGCCGTGC	GAAACACCGGTGCCCTTACTCTCACCTGATTACTTAATCCGTGGGGTTAG	1	bc
ACTTTACATC	GAAACACCGGTCGGGGTTAGAGCTAGAAATAGCAAGTTAACCTAAGGCTA	1	bc
ACACAACGTC	GAAACACCGGTTTGAACTACCTAGTTCAAACCGGTGGGGTTAGAGCTAGA	1	bc
CGAAAACATT	GAAACACCGGTCTCGAGTGAGGTGTTCAGGTGGGGTTAGAGCTAGAAATA	1	bc
CAGTGGGGCC	GAAACACCGGTTCCCGTCCAGTGGGGTTAGAGCTAGAAATAGCAAGTTAA	1	bc
GACGCTTAGC	GAAACACCGGTTTACGTTGCATCGGGGTTAGAGCTAGAAATAGCAAGTTA	1	bc
AAGGGCATAC	GAAACACCGGTGCCCTTACTCTCACCTGATTACTTAATCCATGGGGTTAG	1	bc
CCTCTTAGAC	GAAACACCGGTTTACGTTGCATCGGTGTGGGGTTAGAGCTAGAAATAGCA	1	bc
AATGCGTAGC	GAAACACCGGTTTACGTTGCATCGGTGTGGGGTTAGAGCTAGAAATAGCA	1	bc
TCATCTATTT	GAAACACCGGTTACATTGAGGGTTAGAGCTAGAAATAGCAAGTTAACCTA	1	bc
ATGATGAGCG	GAAACACCGGTTTACGTTGCATCTGTTGTGGGGTTAGAGCTAGAAATAGC	1	bc
GCGAATCGTT	GAAACACCGGTCTCGAGTGAGGTGTTCAGGGTGGGGTTAGAGCTAGAAAT	1	bc
TAAATTTGAC	GAAACACCGGTAACTATATTCATGCGATATCGCCGTATCAGTGGGGTTAG	1	bc
ATTAGATATG	GAAACACCGGTTACATTGAGATTAGAGCTAGAAAAGGCTAGTCCGTTATC	1	bc
ACCCGCCCTA	GAAACACCGGTGCCCTTACTCTCACCTGATTACTTAATCCGTGGGGTTAG	1	bc
AACTTTACCG	GAAACACCGGTCGGGGCCACTCAGTGGTGGGGTTAGAGCTAGAAATAGCA	1	bc
GCGGATCCTT	GAAACACCGGTCTCGAGTGAGGTGTTCAGGGTGGGGTTAGAGCTAGAAAT	1	bc
ACTATAACGC	GAAACACCGGTCGGGGCCACTCAGTGGTGGGGTTAGAGCTAGAAATAGCA	1	bc
TCGATAGAGA	GAAACACCGGTTATATTTGTAAGTTATAAGTGGGGTTAGAGCTAGAAATA	1	bc
CTCCACGTCC	GAAACACCGGTACCTTTGTTGATGCTGGGTGGGAGGAATGTTGTGGAGTT	1	bc
ACATTACGCG	GAAACACCGGTCGATTCATATCGAAACCTTCCCGTGACAGTGGGGTTAGA	1	bc
GTAAACTATA	GAAACACCGGTAACTATATTCATGCGATATCGCCGTATCAGTGGGGTTAG	1	bc
CTATGATTGG	GAAACACCGGTTTACGTTGCATCGGGGTTAGAGCTAGAAATAGCAAGTTA	1	bc
GCAGACGAGC	GAAACACCGGTCGGCGGGTTAGAGCTAGAAATAGCAAGTTAAACTAAGGC	1	bc
GACGAGTCGC	GAAACACCGGTCGGCGGCAATCGTGGGTGGGGTTAGAGCTAGAAATAGCA	1	bc
ACGTTACCGA	GAAACACCGGTCGGGGCCACTCAGTGGTGGGGTTAGAGCTAGAAATAGCA	1	bc
GTGTCACCTC	GAAACACCGGTTCCCGTCCAGTGGGGTTAGAGCTAGAAATAGCAAGTTAA	1	bc
AAGATCATCG	GAAACACCGGTGCATTCGAAAGTCCGGTCGTAGTGTGGACGTGGGGTTAG	1	bc
ACTATCGAAC	GAAACACCGGTAGCAAGTGTGAGACGTGTTAAATAGCGAGTTAACCTACA	1	bc
ACATGGTCGG	GAAGCACCGGTGTACGTATGGACTGAACCAGGGTGTGCAACTAGAAATAG	1	bc
TAATCGTCGT	GAAACACCGGTGTACGTATGGACTGAACCAGGGTGTGCAAGTGAGGTTAG	1	bc
TCCCATATAC	GAAACACCGGTCACTCTGTACATACGTTTTGGCCGTATAAAGCGAGATAG	1	bc
GGAGATGTCT	GAAACACCGGTGACATTGGAGTGGGGTTAGAGCTAGAAATAGCAAGTTAA	1	bc
TCGAATAAGT	GAAACACCGGTCTCGAGTGAGGTGTTCAGGGTGGGGTTAGAGCTAGAAAT	1	bc
AGGTCCCTAC	GAAACACCGGTAAATTTGAGGCTCCGGCATGCAGGAGGCCGTGGGGTTAG	1	bc
ACTACTAGGC	GAAACACCGGTACCTTTGTTGATGCTGGGTGGAAGGTGGGGTTAGAGCTA	1	bc
GCCTTTACGG	GAAACACCGGTCGGGGCCACTCAGTGGTGGGGTTAGAGCTAGAAATAGCA	1	bc
ATTGGGAATC	GAAACACCGGTTAAGCCGAGGTTAGAGCTAGAAATAGCAAGTTAACCTCA	1	bc
AACGCAATAA	GAAACACCGGTGCCCTTACTCTCACCTGATTACTTAATCCGTGGGGTTAG	1	bc
GTAGATGTGT	GAAACACCGGTTACATTGAGATTGGGGTTAGAGCTAGAAATAGCAAGTTA	1	bc
AGCCCCCAGC	GAAACACCGGTGCGTTCCAAAGTCCGGTGGGAGTGTGGACGGGGGGTTAG	1	bc
ATATATCGAG	GAAACACCGGTTATATTTGTAAGTGGGTTAGAGCTAGAAATAGCAAGTTA	1	bc
GGAGCCGACA	GAAACACCGGTAAATTTGAGGCTCCGGCATGCAGGAGGCCGTGGGGTTAG	1	bc
TGCTATCTCC	GAAACACCGGTGTGGCTGAGAGTCCGGCAATGGTGTGGCTGGGGGGTTAG	1	bc
ACACAACGAC	GAAACACCGGTTTGAACTACCGGGGTTAGAGCTAGAAATAGCAAGTTAAC	1	bc
ACGGGTTGTC	GAGACACCGGTGACATTGGGTACAGGGTGGGGTTAGAGCTAGAAATAGCA	1	bc
TGTGGATTCA	GAAACACCGGTTCCCGTCCAGTGGGGTTAGAGCTAGAAATAGCAAGTTAA	1	bc
ATTTTACTGC	GAAACACAGGTCGGGGCCACTCAGTGGTGGGGTTAGAGCTAGCAATAGCA	1	bc
AAAATCGGCC	GCCAGAACGCCGGAGGATTCCTATCGAAACCTTCCCATGACAGTGGGGAT	1	bc
AAGCGTAGCG	GAAACACCGGTTTACGTTGCATCGGTGTGGGGTTAGAGCTAGAAATAGCA	1	bc
AAACTGATAA	GAAACACCGGTAACTATATTCATGCGATATCGCCGTACCAGTGGGGTTAG	1	bc
GGACGTGGGA	GAAACACCGGTGAACTTAAGGACTGGACCAGGAGGTGCCAAGGGGGTTAG	1	bc
AACGGAGACT	GAAACACCGGTGTGGCTGAGAGTCCGGCAATGGTGTGGCTGTGGGGTTAG	1	bc
ATCACTATAA	GAAACACCGGTTACCTTGAGTATTTGGTGGGGTTAGAGCAAGACAAATTA	1	bc
ATACCGTAGC	GAAACACCGGTGCATTCGAAAGTCCGGTCGTAGTGTGGACGTGGGGTTAG	1	bc
AGGCCCCCTC	GAAACACCGGTGTGGCTGAGAGTCCGGCAATGGTGTGGCTGTGGGGTTAG	1	bc
GCAGACACGT	GAAACACCGGTCGGCGGCAATAGAGCTAGGAATAGCAAGTTAACCTAAGG	1	bc
GAAGATGCGG	GAAACACCGGTCGGCAGCGGTGGGGTTAGAGCTAGAAATAGCAAGTTAAC	1	bc
TCATCGCTGT	GAAACACCGGTGTACGTATGGACTGAACCAGGGTGTGCAAGTGGGGTTAG	1	bc
ACCGCTGTAC	GAAACACCGGTGCCCTTACTCTCACCTGATTACTTAATCCGTGGGGTTAG	1	bc
ACGGGTTGAC	GAAACACCGGTGACATTGGGTACAAGTAGGGTTAGAGCTAGAAATAGCAA	1	bc
GGCTGTCTCA	GAAACACCGGTGTGGCTGAGAGTCCGGCAATGGTGTGGCTGTGGGGTTAG	1	bc
CGCATCGAGG	GAAACACCGGTTATATTTGTAAGTGTGTGGGGTTAGAGCTAGAAATAGCA	1	bc
GGACGTACAT	GAAACACCGGTGAGGCCGAGGGGGCGGGGGGGTAGTGGTAGAAAGAGCAG	1	bc
GGCGGCCTAC	GAAACACCGGTGCCCTTACTCTCACCTGATTACTTAATCCGTGGGGTTAG	1	bc
CATCGCAGTA	GAAACACCGGTGTACGTATGGACTGAACCAGGGTGTGCAAGTGGGGTTAG	1	bc
TATAAACTCG	GAAACACCGGTGCATTCGAAAGTCCGGTCGTAGTGTGGACGTGGGGTTAG	1	bc
GAGCAACCTC	GAAACACCGGTGTGGCTGAGAGTCCGGCAATGGTGTGGCTGTGGGGTTAG	1	bc
GTGGCACCCT	GAAACACCGGTGTGGCTGAGAGTCCGGCAATGGTGTGGCTGTGGGGTTAG	1	bc
GATGGTCGGC	GAAACACCGGTGTACGTATGGACTGAACCAGGGTGTGCAAGTGGGGTTAG	1	bc
CCTGTCGGAC	GAAACACCGGTCGGGGCCACGCAGTGGTGGGTTTAGAGCTAGAAAGAGCA	1	bc
GCTACTATGT	GAAACACCGGTTACATTGAGGGTTACAGCTAGACATAGCAAGTTAACCTA	1	bc
GGAAGACACG	GAAACACCGGTCGGCGGCAATCGTGGGCTTAGATCGTGGGGTTAATCGTG	1	bc
GTGGACCGCA	GAAACACCGGTTCCCGTACAGTGAGGTTAGAGCTAGAAATAGCAAGTTAA	1	bc
GGAACCATAC	GAAACACCGGTGTGGCTGAGAGTCCGGCAATGGTGTGGCTGTGGGGTTAG	1	bc
AAGACGCTCG	GAAACACCGGTGCATTCGAAAGTCCGGTCGTAGTGTGGACGTGGGGTTAG	1	bc
GCCCACGCCC	GAAACACCGGTTTGAACTACCTAGAAAGGGTTAGAGCTAGAAATAGCAAG	1	bc
AAACGCTCTA	GAAACACCGGTGCCCTTACTCTCACCTGATTACTTAATCCGTGGGGTTAG	1	bc
CACGCGGTAC	GAAACACCGGTGCCCTTACTCTCACCTGATTACTTAATCCGTGGGGTTAG	1	bc
AAAAAGCCCT	GAAACACCGGTGCCCTTACTCTCACCTGATTAATTAATCCGTGGGGTTAG	1	bc
GGAGCCTCCC	GAAACACCGGTGTGGCTGAGAGTCCGGCAATGGTGTGGCTGTGGGGTTAG	1	bc
ACCTTCACCG	GAAACACCGGTCGGGGCCACTCAGTGGTGGGGTTAGAGCTAGAAATAGCA	1	bc
ACTACTCGGG	GAAACACCGGTACCTTTGTTGATGCTGGCTGGGGTGGGGTTAGAGCTAGA	1	bc
ACGAATCCGT	GAAACACCGGTCTCGAGTGAGGTGTTCAGGGTGGGGTTAGAGCTGGAAAT	1	bc
GGGGATTCTC	GAAACACCGGTTCCCGTCCAGTGGGGTTAGAGCTAGAAATAGCAAGTTAA	1	bc
ATATATCGAG	GAAACACCGGTTATATTTGTAAGTGTTGTGGGGTTAGAGCTAGATATAGC	1	bc
ACCGCTCTCC	GAAACACCGGTGCCCTTACTCTCACCTGATTACTTAATCCGTGGGGTTAG	1	bc
ATCGCCATAT	GAAACACCGGTGCCCTTACTCTCACCTGATTACTTAATCCGTGGGGTTAG	1	bc
GGACTCTATA	GAAACACCGGTAAATTGAGGCTCCGGCATGCAGGAGGCCGTGGGGTTAGA	1	bc
TGAGCCAGAC	GAAACACCGGTAGCAAGTGCGAGACGTGTTAGCAGGGTTAGAGCTAGAAA	1	bc
AGAGACGCGC	GAAACACCGGTCGGCGGTGGGGCTAGAGCTAGAAATAGCAAGGTAACCAA	1	bc
AATCTTCCTA	GAAACACCGGTCCGTAGGAGACCAGGGTGGGATGGACCTGTGGGGTTAGA	1	bc
AGGCGCAGAT	GAAACACCGGTCTCGAGTGAGGTGTCCAGGGTGGGGTTAGAGCTAGAAAT	1	bc
ATCCCCCATA	GAAACACCGGTATATTTTTGGCTCGGTCTTGCAGGGGTAGGGGTGGTTAG	1	bc
CATCGCGGTG	GAAACACCGGTGTTCGTATGGACTGAACCAGGTTGGGCATGGGGGGATAG	1	bc
CTGCTCTTCA	GAAACACCGGTACCTTTGTTGATGCTGGGTGGGGTTAGAGCTAGAAATAG	1	bc
GTCTATCGCG	GAAACACCGGTTATATTTGTAAGTGTGTGGGGTTAGAGCTAGAAATAGCA	1	bc
ACACAATGCC	GAAACACCGGTTTGAACTACCTAGTTCAAACCGGTGGGGTTAGAGCTAGA	1	bc
AGGCACTCCC	GAAACACCGGTGTGGCTGAGAGTCCGGCAATGGTGTGGCTGTGGGGTTAG	1	bc
AGTTTCCCGC	GAAACACCGGTCGGGGCGAAATAGCAAGTTAACCTAAGGCTAGTCCGTTA	1	bc
GTCGCGATGT	GAAACACCGGTTACATTGAGTGGGGTTAGAGCTAGAAATAGCAAGTTAAC	1	bc
AGACTCGGCG	GAAACACCGGTACCTTTGTTGATGCTGGGTGGAAGGAATTTGTGGGGTTA	1	bc
CGTGTTGGAC	GAAACACCGGTGACATTGGGTACAACACGGAATTCGGGCCCATTGGTATG	1	bc
AGGCGGACTC	GAAACACCGGTCCGTAGGAGACCCGTGTGGCATGTACCTGTGGGGTTAGA	1	bc
TAGAGAGATA	GAAACACCGGTTATACCGAGCTGATAGTGGGGTTAGAACTAAGATTACCA	1	bc
TCAACCGGGC	GAAACACCGGTTATATTTGTAAGTGTTGTGGGGTTAGAGCTAGAAATAGC	1	bc
GAGAAGGCTC	GAAACACCGGTTCCCATCAAGTGGGGGTAGGGCTAGAGATAGCAAGTTAA	1	bc
GACAACCCTC	GAAACACCGGTCGGCGGCAATCGTGGGGTGGGGTTAGAGCTAGAAATAGC	1	bc
AACATTCGGA	GAAACACCGGTCGATTCATATCGAAACCTTCCCGTGGGGTTAGAGCTAGA	1	bc
CCTTGCACGC	GGAACACCGGTTGGGGCCACTCAGTGGTGGGGTTAGAGCTAGAAATAGCA	1	bc
TTGCGCCGAA	GAAGCACCGGTTAAGCCGAGTGGGGTTATAGCTAGATATAGCAAGTTAAC	1	bc
ACGGCACTAC	GAAACACCGGTGCCCTTACTCTCACCTGATTACTTAATCCGTGGAGTTAG	1	bc
AAACGACGTA	GAAACACCGGTGCCCTTACTCTCACCTGATTACTTAATCCGTGGGGTTAG	1	bc
ACGATCGGTA	GAAACACCGGTCAATTCATATAGAAACCTTTACGTGACAGCTAGGCTGGT	1	bc
AATGGTTAGC	GAAACACCGGTTTACGTTGCATCGGTGTGGGGTTAGAGCTAGAAATAGCA	1	bc
GACAACACGC	GAAACACCGGTCGGCGGCAATCGTGGGTGGGGTTAGAGCTAGAAATAGCA	1	bc
GTACACACTT	GAAACACCGGTTAAAGTAAATTGCGAGTGGGGTTAGAGCTAGAAATAGCA	1	bc
ATGTCCGGTT	GAAACACCGGTCGATTCATATCGAAACCTTCCCGTTAAGGGTTCGTGGGG	1	bc
CAGTGGAGCC	GAAACACCGGTTCCCGTCCAGTGGGGTTAGAGCTAGAAATAGCAAGTTAA	1	bc
ACAGTAGGTG	GAAACACCGGTCGATTCATATCGAAACCTTCCCGTGACAGTGGGGTTAGA	1	bc
GTGATTCCTC	GAAACACCGGTTCCGGGCGAGGGGTTCTGGGGGGAGAAATAGCTAGATAA	1	bc
CATACCCGCC	GAAACACCGGTGTGGGTAAGAGCTCAACAATGGTGTGGATGTGGGGTTAG	1	bc
GTAAACGAGC	GAAACACCAGTCGGCAGCAATCGTGGGTGGGGTTAGAGCTAGAAATAGCA	1	bc
CATTGAGCAT	GAAACACCGGTTAAGCCGAGGAGTTAGAGCTAGAAATAGCAAGTTAACCT	1	bc
ATTAGGCATC	GAAACACCGGTCCGTAGGAGACCCGTGTGGCATGTACCTGTGGGGTTAGA	1	bc
CGGATCAAAC	GAAACACCGGTTAAGCCGAGTGGGGTTAGAGCTAGAAATAGCAAGTTAAC	1	bc
TCATCTGTGT	GAAACACCGGTTGAATCATATGGTAAACCTACAGATAGAAAGTTAACATA	1	bc
ACGTGTAGTC	GAAACACCGGTGACATTGGGTAAAATAGCAAGTTAACCTAAGGCTAGTCC	1	bc
ACACATCGCC	GAAACACCGGTTTGAACTAGAAATAGCAAGTTAACCTAAGGCTAGTCCGT	1	bc
AATACTCGGT	GAAACACCGGTACCTTTGTTGATGCTGGGTGGAAGGAATGCAGGTTAACC	1	bc
CCTAGCCGTA	GAAACACCGGTGTACGTATGGACTGAACCAGGGTGTGCAAGTGGGGTTAG	1	bc
GGAATCCTCA	GAAACACCGGTGTGGCTGAGAGTCCGGCAATGGTGTGGCTGTGGGGTTAG	1	bc
AGGCGTAGCC	GAAACACCGGTTTACGTTGCATCGGTGTGGGGTTAGAGCTAGAAATAGCA	1	bc
AGAGTGCTTC	GAAACACCGGTGCCCTTACTCTCCCCTGATTACTTAATCCGTGGGGTTAG	1	bc
CACTGCGGTC	GAAACACCGGTCTGAACTACCTAGTTCAAACCGGTGGGGTTAGAGCTAGA	1	bc
TGTCTGGAGG	GAAACACCGGTTCTATTGGTACGTGTGTGGGGTTAGAGCTAGAAATAGCA	1	bc
AGGCTTCACT	GAAACACCGGTTTACGTTGCATCGGTGTGGGGTTAGAGCTAGAAATAGCA	1	bc
CGGCCCACGC	GAAACACCGGTGCATTCGAAAGTCCGGTCGTAGTGTGGAAGTGGGGTTAG	1	bc
ACTAATCGGC	GAAACACCGGTACCTTTGTTGATGCTGGGTGGGGTTAGAGCTAGAAATAG	1	bc
TCGAATACGT	GAAACACCGGTCTCGAGTGAGGTGTTCAGGGTGGGGTTAGAGCTAGAAAT	1	bc
AACTTTAACG	GAAACACCGGTCGGGGCCACTCAGTGGGGTTAGAGCTAGAAATAGCAAGT	1	bc
GAACACACGT	GAAACACCGGTCGGCGGGATGGACCTAGGAATATCGAGCTAACCTTAGGC	1	bc
GCGAATCCAT	GAAACACCGGTCTCGAGTGAGGTGTTCAGGTGGGGTTAGAGCTAGAAATA	1	bc
TAAACAGGCA	GAAACACCGGTAAATTTGAGGCTCCGGCATGCAGGAGGCCGTGGGGTTAG	1	bc
CTCCCCTGCC	GAAACACCGGTGTGGCTGAGAGTCCGGCAATGGTGTGGCTGTGGGGTTAG	1	bc
TCGACCCACC	GAAACACCGGTGTGGCTGAGAGTCCGGCAATGGTGTGGCTGTGGGGTTAG	1	bc
AGCGGGTGGT	GAAACACCGGTTCCCGTCCAGTGGGGTTAGAGCTAGACATAGCAAGTTAA	1	bc
AGCCGCGAGC	GAAACACCGGTGCATTCGAAAGTCCGGTCGTAGTGTGGACGTGGGGTTAG	1	bc
ACTTTAACGA	GAAACACCGGTCGGGGCCACTCAGTGGTGGGGTTAGAGCTAGAAATAGCA	1	bc
ATAATCGTCC	GAAACACCGGTACCTTTGTTGATGCTGGGTGGAAGGTGGGGTTAGAGCTA	1	bc
AGGCCTAGCC	GAAACACCGGTTTACGTTACATCGGGGTGGGGGTAGAGCTAGAAATAGCA	1	bc
ACTCAATCTC	GAAACACCGGTACGTTCAAAGGACGTGTTGGAGGGGGTAGGGCTAGATAT	1	bc
CGGAGTGGCT	GAAACACCGGTTACATTGGGTACAGGGGTGGGGTTAGAGCTAGAAATAGC	1	bc
CACTCACTAC	GAAACACCGGTGCCCTTACTCTCACCTGATTGCTTAAGCCGTGGGGTTAG	1	bc
GCACCGTCGT	GAAACACCGGTGTACGTATGGACTGAACCAGGGTGTGCAAGTGGGGTTAG	1	bc
TCGGGTTGTC	GTTAACCTAAGGCTAGTCCGTTATCAACTTGAAAAAGTGGCACCGAGTCG	1	bc
TGGGGGCCTC	GAAACACCGGTTCCCGTCCAGTGGGGTTAGAGCTAGAAATAGCAAGTTAA	1	bc
AAGCCATGTA	GAAACACCGGTGTGGCTGAGAGCCTGGCAAGGGTGTGTATATGTGGTAAG	1	bc
AAATCTCTAC	GAAACACCGGTGCCCTTACTCTCACCTGATTACTTAATCCGTGGGGTTAG	1	bc
AGAATCCCTA	GAAACACCGGTCTCGAGTGAGGTGTTCAGGGTGGGGTTAGAGCTAGAAAT	1	bc
AGTCCACTAC	GAAACACCGGTAAATTTGAGGCTCCGGCATGCAGGAGGCGTGGGGTTAGA	1	bc
AGACCAGAGC	GAAACACCGGTGCATTCGAAAGTCCGGTCGTAGTGTGGACGTGGGGTTAG	1	bc
AGAATCTGTT	GAAACACCGGTCTCGAGTGAGGTGTTCAGGGTGGGGTTAGAGCTAGAAAT	1	bc
GAGGAAGACA	GAAACACCGGTAGCAAGTGCGGGGTTAGAGCTAGAAATAGCAAGTTAACC	1	bc
CACGCAGTAC	GAAACACCGGTGCCCTTACTCTCACCTGATTACTTAATCCGTGGGGTTAG	1	bc
CGTGTCGTAC	GAAACACCGGTGACATTGGGTACGACACGGAATTCGGGCCCATTGGTATG	1	bc
GCGCAACGCC	GAAACACCGGTTTACGTTGCATCGGTGTGGGGTTAGAGCTAGAAATAGCA	1	bc
AGCCTCGCGC	GAAACACCGGTGCATTCGAAAGTCCGGTCGTAGTGTGGACGTGGGGTTAG	1	bc
TAGCCTTGTC	GAAACACCGGTGTACGTATGGACTGAACGAGGGTGGGCAAGGGGGGTTAG	1	bc
AATGAGCATA	GAAACACCGGTTAAGCCGCGGCGGGAGAGCTAGAAATAGCAAGATAAGCT	1	bc
CTAGTTCTGT	GAAACACCGGTACCTTTGTTGATGCTGGGTGGGGTTAGAGCTAGAAATAG	1	bc
GGGGTCCCTT	GAAACACCGGTCTCGGGTGAGGTGTTCTGGGTGGGGTTAGAGCTAGGAAT	1	bc
GTCTATTGAG	GAAACACCGGTTATACTTGTAAGTGTGTGGGGTTAGAGCTAGAAATAGCA	1	bc
TGAATACTTA	GAAACACCGGTCTCGAGTGAGGTGTTCAGGGTGGGGTTAGAGCTAGAAAT	1	bc
GCCTTCGTCT	GAAACACCGGTTCGAACTAGAAATAGCAAGTTAACCTAAGGCTAGTCCGT	1	bc
CTCCCCTGCA	GAAACACCGGTGTGGCTGAGAGTCCGGCAGTGGTGTGGCTGTGGGGTTAG	1	bc
AACTACTCGG	GAAACACCGGTACCTTTGTTGATGCTGGGTGGAAGGAATTTCTAGAAATA	1	bc
GGGGACGATC	GAAACACCGGTCCCCGTCCAGTGGGGTTAGAGCTAGAAATAGCAAGTTAA	1	bc
GTCACAGTCC	GAAACACCGGTGTGGCTGAGAGTCCGGCAATGGTGTGGCTGTGGGGTTAG	1	bc
CGTTGACAGC	GAAACACCGGTCGGGGCCACTCAGTGGTGGGGCTAGAGCTAGAAATAGCA	1	bc
AACCAACGCC	GAAACACCGGTTTGAACTAGAAATAGCAAGTTAACCTAAGGCTAGTCCGT	1	bc
GGTGATACCT	GAAACACCGGTGACATTGGGTTGGAGCTAGAAATAGCAAGTTAACCTAAG	1	bc
GACGGACCTA	GAAACACCGGTGCCCTTACTCTCACCTGATTACTTAATCCGTGGGGTTAG	1	bc
CATCGTTCCC	GAAACACCGGTGTAAGTATGGTCTGAAGCAGGGTGTGAAAGCGGGGCTAG	1	bc
AAGAGCCCTA	GAAACACCGGTGCCCTTACTCTCACCTGATTACTTAATCCGTGGGGCTAG	1	bc
ACTGATTAGA	GAAACACCGGTTTACGTTGCATCGGGGTTAGAGCTAGAAATAGCAAGTTA	1	bc
CAGCGACGCC	GAAACACCGGTGTACGTATGGACTGAACCAGGGTGTGCAAGTGGGGTTAG	1	bc
TCTCTAGCGC	GAAACACCGGTTATATTTGCTCGGGGGTGGGGTTAGAGCTAGAAATAGCA	1	bc
GAGAACCCTT	GAAACACCGGTTCCCGTCCAGTGGGGTTGGAGCTAGAAATAGCAAGTTGA	1	bc
TTGTGGAGAC	GAAACACCGGTTAAGCCGAGGAGTTAGAGCTAGTAATAGCAAGTTAACCT	1	bc
ACTGACCTCC	GAAACACCGGTGCCCTTACTCTCACCTGATTACTTAATCCGTGGGGTTAG	1	bc
GATACATGCA	GAAACACCGGTAGCAAGTGCGAGACGGGGGGAGAAGTGGGGTTAGAGCTA	1	bc
AACGCACATC	GAAACACCGGTGCCCTTACTCTCACCTGATTACTTAATCCGTGGGGTTAG	1	bc
GGACACTGAC	GAAACACCGGTAGCAAGTGGGGTTAGAGCTAGAAATAGCAAGTTAACCTA	1	bc
AAGAATCCTT	GAAACACCGGTCTCGAGTGAGGTGTTCAGAGTGGGGTTAGAGCTAGAAAT	1	bc
ACGAATATTT	GAAACACCGGTCTCGAGTGAGGTGTTCAGGAGAAATAGCAAGTTAACCTA	1	bc
CTAATTCTTA	GAAACACCGGTCTCGAGTGAGGTGTTCAGGGTGGGGTTAGAGCTAGAAAT	1	bc
ACCTCGTAGT	GAAACACCGGTGTACGTATGGACTGAACCAGGGTGTGCAAGTGGGGTTAG	1	bc
TGAATTATTT	GAAACACCGGTCTCGAGTGAGGAGTTCAGGGTGGGGTTAGAGCTAGAAAT	1	bc
CTTTTAGCGG	GAAACACCGGTCAGGGCCACTCAGAGGTGGGGATCGGCCTGGAAATAACA	1	bc
ATCTTTACCG	GAAACACCGGTCGGGGCCACTCAGTGTTAGAGCTAGAAATAGCAAGTTAA	1	bc
GAGTATGCAT	GAAACACCGGTCCGTAGGAGACCCGTGTGGCATATGTGGGGTTAGAGCTA	1	bc
TCGTGACTGA	GAAACACCGGTCGGGGCCACTCGGTGGTGGGGTTAGAGCTAGAAATAGCA	1	bc
GCAGAAGCGC	GAAACACCGGTCGGCGGGGTGGGGTTAGAGCTAGAAATAGCAAGTTAAAC	1	bc
CACAACCCTT	GAAACACGGGTTAGAGCTAGAAATATCAAGTTAACCTAAGGCTAGTCCTT	1	bc
ACGAATAGTT	GAAACACCGGTCTCGAGTGAGGTGTTCAGGGTGGGGTTAGAGCTAGAAAT	1	bc
TGAGGACCCT	GAAACACCGGTTCCCGTCCAGTGGGGTTAGAGCTAGAAATAGCAAGTTAA	1	bc
CATATGGGTT	GAAACACCGGTGTACGTATGGACTGCACCAGGGTGTGCAAGTGGGGTTAG	1	bc
AGCCCCGTCC	GAAACACCGGTGTGGCTGAGAGTCCGGCAATGGTGTGGCTGTGGGGTTAG	1	bc
TATCTACGCC	GAAACACCGGTAACTGTATTGGCGAGATATCGCCTTAGCAGTGGGGTTAG	1	bc
GTATCTTATT	GAAACACCGGTAACTATATTCATGCGATATCGCCGTATCAGTGGGGTTAG	1	bc
GCCTTGACCG	GAAACACCGGTCGGGGCCACTCAGTGGTGGGGTTAGAGCTAGAAATAGCA	1	bc
TGGAGCGTCG	GAAACACCGGTTTTGTTGGGAGGCGGGGATAGGGCTAGCTGTGGCATGTT	1	bc
TGGCGGCCGC	GAAACACCGGTCCGTAGGAGACCCGTGTGGCATGTACCTGTGGGGTTAGA	1	bc
ACAGGACGCC	GAAACACCGGTTTGCACTGCCTAGTTCAAACCGGTGGGGTTAGAGCTAGA	1	bc
ACAGAGCATA	GAAACACCGGTTAAGCCGAGGAGTTAGAGCTAGAAATAGCAAGTTAACCT	1	bc
TCGGATATGC	GAAACACCGGTTACATTGAGGGTTAGAGCTAGAAATAGCAAGTTAACCTA	1	bc
TTAGGCATAT	GAAACACCGGTTACATTGGGGTTAGAGCTAGAAATAGCAAGTTAACCTAA	1	bc
TGACTCATAT	GAAACACCGGTAACTATATTCATGCGATTAGCAAGTTAACCTAAGGCTAG	1	bc
ACGTGTAATC	GAAACACCGGTGACATTGGGGTTAGAGCTAGAAATAGCAAGTTAACCTAA	1	bc
GAGATACACA	GAAACACCGGTAGCAAGTGCGAGGGTTAGAGCTAGAAATAGCAAGTTAAC	1	bc
CGATGCTTAG	GAAACACCGGTTCACGTTGCATCGTACGTGGGGTTAGAGCTAGAAATAGC	1	bc
GAGTGTTGTC	GAAACGCCGGTGACATTGGGTACAGGGGTGGGGTTAGAGCTAGAAATAGC	1	bc
GACAGTGTCG	GAAACACCGGTAGCAAGTGCGGTTAGAGCTAGAAATAGCAAGTTAACCTA	1	bc
ACGAAGCCTT	GAAACACCGGTCTCGAGTGAGGTGTTCAGGGTGGGGTTAGAGCTAGAAAT	1	bc
TGACTTATCA	GAAACACCGGTAACTATATTCATGCGATATCGCCGTATCAGTGGGGTTAG	1	bc
GATTATCGAG	GAAACACCGGTTATATTTGTAAGTGTGTGGGGTTAGAGCTAGAAATAGCA	1	bc
GGCCCCGGCC	GAAACACCGGTGTTGCTGAGAGCCCGGCAATGGTGTGGCTGTGGGGTTAG	1	bc
AAGTAGGCCT	GAAACACCGGTCCGTAGGAGACCCGTGTGGCATGTACCTGTGGGGTTAGA	1	bc
ATTAACTATG	GAAACACCGGTTACATTGAGGGTTAGAGCTAGAAATAGCAAGTTAACCTA	1	bc
GCCGCCGACA	GAAACACCGGTAAATTTGAGGCTCCGGCATGCAGGAGGCCGTGGGGTTAG	1	bc
CCGAACGCGC	GAAACACCGGTTTGAACTACCTAGTAGCAAGTTAACCTAAGGCTAGTCCG	1	bc
ACATCGCTGT	GAAACACCGGTGTACGTATGGACTGAACCAGGGTGTGCAAGTGGGGTTAG	1	bc
AAGTGTGCCT	GAAACACCGGTCCGTAGGAGACCCGTGTGGCATGTACCTGTGGGGTTAGA	1	bc
GGTACCTGCC	GAAACACCGGTGTGGCTGAGAGTCCGGCAATGGTGTGGCTGTGGGGGTAG	1	bc
AGACGCTGGA	GAAACACCGGTGCATTCGAAAGTCCGGTCGTAGTGTGGACGTGGGGTTAG	1	bc
GTCATCGGCC	GAAACACCGGTACCTTTGTTGATGCTGGTGCTAGAAATAGCAAGTTAACC	1	bc
CGTCTCGTTT	GAAACACCGGTCTCGAGTGAGGTGTTCAGGGTGGGGTTAGAGCTAGAAAT	1	bc
GAGCAAACCT	GAAACACCGGTTTACGTTGCTTCGGGGTGGGGTTAGAGCTAGAAATAGCA	1	bc
GACGCCGCCA	GAAACACCGGTCGCAAGCGAGAGACGTGTTGGTGGGGTTAGAGCTAGACA	1	bc
AGTGGAGACT	GAAACACCGGTTCCCGTCCAGTGGGGTTAGAGCTAGAAATAGCAAGTTAA	1	bc
GAAGAATGGC	GAAACAATAGCAAGTTAACCTAAGGCTAGCCCGTTATCAACTTGAAAAAG	1	bc
CATTCCCGTC	GAAACACCGGTGTACGTATGGACTGAACCAGGGTGTGCAGTGGGGGTAGA	1	bc
CCTAGGCGTA	GAAACACCGGTGTACGTATGGACTGAACCAGGGTGTGCAAGTGGGGTTAG	1	bc
AGCACAGTCC	GAAACACCGGTGTGGCTGAGAGTCCGGCAATGGTGTGGCTGTGGGGTTAG	1	bc
CTAGCTGTGC	GAAACACCGGTTACATTGAGTGGGGTTAGAGCTAGAAATAGCAAGTTAAC	1	bc
AGGCCTATAT	GAAACACCGGTTTACGTTGCATCGGTGTGGGGTTAGAGCTAGAAATAGCA	1	bc
AGAAAAACAG	GAAACACCGGTCGGCGCTAGTCCGTTATCAACTTGAAAAAGTGGCACCGA	1	bc
AACAATGCCT	GAAACACGGGTTAGAGCTAGGAATAGCAAGTTAACCTAAGGCTAGTCCGT	1	bc
CTCCACTGCA	GAAACACCGGTGTGGCTGAGAGTCCGGCAATGGTGTGGCTGTGGGGTTAG	1	bc
TTCGATATGA	GAAACACCGGTTACATTGAGTGGGGTTAGAGCTAGAAATAGCAAGTTAAC	1	bc
CCAAACACGC	GAAACACCGGTCTGCGGGATATAGTAAGTTAACCTAAGCCTAGACTGGCA	1	bc
AGCAACGCGC	GAAACACCGGTGCATTCGAAAGTCCGGTCGTAGTGTGGACGTGGGGTTAG	1	bc
AATCGTGAGG	GAAACACCGGTTATATTTGTAAGTGTGTGGGGTTAGAGCTAGAAATAGCA	1	bc
AATACTCGGC	GAAACACCGGTACCTTTGTTGATGCTGGGTGGAAGGAATGCTGAGGGGTT	1	bc
ATTTTACCGG	GAAACACCGGTCGGGGCCAGTGTTTTTGGGGTTAGAGCTAGAAATAGCAA	1	bc
AGCGTGTTGT	GAATAGCAAGTTAACCTAAGGCTAGTCCGTTATCAACTTGAAAAAGTGGC	1	bc
ACACAAAGCC	GAAACACCGGTTTGAACTACCGGGGTTAGAGCTAGAAATAGCAAGTTAAC	1	bc
CTCTCTATGT	GAAACACCGGTTACATTGGGGTTAGAGCTAGAAATAGCAAGTTAACCTAA	1	bc
AACTTTGGTT	GAAACACCGGTCGATTCATATCGAAACCTTCCCGCGACAGTGGGGTTAGA	1	bc
TTAAGTATTT	GAAACACCGGTTACATTGAGGGTTAGAGCTAGAAATAGCAAGTTAACCTA	1	bc
ACCAACGCTC	GAAACACCGGTTTGAACTAGAAATAGCAAGTTAACCTAAGGCTAGTCCGT	1	bc
GTTGATTATT	GAAACACCGGTTAAGCCGAGGGGTTAGAGTTAGAAATAGCAAGTTAACCT	1	bc
CGCAACGCTT	GCTAGAAATAGCAAGTTAACCTAAGGCTAGTCCGTTATCAACTTGAAAAA	1	bc
CCTCTCGGTC	GAAACACCGGTACCTTTGTTGATGCTGGGTGGAAGGATCTTTGTGGGGTT	1	bc
GGCAGGACCG	GAAACACCGGTCGGCGGCAATCGTGAGTGGGGTTAGAGCTAGAAATAGCA	1	bc
ATCTATTGAG	GAAACACCGGTTTTCTTTGCAAGTGTTGTGGGGTAAGGCTTAGAAATAGC	1	bc
TACGGCCCAC	GAAACACCGGTGCCCTTACTCTCACCTGATTACTTAATCCGTGGGGTTAG	1	bc
TAGGAGTCTC	GAAACACCGGTTCCCGTCCAGTGGGGTTAGAGCTAGAAATAGCAAGTTAA	1	bc
CTCCTGGGAC	GAAACACCGGTACCTTTGTTGATGCTGGGTGGGGTTAGAGCTAGAAATAG	1	bc
TTAATCTGCC	GAAACACCGGTACCTTTGTTGATGCTGGTGTGGGGTTAGAGCTAGAAATA	1	bc
TGTCACCTAC	GAAACACCGGTAAATTTGAGGCTCCGGCATGCAGGAGGCCGTGGGGTTAG	1	bc
GTCACTTATA	GAAACACCGGTAACTATATTCATGCGATATCGCCGTATCAGTGGGGTTAG	1	bc
AAGACACTCG	GAAACACCGGTGCATTCGAAAGTCCGGTCGTAGTGTGGACGTGGGGTTAG	1	bc
CGAATGCCCT	GAAACACCGGTTTCGCAAGAGGTGCTCAGGGTGGGGATAGAGAAAGAACA	1	bc
TTGCGCATCC	GAAACACCGGTTAAGCCGAGTGGGGTTAGAGCTAGAAATAGCAAGTTAAC	1	bc
TTACAACGCA	GAAACACCGGTTTGAACCGGTGGGGTTAGAGCTAGAAATAGCAAGTTAAC	1	bc
GAACGCTCTA	GAAACACCGGTGCCCTTACTCTCACCTGATTACTTAATCCGTGGGGTTAG	1	bc
TCGTTCGGCG	GAAACACCGGTCGATTCATATCGAAACCTTCCCGTGGGGTTAGAGCTAGA	1	bc
TCTCTCGCCG	GAAACACCGGTTATATTTGTAAGTGTGTGGGGTTAGAGCTAGAAATAGCA	1	bc
TAGAATCCTT	GAAACACCGGTCTCGAGTGAGGTGTTCAGGGTGGGGTTAGAGCTAGAAAT	1	bc
AAAATAGCAC	GAAACACCGGTATCTATGTTGATGCTGGGTGGAGCTAGATATAGCAAGTT	1	bc
ATACGCGGCT	GAAACACCGGTACCTGTGATGCTTCTGGGGGGAAGGATCTGTGTGGGGTT	1	bc
ATGGCGACTC	GAAACACCGGTTACCGTCCCGTGGGGTTAGGGCTAGAAATAGAAAATTAA	1	bc
CCGTTATCGA	GAAACACCGGTCGGGGCCACTCAGTGGTGGGGTTAGAGCTAGAAATAGCA	1	bc
AGGGTGCCTA	GAAACACCGGTCCGTAGGAGACCCGTGTGGCATGTACCTTGTGGGGTTAG	1	bc
TCGAGTACCA	GAAACACCGGTTAAGCCGAGTGGGGTTAGAGCTAGAAATAGCAAGTTAAC	1	bc
AGACACCGAC	GAAACACCGGTAGCAAGTGCGAGACGTTTTTGTGGGGTTAGAGCTAGAAA	1	bc
TTTATCATTA	GAAACACCGGTTAAGCCGTGGGGTTAGAGCTAGAAACAGCAAGTTAACCT	1	bc
TCCAACGCGC	GAAACACGGGTTAGAGCTAGAAATAGCAAGTTAACCTAAGGCTAGTCCGT	1	bc
AAGGCTTCGC	GAAACACCGGTTTACGTTGCATCGGTGTGGGGTTAGAGCTAGAAATAGCA	1	bc
AGAACGCCCC	GAAACACCGGTGTGGCAAAAAGTCCGGCAATGGTATAGCTGGGGGGTTAG	1	bc
TAGGCTGCCT	GAAACACCGGTCCGTAGGAGACCCGTGTGGCATGTACCTGTGGGGTTAGA	1	bc
GAGGCACCTA	GAAACACCGGTAAATTTGAGGCTCCGACATGCAGGAGGCCGTGGGGTTAG	1	bc
CAGAATTCCT	ATGTGGGGTTAGAGCTAGAAATAGCAAGTTAACCTAAGGCTAGTCCGTTA	1	bc
AACACAGGCT	GAAACACCGGTAGCAAGTGCGAGACGTGTTTGTGGGGTTAGAGCTAGAAA	1	bc
AGGGACCCGC	GAAACACCGGTGTGGCTGAGAGTCCGGCAATGGTGTGGCTGTGGGGTTAG	1	bc
CCATTGCTTT	GAAACACCGGTCTCGAGTGAGGTGTTCAGGGTGGGGTTAGAGCTAGAAAT	1	bc
GCCTTTAGTG	GAAACACCGGTCGGGGCCACTCAGTGGTGGGGTTAGAGCTAGAAATAGCA	1	bc
CGAATGCCTC	GAAACACCGGTCCGTAGGAGGCCCGTGTGGCATGTGCCTGAGGGAGTAAA	1	bc
ACAATGTCAC	GAAACACCGGTGACATTGGGTATTCGGGCCCATTGGTATGGCAGATCGGA	1	bc
GCCAACGCCT	GAAACACCGGTTTGAACTAGAAATAGCAAGTTAACCTAAGGCTAGTCCGT	1	bc
ATGGCGGATC	GAAACACCGGTTAAACTCCCTTCGGGAATAGCGGGGATAAGGATAGAAAT	1	bc
TGACAAACTC	GAAACACCGGTGTGGCTGAGAGTCCGGCAATGGTGTGGCTGTGGGGTTAG	1	bc
ATGAGAATAG	GAAACACCGGTTAAGCCGAGGAGTTAGAGCTAGAAATAGCAAGTTAACCT	1	bc
CCGTGGACCC	GAAACACCGGTGTGGCTGAGTGTCCGGCAGTGGTATGGCTGGGGGGATAG	1	bc
TAGTCCTCCT	GAAACACCGGTCCGTAGGAGACCCGTGTGGCATGTACCTGTGGGGTTAGA	1	bc
TGTGGGCATA	GAAACACCGGTTAAGCCGTGGGGTTAGAGCTAGAAATAGCAAGTTAACCT	1	bc
AAAGCAATAC	GAAACACCGGTGCCCTTACTCTCACCTGATTACTTAATCCGTGGGGTTAG	1	bc
GTGCTTAGAC	GAAACACCGGTTTACGTTGCATCGGTGTGGGGGTAGAGCTAGAAATAGCA	1	bc
GTACACAATT	GAAACGCCGGTTAAAGTAAATTGCGAGTGGGGTTAGAGCTAGAAATAGCA	1	bc
GCGAATACTT	GAAACACCGGTCTCGAGTGAGGTGTTCAGGGTGGGGTTAGAGCTAGAAAT	1	bc
AGAAGACACG	GAAACACCGGTCGGCGGCAATGTGGGGTTAGAGCTAGAAACAGCAAGTTA	1	bc
TCTCCCGGGG	GAAACACCGGTTATATCTGTAAGTGCGTGGGGTTCGAGCTAGAAATAGCA	1	bc
AATGTGACTT	GAAACACCGGTCCGTAGGAGACCCGTGTGGCATGTACCTGTGGGGTTAGA	1	bc
AGACAACGCA	GAAACACCGGTTTGAACTACCTAGTTCAAACCGGTGGGGTTAGAGCTAGA	1	bc
GCAGAATCGC	GAAACACCGGTCGGCGAGAAATAGCAAGTTAACCTAAGGCTAGTCCGTTA	1	bc
CAGAACGCTG	GAAACACCGGTTCGGTGGGGTTAGAGCTAGAAATAGCAAGTTAACCTACG	1	bc
CAGTGGAGAC	GAAACACCGGTTCCCGTCCCGTGGGGTTAGAGCTAGCAATAGCAAGTTAA	1	bc
ACTCGGCGTC	GAAACACCGGTGTACGTATGGACTGAACCAGGGTGTGCAAGTGGGGTTAG	1	bc
GAGACTCCTT	GAAACACCGGTCTCGAGTGAGGTGTTCAGGGTGGGGTTAGAGCTAGAAAT	1	bc
CTGAGCATGC	GAAACACCGGTTAAGCCGAGGAGTTAGAGCTAGAAATAGCAAGTTAACCT	1	bc
AATTGAGCAT	GAAACACCGGTTAAGCCGAGTGGGGTTAGAGCTAGAAATAGCAAGTTAAC	1	bc
GTGGCGCTCC	GAAACACCGGTTCCCGTCAAGTGGGGTTAGAGCTAGAAATAGCAAGTTAA	1	bc
GGGCGACGTG	GAAACACCGGTTGACGTATGGACTGGATCAGTGTGGGCAAGTGGGGTTAG	1	bc
AACCATAGGT	GAAACACCGGTTTACGTCATATCAGGGTTGGAATTGGTAAGAGCGGGTTG	1	bc
ATCAGCTATG	GAAACACCGGTTACATTGAGATTGGGGTTAGAGCTAGAAATAGCAAGTTA	1	bc
GGAATACTCC	GAAACACCGGTGTGGCTGAGAGTCCGGCAATGGTGTGGCTGTGGGGTTAG	1	bc
GAGGGCCTAC	GAAACACCGGTGCCCTTACTCTCACCTGATTACTTAATCCGTGGGGTTAG	1	bc
GACATACGGG	GAAACACCGGTCGATTCATATCGAAACCTTCCCGTGGGGTTAGAGCTAGA	1	bc
CGGGTAGGCT	GAACCACCGGTGACATTGGAGTGGGGTTAGAGCTAGAAATAGCAAGTTAA	1	bc
AGACAGAGCC	GAAACACCGGTAGCAAGTGGGGTTAGAGCTAGAAATAGCAAGTTAACCTA	1	bc
ACATAGACGT	GAAACACCGGTGTACGTATGGACTGAACCAGGGTGTGCAAGTGGGGTTAG	1	bc
GCTATCGCGA	GAAACACCGGTTATATTTGTAAGTGTGTGGGGTTAGAGCTAGAAATAGCA	1	bc
ATGCTGACCA	GAAACACCGGTTTACGTTGCATCGGTGTGGGGTTAGAGCTAGAAATAGCA	1	bc
AAATCGTCGT	GAAACACCGGTGTACGTATGGACTGAACCAGGGTGGGGTTAGAGCTAGAA	1	bc
TTCACTACGT	GAAACACCGGTTACATTGAGATTATAGCTAGAAAAGGCTAGTCCGTTATC	1	bc
GAGAGAGAAA	GAAACACCGGTAGCAAGTGCGGGGTTAGAGCTAGAAATAGCAAGTTAACC	1	bc
AACAACTTAC	GAAACACCGGTGCCCTTACTCTCACCTGATTACTTAATCCATCGGGTTAG	1	bc
AGGACAGCAG	GAAACACCGGTGCATTCGAAAGTCCGGTCGTAGTGTGGACGTGGGGTTAG	1	bc
GCATTTAGCG	GAAACACCGGTCGGGGCCACTCAGTGGTGGGGTTAGAGCTAGAAATAGCA	1	bc
CCTCGTCGAA	GAAACACCGGTGTACGTATGGACTGAACCAGGGTGTGCAAGTGGGGTTAG	1	bc
AGCGGAGCCT	GAAACACCGGTTCCCGTCCAGTGGGGTTAGAGCTAGAAATAGCAAGCTAA	1	bc
ACATCGGCGT	GAAACACCGGTGTACGTATGTGGGGTTAGAGCTAGAGATAGCAAGTTAAC	1	bc
AATGGACTAC	GAAACACCGGTGCCCTTACTCTCACCTGATTACTTAATCCGTGGGGTTAG	1	bc
TTAATTTTGT	GAAACACCGGTCTCGTGGAGGGTGTTCAGGGAGGGATTAAAGCTAGAATT	1	bc
GACACTGTGA	GAAACACCGGTAGCAAGTGGGGTTAGAGCTAGAAATAGCAAGTTAACCTA	1	bc
GAGAGGGACA	GAAACACCGGTTAAGCGGAGGATAAGCTATTGTTAACTTGGGGCTAGAGA	1	bc
TTGCGCTTAG	GAAACACCGGTTGCGACGTGGGGTTAGAGCTAGAAATAGCGAGTTAAACA	1	bc
GAATAACCTT	GAAACACCGGTCGGCGGGGTTAGAGCTAGAAATAGCAAGTTAACCTAAGG	1	bc
AATCGAGCCC	GAAACACCGGTTTGAACTACCTAGAAATAGCAAGTTAACCTAAGGCTAGT	1	bc
GACAGAGCCC	GAAACACCGGTAGCAAGTGCGAGCAAAGTCATCCTCATGAGCTAGAAATA	1	bc
TAGTCTGCTT	GAAACACCGGTCCGTAGGAGACCCGTGTGGCATGTACCCGTGTGGGGATA	1	bc
GCATTTAACG	GAAACACCGGTCGGGGCCACTCAGTGGTGGGGTTAGAGCTAGAAATAGCA	1	bc
GAGACAGTCC	GAAACACCGGTAGCAAGTGGGGTTAGAGCTAGAAATAGCAAGTTAACCTA	1	bc
CACGAATCCT	GAAACACCGGTCTCGAGTGAGGTGTTCGAGCTAGAAATAGCAAGTTAACC	1	bc
ACAAGCGATT	GAAACACCGGTCGATTCATATCGAAACCTTCCCGTGACAGTGGGGTTAGA	1	bc
GAAATCTGCA	CAAAACACCGGTAAATTTGAGGCTCCGGCATGCAGGAGGCCGTGGGGTTA	1	bc
AAGGCTTAGC	GAAACACCGGTTTACGTTGCATCGGGTTAGAGCTAGAAATAGCAAGTTAA	1	bc
AACGACGCAC	GAAACACCGGTTTGAACTACCTAGTTCGAACCGGTGGGGTTAGAGCTAGA	1	bc
GACATGCGGT	GAAACACCGGTCGACTCATATCGAAACCTCAAGTTAACCTAAGGCTAGTC	1	bc
GCCTTTACAG	GAAACACCGGTCGGGGCCACTCAGTGGTGGGGTTAGAGCTAGAAATAGCA	1	bc
AAAAGCAATA	GAAACACCGGTGCCCTTACTCTCACCTGATTACTTAATCCGTGGGGTTAG	1	bc
TAAAACACGC	GAAACAGCGTATTGAACTAAATATAACAAGTTAACCTAAGGCTAGTGCTA	1	bc
GAGGCACCGC	GAAACACCGGTCGGCGGCGGTGGGGTTAGAGCTAGAAATAGCAAGTTAGC	1	bc
CACAAAGTAC	GAAACACCGGTTAGAGCTAGAAATAGCAAGTTAACCTATGGCTAGTCCGT	1	bc
CAACATAGCC	GAAACACCGGTGCCTTTAGGATGGGTAGAGATAGGTAATAGCTAGAAATC	1	bc
TAAACGCTGC	GAAACACCGGTTACATTGAGGTGTTAGAGCTAGTAATAGTAAGATAACCT	1	bc
CCTAGCATCA	GAAACACCGGTTTAGCCGCGTGGGGATAGAGCTAGAAATAGAAAGTTAAC	1	bc
CTCCTTTACC	GAAACACCGGTCGGGGCCACTCAGTGGTGGGGTTAGAGCTAGAAATAGCA	1	bc
CGGGTTTCCT	GAAACACCGGTGACGGTGGGGTTAGAGCTAGAAATAGCAAGTTAACCTAA	1	bc
GGGGATGCTC	GAAACACCGGTTCCCGTCCAGTGGGGTTAGAGCTAGAAATAGCAAGTTAA	1	bc
GTACCTATGG	GAAACACCGGTTATTGGGGTTAGAGCTAGAAATAGCAAGTTAACCTAAGG	1	bc
GTACACGATT	GAAACACCGGTAACTGTATTGTTGCTGGGGGGATGGAATTTGGGGTTACA	1	bc
GGGGTGGCTA	GAAACACCGGTTACCGTCCAGAGGGGTTAGAGCTAGAAATAGCAAGTTAC	1	bc
ACCTTTAGCG	GAAACACCGGTCGGGGCCACTCAGTGGTGGGGTTAGAGCTAGAAATAGCA	1	bc
ACAAATCAGT	GAAACACCGGTCTCGAGTGAGGTGTTCAGGGTGGGGTTAGAGCTAGAAAT	1	bc
GAGAAGCATC	GAAACACCGGTTCCCGTCCAGTGGGGTTAGAGCTAGAAATAGCAAGTTAA	1	bc
TCTGTTGTGG	GAAACACCGGTTACATTAGGAGGTGTAGCTAGAAATAGCAAGATAAACCA	1	bc
GATAACGACA	GAAACACCGGTAGCAAGTGTGTGACATCGTAAATAGAAAGTGAACCTAAG	1	bc
GTGAGCGACA	GAAACACCGGTTACGCCGACGAGATTCGTTAGAGCTCGAAATAGCAAGTT	1	bc
CCTCCTGTTT	GAAACACCGGCAGGAGGTTAGAGCTAGATATAGCAGGTTAACCTAGAGCT	1	bc
GAGGACGGTC	GAAACACCGGTGCCCGTCCAGTGGGGGTAGAGCTAGAAATAGCAAGTTAA	1	bc
TTGAAACTAA	GAAACACCGGTTAAGCCGAGGGTTAGCGCTAGAAATACCAAGTTAACTTA	1	bc
AGGGGCAGCT	GAAACACCGGTTCCCGTCCAGTGGGGTTAGAGCTAGAAATAGCAAGTTAA	1	bc
GGAATCCCGC	GAAACACCGGTGTGGCTGAGAGTCCGGCAATGGAGTGGCTGTGGGGTTAG	1	bc
AAGACAGGCC	GAAACACCGGTCCGTAGGAGACCCGTGTGGCATGTACCTGTGGGGTTAGA	1	bc
GGCAAGATCC	GAAACACCGGTGTGGCTGAGAGTCCGGCAATGGTGTGGCTGTGGGGTTAG	1	bc
ATACTCGCGC	GAAACACCGGTGCATTCGAAAGTCCGGTCGTAGTGTGGACGTGGGGTTAG	1	bc
TCTTTGTCCC	GAAACACCGGTACGAAGCGCCTGCTCCTAGGAAGGGCTAGAGATAGTAAT	1	bc
AGGGGAGCCT	GAAACACCGGTTCCCGTCCAGTGGGGTTAGAGCTAGAAATAGCAAGTTAA	1	bc
GCCGCCTTGC	GAAACACCGGTGTATGCGAAAGGCTGGTCGGAGTGTGTACAGCTAGATAG	1	bc
AGACTTCCTA	GAAACACCGGTCCGTAGGAGACCCGTGTGGCATGTACCTGTGGGGTTAGA	1	bc
GTCTAACGTG	GAAACACCGGTTATATTTGTAAGTGTGTGGGGTTAGAGCTAGAAATAGCA	1	bc
ATTGAGCATT	GAAACACCGGTTAAGCCGAGTGGGGTTAGAGCTAGAAATAGCAAGTTAAC	1	bc
ACTACTCGTC	GAAACACCGGTACCTTTGTTGATGCTGGGTGGAAGGATTTTTGTGGGGTT	1	bc
TGGTCCCTAC	GAAACACCGGTAAATTTGAGGCTCCGGCATGCAGGAGGCCGTGGGGTTAG	1	bc
GGAACCCGCT	GAAACACCGGTGGATTCATATCGAAACCTTCCCGGGACAGGGGGGTTAGA	1	bc
ATGAGCATGC	GAAACACCGGTTAAGCCGAGTGGGGTTAGAGCTAGAAATAGCAAGTTAAC	1	bc
AGGGTAGGCC	GAAACACCGGTGACATTGGGGTTAGAGCTAGAAATAGCAAGTTAACCTAA	1	bc
GCCCTCACCT	GAAACACCGGTAAATTGGAGGCTCCGGCATGCAGGAGTCCGTGTGGTTAT	1	bc
TAAGATGTGC	CAAAGCACGGAATAGAGCTAGAAATTGAAAGTAAACCGAAGTCTACTCCG	1	bc
ATGACAAGCT	GAAACACCGGTTTACGTTGCATCGGTGTGGGGTTAGAGCTAGAAATAGCA	1	bc
TAGGCACTCC	GAAACACCGGTGCCCTTACTCTCACCTGATTACTTGATACGGGGAGATAT	1	bc
AGTGTAGTTT	GAAACACCGGTGACATTGGCTACATGGGGGTAGAGCTAAGAATAGCAAGT	1	bc
GTACTAGACG	GAAACACCGGTACCTTTGTTGCTGGGGTTAGAGCTAGAAATAGCAAGTTA	1	bc
ACTCTGTCCG	GAAACACCGGTGGCAATAGGATGAGTGGGGCATGGATCGGGCTGGTAATA	1	bc
CGGCTGCCGA	GAAACACCGGTCCGTAGGAGACCCGTGTGGCATGGACCTGTGGGGTTAGA	1	bc
AATATAGGTT	GAAACACCGGTCGATTCATATCGAAACCTTCCCGTGACAGTGGGGTTAGA	1	bc
AAGAATCTCG	GAAACACCGGTGCATTCGAAAGTCCGGTCGTAGTGTGGACGTGGGGTTAG	1	bc
CCTTTCACGA	GAAACACCGGTCGGGGCCACTCAGTGGTGGGGTTAGAGCTAGAAATAGCA	1	bc
GAAGAAGTGC	GAAACACCGGTCGGCGGCAATGTGGGGTTAGAGCTAGAAATAGCAAGTTA	1	bc
TCGGGTTGTC	GAAACACCGGTGACATTGGGTACAGGGTGGGGTTAGAGCTAGAAATAGCA	1	bc
AGAGGATGCT	GAAACACCGGTTCCCGTCCAGTGGGGTTAGAGCTAGAAATAGCAAGTTAA	1	bc
AGGGTTATCT	GATACACCGGTTTACGTTGCATCGGTGTGTGGTTAGAGCTAGAAATAGCA	1	bc
GTTGTGCCGC	GAAACACCGGTTCCCGTCCAGTGGGGTTAGAGCTAGAAATAGCAAGTTAA	1	bc
AGGATACGGC	GAAACACCGGTACCCTCGGAATCCCGAGCGTCGTGTCGTCATGGGGTTCC	1	bc
AAGACCCAAG	GAAACACCGGTGCATTCGAAAGTCCGGTCGTAGTGTGGACGTGGGGATAG	1	bc
GCGTCTGACT	GAAACACCGGTCCGTAGGAGACCCGTGTGGCATGTACCTGTGGGGTTAGA	1	bc
CAAAACGCAA	GAAACACGGGTTAGAGCTAGAAATAGCAAGTTGACCTAAGGCTAGTCCGT	1	bc
ACATCGCCGT	GAAACACCGGTGTACGTATGGACTGAACCAGGGTGTGCAAGTGGGGTTAG	1	bc
GGCATGCGCC	GAAACACCGGTGTGGCTGAGAGTCCGGCAATGGTGTGGCTGTGGGGTTAG	1	bc
CGAGTCTTTG	GAAACACCGGTCTCGAGTGAGGTGTTCAGGGTGGGGTTAGAGCTAGAAAT	1	bc
TCAACTCGGC	GAAACACCGGTACCTTTGTTGATGCTGGGTGGAAGGAATTAGTTGTGGGG	1	bc
CGACAGTCTT	GAAACACCGGTGCATTCGAAATCCCGAGCGTAGTGTGGATGTGGGGTTAG	1	bc
ACCAATCCGT	GAAACACCGGTCTCGAGTGAGGTGTTCAGGGTGGGGTTAGAGCTAGAAAT	1	bc
GTAACCCTCG	GAAACACCGGTAAGGGTCAGAGTCCGGCAATGGTGGGTGTGTGGGGTTAG	1	bc
TCTCTTCCGC	GAAACACCGGTCGGGGCCACTCAGTGGAGCTAGAAATAGCAAGTTAACCT	1	bc
GGGACCCTTT	CAAAACACCGGTGTGGCTGAGAGTCCGGCAATGGTGTGGCTGTGGGGTTA	1	bc
CGGGTGGTTT	GAAACACCGGTTACCTTGGAGACAGAGAGAGCTTGGAGCTACAAGTAGCA	1	bc
AGTGGGGCCT	GAAACACCGGTTCCCGTCCAGTGGGGTTAGAGCTAGAAATAGCAAGTTAA	1	bc
GGCTCACTAA	GAAACACCGGTAACTATATTCATGCGATATCGCCGTATCAGTGGGGTTAG	1	bc
AGTGAGCCTA	GAAACACCGGTCCGTAGGAGACCCGTGTGGCATGTACCTGTGGGGTTAGA	1	bc
AATGCGCAGC	GAAACACCGGTACCTTTGTTGATGCTGGGTGGCAGGAATTTTTGTGGGGT	1	bc
TGAAGACGCG	GAAACACCGGTCGGCGGCAATCGTGGGTGGGGTTAGAGCTAGAAATAGCA	1	bc
AAGAACGCAC	GAAACACCGGTTTGAACTAGAAATAGCAAGTTAACCTAAGGCTAGTCCGT	1	bc
TCCTTTAACG	GAAACACCGGTCGGGGCCACTCAGTGTGGGGTTAGAGCTAGAAATAGCAA	1	bc
AATGTTCTAC	GAAACACCGGTGCCCTTACTCTCACCTGATTACTTAATCCGTGGGGTTAG	1	bc
GCCCCCAATT	GAAACACCGGTAAATTTGAGTCTCTGGCTTGCAGGGGGACGTCGGGATAG	1	bc
GAGGAGCTTA	GAAACACCGGTTCCCGTCCAGTGGGGTTAGAGCTAGAAATAGCAAGTTAA	1	bc
AGCGGCGTGG	GAAACACCGGTTTACGTTGCATCGGGGTTAGAGCTAGAAATAGCAAGTTA	1	bc
AGCGAACGCT	GAAACACCGGTTTGTGGGGTTAGAGCTAGAAATAGCAAGTTAACCTAAGG	1	bc
GGTACCATAC	GAAACACCGGTGTGGCTGAGAGTCCGGCAATGGTGTGGCTGTGGGCTAGA	1	bc
AGATAAAGAC	GAAACACCGGTAGCAAGTGCGAGTTAGAGCTAGAAATAGCAAGTTAATCT	1	bc
GCACCAGGCA	GAAACACCGGTAGCAAGTGCGGGGTTAGAGCTAGAAATAGCAAGTTAACC	1	bc
AACATGCGGT	GAAACACCGGTCGATTCATATCGAAACCTTCCCGTGACAGTGGGGTTAGA	1	bc
AAAGGCGTAC	GAAACACCGGTGCCCTTACTCTCACCTGATTACTTAATCCGTGGGGTTAG	1	bc
GGGCTCTCTC	GAAACACCGGTGTGGCTGAGAGTCCGGCAATGGTGTGGCTGTGGGGTTAG	1	bc
GACGACCGAC	GAAACACCGGTGCCCTTACTCTCACCCGATTACTTAATCCGTGGGGTTAG	1	bc
TGCAGGAAAA	GAAACACCGGTCGATTCATATCGAAACCTTCCCGTGACAGTGGGGTTAGA	1	bc
AGGATCGTTT	GAAACACCGGTCTCGAGTGAGGGGTTCAGGGTGGGGTTAGAGCTAGAAAT	1	bc
GACAGAGTAA	GAAACACCGGTTAGAGCTAGAAATATCAAGTTAACCTGAGGCTAGTCCGT	1	bc
AGTGTGCAAC	GAAACACCGGTTTAGAAACACCGGTTTAGGTTTTAGAGCTAGAAATAGCA	1	bc
GGGAAGCTGG	GAAACACCGGTGCATTCGAAAGTCCGGTCGTAGTGTGGACGTGGGGTTAG	1	bc
ATGCTGCATC	GAAACACCGGTCCGTAGGAGACCCGTGTGGCATGTACCTGTGGGGGTAGA	1	bc
AACCACGCAC	GAAACACCGGTTTGAACTACCTAGTTCAAACCGGTGGGGTTAGAGCTAGA	1	bc
TCACTCGAAG	GAAACACCGGTTATATTTGTAAGTGGAGATAGCGCTAGCAATAGCAAGTT	1	bc
CATCGCGTTT	GAAACACCGGTGTACGTATGGACTGAACCAGGGTGTGCAAGTGGGGTTAG	1	bc
CTTTAGCTAT	GAAACACCGGTTACATTGAGGGTTAGAGCTAGAAATAGCAAGTTAACCTA	1	bc
ATGACTATCT	GAAACACCGGTTTACGTTGCATCGGGGGTAGAGCTAGTAATAGCAAGTTA	1	bc
CTCGACGGTC	GAAACACCGGTCTGAACTACCTAGTTCAAAGCGAGGGGGATAGATATAAA	1	bc
AGCAACGGCC	GAAACACCGGTGTGGCTGAGAGTCCGGCAATGGTGTGGCTGTGGGGTTAG	1	bc
GCGGGTTGTC	GAAACACCGGTGACATTGGGTACAGGGGTGGGGTTAGAGCTAGAAATAGC	1	bc
ATCTAGCGAC	GAAACACCGGTTATATGTGCTATATGTGTTTGTGGGGGTAGAGCTATAGA	1	bc
ATACCTTGGT	GAAACACCGGTTTACGTTGCAGCGGTGTGGGGTTAGAGCTAGAAATAGCG	1	bc
ACCGCCGGAC	GAAACACCGGTGCCCTTACTCTCACCTGATTACTTAATCCGTGGGGTTAG	1	bc
TAGAGAATCA	GAAACACCGGTTAAGCCGAGGTTAGAGCTAGAAATAGCAAGTTAACCTAA	1	bc
GAGTCTGCAT	GAAACACCGGTCCGTAGGAGACCCGTGTGGCATGTACCTGTGGGGTTAGA	1	bc
AACGCTCGAA	GAAACACCGGTGCCCTTACTACCACCTGATTACTTAATCCGTGGGGTTAG	1	bc
ACGCCGCCTC	GAAACACCGGTCCGAAGGAGACCCGTTTTGCATGGACCAGAGGTGGTAAT	1	bc
AACGCAAGAA	GAAACACCGGTGCCCTTACTCTCACCTGATTACTTAATCCGTGGGGTTAG	1	bc
AGGCCTCTAC	GAAACACCGGTAAATTTGAGGCTCCGGCATGCAGGAGGCCGTGGGGTTAG	1	bc
TCGATTGCAG	GAAACACCGGTTATATTTGTAAGTGTGTGGGGTTAGAGCTAGAAATAGCA	1	bc
GAGAGCCTTC	GAAACACCGGTGTGGCTGAGAGTCCGGCAATGGTGTAGCTGTGGGGTTAG	1	bc
GCTGCTTAGC	GAAACACCGGTTTACGTTGCATCGGGGTTAGAGCTAGAAATAGCAAGTTA	1	bc
GAGGGAACAA	GAAACACCGGTCGGCGGCCGGTTAGAGCTAGAAATAGCAAGATAACCTAT	1	bc
CAAATAGTTT	GAAACACCGGTCTCGAGTGAGGTGTTCAGGGTGGGGTTAGAGCTAGAAAT	1	bc
GAGAAGTATC	GAAACACCGGTTCCCGTCCAGTGGGGTTATAGCTAGAAATAGCAAGTTAA	1	bc
GATATTGAAG	GAAACACCGGTGATATTGGTAAGTGTTGGGGGGTTAGAGCTAGAAATACC	1	bc
GTACACAAGT	GAAACACCGGTTACATTGAGTGGGGTTAGAGCTAGAAATAGCAAGTGAAC	1	bc
AGTGCTTTAT	GAAACACCGGTGACATTACGTACAGGGGAGGAGTTAATGCGAGAAGTAAC	1	bc
GACGACACGT	GAAACACCGGTCGGCGGCGTGGGGTTAGAGCTAGAAATAGCAAGTTAACC	1	bc
TAGACACCTT	GAAACACCGGTCTCGAGGTGGGGTTAGAGCTAGAAATAGCAAGTTAACCT	1	bc
AACTATCGAG	GAAACACCGGTTATATTTGTAAGTGTGTGGGGTTAGAGCTAGAAATAGCA	1	bc
TGAGCTCTTC	GAAACACCGGTGTGGCTGAGAGTCTGGCACTGGTGTTGCTGAGTTGATAG	1	bc
AATGGAGCAT	GAAACACCGGTTAAGCCGTGGGGTTAGAGCTAGAAATAGCAAGTTAACCT	1	bc
ACGCATACTT	GAAACACCGGTCTCGAGTGAGGTGTTCAGGGTGGGGTTAGAGCTAGAAAT	1	bc
AACAATGTCC	GAAACACCGGTTTGTGCTAGACATAGTTAGTTAACCTTCGGCTAGGCTGT	1	bc
AGCCTTAGCC	GAAACACCGGTTTACGTTGCATCGGTGTGGAGTTAGAGCTAGAGTTAGCA	1	bc
TGAGGTCTGT	GAAACACCGGTTACATTGAGGGGTTAGAGCTAGAGATAGAAGGTTAACAT	1	bc
GCAAACGCGG	GAAACACCGGTTATATTTGTAAGTGGGGTTAGAGCTAGAAATAGCAAGTT	1	bc
CCAATGTCAC	GAAGCACCGGTGACATTGGGTATTCGGGCCCATTGGTATGGCAGATCGGA	1	bc
GAGGCGCCCC	GAAACACCGGTTCCCGTCCCGTTAGAGCTAGAAATAGCAAGTTAACCTAG	1	bc
CCCCCCCCCC	GAAACACCAGTGTGGCTGAGAGTCCGGCAATGGTGTGGCTGTGGGGTTAG	1	bc
ATACAACGCT	GAAACTAGAAATAGCAAGTTAACCTAAGGCTAGTCCGTTATCAACTTGAA	1	bc
AGGCCCTTAC	GAAACACCGGTAAATTTGAGGCTCCGGCATGCAGGAGGCCGTGGGGTTAG	1	bc
ACGTGTTGGC	GAAACACCGGTGACATTGGGTTAGAGCTAGAAATAGCAAGTTAACCTAAG	1	bc
GAGTCTGCGT	GAAGCACCGGTCCGTAGGAGACCCGTGTGGCATGTACCTGTGGGGTTAGA	1	bc
CGCGATGTCA	GAAACACCGGTGACATTGGGTGGAGGGGTTAGAGCTAGAAATAGAAAGTT	1	bc
TCGTGACCGC	GAAACACCGGTCAAGGCCACTCAGTGGAGGGGGTAAAGCTAGAAATACCT	1	bc
CTAGGTATTT	GAAACACCGGTTATTGGGGTTAGAGCTAGAAATAGCAAGTTAACCTAAGG	1	bc
TGGACCGACA	GAAACACCGGTGAGGCTGAGAGTCCGGCGTTGGTGTAGCTGGGGGGAGAA	1	bc
TCAACGTCGT	GAAACACCGGTGTACGTATGGACTGAACCAGGGTGTGCAAAAGTGGGGTT	1	bc
ACGAATACTT	GAAACACCGGTCTCGAGTGAGGTGTTCAGGGTGGGGTTAGAGCTAGAAAT	1	bc
GATTTAACGC	GAAACACCGGTCGGGGCCACTCAGTGGTGGGGTTAGAGCTAGAAATAGCA	1	bc
GATCGCCGCA	GAAACACCGGAGTACGTATGGACTGAACCAGGGTGTGCAAGTGGGGTTAG	1	bc
AGGCACCCTG	GAAACACCGGAGTGGCTGAGAGTCCGGCAATGGTGTGGCTGTGGGGTTAG	1	bc
TGACGACCCG	GAAACACCGGTCGGCGGTGGGGTTAGAGCTAGAAATAGCAAGTTAACCTA	1	bc
AGGGACCCTC	GAAACACCGGTGTGGCTGAGAGTCCGGCAATGGTGTGGCTGTGGGGTTAG	1	bc
ACTACACGGC	GAAACACCGGTACCTTTGTTGATGCTGGGTGGAAGGAATGTGGGGTTAGA	1	bc
TTTAGGTCAC	GAAACACCGGTTAAGCCGAGGAGTTAGAGCTAGAAATAGCAAGTTAACCT	1	bc
GAGAAGATTA	GAAACACCGGTTCCCGTCCAGTGGGGTTAGAGCTAGAAATAGCAAGTTAA	1	bc
GCAACCTACC	GAAACACCGGTAAATTTGAGGCTCCGGCATGCAGGAGGCCGTGGGGTTAG	1	bc
GCGGTACCAC	GACACCGGTCGGGGCCACTCAGTGGTGGGGTTAGAGCTAGAAATAGCAAG	1	bc
ATGTATATCT	GAAACACCGGTTTACGTTGCATCGGTGTGGGGTTAGAGCTAGAAATAGCA	1	bc
AGTAGGTCTC	GAAACACCGGTCCGTAGGAGACCCGTGTGGCATGTACCTGTGGGGTTAGA	1	bc
TGAGCCTTGT	GAAACACCGGTTACTTCGAGAGGGGTGAGGGATAGAAGTCGCAAGTTTAC	1	bc
TTGTTACCCC	GAAACACCGGTTCCCGCCCATTGGGGGTAGAGGTAGAAATAGCAAGTGAA	1	bc
AGAAGCCCCG	GAAACACCGGTCGGCGGCAATCGTGGGGTGGGGTTAGAGCTAGAAATAGC	1	bc
GTAGGCGGGC	GAAGCACCGGTACCTTTGGTGGGGGTGGGAGGTAGAAATTGGTGGGGTAA	1	bc
ACATTAGGCA	GAAACACCGGTCGATTCATATCGAAACCTTCCCGTGGGGTTAGAGCTAGA	1	bc
GGAGTCAGCC	GAAACACCGGTCGGCGGCAATCGTGGGTGGGGTTAGAGCTAGAAATAGCA	1	bc
ATAAGCGTAG	GAAACACCGGTGTACGTATGGACTGAACCAGGGTGTGCAAGTGGGGTTAG	1	bc
ATGATTGGTT	GAAACACCGGTTTACGTTGCATCGGCGTGGGGTTAGAGCTAGAAATAGCA	1	bc
GGTGGCGTCG	GAAACACCGGTTACGCAGCGGAAAAGTAAATCATCCGAAGTCGGGTTAGA	1	bc
ACACAAGGCC	GCTAGAAATAGCAAGTTAACCTAAGGCTAGTCCGTTATCAACTTGAAAAA	1	bc
ACCCAACGCA	GCTAGAAATAGCAAGTTAACCTAAGGCTAGTCCGTTATCAACTTGAAAAA	1	bc
CACAGCCTAC	GAAACACCGGTTCCCTTACTCTCACCTGATTACTTAATCCGTGGGGTTAG	1	bc
GCGTATACTT	GAAACACCGGTCTCGAGTGAGGTGTTCAGGGTGGGGTTAGAGCTAGAAAT	1	bc
TCCAACGGGG	GAAACACCGGTTATATTTGTAAGTGTGTGGGGTTCGAGCTATAAATAGCA	1	bc
GCCACGGACC	GGAACACCGGTAGCAAGCGCGAGCCGGGTTGGTGGGGCTAGAGCTAGAAA	1	bc
GGCACCTAGT	GAAACACCGGTAAATTTGAGGCTCCGGCATGCAGGAGGCCGTGGGGTTAG	1	bc
AAGACCATCG	GAAACACCGGTGCATTCGAAAGTCCGGTCGTAGTGTGGACGTGGGGTCAG	1	bc
GATATCGTGC	GAAACACCGGTTATATTTGTAAGTGTTGTGGGGTTAGAGCTAGAAATAGC	1	bc
TATACTCGGC	GAAACACCGGTACCTTTGTTGATGCTGGGTGGAAGGTGGGGTTAGAGCTA	1	bc
TCACGACCTA	GAAACACCGGTGCCCTTACTCTCACCTGATTACTTAATCCGTGGGGTTAG	1	bc
CATGTTGTAC	GAAACACCGGTGACATTGGGTGGGGTTAGAGCTAGAAATAGCAAGTTAAC	1	bc
AAAAACGGCA	GAAACACCGGTACCTTTGTTGATGCTGGGTGGAAGGAATGGGGGGGGTTA	1	bc
ACACATATAC	GAAACACCGGTAACTATATTCATGCGATATCGCCGTATCAGTGGGGTTAG	1	bc
CGGTTTAGCT	GAAACACCGGTTTACGTTGCATCGGTGTGGGGTTAGAGCTAGAAATAGCA	1	bc
GCTCTATACA	GAAACACCGGTACATTTGAGGCTCCGGCATGCAGGGGTACGTGGAGATAG	1	bc
GAGGCACCAC	GAAACACCGGTTCCCTTCCTCTCACCTGATTACTTAATCCGTGAGGTTAG	1	bc
GGCACCATTA	GAAACACCGGTGTGGCTGAGAGTCCGGCAATGGTGTAGCTGTGGGGTTAG	1	bc
AGAGCTAGGC	GAAACACCGGTTACATTGAGGGTTAGAGCTAGAAATAGCAAGGTAACCTA	1	bc
TAATCGTAGT	GAAACACCGGTGTACGTATGGACTGAACCAGGGTGTGCAAGTGGGGTTAG	1	bc
AAGCTTCGCA	GAAACACCGGTTTACGTTGGATCGGTGTGGGGGTATAGATGGAAATATCG	1	bc
GAAGGCTGCC	GAAACACCGGTCCGTAGGAGACCCGTGTGGCATGTACCTGTGGGGTTAGA	1	bc
GTGGGCTGTC	GAAACACCGGTTCACGTCCAGTGGGGTTAGAGCTAGAAATAGCAAGTTAA	1	bc
AGGAACACTC	GAAACACCGGTGTGGCTGAGAGTCCGGCAATGGTGTGGCTGTGGGGTTAG	1	bc
ACTACTAGGC	GAAACACCGGTGCCCTTGTTGTTGCTGGGTGGGGATAGCTCGAAAAATCA	1	bc
AAACCTATCC	GAAACACCGGTAACTATATTCATGCGATATCGCCGTATCAGTGGGGTTAG	1	bc
AGTGTTGTAC	GAAACACCGGTGACATTGGGTACAACACGGAATTCGGGCCCATTGGTATG	1	bc
ATTAGGTATG	GAAACACCGGTTACATTGAGGGTTAGAGCTAGAAATAGCAAGTTAACCTA	1	bc
AGGATGATTA	GAAACACCGGTCCGTAGGAGACCCTTGTGACATGTACCTGTGGGGTTAGA	1	bc
GCATCGACGT	GGCTAGTCCGTTGTCAACTTGAAAAAGTGGCACCGAGTCGGGGCTTTTTT	1	bc
CCTTGAGCCC	GAAACACCGGTCGGGGCCACTCAGTGGTGGGGTTAGAGCTAGAAATAGCA	1	bc
TGAATACCTT	GAAACACCGGTCGGGAAGGGGTTGTTCAATGTGGGGTTAGAGCTAGAAAT	1	bc
AAAAACGCTC	ATGTGGGGTTAGAGCTAGAAATAGCAAGTTAACCTAAGGCTAGTCCGTTA	1	bc
AATAGCTATG	GAAACACCGGTTACATTGAGATTAGAGCTAGAAAAGGCTAGTCCGTTATC	1	bc
AACGACATCT	GAAACACCGGTGCCCTTACTCTCACCTGATTACTTAATCCGTGGGGTTAG	1	bc
CCCAGAGCAC	GCTAGAAATAGCAAGTTAACCTAAGGCTAGTCCGTTATCAACTTGAAAAA	1	bc
AAGAGTCGAT	GAAACACCGGTGTACGTATGGACTGAACCAGGGTGTGCAAGTGGGGTTAG	1	bc
TTGCGCATCC	GAAACACCGGTTAAGCCGAGGGTTAGAGCTAGAAATAGCAAGTTAACCTA	1	bc
AGATCTCTGC	GAAACACCGGTTACATTGAGATTAGAGCTAGAAAAGGCTAGTCCGTTATC	1	bc
ACACGACGCC	GCTAGAAATAGCAAGTTAACCTAAGGCTAGTCCGTTATCAACTTGAAAAA	1	bc
CACTGCCTGC	GAAACACCGGTGTCCTTACGCTCAGCTGATGACTTAATCCGTGGAGTTAG	1	bc
AGCAGCATTA	GAAACACCGGTCTCGAGTGAGGTGTTCAGGGTGGGGTTAGAGCTAGAAAT	1	bc
CTGATACGTC	GAAACACCGGTACCTTTGGTTTTTGTGGGGGGGAAGCCTTGAGTGGTTCG	1	bc
GGCAACATCT	GAAACACCGGTGTGGCTGAGAGTCCGGCAATGGTGTGGCTGTGGGGTTAG	1	bc
GACGATCTGC	GAAACACCGGTCGGCGGTGGGGTTAGAGCTAGAAATAGCAAGTTAACCTA	1	bc
AACAGCCGAT	GAAACACCGGTGCCCTTACTCTCACCTGATTACTTAATCCGTGGGGTTAG	1	bc
GTCACTACGC	GAAACACGGGTTAGAGCTAGAAATAGCAAGTTAACCTAAGGCTAGTCCGT	1	bc
ACGTGGTGTC	GAAACACCGGTGACATTGGGTACAGGCTAGAAATAGCAAGTTAACCTAAG	1	bc
GCATTCGCTA	GAAACACCGGTAGATTTGAGTCTCCGGCATGCAGGAGGCCTGGGGTTAGA	1	bc
ATGCTATGGT	GAAACACCGGTTTACGTTGCATCGTGGGGTTAGAGCTAGAAATAGCAAGT	1	bc
ACGTTACGTC	GAAACACCGGTAGGGGCCACTCATGGATGGGGGTATCGCTAGTTATAGCA	1	bc
AAGGCTATAC	GAAACACCGGTGCCCTTACTCTCACCTGATTACTTGGGGTTAGAGCTAGA	1	bc
ATTGCTTATA	GAAACACCGGTTTACGTTGCATCGGTGTGGGGTTAGAGCTAGAAATAGCA	1	bc
CATAGAGGGA	GAAACACCGGTGTACGTATGGACTGAACCAGGGTGTGCAAGTGGGGTTAG	1	bc
TCGATTATAG	GAAACACCGGTAACTATATTCATGCGGTATCGCCGTATCAGTGGGGTTAG	1	bc
ATGATAAGCC	GAAACACCGGTTTACGTTGCATCGGTGTGGGGTTAGAGCTAGAAATAGCA	1	bc
TGCACCGCCC	GAAACACCGGTAAATTTGAGGCTCCGGCATGCAGGAGGCCGTGGGGTTAG	1	bc
CGACTGCTTC	GAAACACCGGTCCGTAGGAGACCCGTGTGGCATGTACCTGTGGGGTTAGA	1	bc
GGCAGTGGTC	GAAACACCGGTGTACGGATGGACTGAACCAGGGTGTGCAAGTGGGGTTAG	1	bc
AAGCTTAGGC	GAAACACCGGTTTACGGTGCATGGTTGAAAAAGTGGCACCGAGTCGGTGC	1	bc
TTATCTAAGG	GAAACACCGGTTACATTGAGGGGTTAGAGCTAGAAATAGCAAGTTAACCT	1	bc
GCGGAGGCGC	GAAACACCGGTGCATTCGAAAGTCCGGTCGTAGTGTGGACGTGGGGTTAG	1	bc
GTGAGGATTA	GAAACACCGGTTAGAGCTAGAAATAGCAAGTAAACCTAAGGCTAGTCCGT	1	bc
TAAGCTACGC	GAAACACCGGTCGGCGGCAATCGTGGGTGGGGTTAGAGCTAGAAATAGCA	1	bc
GTCCTCGGCT	GAAACACCGGTACATGTATTGATGGAAGCAGGGAGGGCAGGTTGGGTCAG	1	bc
AAATAGTCGT	GAAACACCGGTGTACGGCTAGTCCGTTATCAACTTGAAAAAGTGGCACCG	1	bc
GACATTCGGA	GAAACACCGGTCGATTCATATCGAAACCTTCCCTAGAGCTAGAAATAGCA	1	bc
AACCGCACTA	GAAACACCGGTGCCCTTACTCTCACCTGATTACTTAATCCGTGGGGTTAG	1	bc
TATCGCGGAC	GAAACACCGGTGTACGTATGGACTGAACCAGGGAGTGCAAGTGGGGTTAG	1	bc
CGTGGTGGTT	GAAACACCGGTGTACGTATGGACTAGACCAGGGTGGGCAGGTAAGGTTAG	1	bc
AGTATGACAC	GAAACACCGGTCCGTAGGAGACCCGTGTGGCATGTACCTGTGGGGTTAGA	1	bc
ATGCGTGGCG	GAAACACCGGTTTGCGTTGCATCGGTTGTGGGGTTAGAGCTAGAAATAGC	1	bc
ACTGTACGGA	GAAACACCGGTCGGGGCCACTCAGAGGGGGGGTTAGAGATAGCAATAGCT	1	bc
ATTACTCGGC	GAAACACCGGTCTGGGGTTAGAGCTAGAAATAGCAAGTTAACCTAAGGCT	1	bc
TGAGCTGTCC	GAAACACCGGTTTGGTTGAGAGTCCGGCAATGGTGTGGCTGGGGAGATAA	1	bc
CCTAGTAGTC	GAAACACCGGTGTACGTATGGACTGAACCAGGGTGTGCAAGTGGGGTTAG	1	bc
TGACGAGCTT	GAAACACCGGTGCCCTTACTCTCACCTGATTACTTAATCCGTGGGGTTAG	1	bc
TGGGACCCTC	GAAACACCGGTGTGGCTGAGAGTCCGGCAATGGTGTGGCTGTGGGGTTAG	1	bc
GTGAGGCATA	GAAACACCGGTTAAGCCGTGGGGTTAGAGCTAGAAATAGCAAGTTAACCT	1	bc
AAGGTGGTCT	GAAACACCAGTGGGGTTAGAGCTAGAAATAGCAAGGTAACGTAAGGCTAG	1	bc
GATACTCGGC	GAAACACCGGTACCTTTGTTGATGCTGGGTGGAGCTAGAAATAGCAAGTT	1	bc
TTGCTCATCA	GAAACACCGGTTTACGTTGCATCGGAGTGGGAGTAGAGGTAAAAAAAGCA	1	bc
CAGAGCGCAA	GAAACACCGGTTCGGCGCTCTTTTCCTGCAGGTTATGTTCAAGAATTCAT	1	bc
ATTGAGAATG	GAAACACCGGTTAAGCCGAGGTTAGAGCTAGAAATAGCAAGTTAACCTAA	1	bc
AAGGCCAGAC	GAAACACCGGTGCCCTTACTCTCACCTGATTACTTAATCCGTGGGGTTAA	1	bc
GGCCGATCAA	GAAACACCGGTAAATTTGAGTCTCTGGCATGCAGGAGGCCGTGGGGTTAG	1	bc
CTAGTTAGCT	GAAACACCGGTTACATTGAGGGTTAGAGCTAGAAATAGCAAGTTAACCTA	1	bc
AGGCCTTTTA	GAAACACCAGTAAATTTGAGGCTCCGGCATGCAGGAGGCCGTGGGGTTAG	1	bc
TGATGCCTTT	GAAACACCGGTCTCGAGTGAGGTGTTCAGGGTGGGGTTAGAGCTAGAAAT	1	bc
ACTTGTACGC	GAAACACCGGTCGGGGCCACTCAGTGGTGGGGTTAGAGCTAGAAATAGCA	1	bc
AGGTCCACGC	GAAACACCGGTGCATTCGAAAGTCCGGTCGTAGTGTGGACGTGGGGTTAG	1	bc
GTGAACCGAG	GAAACACCGGTGCGTTCGAAAGTCCGGTCGTAGTGTGGACGTGGGGTTAG	1	bc
ACACAAAGCC	GAAACATCGGTTTGAACTAGAAATAGCAAGTTAACCTAAGGCTAGTCCGT	1	bc
TAAATCGCCC	GAGAAATAGCAAGTTAACCTAAGGCTAGTCCGTTATCAACTTGAAAAAGT	1	bc
GAAGAACCTA	GAAACACCGGTCGGCGGCAATCGTTAATCGGTTAATCGTGGGGTTAGAGC	1	bc
GGCAACATAC	GAAACACCGGTGTGGCTGAGAGTCCGGCAATGGTGTGGCTGTGGGGTTAG	1	bc
CGCGTTGAAC	GAAACACCGGTGACATTGGGTACAACGCGGAATTCGGGCCCATTGGTATG	1	bc
GAAAGAGGCC	GAAACACCGGTAGCAAGTGCGAGACGGGGTGAGAGTGGGGTTAGAGCTAG	1	bc
CACATAGCTA	GGGTTAGAGCTAGAAATAGCAAGTTAACCTAAGGCTAGTCCGTTATCAAC	1	bc
GGCTAGCGAG	GAAACACCGGTTATATTTGTAAGTGTGGGGTTAGAGCTAGAAATAGCAAG	1	bc
GTCTCCTCCA	GAAACACCGGTAAATTTGAGGCTCCGGCATGCAGGAGGCCGTGGGGTTAG	1	bc
AAGAGCAGAA	GAAACACCGGTTAAGCCGAGTGGGGTTAGAGCTAAAAATAGCAAGTTAAC	1	bc
ATACTCTACC	GAAACACCGGTACCTTTGTTGATGCTGGGTGGAAGGAATTTTGTGGGGTT	1	bc
GGAAAACTCC	GAAACACCGGTGTGGCTGAGAGTCCGGCAATGGTGTGGCTGTGGGGTTAG	1	bc
AGGCGCTTGC	GAAACACCGGTGCATTCGAAAGTCCGGTCGTAGTGTGGACGTGGGGTTAG	1	bc
ACTATTGGGG	GAAACACCGGTTATATTTGTAAGTGTGTGGGGTTAGAGCTAGAAATAGCA	1	bc
AGGGACCATT	GAAACACCGGTGTGGCTGAGAGTCCGGCAATGGTGTGGCTGTGGGGTTAG	1	bc
CTACTCGTAT	GAAACACCGGTACCTTTGTTGATGTGGGGTTAGAGCTAGAAATAGCAAGT	1	bc
AGGATTCGCT	GAAACACCGGTTTACGTTGCATCGGTGTGGGGTTAGAGCTAGAAATAGCA	1	bc
ACGAGACTCG	GAAACACCGGTTATATTTGTAAGTGTGTGGGGTTAGAGCTAGAAATAGCA	1	bc
AACCTGCATC	GAAACACCGGTCCGTAGGAGACCCGTGTGGCATGTACCTGTGGGGTTAGA	1	bc
AAACAACGCC	GAAACACCGGTTTGAACTACCTAGTTCAAACCGTTAGAGCTAGAAATAGC	1	bc
GAACCCGCGC	GAAACACCGGTCGGCGGCGGTGGGGTTAGAGCTAGAAATAGCAAGTTAAC	1	bc
TGAACTCTTT	GAAACACCGGTCTCGATTGAGGTATTGCGGGTGGTGTTAGAGCTAGCAAT	1	bc
TAGGAACAGC	GAAACACCGGTTCCCGTCCAGTGGGGTTAGAGCTAGAAATAGCAAGTTAA	1	bc
AAAGCTATGC	GAAACACCGGTTACATGAGGGTTAGAGCTAGAAATAGCAAGTTAACCTAA	1	bc
CAAGCCCTCC	GAAACACCGGTGCCCTTACTCTCACCTGATTACTTTATCCGTGGGGTTAG	1	bc
TGCAGCAGCC	GAAACACCGGTGTGGCTGAGAGTCCGGCAATGGTGTGGCTGGGGGGTTAG	1	bc
CAGTGTGATC	GAAACACCGGTGTACGTATGGACTGAACCAGGGTGTGCAAGTGGGGTTAG	1	bc
ACCCATCGCC	GAAACACCGGTTTGAACTAGAAATAGCAAGTTAACCTAAGGCTAGTCCGT	1	bc
GGCCGTTCTC	GAAACACCGGTAAATTTGAGGCTCCGGCATGCAGGAGGCCGTGGGGTTAG	1	bc
CGTGCTCTTT	GAAACACCGGTGACATTGGGTAAAATAGCAAGTTAACCTAAGGCTAGTCC	1	bc
GCATACGGAT	GAAACACCGGTCGATTCATATCGAAACCTTCTCGTGTTAGCGGGGGTAGT	1	bc
CTCCTAGGCA	GAAACACCGGTGTGGCTGAGAGTCTGGCAATGGTGTGGCTGTGGGGTTAG	1	bc
TTGGGGACTC	GAAACACCGGTTCCCGTCCAGTGGGGTTAGAGCTAGAAATAGCAAGTTAA	1	bc
AACCTCGGCC	GAAACACCGGTACCTTTGTTGTAGCAAGTTAACCTAAGGCTAGTCCGTTA	1	bc
CATTGTGTTG	GAAACACCGGTGTACGTATGGACTGAACCAGGGTGTGCGAGTGGGGTTAG	1	bc
AGGCGGCGTC	GAAACACCGGTCCGTAGGAGACCCGTGTGGCATGTACCTGTGGGGTTAGA	1	bc
ATCTATCGCG	GAAACACCGGTTGCAAGTTAACCTAAGGCTAGTCCGTTATCAACTTGAAA	1	bc
GAGACCCTAG	GAAACACCGGTGCATTCGAAAGTCCGGTCGTAGTGTGGACGTGGGGTTAG	1	bc
GTTAGATATG	GAAACACCGGTTACATTGAGGGGTTAGAGCTAGAAATAGCAAGTTAACCT	1	bc
AGTGGTGCCT	GAAACACCGGTTCCCGTCCAGTGGGGTTAGAGCTAGAAATGGCAAGTTAA	1	bc
TCCTTTAGCG	GAAACACCGGTCGGGGCCACTCAGTGGTGGGGTTAGAGCTAGAAATAGCA	1	bc
AGTGAGCATA	GAAACACCGGTCCGTAGGAGACCCGTGTGGCATGTACCTTGTGGGGTTAG	1	bc
GCCCCCACCC	GAAACACCGGTGTGGCTGAGAATCCTGCAATGGGGTGTCTGGGGAGATAT	1	bc
GAACTCCCTA	GAAACACCGGTGCCCTTACTCTCACCTGATTACTTAATCCGTGGGGTTAG	1	bc
ATGCTAGGAT	GAAACACCGGTTTACGTTGCATCGGTGTGGGGTTAGAGCTAGAAATAGCA	1	bc
AAGGCAGTAA	GAAACACCGGTGCCCTTACTCTCACCTGATTACTTAATCCGTGGGGTTAG	1	bc
ACGAATTCTT	GAAACACCGGTCTCGAGTGAGGTGTTTAGGTGGGGTTAGAGCTAGAAATA	1	bc
ACCGTTACCG	GAAACACCGGTCGGGGCCACTCAGTGGTGGGGTTAGAGCTAGAAATAGCA	1	bc
GACATCGGCG	GAAACACCGGTGTACGTATGGACTGAACCAGGGTGTGCAAGTGGGGTTAG	1	bc
CAGCTTATCT	GAAACACCGGTTTACGTTGCATCGGTGTGGGGTTAGAGCTAGAAATAGCA	1	bc
GGCAATCTAC	GAAACACCGGTGTGGCTGAGAGTCCGGCAATGGTGTGGCTGTGGGGTTAG	1	bc
ACTATCACGG	GAAACACCGGTTTTATGGATAAGTGTGTGGGGTTAGAGCTAGAAATAGCA	1	bc
CTGTTATCTC	GAAACACCGGTCGGGGCCACTCAGTGGTGGGGTTAGAGCTAGAAATAGCA	1	bc
CCCATGTCAC	GAAACACCGGTGACATTGGGTATTCGGGCCCATTGGTATGGCAGATCGGA	1	bc
GGTACGGCTA	GAAACACCGGTACGAAGGACGCGCGTGTGGCATGTACCTGTTAGGGTTGG	1	bc
ATGCAGGGCT	GAAACACCGGTTTACGTTGCATCGGGGTTAGAGCTAGAAATAGCAAGTTA	1	bc
CCGCTGAGCT	GAAACACCGGTTTACGTTGCATCGGTGTGGGGTTAGAGCTAGAAATAGCA	1	bc
AAGACTCTCG	GAAACACCGGTGCATTCGAAAGTCCGGTCGTAGTGTGGACGTGGGGTTAG	1	bc
GGCTACCGCC	CAAAACACCGGTGTGGCTGAGAGTCCGGCAATGGTGTGGCTGTGGGGTTA	1	bc
CCACGTTGTC	GAAACACCGGTGTACGTATGGACTGAACCAGGGTGTGCAAGGTGGGGTTA	1	bc
ATGCCTATCC	GAAACACCGGTTTACGTTGCATCGGGGTGGGGTTAGGGCTAGAAATATCA	1	bc
GCCCACGGCC	GAAACACCGGTTTGAACTAGAAATAGCAAGGTAACCTAAGGCTAGTCCGT	1	bc
ATGTCTCGCT	GAAACACCGGTTTACGTTGCATCGGTGTGGGGTTAGAGCTAGAAATAGCA	1	bc
GAGAATCATT	GAAACACCGGTCTCGAGTGAGGTGTTCAGGGTGGGGTTAGAGCTAGAAAT	1	bc
GACCCCTTGA	GAAACACCGGTAACTTTGAGGCTCCGGCATGCAGGAGGCCGTAGGGTTCG	1	bc
TCATTTCTGT	GAAACACCGGTCGATTCATATCGAAACCTTCCCGTGACAGTGGGGTTAGA	1	bc
CCTATTCGTC	GAAACACCGGTGTACGTATGGACTGAACCAGGGTGTGCAAGTGGGGTTAG	1	bc
CCTCGAGGTC	GAAACACCGGTGTACGTATGGACTGAACCAGGGTGTGCAAGTGGGGTTAG	1	bc
AACGTACTCC	GAAACACCGGTGCCCTTACTCTCACCTGATTACTTAATCCGTGGGGTTAG	1	bc
AAGGACGCGC	GAAACACCGGTCGGCGGCAATCGTGGGGGGGGTTAGAGCTAGAAATAGCA	1	bc
TTTAGGCCTC	GAAACACCGGTTAAGCCGTGGGGTTAGAGCTAGAAATAGCAAGTTAACCT	1	bc
GCGTCTGCCT	GAACCACCGGTCCGTAGGAGACCCGTGTGGCATGTACCTGTGGGGTTAGA	1	bc
GACAGAGAGC	GAAACACCGGTAGCAAGTGGGGTTAGAGCTAGAAATAGCAAGTTAACCTA	1	bc
AGGCACCTAC	GAAACACCGGTAAATTTGAGGCTCCGGCATGCAGGAGGCGTGGGGTTAGA	1	bc
AAACGGCCTA	GAAACACCGGTGCCCTTACTCTCACCTGATTACTTAATCCGTGGGGTTAG	1	bc
ATGCGTAGAC	GAAACACCGGTTTACGTTGCATCGGTGTGGGGTTAGAGCTAGAAATAGCA	1	bc
ATGGTGATAC	GAAACACCGGTTCACTTACTATCAGCTGGTTACTAAATCTGTAGAGATAG	1	bc
AGCCTTGGCC	GAAACACCGGTACCTTTGTTGCTTCTTTGTGCAACGGGTTATGGCTAGAA	1	bc
CAACGTCTAC	GAAACACCGGTGTACGTATGGACTGAACCAGGGTGTGCAAGTGGGGTTAG	1	bc
TGAGCGTAAT	GAAACACCGGTTAAGCCGAGGTTAGAGCTAGAGATAGCAAGTTAACCTAA	1	bc
ACACCGCATA	GAAACACCGGTGCCCTTACTCTCACCTGATTACTCAATCCGTGGGGTTAG	1	bc
CGAGTCTGCC	GAAACACCGGTCCGTAGGAGACCCGTGTGGCATGTACCTGTGGGGTTAGA	1	bc
TCACAATGAC	GAAACACCGGTTTGAACTAGAAATAGCAAGTTAACCTAAGGCTAGTCCGT	1	bc
GAGTAGCCTA	GAAACACCGGTTCCCGTCCAGTGGGGTTAGAGCTAGAAATAGCAAGTTAA	1	bc
AGTATGACAC	GAAACACCGGTCAGTAGGAGACCCGTGTGGCATGTACCTGTGGGGTTAGA	1	bc
GCGTCGCCTC	GAAACACCGGTTCCCGTCCAGTGGGGTTAGAGCTAGAAATAGCAAGTTAA	1	bc
GTGGAACGGC	GAAACACCGGTTCCCGTCCAGTGGGGTTAGAGCTAGAAATAGCAAGTTAA	1	bc
TCTCTCGGTT	GAAACACCGGTGTACGTATGGACTGAACCAGGGTGTGCAAGTGGGGTTAG	1	bc
CACGCCTCAC	GAAACACCGGTGCCCTTACTCTCACCTGATTACTTAATCCGTGGGGTTAG	1	bc
GATAACTTAT	GAAACACCGGTAACTATATTCATGCGATATCGCCGTATCAGTGGGGTTAG	1	bc
CGAAAGATAA	GAAACACCGGTTCAGCCGAGGGGTTCGAGCTCGAAATAGCAAGTTAACAT	1	bc
AGTGGAGCAT	GAAACACCGGTTCCCGTCCAGTGGGGTTAGAGCTAGAAATAGCAAGTTAA	1	bc
GTGCTTACCA	GAAACACCGGTTTACGTTGCATCGGTGTGGGGTTAGAGCTAGAAATAGCA	1	bc
CTGCCTGGCT	GAAACACCGGTTTACGTTGCATCGGTGTGGGGTTAGAGCTAGAAATAGCA	1	bc
GAAGAGTCGA	GGAACACCGGTCGGCGGCAATCGGGGGTGGGGTTAGAGCTAGAAATAGCA	1	bc
AACTCCTTCA	GAAACACCGGTAAATTTGAGGCTCCGGCATGCAGGAGGCGTGGGGTTAGA	1	bc
AGACGACCGC	GAAACACCGGTGCATTCGAAAGTCCGGTCGTAGTGTGGACGTGGGGTTAG	1	bc
TAATCGTCGT	GAAACACCGGTGTACGTATGGACTGAACCAGGGTGTGCAAAGTGGGGTTA	1	bc
AACTTTACCG	GAAACACCGGACGGGGCCACTCAGTGGTGGGGTTAGAGCTAGAAATAGCA	1	bc
CGACTTATTC	GAAACACTGGTAACTATATTTATGCGATATCGCCGGATCAGGGGCGTTTT	1	bc
AGTGGAGCGT	GAAACACCGGTTCCCGTCCAGTGGGGTTAGAGCTAGAAATAGCAAGTTAA	1	bc
TGGCGGCCTC	GAAACACCGGTCCGTAGGAGACCCGTGTGGCATGTACCTGTGGGGTTAGA	1	bc
GAGACAGCAA	GAAACAGCAAGTTAACCTAAGGCTAGTCCGTTATCAACTTGAAAAAGTGG	1	bc
TCAGAGATGT	GAAACACCGGTTAAATTGAGGGTTAAAGCTAGAAATAGCAAGTTAACCTA	1	bc
CAGCGACGGC	GAAACACCGGTGTACGTATGGACTGAACCAGGGTGTGCAAGTGGGGTTAG	1	bc
ACACAAAGCC	GCTAGAAGTAGCAAGTTAACCTAAGGCTAGTCCGTTATCAACTTGAAAAA	1	bc
CACAACTCTT	GAAACACGGGTTAGAGCTAGAGATAGCAAGTTAACCTAAGGCTAGTCCGT	1	bc
CCGAGCGATG	GAAACACCGGTTATATTTGTAAGTGTGTGGGGTTAGAGCTAGCAATAGCA	1	bc
TCCGATATAT	CAAACACCGGTTTAGAGCTAGAAATAGCAAGTTAACCTAAGGCTAGTCCG	1	bc
ACATGTGGTC	GAAACACCGGTCGATTCATATCGACACCTTCCCGTGACAGTGGGGTTAGA	1	bc
TTGAGCGTCC	GAAACACCGGTTAAGCCGAGTGGGGTTAGAGCTAGAAATAGCAAGTTAAC	1	bc
AAGCCCCTCG	GAAACACCGGTGCATTCGAAAGTCCGGTCGTAGTGTGGACGTGGGGTTAG	1	bc
TACACAGCTC	GAGACACCGGTCGGCGGCAATCGTGGGTGGGGTTAGAGCTAGAAATAGCA	1	bc
GGAACCTCCC	GAAACACCGGTGTGGCTGAGAGTCCGGCAATGGTGTGGCTGGGGGGTTAG	1	bc
TGTGCTCTGT	GAAACACCGGTAACCTTGAGGGGTTAAAGCTAGAAATAGCAAGTTAACCT	1	bc
GACAAGGACC	GAAGCACCGGTTTGAACTAGGAATAGCAAGTTGACGTAAGGCTAGTCCGT	1	bc
CCAATGTCAC	GAAACACCGGTGACATTGGGTATTCGGGCCCATGGTATGGCAGATCGGAA	1	bc
TAGTCTGCAT	GAAACACCGGTCCGTAGGAGACCCGTGTGGCATGTACCTGTGGGGTTAGA	1	bc
AGACTCGAGC	GAAACACCGGTGCATTCGAAAGTCCGGTCGTAGTGTGGACGTGGGGTTAG	1	bc
GAGAATCCTT	GAAACACCGGTCTCGAGTGAGGTGTTCAGGTGGGGTTAGAGCTAGAAATA	1	bc
GGGGGGGCAT	GAAACACCGGTTCCCGTCCAGTGGGGTTAGAGCTAGAAATAGCAAGTTAA	1	bc
GGAAGCTATA	GAAACACCGGTAAATTTGAGGCTCCGGCATGCAGGAGGCCGTGGGGTTAG	1	bc
TAGAAATACC	GAAACACCGGTTTGAACTAGAAATAACAGGGTAACCTAAGACTAGTCCGT	1	bc
GACCGGGCCC	GAAACACCGGTGGGGTTAGAGCTAGAAATAGCAAGTTAACCTAAGGCTAG	1	bc
AAATGCTTAG	GAAACACCGGTTTACGTTGCATCGGTGTGGGGTTAGAGCTAGAAATAGCA	1	bc
AGGAGTGTAC	GAAACACCGGTTAATCAGAGCTATAAATAGCAAGTTAACCGAAGGCTAAG	1	bc
TATATTGCCC	GAAACACCGGTGACATTGGGTACAAGCAAGTTAACCTAAGGCTAGTCCGT	1	bc
CTAAGATGCT	GAAACACCGGTTTACGTTGCATCGGAGTGGGGTTAGAGCTAGAAATAGCA	1	bc
ACACACCGCC	GAAACACCGGTTTGAACTACCTAGTTCAAACACCGGTTTGAACTACCTAG	1	bc
AGAAGACCCA	GAAACACCGGTCGGCGGCAATCGTGGTTAGAGCTAGAAATAGCAAGTTAA	1	bc
ACCTATCGAG	GAAACACCGGTTATATTTGTAAGTGTGTGGGGTTAGAGCTAGAAATAGCA	1	bc
GATGTTTCGC	GAAACACCGGTTTACGTTGCATCGGTGTGGGGTTAGAGCTAGAAATAGCA	1	bc
TATATCATCC	GAAACACCGGTTACATTGTGATCTCTTTTGTGGGGTTAGAGCTAGAAATA	1	bc
CATAGTAGTA	GAAACACCGGCGTACGTATGGACTGAACCAGGGTGTGCAAGTGGGGTTAG	1	bc
TTCTTTCGAG	GAAACACCGGTTATATTTGTAAGTGTGTGGGGTTAGAGCTAGAAATAGCA	1	bc
GCGATCGAGC	GAAACGCCGGTTATATTTGTAAGTGTGTGGGGTTAGAGCTAGAAATAGCA	1	bc
ACAAAACGCC	GCTAGAAATAGCAAGTTAACCTAAGGCTAGTCCGTTATCAACTTGAAAAA	1	bc
GATATAGAGG	GAGACACCGGTTATATTTGTAAGTGGGGTTATCGCTAGAAATAACCAGTT	1	bc
AACGGACTAG	GAAACACCGGTGCCCTTACTCTCACCTGATTACTTAATCCGTGGGGTTAG	1	bc
ACACAACGTC	GAAACACGGGTTAGAGCTAGAAATAGCAAGTTAACCTAAGGCTAGTCCGT	1	bc
AGACTAGGCA	GAAACACCGGTACCTTTGTTGATGCTGGGTGGAAGGAATTTTGTGGGGTT	1	bc
TGAGAGATGT	GAAACACCGGTTACATTGAGATTAGAGCTAGAAAAAGCTAGTCCGTTATC	1	bc
GCGAGTCCTC	GAAACACCGGTTCCCGTCCAGTGGGGTTAGAGCTAGAAATAGCAAGTTAA	1	bc
AACACCGCGC	GAAACACCGGTTTGAACTACCTAGTTCAAACACCGGTTTGAACTACCTAG	1	bc
AGGGCTGTCT	GAAACACCGGTGACATTGGGTATGGGGTTAGAGCTAGAAATAGCAAGTTA	1	bc
GGACCATACC	GAAACACCGGTAAATTTGAGGCTCCGGCATGCAGGAGGCCGTGGGGTTAG	1	bc
CCCCTCGTCC	GAAACACCGGTTTGAACTACCTAGTTCGAACCGGTGGGGTTAGAGATAGA	1	bc
TGCAGACCCG	GAAACACCGGTCGGCGGTGGGGTTAGAGCTAGAAATAGCAAGTTAACCTA	1	bc
GCATAATGCC	GAAACACCGGTTTGAACTACCTAGCAAGTTAACCTAAGGCTAGTCCGTTA	1	bc
AGGGTTGTCA	GAAACACCGGTCGCTTTGGGTACCGGTCGGGGTTAGAGCTAGCAATAGCT	1	bc
GTCCCTTGCA	GAAACACCGGTGTGGCTGAGAGTCCGGCAATGGTGTGGCTGTGGGGTTAG	1	bc
AGAAGAACAG	GAAACACCGGTCGGCGGCAATCGTGGGTGGGGTTAGAGCTAGAAATAGCA	1	bc
ACTTCACCTC	GAAACACCGGTCGGGGCCACTCAGTGGTGGGGTTAGAGCTAGAAATAGCA	1	bc
ACGAATCGTT	GAAACACCGGTCTCGAGTGAGGTGTTCAGGTTCAGGGTGGGGTTAGAGCT	1	bc
TCTTTGCTGC	GAAACACCGGTCGGGGCCACTCAGTGGTGGGGTTAGAGCTAGAAATAGCA	1	bc
ACAATTATAC	GAAACACCGGTAACTATATTCATGCGATATCGCCGTATCAGTGGGGTTAG	1	bc
GGCCGCATAC	GAAACACCGGTGTGGCTGAGAGTCCGGCAATGGTGTGGCTGTGGGGTTAG	1	bc
AAAGTCGGAC	GAAACACCGGTGCCCTTGCTCTCACCTGATTACTTAATCCGTGGGGTTAG	1	bc
AGAAGACCAG	GAAACACCGGTCGGCGGCAATCGTGGGTGGGGTTAGAGCTAGAAATAGCA	1	bc
ATGATATGCT	GAAACACCGGTTTACGTTGCATCGGGTTAGATTAGCAACGGTTACGTTCC	1	bc
GAGCAGCCTT	GAAACACCGGTTCCCGTCCAGTGGGGTTAGAGCTAGAAATAGCAAGTTAA	1	bc
ATGTATTGTC	GAAACACCGGTGACATTTGGGGTTAGAGCTAGAAATAGCAAGTTAACCTA	1	bc
ATAGCCTCTC	GAAACACCGGTGCCTTCGAAAGTCCGGTCGTAGTGTGGACGGGGGGATAG	1	bc
GAGTGTCGTA	GAAACACCGGTGACATTGGGTACAACACGGAATTCGGGCCCATTGGTATG	1	bc
ACACACCGCC	GAAACACCGGTTTGAACTACCTAGTTCAAACCGGTGGGGTTAGAGCTAGA	1	bc
AGAGGCGTCC	GAAACACCGGTCTTGTCATAACGAAACCTTCCCGTGACAGGAGGTATAGA	1	bc
CTGCTATGCT	GAAACACCGGTACCTTTGTTAGAGCTAGAAATAGCAAGATAACCTGAGAC	1	bc
GGGCAGCCGC	GAAACACCGGTGCATTCGAAAGTACGGTCGTAGTGTAGCTGTGGGGATCG	1	bc
ACCTATACCG	GAAACACCGGTCGGGGCCACTCAGTGGTGGGGTTAGAGCTAGAAATAGCA	1	bc
ATAGCTAATC	GAAACACCGGTTACATTGAGGGTTAGAGCTAGAAATAGCAAGTTAACCTA	1	bc
TAAGTTATGA	GAAACACCGGTTACATTGAGATTGGGGTTAGAGCTAGAAATAGCAAGTTA	1	bc
AACCACCGGC	GAAACACCGGTAAATTTGAGGCTCCGGCATGCAGGAGGCCGTGGGGTTAG	1	bc
GAGAAGCCGA	GAAACACCGGTTCCCGTCCAGTGGGGTTAGAGCTAGAAATAGCAAGTTAA	1	bc
TCGGATCCTT	GAAACACCGGTCTCGAGTGAGGTGTTCAGGGTGGGGTTAGAGCTAGAAAT	1	bc
AGAAGACCAG	GAAACACCGGTCGGCGGCAATCGTGGGTGGGGTTAGAGCTAGAAATAGAA	1	bc
AGGACACTAC	GAAACACCGGTAAATTTGAGGCTCCGGCATGCAGGAGGCCGTGGGGTTAG	1	bc
GCCAGCCGCT	GAAACACCGGTCTCCAGCCAATTGTTCAGGTCCTGTTGGAGCTAGGATAG	1	bc
AAATGAGCAT	GAAACACCGGTTAAGCCGAGGAGTTAGAGCTAGAAATAGCAAGTTAACCT	1	bc
CTAGACGGGC	GAAACACCGGTACCTTTGGTGAGGCTGGGTGGGGATAGAGATAGAAATAG	1	bc
GTGGTGGATC	GAAACACCGGTTCCCGTAGAGCTAGAAATAGGAAGTTAACCTAAGGCTAG	1	bc
AAACGCTCTA	GAAACACCGGTGCCCTTACTCTCACCTGATTACTTTGGGGTTAGAGCTAG	1	bc
AACTTTACAG	GAAACACCGGTCGGGGCCACTCAGTGGTGGGGTTAGAGCTAGAAATAGCA	1	bc
CAAATGTCAC	GAAACACCGGTGACATTGGGTATTCGGGCCCATTGGTATGGCAGATCGGA	1	bc
ACACAAAGCC	GAAACACCGGTTTGAACTACCTAGTTCAAACCGGTGGGGTTAGAGCTAGA	1	bc
GTGAACGAGG	GAAACACCGGTTATATTTGTAAGTGTGTGGGGTTAGAGCTAGAAATAGCA	1	bc
GGTCTGACTA	GCAACACCGGTCCGTAGGAGACCCGTGTGGCATGTACCTTGTGGGGTTAG	1	bc
AGTAACCCTC	GAAACACCGGTGTGGCTGAGAGTCCGGCAATGGCGTGGCTGTGGGGTTAG	1	bc
CAGGAGCTAC	GAAACACCGGTTCCCTTCCTCTGGGGTTATTGCTAGAAATAGCAAGTTAA	1	bc
GCGGCTCCTC	GAAACACCGGTTCCCGTCCAGCGGGGTTAGAGCTAGAAATAGCAAGTTAA	1	bc
ACATCGTGGT	GAAACGCCGGTGTACGTATGGACTGAACCAGGGTGTGCAAGTGGGGTTAG	1	bc
CCAATGTCAC	GAAACACCGGTGACATTGGGTATTCGGGCCCATTGGTATGCAGATCGGAA	1	bc
AGAAACGCGC	GAAACACCGGTTAATGCAAAATGCGGGTGGGGTTGGAGATGGGAGTAGAA	1	bc
AGAAGAAACG	GAAGCACCGGTCGGCGGCAATCGTGGGTGGGGTTAGAGCTAGAAATAGCA	1	bc
AAATCAGCAT	GAAACACCGGACCGTAGGAGGCCCCCCTGCCGAGCGATTTGTGGTGGTAG	1	bc
AATAGCCGTC	GAAACACCGGTGTACGTATGGACTGAACCAGGGTGTGCAAGTGGGGTTAG	1	bc
ACTTAAGAGC	GAAACACCGGTCGGGGCCTCTCAGTGGTGGGGTTAGAGCTAGAAATAGCA	1	bc
AACAACTACC	GAAACACGGGTTAGAGCTAGAAATAGCAAGTTAACCTAAGGCTAGTCCGT	1	bc
CAAAACGAGC	GAAACACCGGTTTGAACTACCTAGTTCAAACACCGGTTTGAACTACCTAG	1	bc
AAGGCTTAGC	GAAACACCGGTTTACGTTGCATCGGGGTTAGAGCTAGAAATAGCAAGTTA	1	bc
GGCCTGCCTT	GAAACACCGGTCCGTAGGAGACCCGTGTGGCATGTACCTGTGGGGTTAGA	1	bc
TCGTCTGCCT	GAAACACCGGTCCGTAGGAGACCCGTGTGGCATGTACCTGTGGGGTTAGA	1	bc
AGACTGACTA	GAAACACCGGTCCGTAGGAGACCCGTGTGGCATGTACCTGTGGGGTTAGA	1	bc
GGGACGTACT	GAAACACCGGTAAATTTGAGGCTCCGGCATGCAGGAGGCCGTGGGGTTAG	1	bc
AGTGGATCCT	GAAACACCGGTTCCCGTCCAGTGGGGTTAGAGCTAGAAATAGCAAGTTAA	1	bc
GAGGGTTTGC	GAAACACCGGTCGGCGGCAATCGTGGGTGGGGTTAGAGCTAGAAATAGCA	1	bc
ATTTAGATAT	GAAACACCGGTTACATTGAGGGTTAGAGCTAGAAATAGCAAGTTAACCTA	1	bc
ATGGGCATAC	GAAACACCGGTTAAGCCGAGGAGTTTCGTTAGAGCTAGAAATAGCAAGTT	1	bc
AGGTGGAGCC	GAAACACCGGTTCCCGTCCAGTGGGGTTAGAGCTAGAAATAGCAAGTTAA	1	bc
AATAATCGGC	GAAACACCGGTACCTTTGTTGATGCTGGGTGGAGCTAGAAATAGCAAGTT	1	bc
AGACAGACTC	GAAACACCGGTCCGTAGGAGACCCGTGTGGCATGTACCTGTGGGGTTAGA	1	bc
AGTGGTACCG	GAAACACCGGTCGGCGGGGTTAGAGCTAGAAATAGCAAGTTAACCTAAGG	1	bc
GGGGCTCTTC	GAAACACCGGTGTGGCTGAGAGTCCGGCAATGGTGTGGCTAGGGGGTTAG	1	bc
ATTATCTATG	GAAACACCGGTTACATTGAGGGTTAGAGCTAGAAATAGCAAGTTAACCTA	1	bc
AGAGTTGGGT	GAAACACCGGTCGATTCATATCGAAACCTTCCCGTGACAGTGGGGTTAGA	1	bc
GGGAAGCTCC	GAAACACCGGTGTGGGTGAGAGGCCGGTAATGCCGGGGCTGGCGGGTTAG	1	bc
GGGCGCCTAC	GAAACACCGGTAAATTTGAGGCTCCGGCATGCAGGAGGCCGTGGGGTTAG	1	bc
GAACAACGAC	GCTAGAAATAGCAAGTTAACCTAAGGCTAGTCCGTTATCAACTTGAAAAA	1	bc
AGGCACACGC	CAAAACACCGGAGCATTCGAGAGTCCTGTCGTAGTGTGGACGTGGGGATA	1	bc
GGAATCATCC	GAACCACCGGTGTGGCTGAGAGTCCGGCAATGGTGTGGCTGTGGGGTTAG	1	bc
AATAGCGCCC	GAAACACCGGTTTGAACTACCTAGTTCAAACCGGTGGGGTTAGAGCTAGA	1	bc
AGCTTACTCC	GAAACACCGGTGTGGCTGAGTGTCCGGCAGGGGTGTGGCTGGGGGGATAG	1	bc
CGAATATCTG	GAAACACCGGTCTCGAGTGAGGCGTTCAGGGCGGGGTTAGAGCTAGAAAT	1	bc
ACCTTTTCCT	GAAACACCGGTCGGGGCCACTCAGTGGTGGGGTTAGAGCTAGAAATAGCA	1	bc
CGAGCGCTAC	GAAACACCGGTTCCCTTACTCTCACCTGATTACTTAATCCGTGGGGTTAG	1	bc
GACAAAGATC	GAAACACCGGTAGCAAGTGCGGGGTTAGAGCTAGAAATAGCAAGTTAACC	1	bc
CAGATAGAGA	GAAACACCGGTAGCAAGTGCGGGGTTAGAGCTAGAAATAGCAAGTTAACC	1	bc
GCGGGTTGTC	GAAACACCGGTGACATTGGGTATGGGGTTAGAGCTAGAAATAGCAAGTTA	1	bc
GGGCGGCTCC	GAAACACCGGTGTGGCTGAGAGTCCGGCGATGGTGTGGCTGAGGTGGTAG	1	bc
CGCCTACCTC	GAAACACCGGTCAGTACGAGGCCCGTGTGGCATGTACCTGGGGAGATAGA	1	bc
CGATCGACGC	GAAACACCGGTTTACGTTGCATCGGTTGTGGGGTTAGAGCTAGAAATAGC	1	bc
ATCTAGGGAG	GAAACACCGGTTATATTTGTATAACTGTTATACAACTTGTTATATAACTG	1	bc
TACCCTAGGT	GAAACACCGGTTACATTGGGGTTAGAGCTAGAAATAGCAAGGTAACCTAA	1	bc
GACATTAGGT	GAAACACCGGTCGATTCATATCGAAACCTTCCCGTGACAAGTGGGGTTAG	1	bc
AAAGATCTAC	GAAACACCGGTGCCCTTACTCTCACCTGATTACTTAATCCGTGGGGTTAG	1	bc
GTTGTGCATA	GAAACACCGGTTAAGCCGAGGACTAGAAATAGCAAGTTAACCTAAGGCTA	1	bc
GTACACGATA	GAAACACCGGTAAATTTGAGTCTCCGGCATGCAGGAGGCGTGGGGTTAGA	1	bc
AGTCGTAATC	GAAACACCGGTCCGTAGGAGACCCGTGTGGCATGTACCTGGGGTTAGAGC	1	bc
CAGAAAGCCA	GAAACACGGGTTAGAGCTAGAAATAGCAAGTTAACCTAAGGCTAGCCCGT	1	bc
GCACAACGCA	GAAACACCGGTTTGAACTAGAAATAGCAAGTTAACCTAAGGCTAGTCTGT	1	bc
TGAACCCTAC	GAAACACCGGTGTGGCTGAGAGTCCGGCAATGGTGTGGCTGTGGGGTTAG	1	bc
CGATGCTTAG	GAAACACCGGTTTACGTTGCATCGGTGTGGGGTTAGAGCTAGAAATAGCA	1	bc
TAGACCCTCA	GAAACACCGGTTAAGCCGAGGGATAGAGCTAGTAATAGCAAGTTAACATA	1	bc
GGCACATTCT	GAAACACCGGTGTGGCTGAGAGTCCGGCAATGGTGTGGCTGTGGGGTTAG	1	bc
GTGGGGCTAC	GAAACACCGGTTAAGGCGCGGAGTGGGTACTGGTAATAATAGCATAACAT	1	bc
CCTCTCGCCC	GAAACACCGGTTATATTTGTAAGTGTTGTGGGGTTAGAGCTAGAAATAGC	1	bc
CGGATTAGCT	GAAACACCGGTTTACGTTGCATCGGTGTGGGGTTAGAGCTAGAAATAGCA	1	bc
ATTAGCTGTG	GAAACACCGGTTACATTGAGGGTTAGAGCTAGAAATAGCAAGTTAACCTA	1	bc
GATACTCGGA	CAAAACACCGGTACCTTTGTTGATGCTGGGTGGAAGGAATTTGTGGGGTT	1	bc
AGCTTTACCG	GGAACACCGGTCGGGGCCACTCAGTGGTGGGGTTAGAGCTAGAAATAGCA	1	bc
AACACCCTCT	GAAACACCGGTGACCATACTCTCACCTGATTACTTAATCCGTGGGGTTAG	1	bc
TCTCGCGGGG	GAAACACCGGTTATATTTGTAAAGAGCTAGAAATAGCAAGTTAACCTAAG	1	bc
TAAGAAACGC	GAAACACCGGTCGGCGGCCGGTTAGAGCTAGAAATAGCAAGTTAACCTAA	1	bc
CGAGTCCTCC	GAAACACCGGTCTCGAGTGAGGTGTTCAGGGTGGGGTTAGAGCTAGAAAT	1	bc
AGGCCCCGAC	GAAACACCGGTAAATTTGAGGCTCCGGCATGCAGGAGGCCGTGGGGTTAG	1	bc
GTGGAGGTTT	GAAACACCGGTTCCCGTCCAGTGGGGTTAGAGCTAGTAATAGCAAGTTAA	1	bc
GGGACCATCA	GAAACACCGGTGTGGCTGAGAGTCCGGCAATGGTGTGGCTGTGGGGTTAG	1	bc
GGAGTCTGTC	GAAACACCGGTCCGTAGGAGACCCGTGTGGCATGTACCTGTGGGGTTAGA	1	bc
GAGGGACCCC	GAAACACCGGTCGGTGTGGTTACAGCTAGAGATAGCATATTGACCTAAGT	1	bc
