AAAAACGCCA	GAAACACCGGTTTGAACTACCGGGGTTAGAGCTAGAAATAGCAAGTTAAC	1
AAAAACTCTC	GAGCTAGAAATAGCAAGTTAACCTAAGGCTAGTCCGTTATCAACTTGAAA	1
AAAACACCGC	GAAACACCGGTTTGAACTAGAAATAGCAAGTTAACCTAAGGCTAGTCCGT	1
AAAACATGCA	GAAACACCGGTAAATTTGAGGCTCCGGCATGCAGGAGGCCGTGGGGTTAG	1
AAAAGCACTA	GAAACACCGGTGCCCTTACTCTCACCTGATTACTTAATCCGTGGGGTTAG	2
AAAAGCCCTA	GAAACACCGGTGCCCTTACTCTCACCTGATTACTTAATCCGTGGGGTTAG	1
AAAAGCCGAC	GAAACACCGGTGCATTCGAAAGTCCGGTCGTAGTGTGGACGTGGGGTTAG	1
AAAATGACTC	GAAACACCGGTCCGTAGGAGACCCGTGTGGCATGTACCTGTGGGGTTAGA	1
AAAATTCGGT	GAAACACCGGTCGATTCATATCGAAACCTTCCCGTGACAGTGGGGTTAGA	3
AAAATTCGGT	GAAACACCGGTCGATTCATATCGAAGCCTTCCCGTGACAGTGGGGTTAGA	1
AAAATTGCCA	GAAAAACAGGTTTGGGGTTAGAGCTAGAAATAGCAAGTTAACCTAAGGCT	1
AAACAACGAC	GAAACACCGGTTTGAACTACCTTAGAGCTAGAAATGGCAAGTTAACCTAA	1
AAACAACGCC	GAAACACCGGTTTGAACTAGAAATAGCAAGTTAACCTAAGGCTAGTCCGT	2
AAACAACGCC	GAAACACCGGTTTGAACTACCGGGGTTAGAGCTAGAAATAGCAAGTTAAC	1
AAACAACGCC	GAAACACCGGTTTGAACTACCTGGGGTTAGAGCTAGAAATAGCAAGTTAA	1
AAACAACGCC	GAAACCCGGGTTAGAGCTAGAAATAGCAAGTTAACCTAAGGCTAGTCCGT	1
AAACAACGCC	GCTAGAAATAGCAAGTTAACCTAAGGCTAGTCCGTTATCAACTTGAAAAA	1
AAACAATGTA	GCTAGAAATAGCAAGTTAACCTAAGGCTAGTCCGTTATCAACTTGAAAAA	1
AAACACGCCC	GTGGGGTTAGAGCTAGAAATAGCAAGTTAACCTAAGGCTAGTCCGTTATC	1
AAACCCATCG	GAAACACCGGTGCATTCGAAAGTCCGGTCGTAGTGTGGACGTGGGGTTAG	1
AAACCCTGGA	GAAACACCGGTGCATTCGAAAGTCCGGTCGTAGTGTGGACGTGGGGTTAG	1
AAACCTCGGT	GAAAGTTAACCTAAGGCTAGTCCGTTATCAACTTAAAACAGGGGCAACGA	1
AAACGACATA	GAAACACCGGTGCCCTTACTCTCACCTGATTACTTAGTCCGTGGGGTTAG	1
AAACGACCTA	GAAACACCGGTGCCCTTACTCTCACCTGATTACTTAATCCGTGGGGTTAG	2
AAACGCAATA	GAAACACCGGTGCCCTTACTCTCACCTGATTACTTAATCCGTGGGGTTAG	1
AAACGCACAA	GAAACACCGGTGCCCTTACTCTCACCTGATTACTTAATCCGTGGGGTTAG	1
AAACGCAGTC	GAAACACCGGTGCCCTTACTCTCACCTGATTACTTAATCCGTGGGGTTAG	1
AAACGCCATT	GAAACACCGGTAACTATATTCATGCGATATCGCCGTATCAGTGGGGTTAG	1
AAACGCCGTA	GAAACACCGGTGCCCTTACTCTCACCTGATTACTTAATCCGTGGGGTTAG	1
AAACTCACGC	GAAACACCGGTGCATTCGAAAGTCAGGTCGTAGTGTGGACGCGGGGTTAG	1
AAACTCCCTA	GAAACACCGGTGCCCTTACTCTCACCTGATTACTTAATCCGTGGGGTTAG	1
AAAGAACCTG	GAAACACCGGTGCATTCGAAAGTCCGGTCGTGGTGTGGACGTGGGGTTAG	1
AAAGAACTAC	GAAACACCGGTGCCCTTACTCTCACCTGATTACTTAATCGTGGGGTTAGA	1
AAAGACCTAT	GAAACACCGGTGCCCTTACTCTCACCTGATTACTTAATCCGTGGGGTTAG	1
AAAGAGACGC	GAAACACCGGTCGGCGGCAATCGTGGGTGGGGTTAGAGCTAGAAATAGCA	1
AAAGATTATA	ACTTGAAAAAGTGGCACCGAGTCGGTGCTTTTTTTCCTGCAGGGTATAAG	1
AAAGCAGTAC	GAAACACCGGTGCCCTTACTCTCACCTGATTACTTAATCCGTGGGGTTAG	1
AAAGCCAGCC	GAAACACCGGTGCGCTTACTCTCACCTGATTACTTAATCCGGGGGGATAG	1
AAAGCCGAAC	GAAACACCGGTGCCCTTACTCTCACCTGATTACTTAATCCGTGGGGTTAG	1
AAAGCCTGAC	GAAACACCGGTGCCCTTACTCTCACCTGATTACTTAATCCGTGGGGTTAG	1
AAAGGACCTA	GAAACACCGGTGCCCTCACTCTCACCTGATTACTTAATCCGTGGGGTTAG	1
AAAGGACTAC	GAAACACCGGTTCCCTTACTCTCACCTGATTACTTAATCCGTGGGGTTAG	1
AAAGGACTCG	GAAACACCGGTTTACGTTGCATCGGGTTAGAGCTAGAAATAGCAAGTTAA	1
AAAGGCATAC	GAAACACCGGTGCCCTTACTCTCACCTGATTACTTAATCCGTGGGGTTAG	1
AAAGGCCCTA	GAAACACCGGTGCCCTTACTCTCACCTGATTACTTAATCCGTGGGGTTAG	1
AAAGGCCTTA	GAAACACCGGTGCCCTTACCCTCACCTGATTACTTAATCCGTGGGGTTAG	1
AAAGGCGGTT	GAAACACCGGTCGATTCATATCGAAACCTTCCCGTGACAGTGGGGTTAGA	1
AAAGTCCCCC	GAAACACCGGTGCCCTTACTCTCACCTTATTACTTTATCCGTGGGGTTAG	1
AAAGTCGTAC	GAAACACCGGTGCCCTTACTCTCACCTGATTACTTAATCCGTGGGGTTAG	1
AAAGTGACAT	GAAACACCGGTGCCCTTACTCTCACCTGATTACTGAATAGGTGGGGATAG	1
AAAGTTCGGT	GAAACACCGGTCGATTCATATCGAAACCTTCCCGTGACAGTGGGGTTAGA	1
AAATAACGCT	GCTAGAAATAGCAAGTTAACCTAAGGCTAGTCCGTTATCAACTTGAAAAA	1
AAATACGCCC	GAGCTAGAAATAGCAAGTTAACCTAAGGCTAGTCCGTTATCAACTTGAAA	1
AAATACGGTC	GAAACACCGGTCGATGGATATCGAAACCTTGCCGTGAGAAGTAGAGATAG	1
AAATATCGAG	GAAACACCGGTTATATTTGTAAGTGTGTGGGGTTAGAGCTAGAAATAGCA	1
AAATCCAAGG	GAAACACCGGTGCATTCGAAAGTCCGGTCGTAGTGTGGACGTGGGGTTAG	1
AAATCCGGAC	GAAACACCGGTCGATTCATTTCGAAATGTTCCCGTAACGGGGGGGTTAAA	1
AAATCGTCGT	GAAACACCGGTGTACGTATGGACTGAACCAGGGCGTGCAAGTGGGGTTAG	1
AAATCGTCGT	GAAACACCGGTGTACGTATGGACTGAACCAGGGTGTGCAAGTGGGGTTAG	1
AAATCTCAAC	GAAACACCGGTGCAATCGAAAGTCCGGTCGTAGTGTGGTCATGGGGGTCG	1
AAATGGGTAT	GAAACACCGGTCGATTTTTATCGAAAGCTTCGCGAGAGCGTGGGGTTAGA	1
AAATGTCCTA	GAAACACCGGTGCCCTTACTCTCACCTGATTACTTAATCCGTGGGGTTAG	1
AAATTCTGCT	GAAACACCGGTCGATTCATATCGAAACCTTCCCGTGACAGTGGGGTTAGA	1
AAATTCTGTG	GAAACACCGGTCGATTCATATCGAAACCTTCCCGTGACAGTGGGGTTAGA	1
AAATTTACCG	GAAACACCGGTCGGGGCCACTCAGTGGTGGGGTTAGAGCTAGAAATAGCA	2
AAATTTAGAC	GAAACACCGGTAACTATATTCATGCGATATCGCCGTATCAGTGGGGTTAG	1
AACAAAGACC	GAAACACCGGTTTGAACTAGAAATAGCAAGTTAACCTAAGGCTAGTCCGT	1
AACAACGAAC	GAAGCACCGGTAGCAAGTGCGGGGTTAGAGCTAGAAATAGCAAGTTAACC	1
AACAACGCAA	GAAACACCGGTTTGAACTACCTGGGGTTAGAGCTAGAAATAGCAAGTTAA	1
AACAACGCAA	GAAACACGGGTTAGAGCTAGAAATAGCAAGTTAACCTAAGGCTAGTCCGT	1
AACAATCGGT	GAAACACCGGTCGATTCATATCGAAACCTTCCCGTGACAGCGGGGTTAGA	1
AACACAACGC	GAAACACCGGTTTGAACTAGAAATAGCAAGTTAACCTAAGGCTAGTCCGT	1
AACACAACGC	GAAACACCGGTTTGGGGTTAGAGCTAGAAATAGCAAGTTAACCTAAGGCT	1
AACACCTAAC	GAAACACCGGTTTGAACTACCTTGGAGTTGGGATAGGCAAGTTAATCGAA	1
AACACGGCCA	GAAACACCGGTTTGAACTACCGGGGTTAGAGCTAGAAATAGCAAGTTAAC	1
AACACGGCCC	GAAACACCGGTTTGAACTACCTAGTTCAAAGAGCTAGAAATAGCAAGTTA	1
AACAGTCGGT	GAAACACCGGTCGATTCATATTGAAACCTTCCCGTGACAGTGGGGTTAGA	1
AACAGTCGGT	GAAACACCGGTCGATTCATATCGAAACCTTCCCGTGACAGTGGGGTTAGA	1
AACATACAGT	GAAACGCCGGTCGATTCATATCGAAACCTTCCCGTGACAGTGGGGTTAGA	1
AACATACGGC	GAAACACCGGTCGATTCATATCGAAACCTTCCCGTGACAGTGGGGTTAGA	1
AACATACTAC	GAAACACCGGTGCCCTTACTCTCACCTGATTACTTAATCCGTGGGGTTAG	1
AACATCCTTC	GAAACACCGGTGCCCTTACTCTCACCTGATTACTTAATCCGTGGGGTTAG	1
AACATCGACG	GAAACACCGGTGTACGTATGGACTGAACCAGGGTGTGCAAGTGGGGTTAG	1
AACATCGCAC	GAAACACCGGTTTGAACTAGAAATAGCAAGTTAACCTAAGGCTAGTCCGT	1
AACATCGGTA	GAAACACCGGTCGATTCATATCGAAACCTTCCCGTGCCAGTGGGGTTAGA	1
AACATGCGGG	GAAACACCGGTCGATTCATATCGAAACCTTCCCGTGAAGGTTTCGTGGGG	1
AACATTAGGG	GAAGCACCGGTCGATCCATATCGAAACCTTCCCGTGACAGTGGGGTTAGA	1
AACATTAGGT	GAAACACCGGTCGATTCATATCGAAACCTTCCCGTGACAGTGGGGTTAGA	1
AACATTCGGA	GAAACACCGGTCGATTCATATCGAAACCTTCCCGTGACAGTGGGGTTAGA	2
AACCAGCCCG	GAAACACCGGTTTGAATAGCTAGAAATAGCAAGTTAACCTAGGGCTAGTC	1
AACCTAGATC	GAAACACCGGTCGGGGCCACTCAGTGGTGGGGTTAGAGCTAGAAATAGCA	1
AACCTTTACA	GAAACACCGGTCGGGGCCACTCAGTGGTGGGGTTAGAGCTAGAAATAGCA	1
AACGAATCAT	GAAACACCGGTCTCGAGTGAGGTGTTCAGGGTGGGGTTAGAGCTAGAAAT	1
AACGACCGCC	GAAACACCGGTGCCCTTACTCTCACCTGATTACTTAATCCGTGGGGTTAG	1
AACGACCTCT	GAAACACCGGTGCCCTTACTCTCACCTGATTACTTAATCCGTGGGGTTAG	1
AACGACTAGC	GAAACACCGGTTTACGGTGCATCGTGGGGGTAGTACTAGTAGAAGCAAGA	1
AACGAGATAC	GAAACACCGGTGCCCTTACTCTCACCTGATTACTTAATCCGTGGGGTTAG	1
AACGATCGGT	GAAACACCGGTTACATTGAGGGTTAGAGCTAGAAATAGCAAGTTAACCTA	1
AACGCAACCC	GAAACGCCGGTGTGCTTACTCTGACCTGATTACTGAATCCGTAGGGTTAG	1
AACGCACAGC	GAAACACCGGTTCACGTTGCATCGGGGTTAGAGCTAGGAATAGCAAGTTA	1
AACGCCCTAC	GAAACACCGGTGCCCTTACTCTCACCTGATTACTTAATCCGTGGGGTTAG	2052
AACGCCCTAC	GAAACACCGGTGCCCTTACTCTCACCTGATTACTTAATCGTGGGGTTAGA	17
AACGCCCTAC	GAAACACCGGTGCCCTTACTCTCACCTGATTACTTAGTGGGGTTAGAGCT	13
AACGCCCTAC	GAAACAAAACCTAAGGCTAGTCCGTTATCAACTTGAAAAAGTGGCACCGA	8
AACGCCCTAC	GAAACACCGGTCTCGAGTGAGGTGTTCAGGGTGGGGTTAGAGCTAGAAAT	3
AACGCCCTAC	GAAACAAAACCTAAGGCCAGTCCGTTATCAACTTGAAAAAGTGGCACCGA	2
AACGCCCTAC	AGGGAGAAAAAACCGTGGCCTTTATTCTAACCGAATAATTAAATCGGGGG	1
AACGCCCTAC	CAAAACACCGGTGCCCTTACTCTCACCTGATTACTTAATCCGTGGGGTTA	1
AACGCCCTAC	GAAACACCGGGCCCTTACTCTCACCTGATTACTTAATCCGTGGGGTTAGA	1
AACGCCCTAC	GAAACACCGGTAAATTTGAGGCTCCGGCATGCAGGAGGCCGTGGGGTTAG	1
AACGCCCTAC	GAAACACCGGTAACTATACTCATGCGATATCGCCGTATCAGTGGGGTTAG	1
AACGCCCTAC	GAAACACCGGTACCCTTACTCTCACCTGATTAGTTGTTCCGTCTAGATAT	1
AACGCCCTAC	GAAACACCGGTACCTTTGTTGATGCTGGGTGGAAGGAATTTTTGTGGGGT	1
AACGCCCTAC	GAAACACCGGTACCTTTGTTGATGCTGGGTGGAAGGATTTTTGTGGGGTT	1
AACGCCCTAC	GAAACACCGGTACCTTTGTTGATGCTGGGTGGGGTTAGAGCTAGAAATAG	1
AACGCCCTAC	GAAACACCGGTCCCCTTCCTGTCGGGTTATAGCTTGATATAGCAAGTTAA	1
AACGCCCTAC	GAAACACCGGTCCGTAGGAGACCCGTGTGGCATGTACCTGTGGGGTTAGA	1
AACGCCCTAC	GAAACACCGGTCTCGAGTGAGGTGTTCAGGGGGGGGTTAGAGCTAGAAAT	1
AACGCCCTAC	GAAACACCGGTGCCCGTCCTCTCACCTGGGTGCTTGATCCAGGAGGATAA	1
AACGCCCTAC	GAAACACCGGTGCCCTACTCTCACCTGATTACTTAATCCGTGGGGTTAGA	1
AACGCCCTAC	GAAACACCGGTGCCCTTACTCTCAAATGATTACAGCACAGGGTGTGATAG	1
AACGCCCTAC	GAAACACCGGTGCCCTTACTCTCACCTGATACTTAATCCGTGGGGTTAGA	1
AACGCCCTAC	GAAACACCGGTGCCCTTCTCTCACCTGATTACTTAATCCGTGGGGTTAGA	1
AACGCCCTAC	GAAACACCGGTGCCTTACTCTCACCTGATTACTTAATCCGTGGGGTTAGA	1
AACGCCCTAC	GAAACACCGGTTACCTTACTCTCATCTAATTACTTATACCGAGGTAATAG	1
AACGCCCTAC	GAAACACCGGTTATATTTGTAAGTGTGTGGGGTTAGAGCTAGAAATAGCA	1
AACGCCCTAC	GAAACACCGGTTCCCGTCCAGTGGGGTTAGAGCTAGAAATAGCAAGTTAA	1
AACGCCGACC	GAAACACCGGTGCACTTACTCTCACCTGATTACTTAATCCGGGGGGTTAG	1
AACGCCTGAA	GAAACACCGGTGCCCTTACTCTCACCTGATTACTTAATCCGTGGGGTTAG	1
AACGCTACCG	GAAACACCGGTCGGGGCCACTCAGTGGTGGGGTTAGAGCTAGAAATAGCA	1
AACGCTCAGC	GAAACACCGGTTTACGTTGCATCGTTAGAGCTAGAAATAGCTAGAAATAG	1
AACGGAGTAC	GAAACACCGGTGCCCTTACTCTCACCTGATTACTTAATCCGTGGGGTTAG	1
AACGTACTTC	GAAACACCGGTGCCCTTATTCTCACCTGATTACGTAATACGTGGGGTAAG	1
AACGTCCACC	GAAACACCGGTGCCCTTACTCTCACCTGATTACTTAATCCGTGGGGTTAG	1
AACGTCCTTA	GAAACACCGGTGCCCTTACTCTCACCTGATTACTTAATCCGTGGGGTTAG	1
AACGTCGCCT	GAAACACCGGTTTGAACTAGAAATAGCAAGTTAACCCAAGGCTAGTCCGT	1
AACTATCGAG	GAAACACCGGTTATATTTGTAAGCGTGTGGGGTTAGAGCTAGAAATAGCA	1
AACTCACGAC	GAAACACCGGTGCCCTTACTCTCACCTGATTACTTAATCCGTGGGGTTAG	1
AACTCGGACC	GAAACACCGGTAGCAAGTGCGAGACGTGTTAAATAGCAAGTTAACCTAAG	1
AACTCGTCGT	GAAACACCGGTGTACGTATGGACTGAAACAGGGTGTGCAAATAGCAAGTT	1
AACTCTCAAC	GAAACACCGGTGCCCTTACTCTCACCTGATTACTTAATCCGTGGGGTTAG	1
AACTTCGGCT	GAAACACCGGTCGATTCATATCGAAACCTTCCCGTGACAGTGGGGTTAGA	1
AACTTTACCG	GAAACACCGGTCGGGGCCACTCAGTGGTGGGGTTAGAGCTAGAAATAGCA	5
AACTTTACCG	GAGACACCGGTCGGGGCCACTCAGTGGTGGGGTTAGAGCTAGAAATAGCA	1
AAGAAACTCG	GAAACACCGGTGCATTCGAAAGTCCGGTCGTAGTGTGGACGTGGGGTTAG	1
AAGAACCTCG	GAAACACCGGTGCATTCGAAAGTCCGGTCGTAGTGTGGACGTGGGGTTAG	6
AAGAACCTCG	GAAACACCGGTGCATTCGAAAGTCCGGTCGTAGTGTGGACGTGGGGATAG	1
AAGAATACTT	GAAACACCGGTCTCGAGTGAGGTGTTCAGGGGTGGGGTTAGAGCTAGAAA	1
AAGAATCCGT	GAAACACCGGTCTCGAGTGAGGTGTTCAGGGTGGGGTTAGAGCTAGAAAT	1
AAGAATCCTT	GAAACACCGGTCTCGAGTGAGGTGTTCAGGGTGGGGTTAGAGCTAGAAAT	1
AAGAATCGTT	GAAACACCGGTCTCGAGCGAGGTGTTCAGGGTGGGGTTAGAGCTAGAAAT	1
AAGAATGCCC	GAAACACCGGTTTGAACTAGAAATAGCAAGTTAACCTAAGGCTAGTCCGT	1
AAGACACCCG	GAAACACCGGTGCATTCGAAAGTCCGGTCGTAGTGTGGACGTGGGGTTAG	1
AAGACACTCG	GAAACACCGGTGCATTCGAAAGTCCGGTCGTAGTGTGGACGTGGGGTTAG	4
AAGACCATAG	GAAACACCGGTGCATTCGAAAGTCCGGTCGTAGTGTGGACGTGGGGTTAG	1
AAGACCATCG	GAAACACCGGTGCATTCGAAAGTCCGGTCGTAGTGTGGACGTGGGGTTAG	1
AAGACCCTAG	GAAACACCGGTGCATTCGAAAGTCCGGTCGTAGTGTGGACGTGGGGTTAG	1
AAGACCCTAG	GAAACACCGGTGCATTCGGAAGTCCGGTCGTAGTGTGGACGTGGGGTTAG	1
AAGACCCTGG	GAAACACCGGTGCATTCGAAAGTCCGGTCGTAGTGTGGACGTGGGGTTAG	1
AAGACCGCCT	GAAACACCGGTCCGTAGGAGACCCGTGTGGCATGTACCTGTGGGGTTAGA	1
AAGACCGTCG	GAAACACCGGTGCATTCGAAAGTCCGGTCGTAGTGTGGACGTGGGGTTAG	1
AAGACTGCCA	GAAACACCGGTCCGTAGGAGACCCGTGTGGCATGTACCTGTGGGGTTAGA	1
AAGACTGCGT	GAAACACCGGTTATATTTGTAAGTGTGTGGGGCTAGAGCTAGAAATAGCA	1
AAGAGCCCTG	GAGACACCGGTGCATTCGAAAGTCCGGTCGTAGTGTGGACGTGGGGTTAG	1
AAGAGCCTAC	GAAACACCGGTGCCCTTACTCTCACCTGATTACTTAATCCGTGGGGTTAG	1
AAGAGCCTCG	GAAACACCGGTGCATTCGAAAGTCCGGTCGTAGTGTGGACGTGGGGTTAG	1
AAGAGTAACG	GAAACACCGGTGCATTCGAAAGTCCGGTCGTAGTGTGGACGTGGGGTTAG	1
AAGAGTAGGG	GAAACACCGGTCGATTCATATCGAAACCTTCCCGTGACAGTGGGGTTAGA	1
AAGATAGTCG	GAAACACCGGTGCATTCGAAAGTCCGGTCGGAGTGTGGACGTGGGGATAG	1
AAGATCCTCG	GAAACACCGGTACAATCGAAAGTCTGGTCGTAGTGTGGACGTGGGGAAAG	1
AAGCACCCTC	GAAACACCGGTGTGGCTGAGAGTCCGGCAATGGTGTGGCTGTGGGGTTAG	1
AAGCACCGTC	GAAACACCGGTTCCCGTCCAGTGGGGTTAGAGCTAGAAATAGCAAGTTAA	1
AAGCCACTCG	GAAACACCGGTGCATTCGAAAGTCCGGTCGTAGTGTGGACGTGGGGTTAG	1
AAGCGATGTC	GAAACACCGGTGACATTGGGGCTAGAAATAGCAAGTTAACCTAAGGCTAG	1
AAGCGCCGTC	GAAACACCGGTGTACGTATGGACTGAACCAGGGTGTGCAAGTGGGGTTAG	1
AAGCGGACTC	GAAACACCGGTCCGTAGGAGACCCGTGTGGCATGTACCTGTGGGGTTAGA	1
AAGCGTAGTC	GAAACACCGGTGTACGTATGGACTGAACCAGGGTGTGCAAGTGGGGTTAG	1
AAGCTAAGAT	GAAACACCGGTTTAAGTTGCTTCGTGGTAGGGCTAGATATAGCAAGATAA	1
AAGGACCAAC	GAAACACCGGTGCCCTTACTCTCACCTGATTACTTAATCCGTGGGGTTAG	1
AAGGAGCCGC	GAAACACCGGTTCCCGTCCAGTGGGGTTAGAGCTAGAAATAGCAAGTTAA	1
AAGGATTAGC	GAAACACCGGTTTACGTTGCATCGGTGTGGGGTTAGAGCTAGAAATAGCA	1
AAGGCCAAAC	GAAACACCGGTCCCCTTACCCTCACCTCATGACTTATTACGGTTAGCAAT	1
AAGGCCATCC	GAAACACCGGTGCCCTTACTCTCACCTGATTACTTAATCCGTGGGGTTAG	1
AAGGCCCGCC	GAAACACCGGTGCCCTTACTCTCACCTGATTACTTAATCCGTGGGGTTAG	1
AAGGCCCTGT	GAAACACCGGTGCCCTTACTCTCACCTGATTACTTAATCCGTGGGGTTAG	1
AAGGCGATAC	GAAGCACCGGTGCCCTTACTCTCACCTGATTACTTAATCCGTGGGGTTAG	1
AAGGCGGATC	GAAACACCGGTACCACGCACATCAGGAGTAGTGGAGTTAGAGCTAGAAAT	1
AAGGCTGACT	GAAACACCGGTCCGTAGGAGACCCGTGTGGCATGTACCTGAGGGGTTAGA	1
AAGGCTGCCT	GAAACACCGGTCCGTAGGAGACCCGTGTGGCATGTACCTGTGGGGTTAGA	1
AAGGCTGCGT	GAAACACCGGTCCGTAGGAGACCCGTGTGGCATGTACCTGTGGGGTTAGA	1
AAGGCTTAGC	GAAACACCGGTTTACGTTGCATCGGTGTGGGGTTAGAGCTAGAAATAGCA	1
AAGGGAGCCT	GAAACACCGGTTCCCGTCCAGTGGGGTTAGAGCTAGAAATAGCAAGTTAA	1
AAGGGTCCTG	GAAACACCGGTCAGTAGGAAACGCTTGCTGTTGTGGGGTTAGATCTAGAA	1
AAGGGTTGTC	GAAACACCGGTGACATTAGAGCTAGAAATAGCAAGTTAACCTAAGGCTAG	1
AAGGTGGATC	GAAACACCGGTCCGTATCAGACCGGGGTGACAGGTGCTATAGCGAGATAT	1
AAGGTTGTAC	GAAACACCGGTAACTGTATTCATGCGATATCGCCGTATCAGTGGGGGTAG	1
AAGTATGCAT	GAAACACCGGTCCGTAGGAGACCCGTGTGGCATGTACCTGTGGGGTTAGA	1
AAGTATGCCT	GAAACACCGGTCCGTAGGAGACCCGTGTGGCATGTACCTGTGGGGTTAGA	2
AAGTATGCCT	GAAACACCGGTCCGTAGGAGACCCGTGTGGCATGTTAGGGGTTAGAGCTA	1
AAGTATGCTT	GAAACACCGGTCCGTAGGAGACCCGTGTGGCATGTACCTGTGGGGTTAGA	1
AAGTCGGCCT	GAAACACCGGTCCGTAGGAGACCCGTGTGGCATGTACCTGTGGGGTTAGA	1
AAGTCTGACT	GAAACACCGGTCCGTAGGAGACCCGTGTGGCATGTACCTGTGGGGTTAGA	3
AAGTCTGCAT	GAAACACCGGTCCGTAGGAGACCCGTGTGGCATGTACCCGTGGGGTTAGA	1
AAGTCTGCGT	GAAACACCGGTCCGTAGGAGACCCGTGTGGCATGTACCTGTGGGGTTAGA	2
AAGTCTGGCT	GAAACACCGGTCCGTAGGAGACCCGTGCGGCATGTACCTGTGGGGTTAGA	1
AAGTCTGTAT	GAAACACCGGTCCGTAGGAGACCCGTGTGGCATGTACCTGTGGGGTTAGA	1
AAGTCTGTCT	GAAACACCGGTCCGTAGGAGACCCGTGTGGCATGTACCTGTGGGGTTAGA	1
AAGTCTGTCT	GAAACACCGGTCCGTAGGAGACCCGCGTGGCATGTACCTGTGGGGTTAGA	1
AAGTGATGAC	GAAACACCGGTGACATTGGGTCGGAGAAATAGCAAGTTAACCTAAGGCTA	1
AAGTGTCGTC	GAAGCACCGGTGTACGTATGGACTGAACCAGGGTGTGCAAGTGGGGTTAG	1
AAGTGTGCCG	GAAACACCGGTCCGTAGGAGACCCGTGTGGCATGTACCTTGTGGGGTTAG	1
AAGTGTGCCT	GAAACACCGGTCCGTAGGAGACCCGTGTGGCATGTACCTGTGGGGTTAGA	1
AAGTGTTGTC	GAAACACCGGTGACATAGTGGGGTTAGAGCTAGAAATAGCAAGTTAACCT	1
AAGTGTTGTC	GAAACACCGGTGACATTGGGTACAGGGTGGGTTAGAGCTAGAAATAGCAA	1
AAGTGTTGTC	GAAACACCGGTGACATTGGGTACAAAAAGTGGGGTTAGAGCTAGAAATAG	1
AAGTTACCGC	GAAACACCGGTCGGGGCCACTCAGTGGTGGGGTTAGAGCTAGAAATAGCA	1
AATAAAGCGC	GAAACACGGGTTAGAGCTGTAAATAGCAAGGTAACGTGAGAGAAGTCCGA	1
AATAACGCGC	GAAACACCGGTTTGAACTAGAAATAGCAAGTTAACCTAAGGCTAGTCCGT	1
AATAAGGCCC	GAAACACCGGTTTGAACTACCTAGTTCAAACCGGTGGGGTTAGAGCTAGT	1
AATAATCGAC	GAAACACCGGTGTACGTATGGACTGAACCAGGGTGTGCAAGTGGGGTTAG	1
AATACAGCCC	GAAACACCGGCTAGTCCGATATCAACTTGGCAAAGAGGCGCCGGGTCGGA	1
AATACTCGGC	GAAACACCGGTACCTTTGTTGATGCTGGGTGGAAGGAATTTGGTGGGGTT	1
AATACTCGGC	GAAACACCGGTACCTTTGTTGATGCTGGGTGAAAGGAATTTGTGGGGTTA	1
AATACTCGGT	GAAACACCGGTACCTTTGTTGATGCTGGGTGGAAGGATTTTTTTGTGGGG	1
AATAGCTATG	GAAACACCGGTTACATTGAGTGGGGTCAGAGCTAGAAATAGCAAGTTAAC	1
AATAGTAGGC	GAAACACCGGTACCTTTGTTGATGCTGGGTGGAAGGAATGGCTAGAGCTA	1
AATAGTTTTG	GAAACACCGGTTACATTGAGATTGGGGTTAGAGCTAGAAATAGCAAGTTA	1
AATATCCACC	GAAACACCGGTACCTTTGTTGATGCTGGGTGGATAGGAATTCGGGCCCAT	1
AATATGCTTC	GAAACACCGGTCCGTAGGAGGCCCGTGTGGCATGTACCTGTGGGGTTAGA	1
AATATGGCTC	GAAACACCGGTCCGTAGGAGACCCGTGTGGCATGTACTTGTGGGGTTAGA	1
AATCAGCCCC	GAAACACCGGTCCGTAGGAGACCCGTGTGGCATGTACCTGTGGGGGTAGA	1
AATCCAGACA	GAAACACCGGTAGCAAGTGCGTGGGGTTAGAGCTAGAAATAGCAAGTTAA	1
AATCCCCCCC	GAAACACCGGTGCATTCGGAAGTCCGGTCGGAGTATGGCCGGGGGGATAG	1
AATCCTGAGC	GAAACACCGGTGATTGGGGTTAGAGCTAGAAATAGCAAGTTAACCTAAGG	1
AATCGTTTTC	GAAACACCGGTGTACGTATGGACTGAACCAGGGTGTGCAAGTGAGGTTAG	1
AATCTATCGA	GAAACACCGGTTATATTTGTAAGTGTGTGGGGTTAGAGCTAGAAATAGCA	1
AATCTCCTCC	GAAAAACCGGTGCCCTTACTCTCACCTGATTACTTAATCCGTGGGGTTAG	1
AATCTGCCCA	GAAACACCGGTCCGTAGGAGACCCGTGTGGCATGTACCTGTGGGGTTAGA	1
AATGAACTAC	GAAACACCGGTGCCCTTACTCTCACCTGATTACTTAATCCGTGGGGTTAG	1
AATGAGCATA	GAAACACCGGTTAAGCCGAGGTGGGGTTAGAGCTAGAAATAGCAAGTTAA	1
AATGATGAGC	GAAACACCGGTTTACGTTGCATCGGTGTGGGGTTAGAGCTAGAAATAGCA	1
AATGATTAGC	GAAACACCGGTTTACGTTGCATCGGTGTGGGGTTAGAGCTAGAAATAGCA	3
AATGATTAGC	GAAACACCGGTTTACGTTGCATCGGTTGTGGGGTTAGAGCTAGAAATAGC	1
AATGCAGAGC	GAAACACCGGTTTACGTTGCATCGGTGTGGGGTTAGAGCTAGAAATAGCA	1
AATGCATCGC	GAAACACCGGTTTACGTTGCATCGGTTGTGGGGTTAGAGCTAGGAATAGC	1
AATGCGGAGC	GGAACAACGGTTTACGTTGCATCGGTGTGGGGTTAGAGCTAGAAATAGCA	1
AATGCGTAGA	GAAACACCGGTTTACGTTGCATCGGTGTGGGGTTAGAGCTAGAAATAGCA	1
AATGCGTAGC	GAAACACCGGTTTACGTTGCATCGGGGTTAGAGCTAGAAATAGCAAGTTA	1
AATGCTTAGA	GAAACACCGGTTTACGTTGCGGTGGGGTTAGAGCTAGAAATAGCAAGTTA	1
AATGCTTCGC	GAAACACCGGTTCACGTTGCATCCGTGTGGGGTTAGAGCTAGAAATAGCA	1
AATGCTTCGC	GAAACACCGGTTTACGTTGCATCGGTGTGGGGTTAGAGCTAGAAATAGCA	1
AATGGTGAGC	GAAACACCGGTTTACGTTGCATCGGTGTGGGGTTAGAGATAGAAATAGCA	1
AATGTAGTCT	GAAACACCGGTGACATTGGGTACAGGGTGGGGTTAGAGCTAGAAATAGCA	1
AATGTCCGCT	GAAACACCGGTTTACTTAGCATCAGTTGGGGGTTAGATCTGGAAATATCA	1
AATGTTTAGC	GAAACACCGGTTTACGTTGCATCGGTGTGGGGTTAGAGCTAGAAATAGCA	2
AATTCTGCCT	GAAACACTGGTCCGTAGGAGACCCGTGTGGCATGTACCTGTGGGGTTAGA	1
AATTGAGTAT	GAAACACCGGTTAAGCCGAGGGGTTAGAGCTAGAAATAGCAAGTTAACCT	1
AATTTAAAGC	GGAACACCAAGTGGGGTTAGAGCTAGAAATAGCAAGTTAACCTAAGGCTA	1
AATTTACAGC	GAAACACCGGTCGGGGCCACTCAGTGGTGGGGTTAGAGCTAGAAATAGCA	1
AATTTACGCA	GAAACACCGGTCGGGGCCACTCAGTGGTGGGGTTAGAGCTAGAAATAGCA	1
AATTTTACCG	GAAACACCGGTCGGGGCCACTCAGTTAGAGCTAGAAATAGCAAGTTAACC	1
ACAAAACGAC	GAAACACCGGTTTGAACTAGAAATAGCAAGTTAACCTAAGGCTAGTCCGT	1
ACAAAACGCC	GAAACACCGGTTTGGGGTTAGAGCTAGAAATAGCAAGTTAACCTAAGGCT	1
ACAAAATCGC	GAAACACCGGTTCATTTGAAAGTCCGGTCGTAGTGTGGACGTGGGGATAG	1
ACAACCGACT	GAAACACCGGTTTGAACTACCTGTGGTTAGAGCTAGAGCTAGCAAGATAA	1
ACAACTAGGC	GAAACACCGGTACCTTTGTTGATGCTGGGTGGGGTTAGAGCTAGAAATAG	1
ACAACTTATA	GAAACACCGGTAACTATATTCATGCGATATCGCCGTATCAGTGGGGTTAG	2
ACAATTAACG	GAAACACCGGTCGGGGCCACTCAGTGGTGGGGTTAGAGCTAGAAATAGCA	1
ACACAAAGCA	GAAACACCGGTTTGAACTAGAAATAGCAAGTTAACCTAAGGCTAGTCCGT	1
ACACAACGAC	GAAACACCGGTTTGAACTACCTAGTTCAAACCGGTGGGGTTAGAGCTAGA	2
ACACAACGAT	GAAACACCGGTTTGAACTAGAAATAGCAAGTTAACCTAAGGCTAGTCCGT	1
ACACAACGCA	GAAACACCGGTTTGAACTAGAAATAGCAAGTTAACCTAAGGCTAGTCCGT	2
ACACAACGCA	GAAGCACCGGTTTGAACTAGAAATAGCAAGTTAACCTAAGGCTAGTCCGT	1
ACACAACGCA	GAGAGCTAGAAATAGCAAGTTAACCTAAGGCTAGTCCGTTATCAACTTGA	1
ACACAACGCA	GAAACACCGGTTTGAACTACCTAGTTCAAACCGGTGGGGTTAGAGCTAGA	1
ACACAACGCG	GAAACACCGGTTTGAACTAGAAATAGCAAGTTAACCTAAGGCTAGTCCGT	2
ACACAACGCT	GAAACACCGGTTTGAACTACCTAGTTCAAACCGGTGGGGTTAGAGCTAGA	1
ACACAACGCT	GAAACACCGGTTTGAACTAGAAATAGCAAGTTAACCTAAGGCTAGTCCGT	1
ACACAACGCT	GAAACACGGGTTAGAGCTAGAAATAGCAAGTTAACCTAAGGCTAGTCCGT	1
ACACAACGGC	GAAACACCGGTTTGAACCGGTGGGGTTAGAGCTAGAAATAGCAAGTTAAC	1
ACACAACGTC	GAAACACCGGTTTGAACTACCTAGTTCAAACCGGTGGGGTTAGAGCTAGA	1
ACACAACTCT	GAAACACCGGTTTGAATTACCTAGTTCAAACCGGTGGGGTTAGAGCTAGA	1
ACACACCGCA	GAAACACCGGTTTGAACTAGAAATAGCAAGTTAACCTAAGGCTAGTCCGT	1
ACACACGCGC	GAAACACTGGTTTGAACTAGAAATAGCAAGTTAACCTAAGGCTAGTCCGT	1
ACACAGCGCC	GAAACACCGGTTTGAACTAGAAATAGCAAGTTAACCTAAGGCTAGTCCGT	2
ACACATCGCG	GAAACACCGGTTTGAACTACCTAGTTCAAACCGGGTGGGGTTAGAGCTAG	1
ACACCACGCC	CAAAACACCGGTTTGAACTACCTAGTTCAAACCGGGTGGGGTTAGAGCTA	1
ACACCACGCC	GAAACACCGGTTTGAACTACCTAGTTCAAACCGGTGGGGTTAGAGCTAGA	1
ACACCGTCGT	GAAACACCGGTGTACGTATGGACTGAACCAGGGTGTGCAAGTGGGGTTAG	2
ACACGCCGTC	GAAACACCGGTTCCCTTACTCTCACCTGATTACTTAATCCGTGGGGTTAG	1
ACACTTAGGT	GAAACACCGGTCGATTCATATCGAAACCTTCCCGTGACAGTGGGGTTAGA	1
ACAGAAACGC	GAAACACCGGTCGGCGGGGTTAGAGCTAGAAATAGCAAGTTAACCTAAGG	1
ACAGAAGCGC	GAAACACCGGTCGGCGGCAATCGTGGGTGGGGTTAGAGCTAGAAATAGCA	1
ACAGAATGCT	GAAACACCGGTTTGAACTAGAAATAGCAAGTTAACCTAAGGCTAGTCCGT	1
ACAGACACGC	GAAACACCGGTCGGCGGCATGGGGTTAGAGCTAGAAATAGCAAGTTAACC	1
ACAGCCATGA	GAAACACCGGTTACATTGAGATTGGGGTTAGAGCTAGAAATAGCAAGTTA	1
ACAGCCCTAA	GACACACCGGTTCCCTGCGTCCCACCTGATTACTTAATCCGTGGGGTTAG	1
ACAGCCCTAT	GAAACACCGGTGCCCTTACTCTCACCTGATTACTTAATCCGTGGGGTTAG	1
ACAGCGACGT	GAAACACCGGTGTACGTATGGACTGAACCAGGGTGTGCAAGTGGGGTTAG	1
ACAGCGTCGT	GAAACACCGGTGTACGTATGGACTGAACCAGGGTGTGCAAGTGGGGTTAG	1
ACAGGTTGAT	GAAACACCGGTGACATTGGGTACGGGGGGGGGTTAGAGATAGATATAGCA	1
ACAGTACTAC	GAAACACCGGTGCCCTTACTCTCACCTGATTACTTAATCCGTGGGGTTAG	1
ACAGTCAGAT	GAAACACCGGTCGATTCATATCGAAACCTTCCCGTGACAGTGGGGTTAGA	1
ACAGTCGTAC	GAAACACCGGTGGACTTACTCTCACCTGATTACTTAATCCGTGGGGTTAG	1
ACAGTTGGTC	GAAACACCGGTCGATTCATATCGAAACCTTCCCGTGGCAGAGAGGTTAGA	1
ACATAAAGCA	GCTAGAAATAGCAAGTTAACCTAAGGCTAGTCCGTTATCAACTTGAAAAA	1
ACATAACGCA	GAAACACCGGTTAGAGCTAGAAATAGCAAGTTAACCTAAGGCTAGTCCGT	1
ACATAACGCC	GAAACACCGGTTTGAACTACCGGGGTTAGAGCTAGAAATAGCAAGTTAAC	1
ACATAGGCGT	GAAACACCGGTGTACGTATGGACTGAACCAGGGTGTGCAAGTGGGGTTAG	2
ACATAGTCGT	GAAACACCGGTGTACGTATGGACTGAACCAGGGTGTGCAAGTGGGGTTAG	3
ACATAGTTGT	GAAACACCGGTGTACGTATGGACTGAACCAGGGTGTGCAAGTGGGGTTAG	1
ACATCAGGGC	GAAACACCGGTGCATTCGAAATCCCGGTCGTAGTGGGGCTGGGGGTAGAG	1
ACATCGACGC	GAAACACCGGTGTACGTATGGACTGAACCAGGGTGTGCAAGTGGGGTTAG	1
ACATCGACGT	GAAACACCGGTGTACGTATGGACTGAACCAGGGTGTGCAAGTGGGGTTAG	1
ACATCGGCGT	GAAACACCGGTGTACGTATGGACTGAACCAGGGTGTGCAAGTGGGGTTAG	1
ACATCGGTGC	GAAACACCGGTGTACGTATGGACTGAACCAGGGTGTGCAAGTGGGGCTAG	1
ACATCGTAGT	GAAACACCGGTGTACGTATGGACTGAACCAGGGTGTGCAAGTGGGGTTAG	1
ACATCGTCGA	GAAACACCGGTGTACGTATGGACTGAACCAGGGTGTGCAAGTGGGGTTAG	1
ACATCGTCGG	GAAACACCGGTGTACGTATGGACTGAACCAGGGTGTGCAAATAGCAAGTT	1
ACATCTCTCG	GAAACACCGGTCGGGCCCACTCAGTGGTGGGGTTAGAGCTAGAAATAGCA	1
ACATCTGCGT	GAAACACCGGTGTACGTATGGACTGAACCAGGGTGTGCAAGTGGGGTTAG	1
ACATGACGCC	GAAACACCGGTTTGAACTAGAAATAGCAAGTTAACCTAAGGCTAGTCCGT	1
ACATTCGGTT	GAAACACCGGTCGATTCATATCGAAACCTTCCCGTGACAGTGGGGTTAGA	1776
ACATTCGGTT	GAAACACCGGTCGATTCATATCGAAACCTTCCCGTGACAAGTGGGGTTAG	99
ACATTCGGTT	GAAACACCGGTCGATTCATATCGAAACCTTCCCGTGAAGGTTTCGTGGGG	16
ACATTCGGTT	GAAACACCGGTCGATTCATATCGAAACCTTCCCGTGGGGTTAGAGCTAGA	16
ACATTCGGTT	GAAACACCGGTCGATTCATATCGAAACCTTCCCGTGACAAAGTGGGGTTA	10
ACATTCGGTT	CAAAACACCGGTCGATTCATATCGAAACCTTCCCGTGACAGTGGGGTTAG	9
ACATTCGGTT	GAAGCACCGGTCGATTCATATCGAAACCTTCCCGTGACAGTGGGTTAGAG	9
ACATTCGGTT	GAAACACCGGTCTCGAGTGAGGTGTTCAGGGTGGGGTTAGAGCTAGAAAT	2
ACATTCGGTT	GAAACACCGGTCAATTCTTGTCAAAACCGTCGTGTGAGCGATTGGTAGGG	1
ACATTCGGTT	GAAACACCGGTCCGTAGGAGACCCGTGTGGCATGTACCTCCTGTGGGGCT	1
ACATTCGGTT	GAAACACCGGTCCGTAGGAGACCCGTGTGGCATGTACCTGTGGGGTTGGA	1
ACATTCGGTT	GAAACACCGGTCGATTCATATCAAAACTTTCCCGAGCAAAGTGAGGTTAG	1
ACATTCGGTT	GAAACACCGGTCGATTCATATCGAAACCTTCCCGTCAGTGGGGTTAGAGC	1
ACATTCGGTT	GAAACACCGGTCGATTCATATCGAAACCTTCGCGTTACCAGTGGGGGTTA	1
ACATTCGGTT	GAAACACCGGTCGATTCATATCGAAGCCTTCCCTGACAGTGGGGTCAGAG	1
ACATTCGGTT	GAAACACCGGTCGATTCATATCGCGAGCTTCCCGTGACATAGGAGTTAGA	1
ACATTCGGTT	GAAACACCGGTCGCGGCATATCGAAACCTTCCCGTGACAGTGGGGGTAAT	1
ACATTCGGTT	GAAACACCGGTCGCTTCATGGCTTAGAGCTAGAAATAGCAAGGTAATCTA	1
ACATTCGGTT	GAAACACCGGTCGGCGGCAATCGTGGTCGTGGGTGGGGTTAGAGCTAGAA	1
ACATTCGGTT	GAAACACCGGTCGGGGCCACTCAGTGGTGGGGTTAGAGCTAGAAATAGCA	1
ACATTCGGTT	GAAACACCGGTGACATTGGGTACAGGGTGGGGTTAGAGCTAGAAATAGCA	1
ACATTCGGTT	GAAACACCGGTGCCCTTACTCTCACCTGATTACTTAATCCGTGGGGTTAG	1
ACATTCGGTT	GAAACACCGGTGGATGCATGGACTGAACCAGCGGGTGCAAGTGGGGTTAG	1
ACATTCGGTT	GAAACACCGGTGTGGCTGAGAGTCCGGCAATGGTGTGGCTGTGGGGTTAG	1
ACATTCGGTT	GAAACACCGGTTATATTTGTAAGTGTGTGGGGTTAGAGCTAGAAATAGCA	1
ACATTCGGTT	GAAACACCGGTTCCCGTCCAGTGGGGTTAGAGCTAGAAATAGCAAGTTAA	1
ACATTCGGTT	GAAACACCGGTTTACGTTGCATCGGGGTTAGAGCTAGAAATAGCAAGTTA	1
ACATTCGGTT	GAAACACGGTCGATTCATATCGAAACCTTCCCGTGACAGTGGGGTTAGAG	1
ACATTCGGTT	GAACACCGGTCGATTCATATCGAAACCTTCCCGTGACAGTGGGGTTAGAG	1
ACATTCGGTT	GAACCACCGGTCGATTCTTTTCGAAATCTTACCGTGACAGAGGGGTTAGA	1
ACATTTACCG	GAAACACCGGTCGGGGCCACTCAGTGGTGGGGTTAGAGCTAGAAATAGCA	3
ACATTTACCG	GAGACACCGGTCGGGGCCACTCAGTGGTGGGGTTAGAGCTAGAAATAGCA	1
ACATTTTGCA	GAAACACCGGTCGATTCATATCGAAACCTTCCCGTGACGGTTGGGGTTGA	1
ACCAAAGCAC	GAAACACCGGTTTGAACCTGGGGTTAGAGCTAGAAATAGCAAGTTAACCT	1
ACCAAAGCCC	GAAACACCGGTTTGAACTACCTGGGGTTAGAGCTAGAAATAGCAAGTTAA	1
ACCAACATAC	GAAACACCGGTTCCCTTACTCTCACCTGATTGCTTAATCTGTGAATATAG	1
ACCAACGCAC	GAAACACCGGTTTGAACTACCTAGGGGGTAGTTCAAACCGGGGTTAGAGC	1
ACCAACGCGA	GAAACACCGGTTGGAACTAGTAAGAGCAAGGTATCCTGATGCTGGTAGGA	1
ACCAAGGTTC	GAAACACCGGTTCCCGGCTAGTTCGGTTCTAGCGAGAAATAGCAAAGTAA	1
ACCAATCGGC	GAAACACCGGTACCTTTGTTGATGCTGGTGTGGGGTTAGAGCTAGAAATA	1
ACCACCCGGC	GAAACACCGGTACCTTTGTTGATGCTGGGTGGAAGGAATAGAAATAGCAA	1
ACCACTCGGC	GAAACACCGGTACCTTTGTTGATGCTGGGTGGGGTTAGAGCTAGAAATAG	1
ACCAGGAGGG	GAAACACCGGTCGTTTCTTATCGAAACCTTCGCTTGACAATAGAGTGCAA	1
ACCATCACCC	GAAACACCGGTGCTTTCCACTACGCAGTGGGGTTAGAGCTAGAAATAGAA	1
ACCATCGGTA	GAAACACCGGTCGATCTAAATCGAAACCTTCGCGGGACCGTGGGGGTAGA	1
ACCATTACCG	GAAACACCGGTCGGGGCCACTCAGTGGTGGGGTTAGAGCTAGAAATAGCA	1
ACCCAACGCC	GAAACACCGGTTTGAACTAGAAATAGCAAGTTAACCTAAGGCTAGTCCGT	1
ACCCCACCTC	GAAACACCGGTCCGTAGGAGACCCGTGTGGCATGTACCTGTGGGGTTAGA	1
ACCCTCCCGC	GAAACACCGGTGGATTGGAGAATCTGGTTGTAGTGGGTACGGGTGGAAAG	1
ACCCTTACCG	GAAACACCGGTCGGGGCCACTCAGTGGTGGGGTTAGAGCTAGAAATAGCA	1
ACCGACATAC	GAAACACCGGTGCCCTTACTCTCACCTGATTACTTAATCCGTGGGGTTAG	3
ACCGATACTT	GAAACACCGGTCTCGAGTGAGGAGTTCAGGGTGGGGTTAGAGCTAGAAAT	1
ACCGATCTAC	GAAACACCGGTGCCCTTACTCTCACCTGATTACTTAATCCGTGGGGTTAG	1
ACCGCCACAC	GAAACACCGGTGCCCTTACTCTCACCTGATTACTTAATCCGTGGGGTTAG	1
ACCGTAACAG	GAAACACCGGTCGGGGCCACTCAGTGGTGGGGTTAGAGCTAGAAATAGCA	1
ACCGTTGACG	GAAACACCGGTCGGGGCCACTCAGTGGTGGGGTTAGAGCTAGAAATAGCA	1
ACCGTTGGTT	GAAACACCGGTCGATTCATATCGAAACCTTCCCGTGACAGTGGGGTTAGA	1
ACCTATCGAG	GAAACACCGGTTATATTTGTAAGTGTTGTGGGGTTAGAGCTAGAAATAGC	1
ACCTCGTCGT	GAAACACCGGTGTACGTATGGACTGAACCAGGGTGTGCAAGTGGGGTTAG	2
ACCTCTGGTG	GAAACACCGGTCGATTCATATCGAAACCTTCCCGTGACAGTGGGGTTAGA	1
ACCTGTACAT	GAAACACCGGTCGGGGCCACTCAGTGGTGGGTTAGAGCTAGAAATAGCAA	1
ACCTTACAGC	GAAACACCGGTCGGGGCCACTCAGTGAGCTAGAAATAGCAAGTTAATAGC	1
ACCTTAGGTA	GAAACACCGGTCGATTCATATCGAAACCTTCCCGTGACAGTGGGGTTAGA	1
ACCTTCACCG	GAAACACCGGTCGGGGCCACTCAGTGGTGGGGTTAGAGCTAGAAATAGCA	1
ACCTTGACCG	GAAACACCGGTCGGGGCCACTCAGTGGTGGGGTTAGAGCTAGAAATAGCA	2
ACCTTTAACG	GAAACACCGGTCGGGGCCACTCAGTGGTGGGGTTAGAGCTAGAAATAGCA	4
ACCTTTAACG	GAAACACCGGTCGGAGCCACTCAGTGGTGGGGTTAGAGCTAGAAATAGCA	1
ACCTTTAACG	GAAACACCGGTCGGGGCCACTCAGTGGAGGGGTTAGAGCTAGAAATAGCA	1
ACCTTTACAG	GAAACACCGGTCGGGGCCACTCAGTGGTGGGGTTAGAGCTAGAAATAGCA	1
ACCTTTACCT	GAAACACCGGTCGGGGCCACTCAGTGGTGGGGTTAGAGCTAGAAATAGCA	1
ACCTTTACTG	GAAACACCGGTCGGGGCCACTCAGTGGTGGGGTTAGAGCTAGAAATAGCA	1
ACCTTTAGCG	GAAACACCAAGTGGGGTTAGAGCTAGAAATAGCAAGTTAACCTAAGGCTA	1
ACCTTTATCG	GAAACACCGGTCGGGGCCACTCAGTGGTGGGGTTAGAGCTAGAAATAGCA	2
ACGAATACTT	GAAACACCGGTCTCGAGTGAGGTGTTCAGGTGGGGTTAGAGCTAGAAATA	1
ACGAATCATT	GAAACACCGGTCTCGAGTGAGGTGTTCAGGGTGGGGTTAGAGCTAGAAAT	5
ACGAATCATT	GAAACACCGGTCTCGAGTGAGGTGTGGTTAGAGCTAGAAATAGCAAGTTA	1
ACGAATCATT	GAAACACCGGTCTCGAGTGAGGTGTTCAGGTGGGGTTAGAGCTAGAAATA	1
ACGAATCCCT	GAAACACCGGTCTCGAGTGAGGTGTTTCGTCCTTTTAGAGCTAGAAATAG	1
ACGAATCCCT	GAAACACCGGTCTCGAGTGAGGTGTTCAGGGTGGGGTTAGAGCTAGAAAT	1
ACGAATCCGT	GAAACACCGGTCTCGAGTGAGGTGTTCAGGGGTGGGGTTAGAGCTAGAAA	1
ACGAATCCGT	GAAACACCGGTCTCGAGTGAGGTGTTCAGGTGGGGTTAGAGCTAGAAATA	1
ACGAATCCTG	GAAACACCGGTCTCGAGTGAGGTGTTCAGGGTGGGGTTAGAGCTAGAAAT	1
ACGAATCGTT	GAAACACCGGTCTCGAGTGAGGTGTTCAGGGTGGGGTTAGAGCTAGAAAT	1
ACGAATCGTT	GAAACACCGGTCTCGAGTGAGGTGTTCAGGTGGGGTTAGAGCTAGAAATA	1
ACGAATGCTT	GAAACACCGGTCTCGAGTGAGGTGTTCAGGGTGGGGTTAGAGCTAGAAAT	1
ACGAATTCTT	GAAACACCGGTCTCGAGTGAGGTGTTCAGGGTGGGGTTAGAGCTAGAAAT	1
ACGACACGCC	GAAACACCGGTCGGCGGCAATCGTGGGGGGGGTTAGAGCTAGAAATAGCA	1
ACGACTCATT	GAAACACCGGTCTCGAGTGAGGTGTTCAGGGTGGGGTTAGAGCTAGAAAT	1
ACGACTCCTT	GAAACACCGGTCTCGAGTGAGGTGTTCAGGGTGGGGTTAGAGCTAGAAAT	4
ACGAGCGGTG	GAAACACCGGTTGATTCATATCGAAACCTTCCCGTGACAGTGGGGTTAGA	1
ACGAGTCGCT	GAAACACCGGTTTACAGTGCATCGGGTTGGGGTTAGAGCTAGAAATATCA	1
ACGAGTTGTA	GAAACACCGGTGACATTGGGTAACATGGGGTTAGAGCTAGAAATAGCAAG	1
ACGATAGAGA	GAAACACCGGTTATATTTGTAAGTGTGTGGGGTTAGAGCTAGAAATAGCA	1
ACGATAGGGC	GAAACACCGGTTAAGCCTAAGAGTTAGAGGTGGTAGTGCTAGGTTTAGCA	1
ACGATCGAAG	GAAACACCGGTTATATTTGTAAGTGTGTGGGGTTAGAGCTAGAAATAGCA	1
ACGATTATCT	GAAACACCGGTTTACGTTGCATCGGTGTGGGGTTAGAGCTAGAAATAGCA	1
ACGATTCAGT	GAAACTAAGGCTAGACCGGTATGACCTTTAGAGAGTTTCGCGCTATCGAT	1
ACGCAACGCC	GAAACACCGGTTTGAACTACCTAGTTCAAACCGGTGGGGTTAGAGCTAGA	1
ACGCACAGCT	GAAACACCGGTTTACGTTGCATCGGGGTTAGAACCACATATAGCAGGTTA	1
ACGCAGTGTA	GAAACACCGGTCGATTCATATCGAAACCTTCCCGTGGGGTTAGAGCTAGA	1
ACGCATACCT	GAAACACCGGTTTACGTTGCATCGTGGTTAGAGTTGGGCATAACATAGTA	1
ACGCATCCTT	GAAACACCGGTCTCGAGTGAGGTGTTCAGGGTGGGGTTAGAGCTAGAAAT	1
ACGCCACGCC	GTGGGGTTAGAGCTAGAAATAGCAAGTTAACCTAAGGCTAGTCCGTTATC	1
ACGCGACCTA	GAAACACCGGTGCCCTTACTCTCACCTGATTACTTAATCCGTGGGGTTAG	1
ACGCGGATAA	GAAACACCGGTTAAGCCGAGTGGGGTTAGAGCTAGAAATAGCAAGTTAAC	1
ACGCTTAGAC	GAAACACCGGTTTACGTTGCATCGGTGTGGGGTTAGAGCTAGAAATAGCA	1
ACGGAAATAC	GAAACACCGGTGCCCTTACTCTCACCTGATTACTTAATCCGTGGGGTTAG	1
ACGGACCTAC	GAAACACCGGTGCCCTTACTCTCACCTGATTACTTAAACCGTGGGGTTAG	1
ACGGATCCTT	GAAACACCGGTCTCGAGTGAGGTGTTCAGGGTGGGGTTAGAGCTAGAAAT	1
ACGGCGCTAC	GAAACACCGGTGCCCTTACTCCCACCTGATTACTTAATCCGTGGGGTTAG	1
ACGGGGTGTC	GAAACACCGGTGACAATTGGGGTTAGAGCTAGAAATAGCAAGTTAACCTA	1
ACGGGTTGAA	GAAGCACCGGTGACATTGGGTACAGGGTGGGGTTAGAGCTAGAAATAGCA	1
ACGGGTTGTA	GAAACACCGGTGACATTGGGTACAAAGTTAACCTAAGGCTAGTCCGTTAT	1
ACGGGTTGTC	GAAACACCGGTGACATTGGGTGGTGGGGTTAGAGCTAGAAATAGCAAGTT	1
ACGGGTTGTC	GAAACACCGGTGACATTGGGTACAGGGGTGGGGTTAGAGCTAGAAATAGC	1
ACGGGTTGTC	TTAGAGCTAGAAATAGCAAGTTAACCTAAGGCTAGTCCGTTATCAACTTG	1
ACGGGTTGTC	GAAACACCGGTGACATTGGGTACAGGGTGGGGTTAGAGCTAGAAATAGCA	1
ACGTCTGCGT	GAAACACCGGTCCGTAGGAGACCCGTGTGGCATGTACCTGTGGGGTTAGA	1
ACGTGTAGTA	GAAACACCGGTGACATTAGAGCTAGAAATAGCAAGTTAACCTAAGGCTAG	1
ACGTGTTGCC	GAAACACCGGTGACAATTGGGGTTAGAGCTAGAAATAGCAAGTTAACCTA	1
ACGTGTTGTA	GAAACACCGGTGACATTGGGTAGTGGGGTTAGAGCTAGAAATAGCAAGTT	1
ACGTTACAGC	GAAACACCGGTCGGGGCCACTCAGTGGTGGGGTTAGAGCTAGAAATAGCA	1
ACGTTATCGT	GAAACACCGGTCGGGGCCACTCAGTGGTGGGGTTAGAGCTAGAAATAGCA	1
ACGTTCCCGC	GAAACACCGGTCGGGGCCACTCAGTGGCGGGGTTAGAGCTAGAAATAGCA	1
ACGTTCGGGC	GAAACACCGGTCAATTCATGTCAAAACATTCCAGCGAAAGTGTGGTTCGA	1
ACGTTGCCTA	GAAACACCGGTCTGTGCCACTCAGTGGTTGGGTTAGAGCTAGAAAGAGCA	1
ACGTTTACCT	GAAACACCGGTGTCCGCTGCCAGGGCCAGTGTTTGGATCGAGAAAGAGAA	1
ACGTTTAGTT	GAAACACCGGTCGATTCATATCGAAACCTTCCCGTGACAGTGGGGTTAGA	1
ACTAATCGGC	GAAACACCGGTACCTTTGTTGATGCTGGGTGGGGTTAGAGCTAGAAATAG	1
ACTACACGGC	GAAACACCGGTACCTTTGTTGATGCTGGGTGGAAGGAATTTGTGGGGTTA	1
ACTACGCGGC	GAAACACCGGTACCTTTGTTGATGCTGGTGTGGGGTTAGAGCTAGAAATA	1
ACTACTAGGA	GAAACACCGGTACCTTTGTTGATGCTGGGTGGAAGGAAGGGTTAGAGCTA	1
ACTACTAGGC	GAAACACCGGTACCTTTGTTGATGCTGGGTGGAAGGAATTTGTGGGGTTA	3
ACTACTAGGC	GAAACACCGGTACCTTTGTTGATGCTGGGTGGAAGGAATTTTGGGGGGTT	1
ACTACTAGGT	GAAACACCGGTACCTTTGTTGATGCTGGGTGGAAGGAATTTGTGGGGTTA	1
ACTACTCGGA	GAAACACCGGTACCTTTGTTGATGCTGGGTGGAAGGAATTGTGGGGTTAG	1
ACTACTCGGT	GAAACACCGGTACCTTTGTTGATGCTGGGTGGAAGGAATTTGTGGGGTTA	1
ACTACTCTGC	GAAACACCGGTACCTTTGTTGATGCTGGGTGGAAGGAATTTGTGGTGTTA	1
ACTACTCTGC	GAAACACCGGTACCTTTGTTGATGCTGGGTGGAAGCTAGAAATAGCAAGT	1
ACTACTCTGC	GAAACACTTAGAGCTAGAAATAGCAAGTTAACCTAAGGCTAGTCCGTTAT	1
ACTACTTGGA	GAAACACCGGTACCTTTGTTGGTGCTGGGTGGAAGGAATTTGTGGGGTTA	1
ACTACTTGGC	GAAACACCGGTACCTTTGTTGATGCTGGGGGGGGTTAGAGCTAGAAATAG	1
ACTAGCGTGG	AAACAACTTGAAAAAGTGGCACCGAGTCGGTGCTTTTTTTCCTGCAGGCC	1
ACTATAGCGC	GAAACACCGGTCGGGGCCACTCAGTGGTGGGGTTAGAGCTAGAAATAGCA	1
ACTATGGATC	GAAACACCGGTAATCAGGGGAGAAGGTAAGCATGTGCTAGAGCGAGAAAT	1
ACTCCAGCGG	GAAACACCGGTTATATTTGTAAGTGTGTGGGGTTAGAGCTAGAAATAGCA	1
ACTCGTAGTC	GAAACACCGGTGTACGTATGGACTGAACCAGGGTGTGCAAGTGGGGTTAG	1
ACTCGTCTTC	GAAACACCGGTGTACGTATGGACTGAACCAGGGTGTGCAAGCGGGGTTAG	1
ACTCTACCGG	GAAACACCGGTCGGGGCCACTCAGTGGTGGGGTTAGAGCTAGAAATAGCA	1
ACTCTACGGC	GAAACACCGGTCGGGGCCACTCAGTGGTGGGGTTAGAGCTAGAAATAGCA	1
ACTCTCCTTC	GAAACACCGGTGTACGTATGGACTGAACCAGGGTGTGCGAGTGGGGATAG	1
ACTCTTACAC	GAAACACCGGTAACTATATTCATGAGAGATAGTAGAATAAGTGGGGTTAG	1
ACTGACCCTT	GAAACACCGGTCTCGAGTGAGGTGTTCAGGTGGGGTTAGAGCTAGAAATA	1
ACTGACTCGC	GAAACACCGGTCGGCGGCAATCGGGTGGGGGTGGGGTTAGAGCTAGAAAT	1
ACTGCATAGC	GAAACACCGGTTTACGTTGCTGTGGGGTTAGAGCTAGAAATAGCAAGTTA	1
ACTGTTAATG	GAAACACCGGTCGGGGCTAGAAATAGCAAGTTAACCTAAGGCTAGTCCGT	1
ACTTAGTCGT	GAAACACCGGTGTACGTATGGACTGAACCAGGGTGTGCAAGTGGGGTTAG	1
ACTTCATCGC	GAAACACCGGTCGGGGCCACTCAGTGGTGGGGTTAGAGCTAGAAATAGCA	1
ACTTCTTAGC	GAAACACCGGTTTACGTTGCATCGGTGTGGGGTTAGAGCTAGAAATAGCA	1
ACTTCTTAGT	GAAACACCGGTTTACGTTGCATCGGGGTTAGAGCTAGAAATAGCATGTTA	1
ACTTGACCTC	GAAACACCGGTAACTATATTCATGCGATATCGCCGTATCAGTGGGGTTAG	1
ACTTGAGCGC	GAAACACCGGTCGGGGCCACTCAGTGGTGGGGTTAGAGCTAGAAATAGCA	1
ACTTGTCGTC	GAAACACCGGTGTACGTATGGACTGAACCAGGGTGTGCAAGTGGGGTTAG	1
ACTTTAAAGC	GAAACACCGGTCGGGGCCACTCAGTGGTGGGGTTAGAGCTAGAAATAGCA	1
ACTTTAACAC	GAAACACCGGTCGGGGTTAGAGCTAGAAATAGCAAGTTAACCTAAGGCTA	1
ACTTTAACCT	GAAACACCGGTCGAGGCCACTCCGTGGTGGGGTTAGAGCTAGAAATAGCA	1
ACTTTAACTA	GAAACACCGGTCGGGGCCACTCAGTTAGAGCTAGAAATAGCAAGTTAACC	1
ACTTTAGAGC	GAAACACCGGTCGGGGCCACTCAGTGGTGGGGTTAGAGCTAGAAATAGCA	1
ACTTTAGCGA	GAAACACCGGTCGGGGCCACTCAGTGGTGGGGTTAGAGCTAGAAATAGCA	1
ACTTTATTCC	GAAACACCGGTCGGGGCCACTCAGTGGTGGGGTTAGAGCTAGAAATAGCA	1
ACTTTCACGC	GAAACACCGGTCGGGGCCACTCAGTGGTGGGGTTAGAGCTAGAAATAGCA	1
ACTTTGCGTT	GAAACACCAGTCGATTCATATCGAAACCTTCCCGTGACAGTGGGGTTAGA	1
AGAAAATGGA	CTAAACACCGGTGCATTCGGAAGTCCGGTCGTAGTGTGGACGTGGGGTTA	1
AGAAACAGAC	GAAACACCGGTAGCAAGTGCGAGACGTTTTTGTGGGGTTAGAGCTAGAAA	1
AGAAACAGAC	GAAACACCGGTAGCAAGTGGGGTTAGAGCTAGAAATAGCAAGTTAACCTA	1
AGAAACTCGA	GAAACACCGGTGCATTCGAAAGTCCGGTCGTAGTGTGGACGTGGGGTTAG	1
AGAAAGAATC	GAAACGCCGGTCCGTAGGAGACCCGTGTGGCATGTAACTGTGGGGTTAGA	1
AGAACATAGC	GAAACACCGGTGCGTTCGAAAGTCCGGTCGTAGTGTGGACGTGGGGTTAG	1
AGAACCATGC	GAAACACCGGTGCATTCGAAAGTCCGGTGGTAGTGTGGAAGTGGGGTTAG	1
AGAACCGAGC	GAAACACCGGTGCATTCGAAAGTCCGGTCGTAGTGTGGACGTGGGGTTAG	1
AGAACGCCTG	GAAACACCGGTGCCCTTACTCTCACCTGATTACTTAATCCGTGGGGTTAG	1
AGAAGAACGC	GAAACACCGGTTTGAACTACCTAGTTCAAACCGGTGGGGTTAGAGCTAGA	1
AGAAGACACG	GAAACACCGGTCGGTTAACCTAAGGCTAGTCCGTTATCAACTTGAAAAAG	1
AGAAGACCAG	GAAACACCGGTCGGCGGCAACGTGGTTAGAGCTAGAAATAGCAAGTTAAC	1
AGAAGACCAG	GAAACACCGGTCGGCGGCAATCGTGGGTGGGGTTAGAGCTAGAAATAGCA	1
AGAAGACGCG	GAAACACCGGTCGGCGGCTAGTCCGTTATCAACTTGAAAAAGTGGCACCG	1
AGAAGAGCCG	GGAACACCGGTCGGGGTGGGGTTAGAGCTAGAAATAGCAAGTTAACCTAA	1
AGAAGAGCCG	GAAACACCGGTCGGCGGGGGGGCTAGAGCTAGAAATAGCAAGGTAACCTA	1
AGAAGCATAT	GAAACACCGGTCTCGAGTGCGGGGTTCAGGGTGGGGTTAGAGCTAGAAAT	1
AGAAGCCCTG	GAAACACCGGTCGGCGGCAATCGTGAGTGGGGTTAGAGCTAGAAATAGCA	1
AGAAGCTCGA	GAAACACCGGTGCATTCGAAAGTCCGGTCGTAGTGTGGACGTGGGGTTAG	1
AGAAGTCCCG	GAAACACCGGTCGGCGGCTAGAAATAGCAAGTTAACCTAAGGCTAGTCCG	1
AGAATAATTT	GAAACACCGGTCTCGAGTGAGGTGTTCAGGGTGGGGTTAGAGCTAGAAAT	1
AGAATACATC	GAAACACCGGTCCGTAGGAGACCCGTGTGGCATGTACCTGTGGGGTTAGA	1
AGAATATTTT	GAAACACCGGTCTCGAGTGAGGTGTTCAGGGTGGGGTTAGAGCTAGAAAT	1
AGAATCGCGC	GAAACACCGGTGCATTCAAAAGTCCGGTCGTAGTGTGGACGTGGGGTTAG	1
AGAATGATTC	GAAACACCGGTCTCGAGTGAGGTGTTCAGGGTGGGGTTAGAGCTAGAAAT	1
AGAATTATGT	GAAACACCGGTTTCGAGTGAGGGGTTCAGGTAGAGGTTGGAACTTGACCT	1
AGACAACGCC	GAAACACCGGTAGCAAGTGCGTGGGGTTAGAGCTAGAAATAGCAAGTTAA	1
AGACAATAGC	GAAACACCGGCGCATTGGAAAGTCGGGTGGTATTGTGGACGTGGGGTTAA	1
AGACACAAAC	GAAACACCGGTAGCAGGTTAGAGCTAGAAATAGCAAGTTAACCTAAGGCT	1
AGACACACAC	GAAACACCGGTAGCAAGTGGGGTTAGAGCTAGAAATAGCAAGTTAACCTA	1
AGACACAGCC	GAAACACCGGTAGCAAGTGGGGTTAGAGCTAGAAATAGCAAGTTAACCTA	1
AGACACAGGC	GTAGAAATAGCAAGTTAACCTAAGGCTAGTCCGTTATCAACTTGAAAAAG	1
AGACACAGGT	GAAACAACGGTGCATTCGAAAGTCCGGTCGGAGTGTGGAAGTGGGGATAG	1
AGACACGGAC	GAAACACCGGTAGCAAGTGGGGTTAGAGCTAGAAATAGCAAGTTAACCTA	1
AGACACTAAA	GAAACACCGGTAGCAAGTGCGAGACGGGGTGAGAGTGGGGTTAGAGCTAG	1
AGACACTAGA	GAAACACCGGTGCATTCGAAAGTCCGGTCGTAGTGTGGACGTGGGGTTAG	1
AGACCATTGA	GAAACACCGGTGCATTCGAAAGCCCGGTCGTAGTGTGGACGTGGGGTTAG	1
AGACCCAGAC	GAAACACCGGTAGCAAGTGCGAGACGTTTTTGTGGGGTTAGAGCTAGAAA	1
AGACCCCAGT	GAAACACCGGTGCATTCGAAAGTCCGGTCGTAGTGTGGACGTGGGGTTAG	1
AGACCCGGGA	GAAACACCGGTGCATTCGAAAGTCCGGTCGTAGTGTGGACGTGGGGTTAG	1
AGACCCTCGC	GAAACACCGGTGCATTCGAAAGTCCGGTCGTAGTGTGGACGTGGGGTTAG	2040
AGACCCTCGC	CAAAACACCGGTGCATTCGAAAGTCCGGTCGTAGTGTGGACGTGGGGTTA	13
AGACCCTCGC	GAAACACCGGTGCATTCGAAAGTCCGGTCGTAGTGTGACGTGGGGTTAGA	3
AGACCCTCGC	GAAACACCGGTAAATTTGAGGCTCCGGCATGCAGGAGGCCGTGGGGTTAG	2
AGACCCTCGC	GAAACACCGGTAACTATATTCATGCGATATCGCCGTATCAGTGGGGTTAG	2
AGACCCTCGC	GAAACACCGGTTACATTGAGGGGTTAGAGCTAGAAATAGCAAGTTAACCT	2
AGACCCTCGC	GAAACACCGGTACATTCTAAAGCTCGGTCGGAGTGTGGACGGGGGGATCG	1
AGACCCTCGC	GAAACACCGGTCGGCGGCAATCGTAGAGCTAGAAATAGCAAGTTAACCTA	1
AGACCCTCGC	GAAACACCGGTCGGCGGCAATCGTGGGTGGGGTTAGAGCTAGAAATAGCA	1
AGACCCTCGC	GAAACACCGGTGACATCGAGAATACGGTGGGGGTAGAGCCAGAAAGATCG	1
AGACCCTCGC	GAAACACCGGTGCATAATGTAGGCCGGTCGGGGTATAGACGTGGGGAGCG	1
AGACCCTCGC	GAAACACCGGTGCATTCGAAAGCCGGTCGTAGTGTGGACGTGGGGTTAGA	1
AGACCCTCGC	GAAACACCGGTGCATTCGAAAGTCCGGTCGCAGTGTGACGTGGGGTTAGA	1
AGACCCTCGC	GAAACACCGGTGCATTCGAAGTCCGGTCGTAGTGTGTACGTGGGGTTAGA	1
AGACCCTCGC	GAAACACCGGTGCATTCGCAAGTACGTTAGTACTGAGGCCGTGGGGTTAG	1
AGACCCTCGC	GAAACACCGGTGCCCTTACTCTCACCTGATTACTTAATCCGTGGGGTTAG	1
AGACCCTCGC	GAAACACCGGTGTACGTATGGACTGAACCAGGGTGTGCAAGTGGGGTTAG	1
AGACCCTCGC	GAAACACCGGTTAAGCCGAGGTGGGGTTAGAGCTAGAAATAGCAAGTTAA	1
AGACCCTCGC	GAAACACCGGTTACATTGAGGGTTAGAGCTAGAAATAGCAAGTTAACCTA	1
AGACCCTCGC	GAAACACCGGTTCCCGTCCAGTGGGGTTAGAGCTAGAAATAGCAAGTTTA	1
AGACCCTCGC	GAAACACGGGTGCATTCGAAAGTCCGGACGTAGTGCGAACGCGGGGCTAG	1
AGACCCTCGC	GAACAAACACCGGGGCATTCGAAAATCCGGGCGTAGGGTGGACGTGGGGG	1
AGACCGTAGA	GAAACACCGGTGCATTCGAAAGTCCGGTCGTAGTGTGGACGTGGGGTTAG	1
AGACCTATAC	GAAACACCGGTAACTATATTCATGCGATATCGCCGTATCAGTGGGGTTAG	1
AGACGATGGC	GAAACACCGGTGCATTCGAAAGTCCGGTCGGAGTGTGGACGTGGGGTTAG	1
AGACGATGTC	GGAACACCGGTGCATTCGAGAGTCCGGTCGTAGTGTGGCCGTGGGGTTAG	1
AGACGGCCTA	GAAACACCGGTCCGTAGGAGACCCGTGTGGCATGTACCTGTGGGGTTAGA	1
AGACGGCCTT	GAAACACCGGTCCGTAGGAGACCCGTGTGGCATGTACCTGTGGGGTTAGA	1
AGACTCGGAC	GAAACACCGGTACAAGGGGTTAGAGCTAGAAATAGCAAGTTAACCTAAGG	1
AGACTCTGCC	GAAACACCGGTGCCTTCGTTGGGCGGGTAGAAGTGGGGACGTCAAGTTAG	1
AGACTCTTTG	GAAACACCGGTGCATTCGAAAGTCCGGTCGTAGTGTGGACGTGGGGTTAG	1
AGACTGATTC	GAAACACCGGTAAGTAGGAGACCCGTGTGTCATGTACCTGTGGGGGTAGG	1
AGACTGTATC	GAAACACCGGTCCGTAGGAGACCCGTGTGGCATGTACCTGTGGGGTTAGA	1
AGAGACAGAC	GAAACACCGGTAGCAAGTGCGAGACGTGTTTGTGGGGTTAGAGCTAGAAA	1
AGAGCACCGC	GAAACACCGGTGCATTCGAAAGTCCGGTCGTAGTGTGGACGTGGGGTTAG	1
AGAGCACTAC	GAAACACCGGTGCCCTTACTCTCACCTGATTACTTAATCCGTGGGGTTAG	1
AGAGCGTAGC	GAAACACCGGTGTACGCATGGACTGAACCAGGGTGTGCAAGTGGGGTTAG	1
AGAGCTGTAC	GAAACACCGGTGCATTTACTCTCAACTGATTACTCAGTCCGTGGGGTTAG	1
AGAGCTGTGT	GAAACACCGGTTACATTGAGGGTTAGAGCTAGAAATAGCAAGTTAACCTA	1
AGAGCTTCTC	GAAACACCGGTGCATTCGAAAGTCCGGTCGTAGTGTGGACGTGGGGTTAG	1
AGAGGACACG	GAAACACAGGTCGGCGGCAATCGTGGGTGGGGTTAGAGCTAGAAATAGCA	1
AGAGGAGCCT	GAAACACCGGTTCCCGTCCAGTGGGGTTAGAGCTAGAAATAGCAAGTTAA	1
AGAGGAGCGT	GAAACACCGGTTCCCGTCCAGTGGGGTTAGAGCTAGAAATAGCAAGTTAA	1
AGAGGCTCTC	GAAACACCGGTGCATTCGAAAGTCCGGTCGTGGTGTGGACGTGGGGTTAG	1
AGAGTCCTAT	GAAACACCGGTGCCCTTACTCTCACCTGATTACTTAATCCGTGGGGTTAG	1
AGAGTCGGCT	GAAACACCGGTCGCTTCATATCGAAACCTTCCCGTCACAGTGGGGTTAGA	1
AGAGTGGTCT	GAAACACCGGTGACATTGGGTACAGGGTGGGGTTAGAGCTAGAAATAGCA	1
AGAGTGGTGT	GAAACACCGGTGCCCTTACTCTCACCTGATTACTTAATCCGTGGGGTTAG	1
AGATACAGAC	GAAACACCGGTAGCAAGTGCGAGACGTGTTTGTGGGGTTAGAGCTAGAAA	1
AGATACTAAA	GAAACACCGGTAAATTTGTGGCTCCTGCTTGCAGGAGGCCGGGTGGTTAT	1
AGATATCCGC	GAAACACCGGTGCATTCCAAAGTCCGGTCGTAGTGTGGACGTGGGGTTAG	1
AGATATCGCG	GAAACACCGGTTATATTTGTAAGTGTGTGGGGTTAGAGCTAGAAATAGCA	1
AGATTATTTT	GAAACACCGGTCTCGAGTGAGGTGTTCAGGGTGGGGTTATAGCTAGAAAT	1
AGATTGCGTC	GAAACACCGGTCCGTAGGAGACCCGTGTGGCATGTGGGGTTAGAGCTAGA	1
AGCAAACTTC	GAAACACCGGTGTGGCTGAGAGTCCGGCAATGGTGTGGCTGTGGGGTTAG	1
AGCAAGACTC	GAAACACCGGTCCGTAGGAGACCCGTGTGGCATGTACCTGTGGGGTTAGA	1
AGCACAGCGC	GAAACACCGGTGTATTCGAAAGTCCGGTCGTAGTGTGGATGTGGGGATAG	1
AGCACCGTTA	GAAACACCGGTTAAGTAGAGCTAGAAATAGCAAGTTAGCCTAAGGCTAGT	1
AGCACGCTTC	GAAACACCGGTGTGGATGAGAGTCCGGCCATGGTTTCGCTGGGGGGTTTA	1
AGCAGACCCG	GAAACACCGGTCGGCGGCAATCGTGGGTGGGGTTAGAGCTAGAAATAGCA	2
AGCAGACCCG	GAAACACCGGTCGGCGGCAATCGTGCTTTTTTTCCTGCAGGGCGGGTCTT	1
AGCAGACCCG	GAAACACCGGTCGGCGGCAATCGTGTTACCTGGCAAGAGCTAGAAATAGC	1
AGCAGAGCCG	GAAACACCGGTCGGCGGTTAGAGCTAGAAATAGAAAGTTAACCTAAGGCT	1
AGCAGCGTAA	GAAACACCGGTGCCCTTGCTCGGGGTTAGAGCTAGAATTAGCAAGGTAAC	1
AGCATAAGGT	GAAACACCGGTCGATTCATATCGAAACCTTCCCGTGACAGTGGGGTTAGA	1
AGCATCATTT	GATACACCGGTCTCGAGTGAGGTGTTCAGGGTGGGGTTAGAGCTAGAAAT	1
AGCATCCTTA	GAAACACCGGTCTCGAGTGAGGTGTTCAGGGTGGGGTTAGAGCTAGAAAT	1
AGCATCGTCC	GAAACACCGGTGTGGCTGAGAGTACGGCAATGGTGTGGCTGTGGGGTTAG	1
AGCATCGTCG	GAAACACCGGTGTACGTATGGACTGAACCAGGGTGTGCAAGTGGGGCTAG	1
AGCATGCTGC	GAAACACCGGTCCGGAGGAGACCCGGGTGATATGGACCCTTTGGGGTAGA	1
AGCATGGGGT	GAAACACCGGTCGATTCATATCGAAACCTTCCCGTGACAGTGGGGTTAGG	1
AGCCACGCGC	GAAACACCGGTGCATTCGAAAGTCCGGTCGTAGTGTGGACGCGGGGTTAG	1
AGCCATAGAC	GAAACACCGGTAGCAAGTGGGGTTAGAGCTAGAAATAGCAAGTTAACCTA	1
AGCCCGTCTC	GAAACACCGGTGCATTCGAAAGTCCGGTCGTAGTGTGGACGTGGGGTTAG	1
AGCCTCCCTG	GAAACACCGGTTCCCGTCCAGTGGGGTTAGAGCTAGAAATAGCAAGTTAA	1
AGCCTCCGGC	GAAACACCGGTACCTTTCTTGAGGCTGGGGGGGGCTAGAGCTAGAAATAG	1
AGCCTTTACC	GAAACACCGGTCGGGGCCACTCAGTGGTGGGGTTAGAGCTAGAAATAGCA	1
AGCGACAGAC	GAAACACCGGTAGCAAGTGCAAGACGTGTTTGTGGGGTTAGAGCTAGAAA	1
AGCGCTGTAC	GAAACACCGGTGCCCTTACTGTCAGCTGTTTACTTAGTCCGTTGGGTTAG	1
AGCGTAGTCT	GAAACACCGACAGGGTTAGAGCTAGAAATAGCAAGTTAACATAAGGACAG	1
AGCGTGATGC	GAAACACCGGTGCGCTTCCTCTCCACTGCTTACTTAATCTGTGGGGTTAG	1
AGCTATAGAG	GAAACACCGGTTATATTTGTAAGTGTGTGGGGTTAGAGCTAGAAATAGCA	1
AGGAAACATT	GAAACACCAGTGTGGCTGAGTGTCCGGCAGTGGTGTGGCTGGGGGGATAG	1
AGGAAACGGA	GAAACACCGGTAGCAAGTGCGTGGGGTTAGAGCTAGAAATAGCAAGTTGA	1
AGGAACCATC	GAAACACCGGTGTGGCTGAGAGTCCGGCAATGGTGTGGCTGTGGGGTTAG	1
AGGAACCCTC	GAAACACCGGTGTGGCTGAGAGTCCGGCAATGGTGTGGCTGTGGGGTTAG	1
AGGAAGCCTC	GAAACACCGGTGTGGCTGAGAGTCCGGCAATGGTGTGGCTGTGGGGTTAG	1
AGGAATCCTC	GAAACACCGGTGTGGCTGAGAGTCCGGCAATGGTGTGGCTGTGGGGTTAG	1
AGGACCCTAC	GAAACACCGGTAAATTTGAGGCTCCGGCATGCAGGAGGCCGTGGGGTTAG	1
AGGACCTAGC	GAAACACCGGTGCATTCGAAAGTCCGGACGGAGTGGGTACGGGTGGATAG	1
AGGACTCCTT	GAAACACCGGTCTCGAGTGAGGTGTTCAGGGTGGGGTTAGAGCTAGAAAT	1
AGGACTCTAA	CAAAACACCGGTAAATTTGAGGCTCCGGCATGCAGGAGGCCGTGGGGTTA	1
AGGAGTAGCT	GAAACACCGGTTTGTGGGGTTAGAGCTAGAAATAGCAAGTTAACCTAAGG	1
AGGATAAGCT	GAAACACCGGTTTACGTTGCATCGTTAGAGCTAGAAATAGCTAGAAATAG	1
AGGATACGTT	GAAACACCGGTCGATTCATATCGAAACCTTCCCGTGACAGTGGGGTTAGA	1
AGGATACTGA	GAAACACCGGTAGCAAGTGCGGGACGTGTTTTTGTGGGGTTAGAGCAAGA	1
AGGATACTTT	GAAACACCGGTCTCGAGTGAGGTGTTCAGGGTGGGGTTAGAGCTAGAAAT	1
AGGATCCTAC	GAAACACCGGTAAATTTGAGGCTCCGGCATGCAGGAGGCCGTGGAGTTAG	1
AGGATGCCAC	GAAACACCGGTCCGTAGGAGACCCGTGTGGCATGTACCTGTGGGGTTAGA	1
AGGATGCGCC	GAAACACCGGTAGCCCGTGATCGTCATGTGGCGGGGCTAGAGCTCGGGGC	1
AGGCAACCTC	GAAACACCGGTGTGGCTGAGAGTCCGGCAATGGTGTGGCTGTGGGGTTAG	2
AGGCACACTC	GAAACACCGGTGTGGCTGAGAGTCCGGCAATGGTGTGGCTGTGGGGTTAG	2
AGGCACCATC	GAAACACCGGTGTGGCTGAGAGTCCGGCAATGGTGTGGCTGTGGGGTTAG	1
AGGCACCATC	GAAACACCGGTGTGGTTGAGAGTCCGGCAATGGTGTGGCTGTGGGGTTAG	1
AGGCACCCTT	GAAACACCGGTGTGGCTGAGAGTCAGGCAATGGTGTGGCTGTGGGGTTAG	1
AGGCACCGTC	GAAACACCGGTGTGGCTGAGAGTCCGGCAATGGTGTGGCTGTGGGGTTAG	1
AGGCACCTAC	GAAACACCGGTAAATTTGAGGCTCCGGCATGCAGGAGGCCGTGGGGTTAG	1
AGGCACCTAC	CCGGTAAATTTGAGGCTCCGGCATGCAGGAGGCCGTGGGGTTAGAGCTAG	1
AGGCACGCTA	GAAACACCGGTGTGGCTGAGAGTCCGGCAATGGTGTGGCTGTGGGGTTAG	1
AGGCACTCTC	GAAACACCGGTGTGGCTGAGAGTCCGGCAATGGTGTGGCTGTGGGGTTAG	2
AGGCATCCGC	GAAACGCCGGTGTGGCTGAGAGTCCGGCAATGGTGTGGCTGTGGGGTTAG	1
AGGCATCGGA	GAAACACCGGTGTAGCTGAGAGTCCGGCAATGGTGTGGCTGTGGGGTTAG	1
AGGCCACTAC	GAAACACCGGTAAATTTGAGGCTCCGGCATGCAGGAGGCCGTGGGGTTAG	4
AGGCCACTAG	GAAACACCGGTAAATTTGAGGCTCCGGCATGCAGGAGGCCGTGGGGTTAG	1
AGGCCATCTA	GAAACACCGGTGCATTCGACAGTCCGGTCGTAGTGGGGACGTGGGGTTAG	1
AGGCCCATAC	GAAACACCGGTAAATTTGAGGCTCCGGCATGCAGGAGGCGTGGGGTTAGA	1
AGGCCCTAGA	GAAGCACCGGTAAATTTGAGGCTCCGGCATGCAGGAGGCCGTGGGGTTAG	1
AGGCCGCCGC	GAAACACCGGTGTGGCTGAGAGTCCGGCAATGGTGTGGCTGTGGGGTTAG	1
AGGCGCATAA	GAAACACCGGTTAAGCCGGGGAGTTAGAGCTAGAAATAGCAAGTTAACCT	1
AGGCGGATTC	GAAACACCGGTCAGTAGGAGACCCGTGTGGCATGTACCTGTGGGGTTAGA	1
AGGCTCATAA	GAAACACCGGTAAATTTGAGGCTCCGGCATGCAGGAGGCCGTGGGGTTAG	1
AGGCTCCTAC	GAAACACCGGTAAATTTGAGGCTCCGGCATGCAGGAGGCCGTGGGGTTAG	1
AGGCTGACCC	GAAACACCGGTCCGTAGGAGACCCGTGTGGCATGTACCTGTGGGGTTAGA	1
AGGCTGAGTC	GAAACACCGGTCCGTAGGAGACCCGTGTGGCATGTACCTGTGGGGTTAGA	1
AGGCTGAGTC	GAAACACCGGTCCGTAGGAGACCCGTGTGGCATGTTAGGGGTTAGAGCTA	1
AGGCTGCTGC	GAAACACCGGTCCGTAGGAGACCCGTGTGGCTAGAAATAGCAAGTTAACC	1
AGGGCCCCTA	GAAACACCGGTAAATTTGAGGCTCCGGCATGCAGGAGGCCGTGGGGTTAG	1
AGGGGAACCT	CTAAACACCGGTGTGGCTGAGAGTCCGGCAATGGTGTGGCTGTGGGGTTA	1
AGGGGAGCCT	GAAACACCGGTTCCCGTCCAGTGGGGTTAGAGCTAGAAATAGCAAGTTAA	1
AGGGGGCCTC	GAAACACCGGTCCGTAGGAGACCCGTGTGGCATGAACCCTTGGGGTTACA	1
AGGGGGGGGA	GAAACACCGGTTCCCGTCCAGTGGGGTTAGAGCTAGAAATAGCAAGTTAA	1
AGGGGTGCCT	GAAACACCGGTTCCCGTCCAGTGGGTTTAGAGCTAGGTATAGCAAGTTAA	1
AGGGGTTGTC	GAAACACCGGTGACATTGGGTGGGGTTAGAGCTAGAAATAGCAAGTTAAC	1
AGGGTACGAC	GAAACACCGGTACCCTTACTCTCACCTGATTACTTAATCCGTGGGGTTAG	1
AGGGTGCGTC	GAAACACCGGTCCGCAGGTAACGGGGCTGGAGCGTGACAGAGGGGGTAGA	1
AGGGTTGTCG	GAAACACCGGTGACATTGGGTGGGGTTAGAGCTAGAAATAGCAAGTTAAC	1
AGGTACCCTC	GAAACACCGGTGTGGCTGGGAGTCCGGCAATGGTGTGGCTGTGGGGTTAG	1
AGGTCCCTGA	GAAACACCGGTAAATTTGAGGCTCCGGCATGCAGGAGGCCGTGGGGTTAG	1
AGGTCTGTCT	GAAACACCGGTCCGTAGGAGACCCGTGTGGCATGTACCTGTGGGGTTAGA	1
AGGTGTTGTC	GAAACACCGGTGACATTGGGTACAGGGTGGGGTTAGAGCTAGAAATAGCA	1
AGGTGTTGTC	GAAAGGACGAAACACCGGTGACATTAGAGCTAGAAATAGCAAGTTAACCT	1
AGTAAGCGTC	GAAACACCGGTCCGTGGAAGACCCGTGTGGCATGTACCTGTGGGGTTTGG	1
AGTACACTTC	GAAACACCGGTCCGTAGGAGACCCGTGTGGCATGTACCTGTGGGGATAGA	1
AGTACGGCTA	GAAACACCGGTAGCAAGAGCTAGAAATAGCAAGTTAACCTAAGGCTAGTC	1
AGTACTCGGA	GAAACACCGGTACCTTTGTTGTGGGGTTAGAGCTAGAAATAGCAAGTTAA	1
AGTAGACCCC	GAAACACCGGTCCGTAGCCGACGCGTGTGGCATGTACATGAGGGAGTAGA	1
AGTAGACCCG	GAAACACCGGTCGGCGGCAATCGTGGTTAGAGCTAGAAATAGCAAGTTAA	1
AGTAGCTATG	GAAACACCGGTTACATTGAGGGTTAGAGCTAGAAATAGCAAGTTAACCTA	1
AGTAGGACGC	GAAACACCGGTCCGTAGGAGACCCGTGTGGCATGTACCTGTGGGGTTAGA	1
AGTATAAGTC	GAAACACCGGTGTACGTATGGACTGAACCAGGGTGTGCAAGTGGGGTTAG	1
AGTATGACTA	GAAACACCGGTCCGTAGGAGACCCGTGTGGCATGTACCTGTGGGGTTAGA	1
AGTATGCATG	GAAACACCGGTCCGTAGGAGACCCGTGTGGCATGTACCTGTGGGGTTAGA	1
AGTATGTATC	GAAACACCGGTCCGTAGGAGACCCGTGTGGCATGTACCTGTGGGGTTAGA	1
AGTCACAGAA	GAGACACCGGTAGCAAGTGCGAGCAAGTGTGGGGTTAGAGCTAGAAACAG	1
AGTCACAGAT	GAAACACCGGTAGCAAGTGCGAGACGTGTTTTGTGGGGTTAGAGCTAGAA	1
AGTCACAGTC	GAAACACCGGTAGCAGGTTAGAGCTAGAAATAGCAAGTTAACCTAAGGCT	1
AGTCCCCTAC	GAAACACCGGTAAATTTGAGGCTCCGGCATGCAGGAGGCCGTGGGGTTAG	1
AGTCGGCCGT	GAAACACCGGTCCGTAGGAGACCCGTGTGGCATGTACCTGTGGGGTTAGA	1
AGTCGGCTCC	GAAACACCGGTCCGTAGGAGACCCGTGTGGCATGTACCTGTGGGGTTAGA	1
AGTCGTCTTC	GAAACACCGGTCCGTAGGAGACCCGTGTGGCATGTACCTGTGGGGTTAGA	1
AGTCTAGTCA	GAAACACCGGTCCGTAGGAGACCCGTGTGGCATGTACCTGTGGGGGTAGA	1
AGTCTGCCTC	GAAACACCGGTCCGTAGGAGACCCGTGTGGCATGTACCTGTGGGGTTAGA	2199
AGTCTGCCTC	GAAACACCGGTCCGTAGGAGACCCGTGTGGCATGTACCTTGTGGGGTTAG	175
AGTCTGCCTC	GAAACACCGGTCCGTAGGAGACCCGTGTGGCTAGAAATAGCAAGTTAACC	23
AGTCTGCCTC	GAAACACCGGTCCGTAGGAGACCCGTGTGGCATGTACCTCCTGTGGGGTT	21
AGTCTGCCTC	GAAACACCGGTCCGTAGGAGACCCGTGTGGCATGTGGGGTTAGAGCTAGA	20
AGTCTGCCTC	GAAACACCGGTCCGTAGGAGACCCGTGTGGCATGTTAGGGGTTAGAGCTA	15
AGTCTGCCTC	GAAACACCGGTCCGTAGGAGACCCGTCCTGTTGTGGGGTTAGAGCTAGAA	13
AGTCTGCCTC	GAAACACCGGTCCGTAGGAGACCCGTGTGGCATGTATGTGGGGTTAGAGC	12
AGTCTGCCTC	GAAACACCGGTCCGTAGGAGACCCGTGTGGCATGTCCTGTGGGGTTAGAG	11
AGTCTGCCTC	GAAACACCGGTCCGTAGGAGACCCGTGGTTAACCTAAGGCTAGTCCGTTA	10
AGTCTGCCTC	GAAACACCGGTCCGTAGGAGACCCGTGTGGCATGTACGTGGGGTTAGAGC	7
AGTCTGCCTC	CAAAACACCGGTCCGTAGGAGACCCGTGTGGCATGTACCTGTGGGGTTAG	5
AGTCTGCCTC	GAAACACCGGTCCGTAGGAGACCCGTGTGGCATGTGTGGGGTTAGAGCTA	5
AGTCTGCCTC	GAAACACCGGTTCGTAGGAGACCCGTGTGGCATGTACCTGTGGGTTAGAG	4
AGTCTGCCTC	GAAACACCGGTCTCGAGTGAGGTGTTCAGGGTGGGGTTAGAGCTAGAAAT	2
AGTCTGCCTC	GAAACACCGGTGTACGTATGGACTGAACCAGGGTGTGCAAGTGGGGTTAG	2
AGTCTGCCTC	AGGGGACGAAACACCGGTCCGTAGGAGACCCGTGTGGCATGTACCTGTGG	1
AGTCTGCCTC	GAAACACCGGTAACTATATTCATGCGATATCGCCGTATCAGTGGGGTTAG	1
AGTCTGCCTC	GAAACACCGGTACCTTTGTTGATGCTGGGTGGAAGGAATTTGTGGGGTTA	1
AGTCTGCCTC	GAAACACCGGTAGCAAGTTAACCTAAGGCTAGTCCGTTATCAACTTGAAA	1
AGTCTGCCTC	GAAACACCGGTCCCTAGGAGGCCCGGTCATCAGGTGCAAGAGGGGGTAGA	1
AGTCTGCCTC	GAAACACCGGTCCGCAGGTTCACCGGGTGGCATGGACCTGGGGGGGTAAA	1
AGTCTGCCTC	GAAACACCGGTCCGTAGGAGACCCGCGTGGCGTTAGCCTGTGGAGTTAGA	1
AGTCTGCCTC	GAAACACCGGTCCGTAGGAGACCCTTTTGGCATTTCCGTGTGTGGTGAGA	1
AGTCTGCCTC	GAAACACCGGTCCGTAGGAGACCGTGTGGCATGTACCTGTGGGGTTAGAG	1
AGTCTGCCTC	GAAACACCGGTCCGTATGAGACCCGTGTTACATGTACCTAGTGGGCTAAA	1
AGTCTGCCTC	GAAACACCGGTCGAGGCCACTCAGTGGTGGGGTTAGAGCTAGAAATAGCA	1
AGTCTGCCTC	GAAACACCGGTCGGCGGGGGGGGGTTAGAGCTAGAAATAGCAAGTTAACC	1
AGTCTGCCTC	GAAACACCGGTCGGGGCCACTCAGTGGTGGGGTTAGAGCTAGAAATAGCA	1
AGTCTGCCTC	GAAACACCGGTCGGTTCATATCGAAACCTTCCCGTGACAGTGGGGTTAGA	1
AGTCTGCCTC	GAAACACCGGTTAAGCCGAGGAGTTAGAGCTAGAAATAGCAAGTTAACCT	1
AGTCTGCCTC	GAAACACCGGTTACATTGAGGGTTAGAGCTAGAAATAGCAAGTTAACCTA	1
AGTCTGCCTC	GAAACACCGGTTACGTGGGGTTAGAGCTAGAAATAGCAAGTTAACCTAAG	1
AGTCTGCCTC	GAAACACCGGTTAGGCCGAGAAGTTAGAGCTAGAAATAGCAAGTGAACCT	1
AGTCTGCCTC	GAAACACCGGTTTGAACTACCTAGTTCAAACCGGTGGGGTTAGAGCTAGA	1
AGTCTGCCTC	GAAACACCGGTTTGAACTAGAAATAGCAAGTTAACCTAAGGCTAGTCCGT	1
AGTCTGCCTC	GAAACGCCGGTCCGTAGGACACCCTGGTGGCGTGAACCTGAGGAGTTACA	1
AGTCTGCCTC	GAACACCGGTCCGTAGGAGACCCGTGTGGCATGTACCTGTGGGGTTAGAG	1
AGTCTGCCTC	GACGAAACACCGGTCCGTAGGAGACCCGTGTGGCATGTACCTGTGGGGTT	1
AGTCTGCCTC	GACGAGACACCGGTCCGTAGGAGACCCGTGTGGCATGTACCTGTGGGGTT	1
AGTCTGCCTC	GCAATGACGAAACACCGGTCCGTAGGAGACCCGTGTGGCATGTACCTGTG	1
AGTCTGCCTC	GTAAGCAACACCGGTCCGTAGGTGAACCTTGTGGCATGGCCCTGTGGGGG	1
AGTGAAGCCT	GAAACACCGGTTCCCGTCCAGTGGGGTTAGAGCTAGAAATAGCAAGTTAA	1
AGTGAAGCCT	GAAACACCGGTTCCCGTCCAGTGGGGTTAGAGCTAGAAATAGCAAATTAA	1
AGTGACCCTC	GAAACACCGGTGTGGCTGAGAGTCCGGCAATGGTGTGGCTGGGGGGTTAT	1
AGTGCCCGTC	GAAACACCGGTACCCTTACTCTCACCTGATTACTTAATCCGTGGGGTTAG	1
AGTGCGCATA	GAAACACCGGTTAAGCCGATGTGCTTTTTTCCTGCAGGTTATGCTCAAGA	1
AGTGCGCTAC	GAAACACCGGTGCCCTTACACTCACCTGATTACTTAATCCGTGGGGTTAG	1
AGTGCTGTCC	GAAAGACCGGTACATTTTTCCTGCCGGACAGAGCGCGGACATCGGGCTAG	1
AGTGGAGACT	GAAACACCGGTTCCCGTCCAGTGGGGTCAGAGCTAGAAATAGCAAGTTAA	1
AGTGGAGACT	GAAACACCGGTTCCCGTCCAGTGGGGCTAGAGCTAGAAATAGCAAGTTAA	1
AGTGGAGACT	GAAACACCGGTTCCCGTCCAGTGGGGTTAGAGCTAGAAATAGCAAGTTAA	1
AGTGGAGCAT	GAAACACCGGTTCCCGTCCAGTGGGGTTAGAGCTAGAAATAGCAAGTTAA	1
AGTGGAGCCG	GAAACACCGGTTCCCGTCCAGTGGGGTTAGAGCTAGAAATAGCAAGTTAA	1
AGTGGAGCGT	GAAACACCGGTTCCCGTCCAGTGGGGTTAGAGCTAGAAATAGCAAGTTAA	2
AGTGGAGCGT	GAACCACCGGTTCCCGTCCAGTGGGGTTAGAGCTAGAAATAGCAAGTTAA	1
AGTGGAGCTT	GAACACCGGTTCCCGTCCAGTGGGGTTAGAGCTAGAAATAGCAAGTTAAC	1
AGTGGAGGCT	GAAACACCGGTTCCCGTCCAGTGGGGTTAGAGCTAGAAATAGCAAGTTAA	1
AGTGGATCCT	GAAACACCGGTTCCCGTCCAGTGGGGTTAGAGCTAGAAATAGCAAGTTAA	2
AGTGGCGCAT	GAAACACCGGTTCCCGTCCAGTGGGGTTAGAGCTAGAAATAGCAAGTTAA	1
AGTGGCGCCT	GAAACACCGGTTCCCGTCCAGTGGGGTTAGAGCTAGAAATAGCAAGTTAA	2
AGTGGGGCTT	GAAACACCGGTTCCCGTCCAGTGGGGTTAGAGCTAGAAATAGCAAGTTAA	1
AGTGGTGTTT	GAAACACCGGTGACATTGGGGTGGGGTTAGAGCTAGAAATAGCAAGTTAA	1
AGTGTAGGCT	GAAACACCGGTGACATTGGGTACAGGGTGGGGTTAGAGCTAGAAATAGCA	1
AGTGTCGGAC	GAAACACCGGTACCTTTGTTGATGCTGGGTGGAAGGATTTTTGTGGGGTT	1
AGTGTTCTGT	GAAACACCGGTGGGGTTAGAGCTGGATATAGCAAGTTAACCTAAGGCTAG	1
AGTGTTGGAT	GAAACACCGGTGACATTGGGGCTAGCAATAGCAAGTTAACGTTAGGCTAG	1
AGTTAGAATC	GAAACACCGGTCCGTAGGAGACCCGTGTGGCATGTACCTGTGGGGTTAGA	1
AGTTCGTCCC	GAAACACCGGTCCGTAGGAGACCCGTGTGGCATGTACCTGTGGGGTTAGA	1
AGTTGGACGC	GAAACACCGGTCCGTAGGAGACCCGTGTGGCATGTACCTTGTGGGGTTAG	1
ATAAAAAGCG	GAAACACCGGTCGGCGGCAATCGTGGTTAGAGCTAGAAATAGCAAGTTAA	1
ATAAACCTGT	GAAACACCGGTAAATTTGAGGCTCCGGCATGCAGGAGGCCGTGGGGTTAG	1
ATAAATGGCC	GAAACATCGGTACCTTTGTTGATGCTGGGTGGGGTTAGAGCTAGCAATAG	1
ATAAATTACA	GAAACACCGGTAACTATATTCATGCGATATCGCCGTATCAGTGGGGTTAG	1
ATAACACCGT	GAAACACCGGTTACATTGCGGCGTAGGGCTAGATATAGCTAGTTAACCTA	1
ATAACATATA	GAAACACCGGTAACTATATTCATGCGATATCGCCGTATCAGTGGGGTTAG	1
ATAACCATGC	GAAACACCGGTTACATTGAGGGGTTACAGCTTAAAATAGCGAGATAACCT	1
ATAACCTCTC	GAAACACCGGTGCATTCGAAAGTCCGGTCGTAGTGTGGACGTGGGGTTAG	1
ATAACGTATA	GAAACACCGGTAACTATATTCATGCGATATCGCCGTATCAGTGGGGTAGG	1
ATAACGTCGT	GAAACACCGGTGTACGTATGGACTGAACCAGGGTGTGCAAGTGGGGTTAG	1
ATAACGTTCT	GAAACACCGGTTGCAATCAGGGTGAGATATTGACCTAGCAGGTTGACCTA	1
ATAACTCTGT	GAAACACCGGTTATTTGAGGGTTAGAGCTAGAAGTAGCAAGTTAACCTAA	1
ATAACTTCTA	GAAACACCGGTAACTATATTCATGCGATATCGCCGTATCAGTGGGGTTAG	1
ATAAGACAAC	GAAACACCGGTCGGCGGCAATCGAGGGTGGGGTTAGAGCTAGAAATAGCA	1
ATAAGATATG	GAAACACCGGTTACATTGAGTGGGGTTAGAGCTAGAAATAGCAAGTTAAC	1
ATAAGCGGTA	GAAACACCGGTCGATTCATATCGAAATCTTCCCGTGACTGTGGGGTTAGA	1
ATAATAAAGC	GAAACACCGGTCGGGGCCACTCAGTGGTGGGGTTAGAGCTAGAAATAGCA	1
ATAATAGGCC	GAAACACCGGTACCTTTGTTGATGCTGGTTGTGGGGTTAGAGCTAGAAAT	1
ATAATTTATA	GAAACACCGGTAACTATATTCATGCGATATCGCCGTATCAGTGGGGTTAG	1
ATACAACGCA	GAAACACCGGTTTGAACTAGAAATAGCAAGTTAACCTAAGGCTAGTCCGT	1
ATACAACGCC	GAAACACCGGTTTGAACTACCTAGCAAGTTAACCTAAGGCTAGTCCGTTA	1
ATACACGGAC	GAAACACCGGTACCTTTGTTGATGCTGGGTGGGGTTAGAGCTAGAAATAG	1
ATACCAACGC	GAAACACCGGTGCATTCGAAAGTCCGGTCGTAGTGTGGACGTGGGGTTAG	2
ATACCAGCGC	GAAACACCGGTGCATTCGAAAGTCCGGTCGTAGTGTGGACGTGGGGTTAG	1
ATACCCTAGA	GAAACACCGGTGCATTCGAAAGTCCGGTCGTAGTGTGGACGTGGGGTTAG	1
ATACCGCCTC	GAAACACCGGTGCATTCGAAAGTCCGGTCGTAGTGTGGACGTGGGGTTAG	1
ATACCTTCTC	GAAACACCGGTGCATTCGAAAGTCCGGTCGTAGTGTGGACGTGGGGTTAG	1
ATACGAGGCT	GAAACACCGGTTTGAGCTACCGGGGTTAGAGCTAGAAGTAGCAAGTTAAC	1
ATACGCAGTA	GAAACACCGGTGCCCTTACTCTCACCTGATTACTTAATCCGTGGGGTTAG	1
ATACGCCTTA	GAAACACCGGTGCCCGTACTCTCACCTGATTACTTAATACGTGGGGATAG	1
ATACGCTCGA	GAAACACCGGTTAATTCGAAGAGCCGGTCGAGGTGTAGACGTGGGGTTAG	1
ATACGGTCGC	GAGACACCGGTGCATTCGAAAGTCCGGTCGTAGTGTGGACGTGGGGTTAG	1
ATACTAGGCA	GAAACACCGGTACCTTTGTTGTGGGGTTAGAGCTAGAAATAGCAAGTTAA	1
ATACTATGCC	GAAACACCGGTACCTTTGTTGATGCTGGGGGGAAGGAATTTTGTGTGGTT	1
ATACTCAGTC	GAAACACCGGTACCTTTGTTGATGCTGGGTGTTAGAGCTAGGTTAGAGCT	1
ATACTCCGCG	GGGTTAGAGCTAGAACTAGCAAGTTAACCTAAGGCTAGTCCGGTATCAAC	1
ATACTCGGAT	GAAACACCGGTACCTTTGTTGAAGCTAGAAATAGCAAGTTAACCTAAGGC	1
ATACTCGGGT	GAAACACCGGTACCTTTGTTGATGCTGGGGGGAAGGATTTTTGTGGGGTT	1
ATACTCTAGC	GAAACACCGGTGCATTCGAAAGTCCGGTCGTAGTGTGGACGTGGGGTTAG	1
ATACTCTGTC	GAAACACCGGTACCTTTGTTGATGCTGGGTGGAAGGAATTTTGTGGGGTT	1
ATACTTATGT	GAAACACCGGTTTACGTTGCATCTAGAGGTGGAAATAGCTAGATATAGTA	1
ATACTTCCGC	GAAACACCGGTCTACGGTAATCGTGGGTGGGGTTAGAGCTAGAAATAGCA	1
ATAGACGCTC	GAAACACCGGTGCATTCGAAAGTCCGGTCGTAGTGTGGACGTGGGGTTAG	1
ATAGAGCGTC	GAAACACCGGTTCCCGTCCAGTGGGTGTAGAGCTAGAAATAGCAAGATAA	1
ATAGATATGC	GAAACACCGGTTACATTGAGGGGTTAGAGCTAGAAATAGCAAGTTAACCT	1
ATAGATGTGT	GAAACACCGGTTACATTGAGGGTTAGAGCTAGAAATAGCAAGTTAACCTA	1
ATAGCCATAC	GAAACACCGGTGCCCTTACTCTCACCTGATTACTTAATCCGTGGGGTTAG	1
ATAGCCGCTC	GAAACACCGGTTCCCGTCCAGTGGGGTTAGAGCTAGAAATAGCAAGTTAA	1
ATAGCTCTGA	GAAACACCGTTTACATTGAGATTGGGGTTAGAGCTAGAAATAGCAAGTTA	1
ATAGCTTATA	GAAACACCGGTAACTATATTCATGCGATATCGCCGTATCAGTGGGGTTAG	2
ATAGGGATGA	GAAACACCGGTTACATTGAGGGTTAGAGCTAGAAATAGCAAGTTAACCTA	1
ATAGGGCATA	GAAACACCGGTTAAGCCGAGGTGGGGTTAGAGCTAGAAATAGCAAGTTAA	1
ATAGGTAGGT	GAAACACCGGTTACATTGAGATTAGAGCTAGAAAAGGCTAGTCCGTTATC	1
ATATACACCC	GAAACACCGGTACCTTTGTTGATGCTGGGTGGATAGGAATTCGGGCCCAT	1
ATATATCGAG	GAAACACCGGTTATATTTGTAGTGGGGTTAGAGCTAGAAATAGCAAGTTA	1
ATATATCGGG	GAAACACCGGTTATATTTGTAAGTGTGTGGGGTTAGAGCTAGAAATAGCA	1
ATATCCACCA	GAAACACCAGTACCTTTGTTGATGCTGGGTGGATAGGAATTCGGGCCCAT	1
ATATCCACCC	GAAACACCGGTACCTTTGTTGATGCTGGGTGGATAGGAATTCGGGCCCAT	1
ATATCGTCGT	GAAACACCGGTGTACGTATGGACTGAACCAGGGTGTGCAAGTGGGGTTAG	1
ATATCTGGAT	GAAACACCGGTCGATTCATATCGAAACCTTCCCTAGACAGTGGGGTTAGA	1
ATATTTACCG	GAAACACCGGTCGGGGCCGCTCAGTGGTGGGGTTAGAGCTAGAAATAGCA	1
ATATTTAGTT	GAAACACCGGTTTACGTTGCATCGGGGTTAGAGCTAGAAATAGCAAGTTA	1
ATCACACTAC	GAAACACCGGTGCCCTTACTCTCACCTGATTACTTAATCCGTGGGGTTAG	1
ATCCACCGAC	GAGGCTAGTCCCGTTTCAACTTGAAAAAATGGCTGCGGGGCGGGGGCTTG	1
ATCCATCGAG	GAAACACCGGTTATATCTGTAAGTGTGTGGGGTTAGAGCTAGAAATAGCA	1
ATCCGCGGCC	GAAACACCGGTACCTTTGTTGATGCTGGTTGGAAGGAATTTGTGGGGTTA	1
ATCCTAGGCC	GAAACACCGGTACCTTTGTTGATGCTGGGTGGAAGGAATGTGGGGTTAGA	1
ATCCTCGGAC	GAAACACCGGTACCTGTGTTGATGCTGGGTGGAAGGAATTTGTGGGGTTA	1
ATCCTTTACC	GAAACACCGGTCGGGGCCACTCAGTGGTGGGGTTAGAGCTAGAAATAGCA	1
ATCGAACGAG	GAAACACCGGTTCTGTTTCTATGTGTGTGGGGTTAGAGCTAGAAATAGCA	1
ATCGAATCCT	GAAACACCGGTCTCGAGTGAGGTGTTCAGGTGGGGTTAGAGCTAGAAATA	1
ATCGATCGAG	GAAACACCGGTTATATTTGTAAGTGTGTGGGGTTAGAGCTAGAAATAGCA	1
ATCGATCGAG	GAAACACCGGTTATAGTAGAGCTAGAAATAGCAAGTTAACCTAAGGCTAG	1
ATCGCCATAA	GAAACACCGGTGCCCTTACTCTCACCTGATTACTTAATCCGTGGGGTTAG	1
ATCTACTCGG	GAAACACCGGTACCTTTGTTGATGCTGGGTGGTGGGGTTAGAGCTAGAAA	1
ATCTATAGAG	GAAACACCGGTTATATTTGTAAGTGTTTGTGGGGTTAGAGCTGGAAATAG	1
ATCTATAGAG	GAAACACCGGTTATATTTGTAAGGGGTTAGAGCTAGAAATAGCAAGTTAA	1
ATCTATAGAG	GAAACACCGGTTATATTTGTAAGTGTGTGGGGTTAGAGCTAGAAATAGCA	1
ATCTATCAAG	GAAACACCGGTTATATTTGTAAGTGTGTGGGGTTAGAGCTAGAAATAGCA	1
ATCTATCGAC	GAAACACCGGTCTCGAGTGAGGTGTTCAGGTGGGGTTAGAGCTAGAAATA	1
ATCTATCGTT	GAAACACCGGTTATATTTGTAAGTGTGTGGGGTTAGAGCTAGAAATAGCA	1
ATCTATCTAG	GAAACACCGGTTATATTTGTAAGTGTGTGGGGTTAGAGCTAGAAATAGCA	1
ATCTATGGAG	GAAACACCGGTTATATTTGTAAGTGTGTGGGGTTAGAGCTAGAAATAGCA	1
ATCTCTCGTA	GAAACACCGGTTATATTTGTAAGTGTGTGGGGTTAGAGCTAGAAATAGCA	1
ATCTGTCGAG	GAAACACCGGTTATATTTGTAAGTGTTGTGGGGTTAGAGCTAGAAATAGC	1
ATCTTTACAG	GAAACACCGGTCGGGGCCACTCAGTGGTGGGGTTAGAGCTAGAAATAGCA	1
ATGAACGGCA	GAAACACGTGGGGTTAGAGCTAGAAATAGCAAGTTAACCTAAGGCTAGTC	1
ATGAAGCGAA	GAAACACCGGTCGGCGGCAATCGTGTGGGGGTGGGGTTAGAGCTAGAAAT	1
ATGAATCCTT	GAAACACCGGTCTCGAGTGAGGTGTTCAGGGTGGGGTTAAAGCTAGAAAT	1
ATGACAAGCT	GAAACACCGGTTTACGTTGCATCGGTTTGTGGGGTTAGAGCTAGAAATAG	1
ATGACTACCA	GAAACACCGGTTTACGTTGCATCGGCTGTGGGGTTAAAGCTAGAATTAGC	1
ATGAGCAGCT	GAAACACCGGTTAAGCCGAGTGGGGTTAGAGCTAGAAATAGCAAGTTAAC	1
ATGAGCTATG	GAAACACCGGTTACATTGAGGGTTAGAGCTAGAAATAGCAAGTTAACCTA	1
ATGAGCTTAC	GAAGCACTGGTTAAGCCGAGGGGTTAGAGCTAGAAATAGCAAGTTAGCCT	1
ATGAGCTTAT	GAAACACCGGTTAAGCCGAGGAGTTAGTGCTAGGAATAGCAAGTTAACAT	1
ATGATAAGCA	GAAACACCGGTTTACGTTGCATCGGTGTGGGGTTAGAGCTAGAAATAGCA	1
ATGATAATCT	GAAACACCGGTTTACGTTGCATCGGTGTGGGGTTAGAGCTAGAAATAGCA	1
ATGATAATCT	GAAACGCCGGTTTACGTTGCATCGGTGTGGGGTTAGAGCTAGAAATAGCA	1
ATGATCATAT	GAAACACCGGTTAAGACGAGTGGGGTTAGAGCTAGAAATAGCAAGTTAAC	1
ATGATCATTT	GAAACACCGGTTAAGCCGAGGAGTTTCGTTAGAGCTAGAATTAGCAAGTT	1
ATGATGCCTC	GAAACACCGGTCCGTAGGAGACCCGTGTGGCATGTACCTGTGGGGTTAGA	1
ATGATTAGAA	GAAACACCGGTTTACCTAATAGCAAGTTAACCTAAGGCTAGTCCGTTATC	1
ATGATTAGAC	GGAACACCGGTTTACGTTGCATCGGTGTGGGGTTAGAGCTAGAAATAGCA	1
ATGATTCGCC	GAAACACCGGTTTACGTTGCATCGCTAGAAATAGCAAGTTAACCTAAGGC	1
ATGCAGAGAT	GAAACACCGGTTTACGTTCCATCGGTGTGGGGTTAGACCTAGAAATAGCA	1
ATGCATAGAA	GAAACACCGGTTTAAGACGCATCGGGCTGGAGGTAGAAATAGGAAGTTAG	1
ATGCATCCTC	GAAACACCGGTGTGGCTGAGAGTCCGGCAATGGTGTGGCTGTGGGGTTAG	1
ATGCCAAACA	GAAACACCGGTATACGGTGCATCGGTTGTTTGGTCAGAGCTAGAAATAAC	1
ATGCCATGCA	GAAACACCGGTGTGGCTGAGAGTCCGGCAATGGTGTGGCTGTGGGGTTAA	1
ATGCCCAGGC	GAAACACCGGTTTACGTTGCATCGGTGTGGGGTTAGAGCTAGGAATAGCA	1
ATGCCTATGT	GACGAAACACCGGTTTACGTTGCATCGGTTGTGGGGTTAGAGCTAGAAAT	1
ATGCGCATTA	GAAACACCGGTTAAGACGAGGAGTTATAGCTGGCACTCCCCATTTAGCCT	1
ATGCGTAGGA	GAAACACCGGTTTACGCTGCATCGGTTGTGGGGTTAGAGCTAGAAATAGC	1
ATGCGTAGTC	GAAACACCGGTTTACGTTGCATCGGTTTGTGGGGTTAGAGCTAGAGATAG	1
ATGCGTCGAT	GAAACACCGGTTTACGTTGCATCGGTGTGGGGTTAGAGCTAGAAATAGCA	1
ATGCTAATAA	GAAACACCGGTTAAGCCGAGGGTTTAGAGCTAGAAATAGCAAGTTAACCT	1
ATGCTAGCCC	GAAACACCGGTTTACGTTGCATCGGTGTGGGGTTAGAGCTAGAAATAGCA	1
ATGCTCATAA	GAAACACCGGTTAAGCCGAGTGGGGTTAGAGCTTGAGATAGCAAGTTAAC	1
ATGCTGACTT	GAAACACCGGTTTACGTTGCATCGGGGTTAGAGCTAGAAATAGCAAGTTA	1
ATGCTTAGCT	GAAACACCGGTTTACGTTGCATCGGTGTGGGGTTAGAGCTAGAAATAGCA	1854
ATGCTTAGCT	GAAACACCGGTTTACGTTGCATCGGTTGTGGGGTTAGAGCTAGAAATAGC	332
ATGCTTAGCT	GAAACACCGGTTTACGTTGCATCGGGGTTAGAGCTAGAAATAGCAAGTTA	243
ATGCTTAGCT	GAAACACCGGTTTACGTTGCATCGGGTTAGAGCTAGAAATAGCAAGTTAA	128
ATGCTTAGCT	GAAACACCGGTTTACGTTGCATCGGTTTGTGGGGTTAGAGCTAGAAATAG	84
ATGCTTAGCT	GAAACACCGGTTTACGTTGCATCGTGGGGTTAGAGCTAGAAATAGCAAGT	57
ATGCTTAGCT	GAAACACCGGTTTACGTTGCAGGAGCTAAGCATGAATTCGGGCCCATTGG	50
ATGCTTAGCT	GAAACACCGGTTTACAAGTTAACCTAAGGCTAGTCCGTTATCAACTTGAA	29
ATGCTTAGCT	GAAAGTTAACCTAAGGCTAGTCCGTTATCAACTTGAAAAAGTGGCACCGA	29
ATGCTTAGCT	GAAACACCGGTTTACGTTGCATCGTTAGAGCTAGAAATAGCTAGAAATAG	26
ATGCTTAGCT	GAAACACCAGTTAACCTAAGGCTAGTCCGTTATCAACTTGAAAAAGTGGC	22
ATGCTTAGCT	GAAACACCGGGGGTTAGAGCTAGAAATAGCAAGTTAACCTAAGGCTAGTC	21
ATGCTTAGCT	GAAACACCGGTTAGAGCTAGAAATAGCAAGTTAACCTAAGGCTAGTCCGT	21
ATGCTTAGCT	CTTAACCTAAGGCTAGTCCGTTATCAACTTGAAAAAGTGGCACCGAGTCG	19
ATGCTTAGCT	GAAACACCGGTTTACGTTAAGTTAACCTAAGGCTAGTCCGTTATCAACTT	19
ATGCTTAGCT	GAAACACCGGTTTGTGGGGTTAGAGCTAGAAATAGCAAGTTAACCTAAGG	19
ATGCTTAGCT	GAAACACCGGTTTACCTAATAGCAAGTTAACCTAAGGCTAGTCCGTTATC	17
ATGCTTAGCT	GGGTTAGAGCTAGAAATAGCAAGTTAACCTAAGGCTAGTCCGTTATCAAC	16
ATGCTTAGCT	GAAACACCGGTTTACGTTGCATCGCTAGAAATAGCAAGTTAACCTAAGGC	15
ATGCTTAGCT	GAAACACCGGTTTACGTTGCGTTAGAGCTAGAAATAGCAAGTTAACCTAA	15
ATGCTTAGCT	GAAACACCGGTTTACGTTGCATCTAACCCCATCGTTGTGGGGTTAGAGCT	14
ATGCTTAGCT	GAAACACCGGTTTACGTTGGAGCTAGAAATAGCAAGTTAACCTAAGGCTA	12
ATGCTTAGCT	GAAACACCGGTTTACGTGGGGTTAGAGCTAGAAATAGCAAGTTAACCTAA	10
ATGCTTAGCT	CAAAACACCGGTTTACGTTGCATCGGTGTGGGGTTAGAGCTAGAAATAGC	5
ATGCTTAGCT	GAAACACCGGTTTACGTTGCTTAGAGCTAGAAATAGCAAGTTAACCTAAG	5
ATGCTTAGCT	GAAACACCGGTTTAGGGGTTAGAGCTAGAAATAGCAAGTTAACCTAAGGC	4
ATGCTTAGCT	GAAACGGGGTTAGAGCTAGAAATAGCAAGTTAACCTAAGGCTAGTCCGTT	4
ATGCTTAGCT	GAAACACCGGTTTACGTTGCATCGGTTACGTTGCAACGTGGGGTTAGAGC	3
ATGCTTAGCT	GAAACGGGGTTAGAGCTAGAAATAGCAAGTTAACCTAGGGCTAGTCCGTT	3
ATGCTTAGCT	GACGAAACACCGGTTTACGTTGCATCGGTGTGGGGTTAGAGCTAGAAATA	3
ATGCTTAGCT	GAAACACCGGTGTGGCTGAGAGTCCGGCAATGGTGTGGCTGTGGGGTTAG	2
ATGCTTAGCT	GAAACACCGGTTTACGTTGCATCGGTTACGTCGCAACGTGGGGTTAGAGC	2
ATGCTTAGCT	CAAAACACCGGTTTACGTTGCATCGCTAGAAATAGCAAGTTAACCTAAGG	1
ATGCTTAGCT	CAAAACACCGGTTTACGTTGCATCGGTTGTGGGGTTAGAGCTAGAAATAG	1
ATGCTTAGCT	GAAACACCGGTAAATTTGAGGCTCCGGCATGCAGGAGGCCGTGGGGTTAG	1
ATGCTTAGCT	GAAACACCGGTACCTTTGTTGATGCTGGGTGGAAGGAATTTTGTGGGGTT	1
ATGCTTAGCT	GAAACACCGGTACTCCGGAAGGCGAAGTGGGGTTAGAGCTAGAAATAGCA	1
ATGCTTAGCT	GAAACACCGGTAGCAAGTGCGAGCTAGAAATAGCAAGTTAACCTAAGGCT	1
ATGCTTAGCT	GAAACACCGGTCCGTAGGAGACCCGAGTGGCATGTACCTGTGGGGTTAGA	1
ATGCTTAGCT	GAAACACCGGTCGATTCATATCGAGACCTTGCCGTGACAAGTGGGGATAG	1
ATGCTTAGCT	GAAACACCGGTGCATTCGAAAGTCCGGTCGTAGTGTGGACGTGGGGTTAG	1
ATGCTTAGCT	GAAACACCGGTTAAGCCGTGGAGTTAGAGCTAGAAATAGCAAGTTAACCT	1
ATGCTTAGCT	GAAACACCGGTTACATCGAGGGTTAGAGCTAGAAATAGCAAGTTAACCTA	1
ATGCTTAGCT	GAAACACCGGTTACGTTGCAGGAGCTAAGCATGAATTCGGGCCCATTGGT	1
ATGCTTAGCT	GAAACACCGGTTACGTTGCATCGGTGTGGGGTTAGAGCTAGAAATAGCAA	1
ATGCTTAGCT	GAAACACCGGTTAGAACTAGACCTAGCAAGTTAGCATATGGCTAGTCAGA	1
ATGCTTAGCT	GAAACACCGGTTCCCGTCCAGTGGGGTTAGAGCTAGAAATAGCAAGTTAA	1
ATGCTTAGCT	GAAACACCGGTTTACGCTGTATCGTTGTGGAGTTAGAGTTGGAAAAGGAA	1
ATGCTTAGCT	GAAACACCGGTTTACGGTGCGGCTAGAGCGGGTTATAGCTAGATATACTA	1
ATGCTTAGCT	GAAACACCGGTTTACGTTCATCGGTGTGGGGTTAGAGCTAGAAATAGCAA	1
ATGCTTAGCT	GAAACACCGGTTTACGTTGCATCGGGGTTAGCTAGAAATAGCAAGTTAAC	1
ATGCTTAGCT	GAAACACCGGTTTACGTTGCATCGGGTTTATAGCTATCACTAGCCCTTTC	1
ATGCTTAGCT	GAAACACCGGTTTACGTTGCATCGGTGAAGGGGGAGAGAGAGCAAGAGCA	1
ATGCTTAGCT	GAAACACCGGTTTACGTTGCATCGGTGATTGGGTAGAGCTAGCAATAGAT	1
ATGCTTAGCT	GAAACACCGGTTTACGTTGCATCGGTGTGGGTTAGAGCTAGAAATAGCAA	1
ATGCTTAGCT	GAAACACCGGTTTACGTTGCATCGGTGTGGGTTAGAGCTAGAAATAGCGA	1
ATGCTTAGCT	GAAACACCGGTTTACGTTGCATCGGTGTTGGGGGGGTTCTAGCTAGAGCA	1
ATGCTTAGCT	GAAACACCGGTTTACGTTGCATCGGTTACGTTGCAGCGTGGGGTTAGAGC	1
ATGCTTAGCT	GAAACACCGGTTTACGTTGCTTAGAGCTAGGAATAGCAAGTTAACCTAAG	1
ATGCTTAGCT	GAAACCCGGTTTACGTTGCATCGGTGTGGGGTTAGAGCTAGAAATAGCAA	1
ATGCTTAGCT	GAAAGTTAACCTAAGGCTAGTCCGTTATCAACTTGAAAAGTGGCACCGAG	1
ATGCTTAGCT	GACGAAACACCGGTTTACGTTGCATCGGGTTAGAGCTAGAAATAGCAAGT	1
ATGGAATCCT	GAAACACCGGTCTCGAGTGAGGTGTTCAGGGTGGGGTTAGAGCTAGAAAT	1
ATGGAGGGTC	GAAACATCGGTTCCCTCCCAGTGAGACTATAGCTAGAAATAGCAAGTTAA	1
ATGGCGTCTC	GAAACACCGGTTCCCGTCCAGTGGGGTTAGAGCTAGAAATAGCAAGTTAA	1
ATGGTGCGTA	GAAACACCGGTTAAGTAGAGCTAGAAATAGCAAGTTAACCTAAGGCTAGT	1
ATGGTTGGCA	GAAACACCGGTTTACGTTGCATCGGAGTGTGGTTAGAGATAGAAATAGCT	1
ATGGTTGTCT	GAAACACCGGTTAAAGTTGGAAGGAATAGCAAGTTAACCTAAGGCTAGTC	1
ATGTGAGTAA	GAAACACCGGTTAAGCCGAGTGGGGTTAGAGCTAGAAATAGCAAGTTAAA	1
ATGTTGAGGC	GAAACACCGGTCGGGGCCACTCAGTGGTGGGGTTAGAGCTAGAAATAGCA	1
ATGTTGAGTT	GAAACACCGGTTTACTTTGCATCGGCTTCGTGCTTGACATAGCAAGTTAA	1
ATGTTGCGCT	GAAACACCGGTTTATCTTGCATCGGTTCTGGGGTAGAGCTAGAAATAGCT	1
ATTACTCGGC	GAAACACCGGTACCTTTGTTGATGCTGGGTGGAAGGAATGTGGGGTTAGA	1
ATTACTCGGC	GAAACACCGGTACCTTTGTTGATGCTGGGTGGAAGGTGGGGTTAGAGCTA	1
ATTACTCGGT	GAAACACCGGTACCTTTGTTGTGGGGTTAGAGCTAGAAATAGCAAGTTAA	1
ATTAGATAGG	GAAACACCGGTTACATTGAGGGGTTAGAGCTAGAAATAGCAAGTTAACCT	1
ATTAGATATG	GAAACACCGGTTACATTGAGGGTTAGAGCTAGAAATAGCAAGTTAACCTA	2
ATTAGATATG	GAAACACCGGTTACATTGAGGGGTTAGAGCTAGAAATAGCAAGTTAACCT	1
ATTAGATATG	GAAACACCGGTTACAATTGAGGGTTAGAGCTAGAAATAGCAAGTTAACCT	1
ATTAGCAATG	GAAACACCGGTTACATTGAGATTAGAGCTAGAAAAGGCTAGTCCGTTATC	1
ATTAGCGATG	GAAACACCGGTTACAGGGGTTAGAGCTAGAAATAGCAAGTTAACCTAAGG	1
ATTAGCTACG	GAAACACCGGTTACATGAGGGGTTAGAGCTAGAAATAGCAAGTTAACCTA	1
ATTAGCTAGG	GAAACACCGGTTAAGGGTTAGAGCTAGAAATAGCAAGTTAACCTAAGGCT	1
ATTAGCTCTG	GAAACACCGGTTACATTGAGGGTTAGAGCTAGAAATAGCAAGTTAACCTA	1
ATTAGTTCTG	GAAACACCGGTTACATTGAGTGGGGTTAGAGCTAGAAATAGCAAGTTAAC	1
ATTATCCTTA	GAAACACCGGTTAAGCCGAGAGGGGTTAGAGCTATACATAGCAAGTTAAC	1
ATTCCCATCT	GAAACACCGGTTTGGCTGACAGTGCGGCAATGGTGTGGCTGTGGGGATAG	1
ATTCGCTATG	GAAACACCGGTTACATTGAGGGTTAGAGCTAGAAATAGCAAGTTAACCTA	1
ATTCGCTATG	GAAACACCGGTTACATTGAGTGGGGTTAGAGCTAGAAATAGCAAGTTAAC	1
ATTCGTCGTT	GAAACACCGGTTTACGTTTGTACGGAACAGGAATAGGCAGGTAAGGTTAG	1
ATTCTATCTG	GAAACACCGGTTATATTTGTAAGTGGGGTTAGAGCTAGAAATAGCAAGTT	1
ATTCTCAGCG	AAACAACTTGAAAAAGTGGCACAGAGTCGGTGCTTTTTTTCCTGCAGGCC	1
ATTCTTACTC	GAAACACCGGTCCGTAGGAGACCCGTGTGGCATGTACCTGTGGGGTTAAT	1
ATTGAGAATA	GAAACACCGGTTAAGCCGAGTGGGGTTAGAGCTAGAAATAGCAAGTTAAC	1
ATTGAGAATA	GAAACACCGGTTAAGCCGAGGGGTTAGAGCTAGAAATAGCAAGTTAACCT	1
ATTGAGCATC	GAAACACCGGTTAAGCCGAGTGGGGTTAGAGCTAGAAATAGCAAGTTAAC	1
ATTGAGCATC	GAAACACCGGATAATACGATAGGGGTTAGAGCTAGAAATAGCAAGTTAAC	1
ATTGAGCATT	GAAACACCGGTTAAGCCGAGGTTAGAGCTAGAAATAGCAAGTTAACCTAA	1
ATTGAGCCTA	GAAACACCGGTTAAGCCGAGGAGTTTCGTTAGAGCTAGAAATAGCAAGTT	1
ATTGAGCCTA	GAAACACCGGTTAAGCCGAGGGGTTAGAGCTAGAAATAGCAAGTTAACCT	1
ATTGAGCTTA	GAAACACCGGTAGTGGGGTTAGAGCTAGAAATAGCAAGTTAACCTAAGGC	1
ATTGAGGATA	GAAACACCGGTTAAGCCGAGGTGGGGTTAGAGCTAGAAATAGCAAGTTAA	1
ATTGCACGTA	GAAACACCGGTTAAGCCGAGTGGGGTTAGAGCTAGAAATAGCAAGTTAAC	1
ATTGGAGGCT	GAAACACCGGTTCCCGTCCAGTGGGGTTAGAGCTAGAAATAGCAAGTTAG	1
ATTGTTGATT	GAAACACCGGTGACTTTGGGTAGAAATCGCAAGTTAATATAGGTCTAAAC	1
ATTTAGCATA	GAAACACCGGTTAAGCCGAGTGGGGTTAGAGCTAGAAATAGCAAGTTAAC	1
CAAAAAGACC	GAAACACGGGTTAGAGCTAGAAATAGCAAGTTAACCTAAGGCTAGTCTGT	1
CAAAACGACT	GAAACACCGGTTTGAACTACCTAGGGGTTAGAGCTAGAAAAAGCAAGTTA	1
CAAAACTCAC	GAAACACCGGTTTGAACTAGAAATAGCAAGTTAACCTAAGGCTAGTCCGT	1
CAACGCCTTT	GAAACACCGGTCTCGAGTGAGGTGTTCAGGGTGGGGTTAGAGCTAGAAAT	1
CAACGCGGCA	GAAACACCGGTACCTTTGTTGATGCTGGACGGAAGGATTGAGGTGTTAGA	1
CAACTCATTC	GAAACACCGGTAACTATATTCATGCGATATCGCCGTATTAGTGGTGTTAG	1
CAACTCGGAG	GAAACACCGGTACCTTTGTTGATGCTGGGTGGAAGGAATGTGGGGTTAGA	1
CAAGAATCCT	GAAACACCGGTCGGGGCCACTCAGTGGTGGGGTTAGAGCTAGAAATAGCA	1
CAAGACCGAC	GAAACACCGGTGCCCTTACTCTCACCTGATTACTTAATCCGTGGGGTTAG	1
CAAGCCGTAC	GAAACACCGGTGCCCTTACTCTCACCTGGTTGCTTAATCCGTGGGGTTAT	1
CAATACGGCC	GAAACACCGGTTTGAACTACCGGGGTTAGAGCTAGAAATAGCAAGTTAAC	1
CAATCCTCGC	GAAACACCGGTGCATTCGAGAGTCCGGTCGTAGTGTGGACGTGGGGTTAG	1
CAATTTGGTT	GAAACACCGGTCGATTCGTATCGAAACCTTCCCGTTACAGTGGGGTTAGA	1
CACAAAACGC	GAAACACCGGTTTGAACTACCTAGTTCAAACCGGTGGGGTTAGAGCTAGA	1
CACAAATCCA	GAAACACCGGTTTGAACTAGAAATAGCAAGTTAACCTAAGGCTAGTCCGT	1
CACAACGCCC	GAAACACCGGTTTGAACTAGAAATAGCAAGTTAACCTAAGGCTAGTCCGT	947
CACAACGCCC	GAAACACCGGTTTGAACTACCTAGTTCAAACCGGTGGGGTTAGAGCTAGA	274
CACAACGCCC	GAAACACCGGTTTGAACTACCGGGGTTAGAGCTAGAAATAGCAAGTTAAC	225
CACAACGCCC	GAAACACCGGTTTGAACTACCTGGGGTTAGAGCTAGAAATAGCAAGTTAA	121
CACAACGCCC	GAGCTAGAAATAGCAAGTTAACCTAAGGCTAGTCCGTTATCAACTTGAAA	107
CACAACGCCC	GCTAGAAATAGCAAGTTAACCTAAGGCTAGTCCGTTATCAACTTGAAAAA	80
CACAACGCCC	GAAACACCGGTTTGGGGTTAGAGCTAGAAATAGCAAGTTAACCTAAGGCT	59
CACAACGCCC	GAAACACCGGTTTGAACCTGGGGTTAGAGCTAGAAATAGCAAGTTAACCT	38
CACAACGCCC	GAAACACCGGTTTGAACTACCTAGTTCAAACCGGAAAAAGTGGCACCGAG	27
CACAACGCCC	GAAACACCGGTTTGAAGAGCTAGAAATAGCAAGTTAACCTAAGGCTAGTC	26
CACAACGCCC	GAAACACCGGTTTGAACTACCTAGGGGGTAGTTCAAACCGGGGTTAGAGC	22
CACAACGCCC	GAAACACCGGTTTGAACTACCTAGTTCAAAGAGCTAGAAATAGCAAGTTA	20
CACAACGCCC	GAAACACCGGTTTGAACTACCTAGCAAGTTAACCTAAGGCTAGTCCGTTA	15
CACAACGCCC	GAAGAGCTAGAAATAGCAAGTTAACCTAAGGCTAGTCCGTTATCAACTTG	14
CACAACGCCC	GAGAGCTAGAAATAGCAAGTTAACCTAAGGCTAGTCCGTTATCAACTTGA	14
CACAACGCCC	GAAACACCGGTTTGAACTACGGGGTTAGAGCTAGAAATAGCAAGTTAACC	13
CACAACGCCC	CCACGGGTTAGAGCTAGAAATAGCAAGTTAACCTAAGGCTAGTCCGTTAT	12
CACAACGCCC	GAAACACCGGTTTGAGGTGGGGTTAGAGCTAGAAATAGCAAGTTAACCTA	11
CACAACGCCC	GAAACGGGGTTAGAGCTAGAAATAGCAAGTTAACCTAAGGCTAGTCCGTT	10
CACAACGCCC	GTGGGGTTAGAGCTAGAAATAGCAAGTTAACCTAAGGCTAGTCCGTTATC	10
CACAACGCCC	GAAACACCGGTTTGAACTACCTTAGAGCTAGAAATAGCAAGTTAACCTAA	8
CACAACGCCC	CAAAACACCGGTTTGAACTAGAAATAGCAAGTTAACCTAAGGCTAGTCCG	5
CACAACGCCC	GAAACACCGGTTCGAACTACCTAGGGGGTAGTTCAAACCGGGGTTAGAGC	5
CACAACGCCC	GAAACACCGGTTTGAACTACCTAGTTCAAACCGGGTGGGGTTAGAGCTAG	4
CACAACGCCC	GAAACACCGGTTTGAACTAGAGCTAGAAATAGCAAGTTAACCTAAGGCTA	4
CACAACGCCC	GAAACACGGGTTAGCGCTAGAAATAGCACGTTATCCTAAGGCTAGTCCGT	3
CACAACGCCC	GAGAGCTAGAAATAGCAAGTTAACCTAAGGCTAGTCCGTTATCAACTTAA	3
CACAACGCCC	GAAACACCGGTTCGAACTACCTTAGAGCTAGAAATAGCAAGTTAACCTAA	2
CACAACGCCC	GAAACACCGGTTTGAACTACCTAGAAAGGGTTAGAGCTAGAAATAGCAAG	2
CACAACGCCC	ATAGAAATAGCAAGTTAACCTAAGGCTAGTCCGTTATCAACTTGAAAAAG	1
CACAACGCCC	CAAAACACCGGTTTGAACTACCGGGGTTAGAGCTAGAAATAGCAAGTTAA	1
CACAACGCCC	GAAACACCGGCTTGAACTACCTAAAGAAATAGCAAGTTAACCTAAGGCTA	1
CACAACGCCC	GAAACACCGGTACCTTTGTTGATGCTGGGGGGAAGGATGGTGGGGTTAGA	1
CACAACGCCC	GAAACACCGGTAGCAGGTACGAGACGTGTTAAATAGCAAGTTAACCTAAG	1
CACAACGCCC	GAAACACCGGTCCGTAGGAGACCCGTGTGGCATGTACCTTGTGGGGTTAG	1
CACAACGCCC	GAAACACCGGTCTCGAGTGAGGTGTTCAGGGTGGGGTTAGAGCTAGAAAT	1
CACAACGCCC	GAAACACCGGTCTCGAGTGAGGTGTTCAGGTGGGGTTTGAACTAGAAATA	1
CACAACGCCC	GAAACACCGGTTACAGTTGGGAATAGAGCTAGAACTAGCAGGTTGACCTT	1
CACAACGCCC	GAAACACCGGTTTAACTACCTAGTTCAAACCGGTGGGGTTAGAGCTAGAA	1
CACAACGCCC	GAAACACCGGTTTCAACTGCCGGGGGTATTTCTAGAGATAGCGATTTAAC	1
CACAACGCCC	GAAACACCGGTTTGAACGACCTAGAAAGGGTTAGAGCTAGAAATAGCAAG	1
CACAACGCCC	GAAACACCGGTTTGAACTACCTAAAGAAATAGCAAGTTAACCTAAGGCTA	1
CACAACGCCC	GAAACACCGGTTTGAACTACCTAGTTCAAACCGGAAAAGTGGCACCGAGT	1
CACAACGCCC	GAAACACCGGTTTGAACTACCTAGTTCAAACCGGATGGGGTTAGAGCTAG	1
CACAACGCCC	GAAACACCGGTTTGAACTAGAAATAGAAGTTAACCTAAGGCTAGTCCGTT	1
CACAACGCCC	GAAACACCGGTTTGAACTATGTGGGTTTAGGGCTAGAACTAGCAAGTTCA	1
CACAACGCCC	GAAACACCGGTTTGACTTAGAGTTAGCCAGTTAACCTACGGCTAGTCCGG	1
CACAACGCCC	GAAACACCGGTTTGCACTAGACACAGCTAGTTAACCTAACGCTAGTCCGA	1
CACAACGCCC	GAAACACCGGTTTGGCTGAGAGTCCGGCAATGGAGTTGCTGCGGGGTTAG	1
CACAACGCCC	GACTATAAATAGCAAGTTAACCTAAGGCTAGTCCGTTATCAACTTGAAAA	1
CACAACGCCC	GAGATAGAAGTTGCATGTTATCCTTAGTGTAGTTCGTTATCAACTTGTAA	1
CACAACGTAT	GAAACACCGGTTTGAACTACCTAGTTCAAACCGGGTGGGGTTAGAGCTAG	1
CACAACTAAG	GAAACACCGGTTTGAAGAGCTAGAAATAGCAAGTTAACCTAAGGCAAGTC	1
CACAACTTAT	GAAACACCGGTAACTATATTCATGCGATATCGCCGTATCAGTGGGGTTAG	1
CACAATGGCA	GAAACACCGGTTTGAACTAGAAATAGCAAGTTAACCTAAGGCTAGTCCGT	1
CACACAGCAC	GAAACACCGGTAGCAAGTGCGAGGCGTGTTAGATAGAACTATAACCTAAG	1
CACACCCTAA	GAAACACCGGTGCCCTTACTCTCACCTGATTACTTAATCCGTGGGGTTAG	1
CACACGCTAC	GAAACACCGGTGCCCTTACTCTCACCTGATTACTTAATCCGTGGGGTTAG	1
CACACTCCCC	GAAACACCGGTTTGAACTACCTAGTTCAAGCCGGTGGGGTTAGAGCTAGA	1
CACACTGCCT	GAAACACCGGTTTGAACTAGAAATAGCAAGTTAACCTAAGGCTAGTCCGT	1
CACAGCACAC	GAAACACCGGTGCCCTTACTCTCACCTGACTACTTAATCCGTGAGGATAA	1
CACATAGCAC	GAAACACCGGTTTGAACTAGAAATAGCAAGTTAACCTAAGGCTAGTCCGT	1
CACATAGCTA	GAAACACCGGTTTGAACTAGAAATAGCAAGTTAACCTAAGGCCAGTCCGT	1
CACATCGACA	GAACCACCGGTTTGAACTACCTAGTTCAAACCGGTGGGGTTAGAGCTAGA	1
CACATCGTCG	GAAACACCGGTGTACGTATAGACCGAACCAGGGTGTGCAAGTGGGGTTAG	1
CACATGACTT	GAAACACCGGTTTGAACTACCTAGTTGTGGGGTTAGAGCTAGAAATAGCA	1
CACCTTTACC	GAAACACCGGTCGGGGCCACTCAGTGGTGGGGTTAGAGCTAGAAATAGCA	1
CACGAACTCC	GAAACACCGGTGCCCTTACTCTCACCTGATTACTTAATCCGTGGGGTTAG	1
CACGAAGAAA	GAAACACCGGTTTGAACTACCTAGGGGGTAGTTCAAACCGGGGTTAGAGC	1
CACGAATCCT	GAAACACCGGTCTCGAGTGAGGTGTTCAGGGTGGGGTTAGAGCTAGAAAT	1
CACGAATCCT	GAAACACCGGTCTCGAGTGAGGTGTTCAGGGTGGGGTTAGAGATAGAAAT	1
CACGACAGAC	GAAACACCGGTGCCCTTACTCTCACCTGATTACTTAGTGGGGTTAGAGCT	1
CACGACCTGA	GAAACACCGGTTTGAACTAGAAATAGCAAGTTAACCTAAGGCTAGTCCGT	1
CACGACCTTC	GAAACACCGGTGCCCTTACTCTCACCTGATTACTTAATCCGTGGGGTTAG	1
CACGAGCTAC	GAAACACCGGTGCCCTTACTCTCACCTGATTACTTAGTGGGGTTAGAGCT	1
CACGCAATCC	GAAACACCGGTAGCAATACTGTCACGTGTTTACTTAATTAGAGCGGTTAA	1
CACGCCATCA	GAAACACCGGTGTCCTTGCTGCCCACTGATTAATTAATCCGTGGGGTTAG	1
CACGCCGCTC	GAAACACCGGTGGCCTTACTCTCACCTGATTACTTAATCCGTGGGGTTAG	1
CACGTCCTAT	GAAACACCGGTGTCGTTACTGGCATTTGATTACTTAATACGGCTAGTTAT	1
CACTCCTACG	GAAACACCGGTAAATTTGAGGCTCCGGCATGCAGGAGGCCGTGGGGTTAG	1
CACTTAGTCT	GAAACACCGGTGAGATGGTGGACAGGGAGGGGTTAGAGCTAGAAATAGCA	1
CAGAAAGCAC	GAAACACCGGTTTGAACTTGGGGTTAGAGCTAGAAATAGCAAGTTAACCT	1
CAGACACAGA	GAAACACCGGTAGCAAGTGCGAGACGTGTTTGTGGGGTTAGAGCTAGAAA	1
CAGAGAGCCC	GAAACACCGGTTTGAACTACCTGGGGTTAGAGCTAGAAATAGCAAGTTAA	1
CAGAGTCATC	GAAACACCGGTGTACGTATGGACTGAACAGGGTGTGCAAGTGGGGTTAGA	1
CAGATCCTCT	GAAACACCGGTCTCGCGTGAGGCTTTCAGGGTTTGGTTAGAGCTAGAAAT	1
CAGATCGAGG	GAAACACCGGTTATATTTGTAAGTGTGTGGGGTTAGAGCTAGAAATAGCA	1
CAGATCGGCC	GAAACACCGGTACCTTTGTTGCTGCTGGGTGGAAGGAATTTGTGGGGTTA	1
CAGCAAGCCA	GAAACACGGGTTAGAGCTCGAACTAGCAAGTTAAACTAATGCTAGTACGT	1
CAGCTTGGCT	GAAACACCGGTTTACGTTGCATCGGTGTGGGGTTAGAGCTAGAAATAGCA	1
CAGGCCCTAA	GAAACACCGGTGCCCTTACTCTCACCTGATTACTTAATCCGTGGGGTTAG	1
CAGGCCGATT	GAAACACCGGTCCGCGGCACTCGCGGGGGGGGGTAAAGATAGATATAAAA	1
CAGGTTGTCA	GAAACACCGGTGACATTGGGAAGTGGGGTTAGAGCTAGAAATAGCAAGTT	1
CAGTGCGTCT	GAAACACCGGTTAAACCGAGGGATTAGGGCTAGGAGTTACAGGTAAAACT	1
CAGTGGAGCC	GAAACACCGGTTCCCGTCCAGTGGGGTTAGAGCTAGAAATAGCAAGTTAA	1
CAGTTACAGC	GAAAAACCGGTTGGGGCCACTCAGTGGTGGGGTTAGAGCTAGAAATAGAA	1
CAGTTACCTC	GAAACACCGGTCAGGGCCACTCAGTGGAGGGGTTAGAGCTAGAAGTAGCA	1
CAGTTAGTGC	GAAACACCGGTCGCGGTAACTACGTGGTGGGGTTAGAGCTAGAAATAGCA	1
CATAAACCCC	GAAACACCGGTCCAAGCCACCCAGTGGTGGGGTTAGAGCTAGAAATAGCA	1
CATAACGGGC	GAAACACGGGTTAGCGCTAGAAATAAAAAGTTAACCTAAGCATAGTCCGT	1
CATAACGTAT	GAAACACCGGTAACTATATTCATGCGATATCGCCGTATCAGTGGGGTTAG	1
CATAACTTAT	GAAACACCGGTAACTATATTCATGCGATATCGCCGTATCAGTGGGGTTAG	1
CATAACTTAT	GAAACACCGGTAACTATATTCATGCGATATCGCCGTATCAAGTGGGGTTA	1
CATACTCGTA	GAAACACCGGTGTACGTATGGACTGAACCAGGGTGTGCAAGTGGGGTTAG	1
CATAGAGAGG	GAAACACCGGTTATATTTGTAAGTGTGTGGGGTTAGAGCTAGAAATAGCA	1
CATAGCCTTA	GAAACACCGGTCTACGTATCCACTGACCCAGGGGGTGCAAAGTGGGGTTA	1
CATAGCGCCA	GAAACACCGGTTTGAACTAGAAATAGCAAGTTAACCTAAGGCTAGTCCGT	1
CATAGCGTGG	GAAACACCGGTTATATTGGGGCTAGAGCTAGAATTAGCAAGTTAACCAAA	1
CATAGTAGTA	GAAACACCGGTGTACGTATGGACTGAACCAGGGTGTGCAAGTGGGGTTAG	1
CATAGTAGTT	GAAACACCGGTGTACGTATGGACTGAACCAGGGTGTGCAAGTGGGGTTAG	1
CATATACCGA	GAAACACCGGTCGGTGCCACTCAGTGGTGGGGTTAGAGCTAGAAATAGCA	1
CATCGCAGTA	GAAACACCGGTGTACGTATGGACTGAACCAGGGTGTGCAAGTGGGGTTAG	1
CATCGGAGTA	GAAAAACCGGTGTACGTATGGACTGAACCAGGGTGTGCAAGTGGGGTTAG	1
CATCGTCGTC	GAAACACCGGTGTACGTATGGACTGAACCAGGGTGTGCAAGTGGGGTTAG	2087
CATCGTCGTC	GAAACACCGGTGTACGTATGGACTGAACCAGGGTGTGCAAAGTGGGGTTA	83
CATCGTCGTC	GAAACACCGGTGTACGTATGGACTGAACCAGGGTGTGGGGTTAGAGCTAG	28
CATCGTCGTC	GAAACACCGGTGTACGTATGGACTGAACCAGGGTGTGCAAATAGCAAGTT	17
CATCGTCGTC	GAAACACCGGTGTACGTATGGACTGAACCAGGGTGTGCAATGGGGTTAGA	6
CATCGTCGTC	GAAACACCGGTGTACGTATGGACTGAACCAGGGGAGCTAGAAATAGCAAG	5
CATCGTCGTC	CAAAACACCGGTGTACGTATGGACTGAACCAGGGTGTGCAAGTGGGGTTA	3
CATCGTCGTC	GAAACACCGGTCCGTAGGAGACCCGTGTGGCATGTACCTGTGGGGTTAGA	2
CATCGTCGTC	GAAACACCGGTGTACGTATGACTGAACCAGGGTGTGCAAGTGGGGTTAGA	2
CATCGTCGTC	GAAACACCGGTGTACGTATGGACTGAACAGGGTGTGCAAGTGGGGTTAGA	2
CATCGTCGTC	GAAACACCGGTGTGGCTGAGAGTCCGGCAATGGTGTGGCTGTGGGGTTAG	2
CATCGTCGTC	CAAAACACCGGTGTACGTATGGACTGAACGAGGGTGTGCAAGTGGGGTTA	1
CATCGTCGTC	GAAACACCGGTAACTATATTCGTGCGATATCGCCGTATCAGTGGGGTTGG	1
CATCGTCGTC	GAAACACCGGTAGCAAGTGGGGTTAGAGCTAGAAATAGCAAGTTAACCTA	1
CATCGTCGTC	GAAACACCGGTATACGGAGGGACTGAAGCGGGGTGTGCTAAGTGCGGTTA	1
CATCGTCGTC	GAAACACCGGTATACGTGTGGACCGAACATGGGGGAGCACGTGGGGTTAG	1
CATCGTCGTC	GAAACACCGGTCCGGTTCCTCTCACGTGGGTGCTTGATCCGTGAGTATAG	1
CATCGTCGTC	GAAACACCGGTCCGTAGGAGACCCGTGTGGCATGTACCTGTGGGGTTGGA	1
CATCGTCGTC	GAAACACCGGTCTCGAGTGAGGTGTTCAGGGGTGGGGTTAGAGCTAGAAA	1
CATCGTCGTC	GAAACACCGGTGACATTGGGTACAGGGGTGGGGTTAGAGCTAGAAATAGC	1
CATCGTCGTC	GAAACACCGGTGCCCTTACTCTCACCTGATTACTTAATCCGTGGGGTTAG	1
CATCGTCGTC	GAAACACCGGTGTACGTATGACTGAACCAGGGTGTGCAGGTGGGGTTAGA	1
CATCGTCGTC	GAAACACCGGTGTACGTATGGACTGAACCAGGGGGGCTAGAAATAGCAAG	1
CATCGTCGTC	GAAACACCGGTGTACGTATGGACTGAACCAGGTGTGCAAGTGGGGTTAGA	1
CATCGTCGTC	GAAACACCGGTGTACGTATGGACTGAACGGGGTGTGCAAGTGGGGTTAGA	1
CATCGTCGTC	GAAACACCGGTGTCCGGATGGACTGAACCTAGGTGTGACATTAGGCTAAG	1
CATCGTCGTC	GAAACACCGGTGTCCGTATGGCCTGAACCTGGGGGTGCAAGGCTGGTTAG	1
CATCGTCGTC	GAAACACCGGTTATATTTGTAAGTGTGTGGGGTTAGAGCTAGAAATAGCA	1
CATCGTCGTC	GAAACACCGGTTCACGTATGGTCTGTGCCGGGGTGGGCCAGGGGGGATAA	1
CATCGTCGTC	GAAACACCGGTTCCCGTCCAGTGGGGTTAGAGCTAGAAATAGCAAGTTAA	1
CATCGTCGTC	GAAACACCGGTTTGAACTACCGGGGTTAGAGCTAGAAATAGCAAGTTAAC	1
CATCGTCGTC	GAAACACCGGTTTGCACTAGAAATAGCAAGGTAACCTAAGGCTAGTCCGT	1
CATCGTCGTC	GAAACACCGTGGAACGAAGGACTTGACCCAGGGGGGCAAGGGGGGGTTGG	1
CATCGTCGTC	GAAACCCGGTGTACGTATGGACTGAACCAGGGTGTGCAAGTGGGGTTAGA	1
CATCGTCGTC	GAAACGCCGGTTTGAACTACCTAAAGAAATAGCAAGTTAACCTAAGGCTA	1
CATCGTCGTC	GGGTTAGAGCTAGAAATAGCAAGTTAACCTAAGGCTAGTCCGTTATCAAC	1
CATCTATCGA	GAAACACCGGTTATATTGGGGTTAGAGCTAGAAATAGCAAGTTAACCTAA	1
CATCTTAGAC	GAAACACCGGTGTACGTATGGACTGAACCAGGGTGTGCAAGTGGGGTTAG	1
CATGAAGCGC	GAAACACCGGTTTGAACTACCTAGTTCAAACCGGTGGGGTTAGAGCTAGA	1
CATGGTAGAC	GAAACACCGGTGTACGTATGGACTGAACCAGGGTGTGCAAGTGGGGTTAG	1
CATGGTAGTT	GAAACACCGGTGTACGTATGGACTGAACCAGGGTGTGCAAGTGGGGTTAG	1
CATGTACAGC	GAAACACCGGTCGGGGCCACTCAGTGGTGGGGTTAGAGCTAGAAATAGCA	1
CATGTCCCGA	GAAACACCGGTCGGGGCCACTCAGTGGTGGGGTTAGAGCTAGAAATAGCA	1
CATGTGGTGT	GAAACACCGGTGACAATTGGGGTTAGAGCTAGAAATAGCAAGTTAACCTA	1
CATTAGCAGT	GAAACACCGGTTACATTGAGATTAGAGCTAGAAAAGGCTAGTCCGTTATC	1
CATTAGCCGC	GAAACACCGGTCGGCGGCTAGAGCTTTAAAAAGCAAAGTAACCTAAGTCG	1
CATTAGCTAT	GGAACACCGGTTACATTGAGGGGTTAGAGCTAGAAATAGCAAGTTAACCT	1
CATTGAGCAT	GAAACACCGGTTAAGCCGAGTGGGGTTAGAGCTAGAAATAGCAAGTTAAC	1
CATTGCCTTC	GAAACACCGGTGTACGTATGGACTGAACCAGGGCGTGGGGTTAGAGCTAG	1
CATTTACCTT	GAAACACCGGTCCGTAGGAGACCCGTGTGGGATGTGCCCGTGGGGTTAGA	1
CATTTAGAGG	GAAACACCGGTTATATTTGTAAGTGTTGTGGGGTTAGAGCTAGAAATAGC	1
CATTTATGGC	GAAACACCGGTCGGGGCCACTCAGTGGTGGGGTTAGAGCTAGAAATAGCA	1
CATTTGACGC	GAAACACCGGTCGGGGCCACTCAGTGGTGGGGTTAGAGCTAGAAATAGCA	1
CATTTTACGC	GAAAAACCGGTCGGGGCCACTCAGTGGTGGGGTTAGAGCTAGAAATAGCA	1
CCAAACGCTC	GAAACACCGGTTTGAACTACCTAGGGGGTAGTTTAAACCGGGGTTAGAGC	1
CCAAGTCGTC	GAAACACCGGTGTACGTATGGACTGAACCAGGGTGTGCAAGTGGGGTTAG	1
CCAATCGTTG	GAAACACCGGTTATATTTGTAAGTGTGTGGGGTTAGAGCTAGAAATAGCA	1
CCACCTGCCG	GAAACACCGGTACCTTTGTTGTTGGTGGGGGGAAGGTAGTGTGAGGGGTA	1
CCAGCCTCGC	GAAACACCGGTCGGCGGCAATCGTGGGTGGGGTTAGAGCTAGTAATAGCA	1
CCATGTGGTC	GAAACACCGGTCGATTCATATCGAAACCTTCCCGTGACAAGTGGGGTTAG	1
CCATTAGGGT	GAAACACCGGTCGATTCATATCGAAACCTTCCCGTGACAGTGGGGTTAGA	1
CCCAAAACAC	GAAACACCGGTTCACGGGCAGAGGGCTTAGAGCTAGAGATAGCAATTTAA	1
CCCAAAGCTC	GAAACACCGGTTTGAACTAGAAATAGCAAGTTAACCTAAGGCTAGTCCGT	1
CCCACCCCCC	GAAACACGGGTTAGAGCTAGAAATAGCAAGTTAACCGAAGGCGGGGCCGT	1
CCCACCCTGC	GAAACACCGGTGCCCTTACTCTTACCTGATTAATTGATCCGTGGGGTTAG	1
CCCACCTCCC	GAAACACCGGTTTGAACTAGAAATAGCAAGTTAACCTAAGGCTAGTCCGT	1
CCCATCACTT	GAAACACCGGTCTCGAGTGCGGTGTTCAGGGTGGGGATAGAGCTAGAAAT	1
CCCATCGTTT	GAAACACCGGTCTCGAGTGAGGTGTTCAGGGTGGGGTTAGAGCTAGAAAT	1
CCCCTCGCCC	GAAACACCGGTTTGAACTAGAAATAGCAAGTTAACCTAAGGCTAGTCCGT	1
CCGAACGACC	GAACTAGCAATATAAAGTTAAACGAAGACTGGGCCGTTATCGCTTTAAAA	1
CCGAAGCCCC	GAAACACCGGTTCCCGTCCAGAGTGGCTAGATCTCGTAATACCAATCTAA	1
CCGAGCATGC	GAAACACCGGTCAGGGACAGTTAGAAATGGCATGATAACTTGAAACTGGT	1
CCGAGCGAGG	GAAACACCGGTTATATTTGTAAGTGTGTGGGGTTAGAGCTAGAAATAGCA	1
CCGTGAACGA	GAAACACCGGTCGGGGCCACTCAGTGGTGGGGTTAGAGCTAGAAATAGCA	1
CCGTTAATGA	GAAACACCGGTCGAGGCCAATCAGTGGTGGGGGTAGAGCTAGCTAGAACA	1
CCGTTACTGA	GAAACGCCGGTCGGGGCCACTCAGTAGTGGGGTTAGGGCTAGAAATAGCA	1
CCGTTAGTGC	GAAACACCGGTCGGGGCCACTCAGTGGTGGGGTTAGAGCTAGAAATAGCA	1
CCTAACGCAC	GCTAGAAATAGCAAGTTAACCTAAGACTAGGCCGTTATCAACTTGAAAAA	1
CCTATAACGA	GAAACACCGGTCGGGGCCACTCAGTGGTGGGGTTAGAGCTAGAAATAGCA	1
CCTATCCGTC	GAACCACCGGTATCCAGCTAGGTCTTACTAGTAGGGCTAGAGCGAGATAT	1
CCTATCGTGC	GAAACACCGGTTATATTTGTAAGTGTGTGGGGTTAGAGCTAGAAATAGCA	1
CCTATCTAAG	GAAACACCGGTTATATTTGTAATTTTGTGGGGTTAGAGCTAGAAATAGCA	1
CCTCAGCGTC	GAAACACCGGTGTACGTATGGACTGAACCAGGGTGTGCAAGTGGGGTTAG	1
CCTCGCAGTT	GAAACACCGGTGGACGGATGGACTTAGCTAGGGGGTGTAGAGCTAGATAT	1
CCTCGTAGTG	GAAACACCGGTGTACGTATGGACTGAACCAGGGTGTGCAAGTGGGGTTAG	1
CCTCGTGGCC	GAAACACCGGTGTACGTATGGACTGAACCAGGGTGTGCAAGTGGGGTTAG	1
CCTCTACGTC	GAAACACCGGTGTACGTATGGACTGAACCAGGGTGTGCAAGTGGGGTTAG	1
CCTCTAGAGG	GAAACACCGGTTATATTTGTAAGTGTGTGGGGCTAGAGCTAGAAATAGCA	1
CCTGCACTAC	GAAACACCGGTGCCCTTACTCTCACCTGATTACTTAATCCGTGGGGTTAG	1
CCTGTACGGA	GAAACACCGGTCGGGGCCACTCAGTGGTGGGGTTAGAGCTAGAAATAGCA	1
CCTGTCGGGG	GAAACACCGGTTATATTTGTAAGGGTGTGGGGTTAGAGCTAGAAATAGCA	1
CCTGTTGTGG	GAAACACCGGTGACATTTGGAGGAGGGTGGGGTTAGAGCTAGAAATAGCA	1
CCTTACAGCC	GAAACACCGGTCGGGGCCACTCAGTGGTGGGGTTAGAGCTAGAAATAGCA	1
CCTTGCGCGC	GAAACACCGGTCGGGGCCACTCAGTGGTGGGGTTAGAGCTAGAAATAGCA	1
CCTTTAACTA	GAAACACCGGTCGGGGCCACTCAGTGGTGGGGTTAGAGCTAGAAATAGCA	1
CCTTTACCGC	GAAACACCGGTCGGGGCCACTCAGTGGTGGGGTTAGAGCTAGAAATAGCA	2592
CCTTTACCGC	AGTCCGTTACAACTTGAAAAAGTGGCACCGAGTCGGTGCTTTTTTTCCTG	32
CCTTTACCGC	GAAACACCGGTCGGGGTTAGAGCTAGAAATAGCAAGTTAACCTAAGGCTA	29
CCTTTACCGC	GAAACACCGGTCGGGGCTAGAAATAGCAAGTTAACCTAAGGCTAGTCCGT	28
CCTTTACCGC	GAAACACCGGTCGGGGCCACCGGTGGGGTTAGAGCTAGAAATAGCAAGTT	21
CCTTTACCGC	GAAACACCGGTCGGGGCCACTCAGTGAGCTAGAAATAGCAAGTTAATAGC	21
CCTTTACCGC	GAAACACCGGAGGCTAGTCCGTTACAACTTGAAAAAGTGGCACCGAGTCG	20
CCTTTACCGC	GAAACACCGGTCGGGGCCACTCAGTGGGTGGGGTTAGAGCTAGAAATAGC	18
CCTTTACCGC	GAAACACCAAGTGGGGTTAGAGCTAGAAATAGCAAGTTAACCTAAGGCTA	17
CCTTTACCGC	GAAACACCGGTCGGGGCCACTCAGTTAGAGCTAGAAATAGCAAGTTAACC	17
CCTTTACCGC	GAAACACCGGTCGGGGCCAGTTAGAGCTAGAAATAGCAAGTTAACCTAAG	17
CCTTTACCGC	GAAACACCGGTCGGGGCCAGAGCTAGAAATAGCAAGTTAACCTAAGGCTA	16
CCTTTACCGC	GAAACACCGGTCGGGGCCACTCAGTGAAATAGCAAGTTAACCTAAGGCTA	15
CCTTTACCGC	GAAGCACCGGTCGGGGCCACTCAGTGAAATAGCAAGTTAACCTAAGGCTA	13
CCTTTACCGC	GAAACACCGGTCGGGGCCACTCAGTGGTGGGTTAGAGCTAGAAATAGCAA	11
CCTTTACCGC	CAAAACACCGGTCGGGGCCACTCAGTGGTGGGGTTAGAGCTAGAAATAGC	9
CCTTTACCGC	GAAACACCGGTCGGGGCCACTCAGTGTAGAGCTAGAAATAGCAAGTTAAC	8
CCTTTACCGC	GAAACACCGGTCGGGGCCACTCAGTGTGGGGTTAGAGCTAGAAATAGCAA	8
CCTTTACCGC	GAAACACCGGTCGGGCCACTCAGTGGTGGGGTTAGAGCTAGAAATAGCAA	3
CCTTTACCGC	GAAACACCGGTCGGGGCACTCAGTGGTGGGGTTAGAGCTAGAAATAGCAA	2
CCTTTACCGC	GAAACACCGGTCGGGGCCACTCAGTGGCGGGGGTTGAGGTAGAAAAAGAA	2
CCTTTACCGC	GAAACACCGGTAGCAAGTGCGAGCTAGAAATAGCAAGTTAACCTAAGGCT	1
CCTTTACCGC	GAAACACCGGTCCGTAGGAGACCCGGGTGGCATGTACCTGTGGGGTTAGA	1
CCTTTACCGC	GAAACACCGGTCCGTAGGAGACCCGTGTGGCATGTACCTGTGGGGTTAGA	1
CCTTTACCGC	GAAACACCGGTCCGTGGGACTCAGGTGTGGGGTGAGAGCTAGAAATAGCA	1
CCTTTACCGC	GAAACACCGGTCGGGCCACTCAGTGGTGGGGTTAGAGCTAGAGATAGCAA	1
CCTTTACCGC	GAAACACCGGTCGGGGACACTCAGTGATGTGGGTAGAGCTAGCTATAGCA	1
CCTTTACCGC	GAAACACCGGTCGGGGCAAGTCCGACAGGGGGATAAGGCTATGGGTAGCA	1
CCTTTACCGC	GAAACACCGGTCGGGGCCACTCAGTGGCGGGGGTTTAGCTTGAAATATAA	1
CCTTTACCGC	GAAACACCGGTCGGGGCCACTCTCCGGTGGGGTTGGGGCTAGGAATATCG	1
CCTTTACCGC	GAAACACCGGTCGGGGCGACTCAGGGGGGGGGAGAGAGCCAGAAAGATCA	1
CCTTTACCGC	GAAACACCGGTCGGGGTCACTCAGGGGTGGGGGTTGGGCTTGACATGGCA	1
CCTTTACCGC	GAAACACCGGTCTCGAGTGAGGTGTTCAGGTGGGGTTAGAGCTAGAAATA	1
CCTTTACCGC	GAAACACCGGTCTGGGCCACTCAGTTGTGGGGGTAGATCTAGCAATAGCT	1
CCTTTACCGC	GAAACACCGGTGACATTGGGTACAGGGTGGGGTTAGAGCTAGAAATAGCA	1
CCTTTACCGC	GAAACACCGGTGGGGTTAGAGCTAGAAATAGCAAGTTAACCTAAGGCTAG	1
CCTTTACCGC	GAAACACCGGTGTACGTATGGACTGAACCAGGGTGTGCAAGTGGGGTTAG	1
CCTTTACCGC	GAAACACCGGTGTGGCTGAGAGTCCGGCAATGGTGTGGCTGTGGGGTTAG	1
CCTTTACCGC	GAAACACCGGTTGGGGCCCCGTGGGGTTGGGGTCAGAGATAGAAAGTTAA	1
CCTTTACCGC	GAAACACCGGTTTACGTTGCATCGGTGTGGGGTTAGAGCTAGAAATAGCA	1
CCTTTACCGC	GAAACACCGGTTTGAACCACTTAGTTGTGGGGTTAGAGCTAGAAATAGCA	1
CCTTTACCGC	GCAACACCGGTCGGGCCACTCAGTGGTGGGGTTAGAGCTAGAAATAGCAA	1
CCTTTACCGC	GGAACACCGGTCGGGGCCACTCAGTGGCGGGGGTGAAGCAAGAAAAAAAA	1
CCTTTACCGC	GTAACACCGGTCGGGGCCACTCAGTGGCGGGGGTTAAGCTAGAAATAAAC	1
CCTTTAGGGA	GAAACACCGGTCGGGGTTAGAGCTAGAAATAGCAAGTTAACCTAAGGCTA	1
CCTTTGACGA	GAAACACCGGTCGGGGCCGCTCAGTGGTGGGGTTAGAGCTAGTAATAGCA	1
CGAAACCTGC	GAAACACCGGTCGCGAGCGAGCGGGTCAGGAGGTGGTAGTGCTAGAAATA	1
CGAAACGCGC	GAAACTCCGGTGCATTCGAAAGTCCGGTCGTAGTGTGGACGTGGGGTTAG	1
CGAACCTCGT	GAAACACCGGTGCATTCGAAAGTCCGGTCGTAGTGTGGACGTGGGGTTAG	1
CGAACGATGC	GAAACACCGGTGCGTTCGAAAGTCCGGTCGTAGTGTGGACGTGGGGTTAG	1
CGAAGCCCTA	GAAAAACCGGTCTCGAGTGAGGTGTTCAGGGTGGGGTTAGAGCTAGAAAT	1
CGAAGCTGTT	GAAACACCGGTCTCGAGTGAGGTGTTCAGGGTGGGGTTAGAGCTAGAAAT	1
CGAAGCTTTC	GAAACACCGGTCTCGAGTGAGGTGTGGTTAGAGCTAGAAATAGCAAGTTA	1
CGAATAACAT	GAAACACCGGTCTCGAGTGAGGTGTTCAGGGTGTGGTTAGAGCTAGAAAT	1
CGAATAATTC	GAAACACCGGTCTCGAGTGAGGTGTTCAGGGTGGGGGTAGAGCTAGAAAT	1
CGAATACTGC	GAAACACCGGTCTCGAGTGAGGTGTTCAGGGTGGGGTTAGAGCTAGAAAT	1
CGAATCAGCT	GAAACACCGGTCTCGAGTGAGGTGTTCAGGGTGGGGTTAGAGCTAGAAAT	1
CGAATCCTTT	GAAACACCGGTCTCGAGTGAGGTGTTCAGGGTGGGGTTAGAGCTAGAAAT	2108
CGAATCCTTT	GAAACACCGGTCTCGAGTGAGGTGTTCAGGTGGGGTTAGAGCTAGAAATA	297
CGAATCCTTT	GAAACACCGGTCTCGAGTGAGGTGTTCAGGGGTGGGGTTAGAGCTAGAAA	45
CGAATCCTTT	GAAACACCGGTCTCGAGTGAGGTGTGGTTAGAGCTAGAAATAGCAAGTTA	39
CGAATCCTTT	GAAACACCGGTCTCGAGTGAGGTGGGGTTAGAGCTAGAAATAGCAAGTTA	37
CGAATCCTTT	GAAACACCGGTCTCGGTGAGGTGTTCAGGGTGGGGTTAGAGCTAGAAATA	24
CGAATCCTTT	GAAACACCGGTCTCGAGTGAGGTGTTCAAGGGTGGGGTTAGAGCTAGAAA	23
CGAATCCTTT	GAACACCGGTCTCGAGTGAGGTGTTCAGGGTGGGGTTAGAGCTAGAAATA	20
CGAATCCTTT	GAAACACCGGTCTCGAGTGAGGTGTTCTTCAGGGTGGGGTTAGAGCTAGA	15
CGAATCCTTT	GAAACACCGGTAGCAAGTTAACCTAAGGCTAGTCCGTTATCAACTTGAAA	9
CGAATCCTTT	GAAACACCGGTCTCGAGTGAGGTGTTTCGTCCTTTTAGAGCTAGAAATAG	8
CGAATCCTTT	GAAACACCGGTCTCGAGTGAGGTGTTCAGGACTGAATAGGGAGGACGATG	5
CGAATCCTTT	CAAAACACCGGTCTCGAGTGAGGTGTTCAGGGTGGGGTTAGAGCTAGAAA	3
CGAATCCTTT	GAAACACCGGTCCGTAGGAGACCCGTGTGGCATGTACCTGTGGGGTTAGA	3
CGAATCCTTT	GAAACACCGGTCTCGAGTGAGGTGTTCAGGTGGGTTAGAGCTAGAAATAG	2
CGAATCCTTT	GAAACACCGGTCTCGTGTGAGATGTTCAGGGTGTAGATATAGCTAGAGAT	2
CGAATCCTTT	AGAGGGCGAAACACCGGTCTCGAGTGAGGTGTTCAGGGTGGGGTTAGAGC	1
CGAATCCTTT	AGGGAGGAAAAACGGGTCTCGAGTGAGGTGTTCAGGGTGGGGTTAGAGCT	1
CGAATCCTTT	GAAACACCGGCTTCGCGTGAGGAATTGAGGGGGTAGATATAGCAATAGCT	1
CGAATCCTTT	GAAACACCGGTAAATTTGAGGCTCCGGCATGCAGGAGGCCGTGGGGTTAG	1
CGAATCCTTT	GAAACACCGGTCGGGGTGAGTGTGCGGCAGTGGTGGTGCTGGGAGGATAG	1
CGAATCCTTT	GAAACACCGGTCTCGAGAGAGGCGTTCAGTGACGGGATAGAGCTAGAAAT	1
CGAATCCTTT	GAAACACCGGTCTCGAGTGAGGTTTTCAGTGTTGTGTTATATCTCGAAAT	1
CGAATCCTTT	GAAACACCGGTCTCGCTTGGGGTGTTCCGGTGGGGTGAGAGCTAGGATTA	1
CGAATCCTTT	GAAACACCGGTCTTGTTTGAGGGGTTCAGGGGGTGGTTATAGCTAGAAAT	1
CGAATCCTTT	GAAACACCGGTGACATTGGGTACAGGGTGGGGTTAGAGCTAGAAATAGCA	1
CGAATCCTTT	GAAACACCGGTGACATTGGGTAGTGGGGTTAGAGCTAGAAATAGCAAGTT	1
CGAATCCTTT	GAAACACCGGTGCATTCGAAAGTCCGGTCGTAGTGTGGACGTGGGGTTAG	1
CGAATCCTTT	GAAACACCGGTGCCCTTACTCTCACCTGATTACTTAATCCGTGGGGTTAG	1
CGAATCCTTT	GAAACACCGGTTTACGTTGCATCGGTGTGGGGTTAGAGCTAGAAATAGCA	1
CGAATCCTTT	GAAACACCGGTTTACGTTGCATCGGTTGTGGGGTTAGAGCTAGAAATAGC	1
CGAATCCTTT	GAAACACGGGTTAGAGGTAGGAATAGCAAGTTAACCCTAGGCCAGTCCGT	1
CGAATCCTTT	GAACACCGGTCTCGGGTAAGGTGATCAGGGGGGGGGTAGAGCTAGGAATA	1
CGAATCCTTT	GAACACCGGTTCTATTGAGATTGCGGTTAGACCTAAAACTAGCAAGTTAA	1
CGACCATGGC	GAAACACCGGTGCATTCGAAAGTCCGGTCGTAGTGTGGACGTGGGGTTAG	1
CGACCCTCTG	GAAACACCGGTGCATTCGAAAGTCCTGTCGTGGGGTTAACGTGGGGAAAA	1
CGACGTTGTC	GAAACACCGGTTTACGTATGGACGGAACCAGGGTGTGCATGTGGGGTTAG	1
CGACTATTGC	GAAACACCGGTTGGGGCATCTCAGTGGGGCGGTTAGAGCTAGAAATAGCA	1
CGACTTATTT	GAAACACCGGTCTCGAGTGAGGTGTTCAGGGGGGGGTTGGAGCTAGAAAT	1
CGACTTCGTC	GAAACACCGGTGTACGTATGGACTGAACCAGGGTGTGCAAGTGGGGTTAG	1
CGACTTCTGT	GAAACACCGGTCTCGAGTGAGGTGTTCAGGGTGGGGTTAGAGCTAGAAAT	1
CGAGATGCGC	GAAACACCGGTCGGCGGCAATCGTGGGTGGGGTTAGAGCTAGAAATAGCA	1
CGAGCTGACT	GAAACACCGGTGACATTGGGTGCTTTTTCTCCTGCAGGAGACAACACGGA	1
CGAGTACGTT	GAAACACCGGTCTCGAGAGAGGGGTTCAGGTGGGGTTAGAGCTAGAAATA	1
CGAGTTGAAT	GAAACACCGGTGACATTGGGTAGTGGGGTTAGAGCTAGAAATAGCAAGTT	1
CGAGTTGGCC	GAAACACCGGTGACTTTGGGGATAGGGGGGGGTTAGAGCTTGAAATGGCA	1
CGCACACCCC	GAAACACCGGTGTGGCTGAGAGTCCGGCAATGGTGTGGCTGTGGGGATAG	1
CGCATCAGTT	GAAACACCGGTCTCGAGTGAGGTGTTCAGGTGGGGTTAGAGCTAGAAATA	1
CGCATTACCT	GAAACACCGGTCATATTCGCTACGCAATGTGGGTAGAGCGATAAAAATAG	1
CGCATTCTGT	GAAACACCGGTCTCGAGTGAGGTGTTCAGGGTGGGGTTAGAGCTAGAAAT	1
CGCCCTCCCC	GAAACACCGGTGCCGTTGCCTCCAGGGTGGGGTTAGAGCTAGAAATAGCA	1
CGCCTCAGGC	GAAACAACGGTGCATTCGAGAGTCCGGTCGTAGTGTGGAAGTGGGGTTAG	1
CGCCTTTACC	GAAACACCGGTCGGGGCCACTCAGTGGTGGGGTTAGAGCTAGAAATAGCA	1
CGCGCATGTC	GAAACATCGGTGCATTCGAAACGCCGGGCGTAGTGTGGACGAGGGGGTAG	1
CGCGCCGCCC	GAAACACCGGTGACATTGGGTAGAGGGTGGGGTTAGAGCTAGAAAGTTCA	1
CGCGCTCTAT	GAAGCACCGGTGCCCTTACTCTCACCTGATTACTTAATCGTGAGGCTAGA	1
CGCGTTTTAT	GAAACACCGGTGACACTGGGTACAGGGTGGGGTTAGAGCTAGAAATAGCA	1
CGGACTCGTC	GAAACACCGGTGTACGTATGGACTGAACCAGGGTGTGCAAGTGGGGTTAG	1
CGGATACTCC	GAAACACCGGTCTCGAGTGAGGTTGGGGGAGAGCTAGCTAAAGCAAGGTA	1
CGGATATTTT	GAAACACCGGTCTCGAGTGAGGTGTTCAGGGTGGGGTTAGAGCTAGAAAT	1
CGGATGCTTC	GAAACCCCGGTCTCGAGTGAGGAGTTCAGGGGGGGGTTAGAGCTAGAAAT	1
CGGATTATGT	GAAACACCGGTTACATTGAGGGTTAGAGCTAGAAATAGCAAGTTAACCTA	1
CGGATTCCTA	GAAACACCGGTCCGTAGGAGACCCGTGTGGCATGTATGTGGGGTTAGAGC	1
CGGCTCATCT	GAAACACCGGTTTACCTTGGATCGCGGTGGGGTTAGAGCTAGAAATAGCA	1
CGGCTCTCGC	GAAACACCGGTGCATTCGAAAGTCCGGTCGTAGTGTGGACGTGGGGTTAG	1
CGGGAGGCTC	GAAACACCGGTTCCCGTACAGTGGGGTTAGAGCTAGAAATAGCAAGTTAA	1
CGGGTGGGCC	GAAACACCGGTGACATTTGGGTTAGAGCTAGAAATAGCAAGTTAACCTAA	1
CGGGTTAGCT	GAAACACCGGTTTAAGTTGCCTCGGAATGGGGAGTTAGCGCTAGGAATAG	1
CGGGTTGCTC	GAAACACCGGTGACAGTGGGGAGGGGTAGAGCTAGAAAAAGCAAGTTTAC	1
CGGTTCGGTT	GAAACACCGGTCGATTCATATCGAAACCTTCCCGTGACAGTGGGGTTAGA	1
CGTAACGCAA	GAAACACCGGTTTGAACTACCGGGGTTAGAGCTAGAAATAGCAAGTTAAC	1
CGTACCTCGT	GAAACACCGGTGCATTCGAAAGTCCGGTCGTAGTGTGGACGTGGGGTTAG	1
CGTAGCGTGC	GAAACACCGGTTATATTTGTAAGTGTGTGGTGTTAGAGCTAGAAATAGCA	1
CGTAGTGTAA	GAAACACCGGTGACATTGGGTTAGGGCTAGAAATAGCAAGTTAACCTAAG	1
CGTATACTTC	GAAACACCGGTCTCGAGTGAGGTGTTCAGGGTGGGGTTAGAGCTAGAAAT	1
CGTATCCCCT	GAAACACCGGTCTCGAATGTCGTCTTCAGGGGGTAGATATAGCTATAACT	1
CGTATCGAGT	GAAACACCGGTTATATTTGTAAGTGGGTGTGGTTATAGCTATAAATAGCA	1
CGTATTCGTC	GAAACACCGGTGTACGTATGGACTGAACCAGGGTGTGCAAGTGGGGTTAG	1
CGTCCTATTA	GAAACACCGGTCACAAGGAGACCCTTGTGGCGTTAACGCTAGAAATTACA	1
CGTCCTTAGC	GAAACACCGGTGCATTCGAAAGTCCGGTCGTAGTGTGGACGTGGGGTTAG	1
CGTCTGCATA	GAAACACCGGTCCGTAGGAGACCCGTGTGGCATGTACCTGTGGGGTTAGA	1
CGTCTGTATC	GAAACACCGGTCCGTAGGAGACCCGTGTGGCATGTACCTGTGGGGTTAGA	1
CGTGGGCTGC	GAAACACCGGTGTTCGTATGGGCTGAACCAGGGTGGGCAAGTGGTGTTAG	1
CGTGGGGTCC	GAAACACCGGTGACATTGGGTTAGGGCTAGAAATAGAAAGTTAACCTAAG	1
CGTGGTGGAT	GAAACACCGGTGACATTGGGTAGTGGGGTTAGAGCTAGAAATAGCAAGTT	1
CGTGTACACT	GAAACACCGGTGACATTGGGTACAAGATTGAACTAGCACGTTAACCTAAG	1
CGTGTACTTT	GAAACACCGGTCTCGAGTGAGGTGTTCAGGGTGGGGTTAGAGCTAGAGAT	1
CGTGTAGACA	GAAACACCGGTGACATTGGCTCCACCCGGTGGGTATAGAGCTAGAAATAG	1
CGTGTGGCAT	GAAACACCGGTGACATTGGGTAACATGGGGTTAGAGCTAGAAATAGCAAG	1
CGTGTTGTCT	GAAACACCGGTGACATTGGGTACAGGGTGGGGTTAGAGCTAGAAATAGCA	489
CGTGTTGTCT	GAAACACCGGTGACATTGGGTACAGGGGTGGGGTTAGAGCTAGAAATAGC	129
CGTGTTGTCT	GAAACACCGGTGACATTGGGTGTGGGGTTAGAGCTAGAAATAGCAAGTTA	94
CGTGTTGTCT	GAAACACCGGTGACATTGGGTATGGGGTTAGAGCTAGAAATAGCAAGTTA	64
CGTGTTGTCT	GAAACACCGGTGACAGTGGGGTTAGAGCTAGAAATAGCAAGTTAACCTAA	60
CGTGTTGTCT	GAAACACCGGTGACATTGGGTACAGAGCTAGAAATAGCAAGTTAACCTAA	60
CGTGTTGTCT	GAAACACCGGTGACATTGGGTTAGAGCTAGAAATAGCAAGTTAACCTAAG	58
CGTGTTGTCT	GAAAAAGTGGCACCGAGTCGGTGCTTTTTTTCCTGCAGGAGACAACACGG	56
CGTGTTGTCT	GAAACACCGGTGACATTGGTGGGGTTAGAGCTAGAAATAGCAAGTTAACC	54
CGTGTTGTCT	GAAACACCGGTGACATTGGGTGCTTTTTTTCCTGCAGGAGACAACACGGA	53
CGTGTTGTCT	GAAACACCGGTGACATAGTGGGGTTAGAGCTAGAAATAGCAAGTTAACCT	48
CGTGTTGTCT	GAAACACCGGTGACAAGTGGGGTTAGAGCTAGAAATAGCAAGTTAACCTA	44
CGTGTTGTCT	GAAACACCGGTGACATTGGGTAGTGGGGTTAGAGCTAGAAATAGCAAGTT	39
CGTGTTGTCT	GAAACACCGGTGACATTAGAGCTAGAAATAGCAAGTTAACCTAAGGCTAG	33
CGTGTTGTCT	GAAACACCGGTGGGGTTAGAGCTAGAAATAGCAAGTTAACCTAAGGCTAG	33
CGTGTTGTCT	GAAACACCGGTGACATTGGGGTTAGAGCTAGAAATAGCAAGTTAACCTAA	31
CGTGTTGTCT	GAAACACCGGTGACATTGGGTAGGTGGGGTTAGAGCTAGAAATAGCAAGT	31
CGTGTTGTCT	GAAACACCGGTGACATTGGGTAGAAATAGCAAGTTAACCTAAGGCTAGTC	30
CGTGTTGTCT	GAAACACCGGTGACATTGGGTACACAGGGTGGGGTTAGAGCTAGAAATAG	29
CGTGTTGTCT	GAAAGGACGAAACACCGGTGACATTAGAGCTAGAAATAGCAAGTTAACCT	29
CGTGTTGTCT	GAAACACAGAGCTAGAAATAGCAAGTTAACCTAAGGCTAGTCCGTTATCA	28
CGTGTTGTCT	GAAGTGGGGTTAGAGCTAGAAATAGCAAGTTAACCTAAGGCTAGTCCGTT	28
CGTGTTGTCT	GAAACACCGGTGACATTGGGTAACATGGGGTTAGAGCTAGAAATAGCAAG	27
CGTGTTGTCT	TTAGAGCTAGAAATAGCAAGTTAACCTAAGGCTAGTCCGTTATCAACTTG	27
CGTGTTGTCT	GAAACACCGACAGGGTTAGAGCTAGAAATAGCAAGTTAACCTAAGGCTAG	26
CGTGTTGTCT	GAAACACCGGTGACATTGGGGCTAGAAATAGCAAGTTAACCTAAGGCTAG	26
CGTGTTGTCT	GAAACACCGGTGACATTATCAACTTGAAAAAGTGGCACCGAGTCGGTGCT	25
CGTGTTGTCT	GAAACACCGGTGACATTGGGGTGGGGTTAGAGCTAGAAATAGCAAGTTAA	23
CGTGTTGTCT	GAAACACCGGTGACATTGGGTACAAAAAGTGGGGTTAGAGCTAGAAATAG	23
CGTGTTGTCT	GAAACACCGGTGACATTGGGTACAGTTAGAGCTAGAAATAGCAAGTTAAC	23
CGTGTTGTCT	GAAACACCGGTGACAATTGGGGTTAGAGCTAGAAATAGCAAGTTAACCTA	22
CGTGTTGTCT	GAAACACCGGTGACATTGGGTGGGGTTAGAGCTAGAAATAGCAAGTTAAC	21
CGTGTTGTCT	GAAACACCGGGGTGGGGTTAGAGCTAGAAATAGCAAGTTAACCTAAGGCT	17
CGTGTTGTCT	GAAACACCGGTGACATTGGGATGGGGTTAGAGCTAGAAATAGCAAGTTAA	17
CGTGTTGTCT	GAAACACCGGTGACATTGGGTACTTTTTTCCTGCAGGAGACAACACGGAA	17
CGTGTTGTCT	GAAACACCGGTGATTGGGGTTAGAGCTAGAAATAGCAAGTTAACCTAAGG	17
CGTGTTGTCT	GAAACACCGGTGACATTGGGTGGTGGGGTTAGAGCTAGAAATAGCAAGTT	16
CGTGTTGTCT	GAAACACCGGTGACATTCAGTGGGGTTAGAGCTAGAAATAGCAAGTTAAC	15
CGTGTTGTCT	GAAACACCGGTGACATTGGGTACAAAGTTAACCTAAGGCTAGTCCGTTAT	15
CGTGTTGTCT	GAAACACCGGTGACATTGGGTCGGAGAAATAGCAAGTTAACCTAAGGCTA	14
CGTGTTGTCT	GAAACACCGGTGACATTGGGTTTTAGAGCTAGAAATAGCAAGTTAACCTA	14
CGTGTTGTCT	ATAGCAAGTTAACCTAAGGCTAGTCCGTTATCAACTTGAAAAAGTGGCAC	13
CGTGTTGTCT	GAAACACCGGTGAAGTGGGGTTAGAGCTAGAAATAGCAAGTTAACCTAAG	12
CGTGTTGTCT	GAAACACCGGTGACATTGGGTACATTGGGTACATTGGGTGGGGTTAGAGC	12
CGTGTTGTCT	GAAACACCGGTGACATTGGGTAGGGGTTAGAGCTAGAAATAGCAAGTTAA	12
CGTGTTGTCT	GAAACACCGGTGACATTGCAGGGGGTTAGAGCTAGAAATAGCAAGTTAAC	11
CGTGTTGTCT	GAAACACCGGTGACATTGGGTACGGGTTAGAGCTAGAAATAGCAAGTTAA	11
CGTGTTGTCT	GAAACACCGGTGACATTGGGTACTTGGGTACAGGGTGGGGTTAGAGCTAG	11
CGTGTTGTCT	GAAACACCGGTGACATTGGGTACAAGATTGAAATAGCAAGTTAACCTAGG	10
CGTGTTGTCT	GAAACACCGGTGACATTGGGTAGGGTTAGAGCTAGAAATAGCAAGTTAAC	10
CGTGTTGTCT	GAAACACCGGTGACATTGGTTAGAAATAGCAAGTTAACCTAAGGCTAGTC	10
CGTGTTGTCT	GAAACACCGGTGACATTGGGTACACCCGGTGGGGTTAGAGCTAGAAATAG	9
CGTGTTGTCT	GAAACACCGGTGACAGCTAGAAATAGCAAGTTAACCTAAGGCTAGTCCGT	7
CGTGTTGTCT	GAAACACCGGTGACATTGGGTACAGGTGGGGTTAGAGCTAGAAATAGCAA	7
CGTGTTGTCT	GAAACACCGGTGACATTGGGTACAAGAGCTAGAAATAGCAAGTTAACCTA	5
CGTGTTGTCT	GAAACGCAGAGCTAGAAATAGCAAGTTAACCTAAGGCTAGTCCGTTATCA	5
CGTGTTGTCT	GTTGGGGTTAGAGCTAGAAATAGCAAGTTAACCTAAGGCTAGTCCGTTAT	4
CGTGTTGTCT	GAAACACCGGTGACATTGGGAGCAAGTTAACCTAAGGCTAGTCCGTTATC	3
CGTGTTGTCT	GAAACACCGGTGACATTGGGTACAGGGCTAGAAATAGCAATAGCAAATAG	2
CGTGTTGTCT	GAAACACCGGTGACATTGGGTACAGGGTGGGTTAGAGCTAGAAATAGCAA	2
CGTGTTGTCT	AGTAGCAAGTTAACCTAAGGCTAGTCCGTTATCAACTTGAAAAAGTGGCA	1
CGTGTTGTCT	CAAAACACCGGTGACATTGGGTACAGGGTGGGGTTAGAGCTAGAAATAGC	1
CGTGTTGTCT	GAAAAACTGGCGCCCCGTCGGAGCTTTTTTCCTGCAGGAGACAACACTGG	1
CGTGTTGTCT	GAAAAAGTGGCACCGAGTCGGTGCTTTTTTCCTGCAGGAGACAACACGGA	1
CGTGTTGTCT	GAAACACCGGTAAATTTGAGGCTCCGGCATGCAGGAGGCCGTGGGGTTAG	1
CGTGTTGTCT	GAAACACCGGTCACGTTAGGACCATTGGCTGCGTTGGGAGAGCTAGAGAT	1
CGTGTTGTCT	GAAACACCGGTCCCAATGAGAACACTGGGGGGTGTTACAGCTAGAATAGA	1
CGTGTTGTCT	GAAACACCGGTCCGTAGGAGACCCGTGTGGCATGTACCTGTGGGGTTAGA	1
CGTGTTGTCT	GAAACACCGGTCTCGAGTGAGGTGTTCAGGGTGGGGTTAGAGCTAGAAAT	1
CGTGTTGTCT	GAAACACCGGTGACATCGGGTACAAGATTGGAATAGCAAGTTAACCTAAG	1
CGTGTTGTCT	GAAACACCGGTGACATTGGCGGGGGTAGAGCTAGAAATAACAAGATTAAC	1
CGTGTTGTCT	GAAACACCGGTGGGGTTAGAGTTAGGACTATCGAGTTACCCTAAGGCTAG	1
CGTGTTGTCT	GAAACACCGGTTCCCGTCCAGTGGGGTTAGAGCTGGAAATAGCAAGTTAA	1
CGTGTTGTCT	GAAGCGGGGGTACCGCTAGAGATAGCTAGTTAACCTATGGCTAGACAGAT	1
CGTGTTGTCT	GAAGGAACCACCGGTGAATTATTCACTTGAAAAAGTTGCACCGGGTCGGT	1
CGTGTTGTCT	GAATCACCGGTGACCGTGCAGAGGGATAAGGCATAGTAATATAAGGTTAA	1
CGTGTTGTCT	GACGAAACACCGGTGACGTTGGGTGGTGGGGTTAGAGCTAGAAATAGCAA	1
CGTGTTGTCT	GACGAAACACCGGTTCCCGTCCAGTGGGGTTAGAGCTAGAAATAGCAAGT	1
CGTGTTGTCT	GAGACACCGGTCGATTCATATCGAAACCTTCCCGTGACAGTGGGGTTAGA	1
CGTGTTGTCT	GTTAGGGTTAGAGATAGAAATAGCAAGCTAAGCTAAGGCTAGTCCGTTAT	1
CGTTATGTTT	TTAGAGCTAGAAATAGCAAGTTAACCTAAGGCTAGCCCGTTATCAACTTG	1
CGTTCTGACT	GAAACACCGGTGACATTGGGTAATATGGGGGTAGAGCTAGAAATAGCAAG	1
CGTTGACTGC	GAAACACCGGTCTTGGTTATAGCTAGGAATAGCTAGTTAACCTAAGGCTA	1
CGTTTAGTCC	GAAACACCGGTGACAGTGGCTACGGGGTGGGGTTAGAGCTAGAAATAGCA	1
CTAAAAGGCA	GAAACACCGGTACCTTTGTTGATGCTGGGTGGAAGGAGCTAGATGCTGGT	1
CTAACCACCC	GAAACACCGGTACCTTTGTTGATGCTGGGTGGTTAGGAATTCGGGCCCAT	2
CTAATCGGAA	GAAACACCGGTACCTTTGTTGATGCTGGGTGGAAGGAATTTTGTGGGGTT	1
CTACACTCGC	GAAACACCGGTGCATTCGAAAGTCCGGTCGTAGTGCGGACGTGGGGTTAG	1
CTACCCACCC	GAAACACCGGTACCTTTGTTGATGCTGGGTGGGTAGGAATTCGGGCCCAT	1
CTACTAGGTA	GAAACACCGGTACCTTTGTTGATGCTGGGTGGAAGGAATTTTGTGGGGTT	1
CTACTCGGCC	GAAACACCGGTACCTTTGTTGATGCTGGGTGGGGTTAGAGCTAGAAATAG	365
CTACTCGGCC	GAAACACCGGTACCTTTGTTGATGCTGGGTGGAAGGAATTTGTGGGGTTA	302
CTACTCGGCC	GAAACACCGGTACCTTTGTTGATGCTGGGTGGAAGGAATTTTGTGGGGTT	229
CTACTCGGCC	GAAACACCGGTACCTTTGTTGATGCTGGGTGGAAGGAATGTGGGGTTAGA	129
CTACTCGGCC	GAAACACCGGTACCTTTGTTGATGCTGGGTGGAAGCTAGAAATAGCAAGT	77
CTACTCGGCC	GAAACACCGGTACCTTAGAGCTAGAAATAGCAAGTTAACCTAAGGCTAGT	65
CTACTCGGCC	GAAACACCGGTACCTTTGTTGATGCTGGTGTGGGGTTAGAGCTAGAAATA	55
CTACTCGGCC	GAAACACCGGTACCTTTGTTGTGGGGTTAGAGCTAGAAATAGCAAGTTAA	50
CTACTCGGCC	GAAACACCGGTACCTTTGCTGATGCTGGGTGGAAGGGATTTTTGTGGGGT	45
CTACTCGGCC	GAGGCTAGTCCGTTATCAACTTGAAAAAGTGGCACCGAGTCGGTGCTTTT	41
CTACTCGGCC	GAAACACCGGTACCTTTGTTGATGCTGGGTGGAAGGAAGGTGGGGTTAGA	39
CTACTCGGCC	GAAACACCTAGTCCGTTATCAACTTGAAAAAGTGGCACCGAGTCGGTGCT	34
CTACTCGGCC	GAAACACCGGTACCTTTGTTGATGCTGGGCTAGTCCGTTATCAACTTGAA	31
CTACTCGGCC	GAAACACCGGTACCTTTGTTGATGCTGGGTGGAAGGAATTGTGGGGTTAG	30
CTACTCGGCC	GAAACACTTAGAGCTAGAAATAGCAAGTTAACCTAAGGCTAGTCCGTTAT	26
CTACTCGGCC	GAAACACCGGTACCTTTGTTGATGCTGGGTGGAAGGAAGGGGTTAGAGCT	24
CTACTCGGCC	GAAACACCGGTACCTTTGTTGATGCTGGGTGGAAGGAAGGGTTAGAGCTA	24
CTACTCGGCC	GAAACACGTGGGGTTAGAGCTAGAAATAGCAAGTTAACCTAAGGCTAGTC	22
CTACTCGGCC	GAAACACCGGTACCTTTGTTGATGCTGGGTGGAAGGTACACCGGTACCTT	21
CTACTCGGCC	GAAACACCGGTACCTTTGTTGAGGGGTTAGAGCTAGAAATAGCAAGTTAA	19
CTACTCGGCC	GAAACACCGGTACCTTTGTTGATGCTGGGTGGAAGGTGGGGTTAGAGCTA	19
CTACTCGGCC	GAAACACCGGTACCTTTGTTGATGCTTGGAAATAGCAAGTTAACCTAAGG	19
CTACTCGGCC	GAAACACCGGTACCTTTGTTGATTAGCAAGTTAACCTAAGGCTAGTCCGT	19
CTACTCGGCC	GAAACACCGGTACCTTTGTTGATGCTGGGTGGAAGGAGCTAGATGCTGGT	18
CTACTCGGCC	GAAACACCGGTACCTTTGTTGATGCTGGTTGTGGGGTTAGAGCTAGAAAT	18
CTACTCGGCC	GAAACACCGGTACCTTTGTTGAAGCTAGAAATAGCAAGTTAACCTAAGGC	17
CTACTCGGCC	GAAACACCGGTACCTTTGTTGATGCTAGAAATAGCAAGTTAACCTAAGGC	17
CTACTCGGCC	GAAACACCGGTACCTTTGTTGATGCTGGGTGTTAGAGCTAGGTTAGAGCT	17
CTACTCGGCC	GAAACACCGGTACCTTTGTTGATGCTGGGTGGAAGAGCTAGAAATAGCAA	16
CTACTCGGCC	GAAACACCGGTACCTTTGTTGATGCTGGGTTGTGGGGTTAGAGCTAGAAA	14
CTACTCGGCC	GAAACACCGGTACCTTTGTAGATGCTGGGTGGAAGAAGGGGTTAGAGCTA	12
CTACTCGGCC	GAAACACCGGTACCTTTGTTGATGCTGGGTGGAAGGAATAGAAATAGCAA	12
CTACTCGGCC	GAAACACCGGTACCTTTATTGATGCTGGGTGGAAGTTAGAGCTAGAAATA	11
CTACTCGGCC	GAAACACCGGTACCTTTGTTGATGCTGGGTGGTGGGGTTAGAGCTAGAAA	10
CTACTCGGCC	GAAACACCGGTACCTTTGTTGATGCTGGGTGGAAGGAATGGTTAGAGCTA	9
CTACTCGGCC	GAAACACCGGTACCTTTGTTGATGTTTGTGGGGTTAGAGCTAGAAATAGC	9
CTACTCGGCC	GAAACACCGGTACCTTTGTTGATGCTGGGTAGCAAGTTAACCTAAGGCTA	8
CTACTCGGCC	GAAACACCGGTACCTTTGTTGATGCTGGGTGGAAGGATGCTGGGTGGGGT	8
CTACTCGGCC	GAAACACCGGTACCTTTGTTGATGCTGGTGGGGTTAGAGCTAGAAATAGC	8
CTACTCGGCC	GAAACACCGGTACCTTTGTTGATGCTGGGTGGAAGGAATAGAGCTAGAAA	6
CTACTCGGCC	GAAACACCGGTACCTTTGTTGATGCTGGGTGGAAGGAAAGTTAACCTAAG	5
CTACTCGGCC	GAAACACCGGTACCTTTGTTGATGCTGGGTGGAAGGAAGTGGGGTTAGAG	4
CTACTCGGCC	GAAACACCGGTACCTTTGTTGATGCTGGGTGGATTTTGTGGGGTTAGAGC	4
CTACTCGGCC	GAAACACCGGTACCTTTGTTGATGCTGGGTGGAAGGATGTGGGGTTAGAG	3
CTACTCGGCC	GAAACACCGGTACCTTTGTTGATGCTGGGTGGCACCGAGTCGGTGCTTTT	3
CTACTCGGCC	GAAACACCGGTGCATTCGAAAGTCCGGTCGTAGTGTGGACGTGGGGTTAG	3
CTACTCGGCC	GAAACACCGGTACCTTGTTGATGCTGGGTGGAAGGAATAGAAATAGCAAG	2
CTACTCGGCC	GAAACACCGGTACCTTTGTTGATGCTGGGTGGAAGGAGTGGGGTTAGAGC	2
CTACTCGGCC	GAAACACCGGTGTACGTATGGACTGAACCAGGGTGTGCAAGTGGGGTTAG	2
CTACTCGGCC	AACGAACCCCGGGACCCTTTTTTATGCTTGGGGGGAGGGATTTTGGGGGG	1
CTACTCGGCC	CAAAACACCGGTACCTTTGTTGAGGGGTTAGAGCTAGAAATAGCAAGTTA	1
CTACTCGGCC	CAAAACACCGGTACCTTTGTTGATGCTGGGTGGAAGGAAGTGGGGTTAGA	1
CTACTCGGCC	CAAAACACCGGTACCTTTGTTGATGCTGGGTGGAAGGAATGGGTGGGGTT	1
CTACTCGGCC	CAAAACACCGGTACCTTTGTTGATGCTGGGTGGGGTTAGAGCTAGAAATA	1
CTACTCGGCC	GAAACACCAGTACCTTTGTTGATGCTTGTTGTGGGTAGAGCTCGAAATAG	1
CTACTCGGCC	GAAACACCGATAACTAGAAATTGAAGGTTAAATTAGGAGTGGTGCGTTAT	1
CTACTCGGCC	GAAACACCGGCACCTTTGTTGATGCTGGGTGGAAGGAAAGTTAACCTAAG	1
CTACTCGGCC	GAAACACCGGCAGTTTGGTTGAAGCTGAGTGGGGTTAGAGCTAGAAATAG	1
CTACTCGGCC	GAAACACCGGTACCTATGTTGATGCTGGGGGGGAGGTTATTGGTGGAGAT	1
CTACTCGGCC	GAAACACCGGTACCTGTGTTTCTGCTGGGGGGTTAGTGCTGGAAATAGCA	1
CTACTCGGCC	GAAACACCGGTACCTTGTTGATGCTGGGTGGAGGGAATAGAAATAGCAAG	1
CTACTCGGCC	GAAACACCGGTACCTTTCTTGATTAGCAGGTTATCCTGATGCTAATCCGT	1
CTACTCGGCC	GAAACACCGGTACCTTTGTTGATACTGGGTGGCACCGAGTCGGTGCTTTT	1
CTACTCGGCC	GAAACACCGGTACCTTTGTTGATGCTGGGGGAAGGATTTTTTTGTGGGGT	1
CTACTCGGCC	GAAACACCGGTACCTTTGTTGATGCTGGGTGGAAGTTAGAGCTAGAAGTA	1
CTACTCGGCC	GAAACACCGGTACCTTTGTTGATGCTGGGTGGATTTTGTGAGGTTAGAGC	1
CTACTCGGCC	GAAACACCGGTACCTTTGTTGATGCTGGGTGGATTTTGTGGGGTCAGAGC	1
CTACTCGGCC	GAAACACCGGTACCTTTGTTGATTCTTGGTTGCCGGCATGTGGGGTTAGC	1
CTACTCGGCC	GAAACACCGGTACCTTTGTTGGTGCTAGGAGGGGTTAGTGCTAGTAGTCG	1
CTACTCGGCC	GAAACACCGGTATCTTTGTTGATGCTGGGTGGAAGGAAGTGGGGTTAGAG	1
CTACTCGGCC	GAAACACCGGTCGCCGTCAATCGGGGGGGGGGTTAGAGCTAGAAATAGCA	1
CTACTCGGCC	GAAACACCGGTCGGGGCCACTCAGTGGTGGGGTTAGAGCTAGAAATAGCA	1
CTACTCGGCC	GAAACACCGGTCTCGAATGAGGTGTTCAGGGTGGGGTTAGAGCTAGAAAT	1
CTACTCGGCC	GAAACACCGGTGTGGCTGAGAGTCCGGCAATGGTGTGGCTGTGGGGTTAG	1
CTACTCGGCC	GAAACACCGGTTACATTGAGGGTTAGAGCTAGAAATAGCAAGTTAACCTA	1
CTACTCGGCC	GAAACACCGGTTTACGTTGCATCGGTTGTGGGGTTAGAGCTAGAAATAGC	1
CTACTCGGCC	GACGAAACACGTGGGGTTAGAGCTAGAAATAGCAAGTTAACCTAAGGCTA	1
CTACTCGGCC	GAGGCTAGCCCGTTATCAACTTGAAAAACATGCGCCGGGGCTAGGCTTTT	1
CTACTCGGCC	GCTAGAAATAGCAAGTTAACCTAAGGCTAGTCCGTTATCAACTTGAAAAA	1
CTACTCGGCC	GGGCTAGTCCGTTATCAACTTGAAAAAGTGGCACCGAGTCGGTGCTTCTT	1
CTACTCGGCC	GGGCTAGTCCGTTTTACACTTGGAACAGCGGCACCGAGTCGGTGGTTTTT	1
CTACTGGGAA	GAAACACCGGTACCTTTGTTGATGCTGGGTGGGGTTAGAGCTAGAAATAG	1
CTACTGGGTA	GAAACACCGGTACCTTTGTTGATGCTGGGTGGAAGGAATTTGTGGGGTTA	1
CTAGAGTCAC	GAAACACCGGTTCCCGTACACTGGGGATGCGGATGGGACTGTCAAGTTAA	1
CTAGCTGTGG	GAAACACCGGTTACATTGGGCGCTATAGCTAGAAATAGCAGGTTAACCTA	1
CTAGTCGTGC	GAAACACCGGTACCTTAGAGCTAGAAATAGCAATTTAGCCTAAGGCTAGT	1
CTATCAACCC	GAAACACCGGTACCTTTGTTGATGCTGGGTGGATAGGAATTCGGGCCCAT	1
CTATCCACCC	GAAACACCGGTACCTTTGTTGATGCTGGGTGGATAGGAATTCGGGCCCAT	35
CTATCCACCC	GAAACACCGGTTCATTTGATAGCTATGGATGGAAAGGAAATCGAGCCCTT	1
CTATCCACCC	GAAACACTGGTACCTTTGTTGATGCTGGGTGGATAGGAATTCGGGCCCAT	1
CTATCCACCC	GAAACACCGGTACCTTTGTTGATGCTGGGGGGATAGGAATTCGGGCACAT	1
CTATCCACCC	GAAACACCGGTACCTTCGTTGATGCTGGGTGGATAGGAATTCGGGCCCAT	1
CTATCCACCC	CAAAACACCGGTACCTTTGTTGATGCTGGGTGGATAGGAATTCGGGCCCA	1
CTATCCACGC	GAAACACCGGTACCTTTGTTGATGCTGGGTGGATAGGAATTCGGGCCCAT	1
CTATCTACCC	GAAACACCGGTACCTTTGTTGATGCTGGGTGGATAGGAATTCGGGCCCAT	1
CTATTAACGC	GAAACACCGGTCGGGGCCACTCAGCTGTGGGGTTAGAGCTAGAAATAGCA	1
CTATTAGGTC	GAAACACCGGTACCTTTGTTGATGCTGGGTGGGGTTAGAGCTAGAAATAG	1
CTATTTATGC	GAAACACCGGTTACATTGAGGGGTTACAGCTAGAAATAGCAAGTTAACCT	1
CTCATTTACC	GAAACACCGGTCGGGGCCACTCAGTGGTGGGGTTAGAGCTAGAAATAGCA	1
CTCCACGCCT	GAAACACCGGTTGAGGGCGTGTGAGGGATTGAAGCGATGAGTTGAGCTAA	1
CTCCCCTGCA	GAAACACCGGTGTGGCTGAGAGTCCGGCAATGGTGTGGCTGTGGGGTTAG	11
CTCCCCTGCA	GAAACACCGGTGCGGCTGAGAGTCCGGCAATGGTGTGGCTGTGGGGTTAG	1
CTCCCCTGCA	GAAACACCGGGGAGGCTGAGAGTCCGTCAATGGCGTGGCTGTGGGGTTAG	1
CTCCCCTGCA	GAAACACCGGTGTGGCTGAGAGTCCGGCAATGGTGTGGCTGCGGGGTTAG	1
CTCCCCTGCA	GAAACACCAGTGTGGCTGAGAGTCCGGCAATGGTGTGGCTGTGGGGTTAG	1
CTCCCCTGCC	GAAACACCGGTGTGGCTGAGAGTCCGGCAATGGTGTGGCTGTGGGGTTAG	1
CTGAAGGCCC	GAAACACCGGTTTCAACTAGAAATAGCAAGTTAAACTAAGGCTAGTCCGT	1
CTGACACAGA	GAAACACCGGTAGCAAGTGCGAGACGTTTTTGTGGGGTTAGAGCTAGAAA	1
CTGATCCAAA	GAAACACCGGTTAAGCCGAGTGGGGTTAGAGCTAGAAATAGCAAGTTAAC	1
CTGATTCTTT	GAAACACCGGTCTCGAGTGCGGTGTTCTGGGGGGAGTTCTAGCTAGAGCT	1
CTGCAGCCCC	GAAACACCGGTTCCCGTCCAGTGGGGTTAGAGCTAGAAATAGCAAGTTAA	1
CTGCGCGGCA	GAAACACCGGTACCTTTGTTGATGCTGGGTGGAAGGAAGGTGGGGTTAGA	1
CTGCGCTTGA	GAAACACCGGTTAAGCCGAGTGGGGTTAGAGCTAGAAATAGCAAGTTAAC	1
CTGCGGAGCT	CAAAACACCGGTTTATATTAGATCGGTGTGGCATTAGAGCGAGGAATTGC	1
CTGCTCATGA	GAAACACCGGTTTACGTTGCATCGGTGTGGGGTTAGAGCTAGAAATAGCA	1
CTGCTTAGGC	GAAACACCGGTTTACGTTGCATCGGTGTGGGGTTAAAGCTAGAAATAGCA	1
CTGCTTCCTT	GAAACACCGGTTTACGTTGCATCGGTTGTGGGGGTATAGCTAGTAATAGC	1
CTGCTTCGTT	GAAACACCGGTTTACGTTGCATCGGTGTGGGGTTAGGGCTAGAAATAGCA	1
CTGCTTCTAT	GAAACACCGGTTTACGTTGCATCGGTGTGGGGTTAGTGCTAGAAATAGCA	1
CTGGATAGCT	GAAACACCGGTTTACGTTGCATCGGTGTGGGGTTAGAGCTAGAAATAGCA	1
CTGGCTATGC	GAAACACCGGTTACATTGAGGGTTAGAGCTAGAAATAGCAAGTTAACCTA	1
CTGGGCATCA	GAAACACCGGTTAAGCCGTGGGGTTAGAGCTAGAAATAGCAAGTTAACCT	1
CTGGGTGGTA	GAAACACCGGTGTACGTATGGACTGAACCAGGGTGTGCAAGTGGGGTTAG	1
CTGGGTTTTT	GAAACACCGGTTAAAATTGAGGGTTAGAGCTAGGGATAACAGCTTGACCT	1
CTGTTGGGGC	GAAACACCGGTACCTTTGTTGATGCTGGGAGGAAGGAAATTGCGGGGTTA	1
CTTAGTCGTA	GAAACACCGGTGTACGTATGGACTGAACCAGGGTGTGCAAGTGGGGTTAG	1
CTTCTGCCTA	GAAACACCGGTCCGTAGGAGACCCGTGTGGCATGTACCTGTGGGGTTAGA	1
CTTTCACGGT	GAAACACCGGTCGGGGCCACTCAGTGGTGGGGTTAGAGCTAGAAATAGCA	1
CTTTTACAGA	GAAACACCGGTCGTGGCCACTCAGTGGTGGGGGTAGATCTAGAAATAGCA	1
CTTTTATCTC	GAAACACCGGTCGGGGCCACTCAGTGGTGGGGTTAGAGCTAGAAATAGCA	1
CTTTTTGGCT	GAAACACCGGTGGGGTTAGAGCTAGAAATAGCAAGTTAACCTAAGGCTAG	1
GAAAAAGAAA	GAAACACCGGTAGCAAGTGCGAGACGTGTTAACGCTATTTCTAGCTCTAA	1
GAAAAAGCCA	GAAACACCGGTAGCAAGTGCGGGTTAGAGCTAGAAATAGCAAGTTAACCT	1
GAAAAAGCCC	GAAAGCACCGGTAGCAAGTGCGAGACGTGTTGGTGGGGTTAGAGCTAGAA	1
GAAAAAGCGC	GAAACACCGGTCGGCGGCAATCGTGGGTGGGGTTAGAGCTAGAAATAGCA	1
GAAAAGCGCA	GAAACACCGGTCGATTCATATCGAAACCTTCCCGTGACAGTGGGGTTAGA	1
GAAACCGCCC	GAAACACCGGTAGCAAGTGCGAGACGTTTTTGTGGGGTTAGAGCTAGAAA	1
GAAACGCCCT	GAAACACCGGTGCCCTTACTCTCACCTGATTACTTAATCCGTGGGGTTAG	1
GAAACTGACC	GAAACACCGGTAGCAAGTGGGGTTAGAGCTAGAAATAGCAAGTTAACCTA	1
GAAAGCGGCC	GAAACACCGGTACCTTTGATGATGCTGGGATGGAGGGATTTTTGGGGTGT	1
GAAAGGCCAA	GAAACACCGGTGCCCTTACTCTCACCTGATTACTTAATACGTGGGGTTAG	1
GAAAGGTTCC	GAAACACCGGTGTGGCTGAGAGTCCGGCAATGGTATGGCTGGGGGTTGAG	1
GAAATAAACA	GAAACACCGGTAGCAAGTGCGAGACGTGTTAAATAGCAAGTTAACCTAAG	1
GAACAACGAC	GAAACACGGGTTAGAGCTAGAAATAGCAAGTTAACCTAAGGCTAGTCCGT	1
GAACAACGCC	GAAACACCGGTTTGAGGAGCTAGAAATAGCAAGTTAACCTAAGGCTAGTC	1
GAACCAGAAA	GAAACACCGGTAGCAAGTGCGAGACGTGTTTGTGGGGTTAGAGCTAGAAA	1
GAACCCCTCC	GAAACACCGGTGTGGCTGAGAGTCCGGCAATGGTGTGGCTGTGGGGTTAG	1
GAACGACGCC	GAAACACCGGTTTGAACTACCTAGTTCAAACCGGTGGGGTTAGAGCTAGA	1
GAACGCACTA	GAAACACCGGTGCCCTTACTCTCACCTGATTACTTAATCCGTGGGGTTAG	1
GAACGCCATA	GAAACACCGGTGCCCTTACTCTCACCTGATTACTTAATCCGTGGGGTTAG	1
GAACGCCTTA	GAAACACCGGTGCCCTTACTCTCACCTGATTACTTAATCCGTGGGGTTAG	1
GAACTCCTGC	GAAACACCGGTCGGCGGCAGCGGGGTTAGAGCTAGAAATAGCAAGTTAAC	1
GAAGAAATGA	GAAACACCGGTCGGCGGCAATCGTGGGAGGGGTTAGAGCTCGAAATAGCA	1
GAAGAATCGA	GAAACACCGGTCGGCGGCAAGTTAATAAATAGCAAGTTAGCCTAAGGCTA	1
GAAGACATAT	GAAACACCGGTGCCCTTACTCTCACCTGATTACTTAATCCGTGGGGTTAG	1
GAAGACCCGC	GAAACACCGGTCGGCGGCAATCGTGGGTGGGGTTAGAGCTAGAAATAGCA	918
GAAGACCCGC	GAAACACCGGTCGGCGGTTAGAGCTAGAAATAGCAAGTTAACCTAAGGCT	85
GAAGACCCGC	GAAACACCGGTCGGCGGCAATCGTGGTATGAGCCACGTGGGGTTAGATCG	69
GAAGACCCGC	GAAACACCGGTCGGCGGTGGGGTTAGAGCTAGAAATAGCAAGTTAACCTA	69
GAAGACCCGC	GAAACACCGGTCGGCGGCAATCGTGGTTAGAGCTAGAAATAGCAAGTTAA	50
GAAGACCCGC	GAAACACCGGTCGGCGATAGCAAGTTAACCTAAGGCTAGTCCGTTATCAA	49
GAAGACCCGC	GAAACACCGGTCGGCGGCAATCGTGGGGTGGGGTTAGAGCTAGAAATAGC	45
GAAGACCCGC	GAAACACCGGTCGGCGGCTAGTCCGTTATCAACTTGAAAAAGTGGCACCG	40
GAAGACCCGC	GAAACACCGGTCGGCGGCAATCGTGCTTTTTTTCCTGCAGGGCGGGTCTT	36
GAAGACCCGC	GAAACACCGGTCGGCGGCAATCGTTAGAGCTAGAAATAGCAAGTTAACCT	32
GAAGACCCGC	GAAACACCGGTCGGTGGGGTTAGAGCTAGAAATAGCAAGTTAACCTAAGG	31
GAAGACCCGC	GAAACACCGGTCGGCGGCAATCGTGTGGGGGTGGGGTTAGAGCTAGAAAT	30
GAAGACCCGC	GAAACACCGGTCGGCGGCAATCGTTAGAGCTAGAAATAGCTAGAAATAGC	30
GAAGACCCGC	GAAACACCGGTCGGCGGGGTTAGAGCTAGAAATAGCAAGTTAACCTAAGG	29
GAAGACCCGC	GAAACACCGGTCGGCGGCAGGGGGTTAGAGCTAGAAATAGCAAGTTAACC	27
GAAGACCCGC	GAAACACCGGTCGGCGGGGTGGGGTTAGAGCTAGAAATAGCAAGTTAACC	26
GAAGACCCGC	GAAACACCGGTCGGATAGCAAGTTAACCTAAGGCTAGTCCGTTATCAACT	24
GAAGACCCGC	GAAACACCGGTCGGCGGCAATCTAGAAATAGCAAGTTAACCTAAGGCTAG	24
GAAGACCCGC	GAAACACCGGTCGGCGGAGCTAGAAATAGCAAGTTAACCTAAGGCTAGTC	23
GAAGACCCGC	GAAACACCGGTCGGGGTGGGGTTAGAGCTAGAAATAGCAAGTTAACCTAA	22
GAAGACCCGC	GAAACACCGGTCGGCGGCAAAGCTAGAAATAGCAAGTTAACCTAAGGCTA	21
GAAGACCCGC	GAAACACCGGTCGGCGGCAATCGTAGAGCTAGAAATAGCAAGTTAACCTA	21
GAAGACCCGC	GAAACACCGGTCGGCGGCAATCGTTTTGTGGGGTTAGAGCTAGAAATAGC	21
GAAGACCCGC	GAAACACCGGTCGGCGGCAATGTGGGGTTAGAGCTAGAAATAGCAAGTTA	21
GAAGACCCGC	GAAACACCGGTCGGCGGCGTGGGGTTAGAGCTAGAAATAGCAAGTTAACC	21
GAAGACCCGC	GAAACACCGGTCGGCTAGTCCGTTATCAACTTGAAAAAGTGGCACCGAGT	20
GAAGACCCGC	GAAACACCGGTCGGGGTTAGAGCTAGAAATAGCAAGTTAACCTAAGGCTA	20
GAAGACCCGC	GAAACACCGGTCGGCGGCAATCGTTTTTGTGGGGTTAGAGCTAGAAATAG	19
GAAGACCCGC	GAAACACCGGTCGGCGGCGGTGGGGTTAGAGCTAGAAATAGCAAGTTAAC	19
GAAGACCCGC	GAAACACCGGTCGGCTAGAAATAGCAAGTTAACCTAAGGCTAGTCCGTTA	19
GAAGACCCGC	GAAACACCGGTCGGCGGCAAGGCTAGTCCGTTATCAACTTGAAAAAGTGG	18
GAAGACCCGC	GAAACACCGGTCGGCGGGTTAGAGCTAGAAATAGCAAGTTAACCTAAGGC	17
GAAGACCCGC	GAAACACCGGTCGGCGGCAACGTGGTTAGAGCTAGAAATAGCAAGTTAAC	16
GAAGACCCGC	GAAACACCGGTCGGCGGCAGCGGGGTTAGAGCTAGAAATAGCAAGTTAAC	16
GAAGACCCGC	GAAACACCGGTCGGCGGGTGGGGTTAGAGCTAGAAATAGCAAGTTAACCT	16
GAAGACCCGC	GAAACACCGGTCGGCGGCAAGTGGGTGGGGTTAGAGCTAGAAATAGCAAG	15
GAAGACCCGC	GAAACACCGGTCGGCGGCAATCGTGTTACCTGGCAAGAGCTAGAAATAGC	15
GAAGACCCGC	GAAACACCGGTCGGCGGCAATCGTTAATCGGTTAATCGTGGGGTTAGAGC	12
GAAGACCCGC	GAAACACCGGTCGGCGGCAAAAAAATGCTTTTTTTCCTGCAGGGCGGGTC	11
GAAGACCCGC	GAAACACCGGTCGGCGGCAAGTTAATAAATAGCAAGTTAACCTAAGGCTA	10
GAAGACCCGC	GAAACACCGGTCGGCGGCAATCGCCGCCGTGGGGTTAGAGCTAGAAATAG	10
GAAGACCCGC	GAAACACCGGTCGGCGGCCGGTTAGAGCTAGAAATAGCAAGTTAACCTAA	9
GAAGACCCGC	GAAACACCGGTCGGCGGCTAGAAATAGCAAGTTAACCTAAGGCTAGTCCG	9
GAAGACCCGC	GAAACACCGGTCGGCGGCAACGTGGGGTTAGAGCTAGAAATAGCAAGTTA	8
GAAGACCCGC	GAAACACCGGTCGGCGGCAATCGTGTGGGGTTAGAGCTAGAAATAGCAAG	5
GAAGACCCGC	GAAACACCGGTCGGCGGCAATTAGAGCTAGAATTAGAATTAGAGCTAGAA	5
GAAGACCCGC	CAAAACACCGGTCGGCGGCAATCGTGGTTAGAGCTAGAAATAGCAAGTTA	4
GAAGACCCGC	GAAACACCGGTCGGCGGCAATCGTGTTAGATTTAGGTTAGAGCTAGAAAT	4
GAAGACCCGC	GAAACACCGGTCGGCGGGTGGGGGTAGAGCTAGAAATAGCAAGTTAACCT	4
GAAGACCCGC	GAAACACCGGTGCATTCGAAAGTCCGGTCGTAGTGTGGACGTGGGGTTAG	4
GAAGACCCGC	GAAACACCGGTCGGCGGCAATCAAGTTAACCTAAGGCTAGTCCGTTATCA	3
GAAGACCCGC	GAAACACCGGTCGGCGGCAATCGTGGTCGTGGGTGGGGTTAGAGCTAGAA	2
GAAGACCCGC	GAAACACCGGTCGGTTAACCTAAGGCTAGTCCGTTATCAACTTGAAAAAG	2
GAAGACCCGC	GAAACACCGGTTTGAACTAGAAATAGCAAGTTAACCTAAGGCTAGTCCGT	2
GAAGACCCGC	CAAAACACCGGTCGGCGGCAATGTGGGGTTAGAGCTAGAAATAGCAAGTT	1
GAAGACCCGC	GAAACACCGGCCGGCGGCAATCGTGTTAGATTTAGGTTAGAGCTAGAAAT	1
GAAGACCCGC	GAAACACCGGTAAATTTGAGGCTCCGGCATGCAGGAGGCCCGTGGGGTTA	1
GAAGACCCGC	GAAACACCGGTAGCAAGTTAACCTAAGGCTAGTCCGTTATCAACTTGAAA	1
GAAGACCCGC	GAAACACCGGTCAGCGGCAATTAGAGCTAGAATTAGAATTAGAGCTAGAA	1
GAAGACCCGC	GAAACACCGGTCGGCGGCAACCGTGGGTGGGGTAGAGCTAGAAATAGCAA	1
GAAGACCCGC	GAAACACCGGTCGGCGGCAATCGTGGGTGGGGTAGAGCTAGAAATAGCAA	1
GAAGACCCGC	GAAACACCGGTCGGCGGCAATCGTGGGTGGGTTAGAGCTAGAAATAGCAA	1
GAAGACCCGC	GAAACACCGGTCGGCGGCAGTCGTGGTGGGGTTAGAGCTAGAAATAGCAA	1
GAAGACCCGC	GAAACACCGGTCGGCGGCTAGAAATAGCAAGTTAACCTAGGCTAGTCCGT	1
GAAGACCCGC	GAAACACCGGTCGGCGGGTGGGGGTAGAGCTCGAAAAAACAAGGTAAACT	1
GAAGACCCGC	GAAACACCGGTCGGCGGTGTCGGGATATGGGTTTAAATATAGAAATAACA	1
GAAGACCCGC	GAAACACCGGTCGGCGGTTTGATCTAGGAATAGAAAGTTAAAATAAGGAT	1
GAAGACCCGC	GAAACACCGGTCGGTTAACCTAAGGCTAGTCCGTTATCAACTCGAAAAAG	1
GAAGACCCGC	GAAACACCGGTCTCGAGCGATCGGTTCTTCAGGGAGGGGTTAGAGCTAGA	1
GAAGACCCGC	GAAACACCGGTGCATTCGAAAGGCCGGTCGTAGTGTAGACGGGGGTATCA	1
GAAGACCCGC	GAAACACCGGTGCATTCGAAAGTCCGTTCGTATTGTGGACGTGGGGTTAT	1
GAAGACCCGC	GAAACACCGGTGTACGTATGGACTGAACCAGGGTGTGCAAGTGGGGTTAG	1
GAAGACCCGC	GAAACACCGGTGTATGTATGGACTGAACCAGGGTGTGCAAGTGGGGTTAG	1
GAAGACCCGC	GAAACACCGGTTAAGCCGAGGAGTTAGAGCTAGAAATAGCAAGTTAACCT	1
GAAGACCCGC	GAAACACCGGTTAAGCCGAGTGGGGTTAGAGCTAGAAATAGCAAGTTAAC	1
GAAGACCCGC	GAAACACCGGTTACATTGAGGGTTAGAGCTAGAAATAGCAAGTTAACCTA	1
GAAGACCCGC	GAAACACCGGTTGACGGCAATCGTGGGTGTGGTTAGAGCTAGATATAGTT	1
GAAGACCCGC	GAAACACCGGTTGGCGGTTATTCCCAGAAAGCGCGAGATTACCGTTTGCG	1
GAAGACCCGC	GAAACACCGGTTTACGCTGCATCGGTGTGGGGTTAGAGCTAGAAATAGCA	1
GAAGACCCGC	GAAACGCCGGTCGGTTAACCTAAGGCTAGTCCGTTATCAACTTGAGAAAG	1
GAAGACCCGC	GAACACCGGTCGGCGGCAATCGTGGGTGGGGTTAGAGCTAGAAATAGCAA	1
GAAGACCCGC	GAGACACCGGTCGGCGGCAATCAAGTTAACCTAAGGCTAGTCCGTTATCA	1
GAAGACCCGC	GAGACACCGGTTACATTGAGGGTTAGAGCTAGAAATAGCAAGTTAACATA	1
GAAGACCGTT	GAAACACCGGTCGGCGGCAATCGTGGGTGGGGTTAGAGCTAGAAATAGCA	1
GAAGACGAGT	GAAACACCGGTCGGCGGCAATCGCGGGTGGGGTTAGATCTAGAAATAGCA	1
GAAGACTTGA	GAAACACCGGTCGGCGGCAATCGTGGGGTGGGGTTAGAGCTAGAAATAGC	1
GAAGAGCCCT	GAAACACCGGTCGGCGGCAATAGTGGGTGGGGTTAGGGCTAGAAATGGCA	1
GAAGATAGGC	GAAACACCGGTAACTATATTCATGCGATATCGCCGTATCAGGGGGGTTAG	1
GAAGATATGT	GAAACACCGGTTACATTGAGGGGTTAGAGCTAGAAATAGCAAGTTAACCT	1
GAAGCCCTAA	GAAACACCGGTGCCCTTACTCTCACCTGATTACTTAATCCGTGGGGTTAG	1
GAAGCGCCGA	GAAACACCGGTCGGCGGTGGGGTTAGAGCCAGAAATAGCAAGTTAACCTA	1
GAAGCTAGGT	GAAACACCGGTCGGCGGCAATCGTGGGTGGGATTAGAGCTAGAAATAGCA	1
GAAGGACGGC	GAAACACCGGTCGGCGGCAATCGTGGGTGGGGTTAGAGCTAGAAATAGCA	1
GAAGGACTGC	GAAACACCGGTCGGCGGCAATCGTGGTATGAGCCACGTGGGGTTAGATCG	1
GAAGGCCCTA	GAAACACCGGTGCCCTTACTCTCACCTGATTACTTAATCCGTGGGGTTAG	1
GAAGGCGCGT	GAAACACCGGTCGGCGGCAATCGTGGGTGGGGTTAGAGCTAGAAATAGCA	1
GAAGTACCGA	GAAACACCGGTCGGCGGCAATCGTGGGTGGGGTTAGAGCTAGAAATAGCA	1
GAAGTCATAC	GAAACACCGGTGCCTTTATTCATGCGATATTTCCGAATCAGTGGGGTTAG	1
GAAGTCTGGC	GAAACACCGGTCCGTAGGAGACCCGTGTGGCATGTACCTGTGGGGTTAGA	1
GAATCCGGTT	GAAACACCGGTCGATTAATATCGAACCCTTCCCGTGACCTTGGAGTTAGA	1
GAATCGTGGT	GAAACACCGGTGTACGTATGGACTGAACCAGGGTGTGCAAGTGGGGTTAG	1
GAATGCGTCG	GAAACACCGGTTTACGTTGCATCGGTGTGGGGTTAGAGCTAGAAATAGCA	1
GAATGCTTGG	CTTAACCTAAGGCTAGTCCGTTATCAACTTGAAAAAGTGGCACCGAGTCG	1
GAATTCGGGT	GAAACACCGGTCGATTCATATCGAAACCTTCCCGTGACAGTGGGGGTAGA	1
GAATTTCACC	GAAACACCGGTTTACGTTGCATCGGGTTAGAGCTAGAAATAGCAAGTTAA	1
GACAAAGCAC	GAAACACCGGTTTGAACTAGAAATAGCAAGTTAACCTAAGGCTAGTCCGT	1
GACAATCACA	GAAACACCGGTAAGAAGCTTGGTTGGATCTAGCGGTAGCAAGGTGGCCTA	1
GACAATGACC	GAAACACCGGTTTGAACTAGAAATAGCAAGTTAACCTAAGGCTAGTCCGT	1
GACACACCCC	GAAACACCGGTCGGCGGTTCGAGCTAGAACTAGCAAGATCAACTTAAGCT	1
GACACAGACA	GAAACACCGGTAGCAAGTGCGAGACGTGTTTGTGGGGTTAGAGCTAGAAA	409
GACACAGACA	GAAACACCGGTAGCAAGTGGGGTTAGAGCTAGAAATAGCAAGTTAACCTA	247
GACACAGACA	GAAACACCGGTAGCAAGTGCGAGACGTGTTAAATAGCAAGTTAACCTAAG	195
GACACAGACA	GAAACACCGGTAGCAAGTGCGAGACGTGTTTTTGTGGGGTTAGAGCTAGA	89
GACACAGACA	GAAACACCGGTAGCAAGTGCGGGGTTAGAGCTAGAAATAGCAAGTTAACC	52
GACACAGACA	GAAACACCGGTAGCAAGTGCGTGGGGTTAGAGCTAGAAATAGCAAGTTAA	44
GACACAGACA	GAAACACCGGCTAGTCCGTTATCAACTTGAAAAAGTGGCACCGAGTCGGT	43
GACACAGACA	GAAACACCGGTAGCAAGTGCGAGCTAGAAATAGCAAGTTAACCTAAGGCT	35
GACACAGACA	GACCGGGGTTAGAGCTAGAAATAGCAAGTTAACCTAAGGCTAGTCCGTTA	35
GACACAGACA	GAAACACCGGTGGGGTTAGAGCTAGAAATAGCAAGTTAACCTAAGGCTAG	32
GACACAGACA	GAAACACCGGTAGCAAGTGCGGGTTAGAGCTAGAAATAGCAAGTTAACCT	31
GACACAGACA	GAAACACCGGTACAAGGGGTTAGAGCTAGAAATAGCAAGTTAACCTAAGG	30
GACACAGACA	GAAACACCGGTAGCAAGTGCGAGACGTGTTTTGTGGGGTTAGAGCTAGAA	28
GACACAGACA	GAAACACCGGTAGCAAGTGCGAGACGTTTGTGGGGTTAGAGCTAGAAATA	28
GACACAGACA	GAAACACCGGTAGCAAGTGCGAGACGTGTGTGGGGTTAGAGCTAGAAATA	27
GACACAGACA	GTAGAAATAGCAAGTTAACCTAAGGCTAGTCCGTTATCAACTTGAAAAAG	27
GACACAGACA	GAAACCGGGGTTAGAGCTAGAAATAGCAAGTTAACCTAAGGCTAGTCCGT	26
GACACAGACA	GAAAGCACCGGTAGCAAGTGCGAGACGTGTTGGTGGGGTTAGAGCTAGAA	24
GACACAGACA	GAAACACCGGTAGCAAGTGCGAGACGTGTTAGACGTGGGGTTAGAGCTAG	22
GACACAGACA	GAAACACCGGTAGCAAGTGCGAGCAAGTGTGGGGTTAGAGCTAGAAATAG	21
GACACAGACA	GAAACACCGGTAGCAAGAGCTAGAAATAGCAAGTTAACCTAAGGCTAGTC	19
GACACAGACA	GAAACACCGGTAGCAGGTTAGAGCTAGAAATAGCAAGTTAACCTAAGGCT	19
GACACAGACA	GAAACACCGGTAGCAAGTGGAGCTAGAAATAGCAAGTTAACCTAAGGCTA	18
GACACAGACA	GAAACACCGGTAGCAAGTGCGAGACGTATGGGGGTTAGAGCTAGAAATAG	15
GACACAGACA	GAAACACCGGTAGCAAGTTAACCTAAGGCTAGTCCGTTATCAACTTGAAA	15
GACACAGACA	GAAACACCGGTAGCAAGTGCGAGACGTGTTAACGCTATTTCTAGCTCTAA	13
GACACAGACA	GAAACACCGGTAGCAAGTGCGAGCAAGTTTGTGGGGTTAGAGCTAGAAAT	12
GACACAGACA	GAAGCACCGGTAGCAAGTGCGGGGTTAGAGCTAGAAATAGCAAGTTAACC	12
GACACAGACA	GAAACACCGGTAGCAAGTGCGAGCGGTGCTTTTTTTCCTGCAGGTGTCTG	9
GACACAGACA	GAAACACCGGTTGAATGGGGTTAGAGCTAGAAATAGCAAGTTAACCTAAG	9
GACACAGACA	GAAACACCGGTAGCAAGTGCGAGACGGGGTGAGAGTGGGGTTAGAGCTAG	8
GACACAGACA	GAAACACCGGTAGCAAGTGCGAGCTAGAAATAACAAGTTAACCTAAGGCT	8
GACACAGACA	GAAACACCGGTAGCAAGTGCGAGCATTTTTGTGGGGTTAGAGCTAGAAAT	7
GACACAGACA	GAAACACCGGTAGCAAGTGCGAGACGTTTGAGGGGTTAGAGCTAGAAATA	5
GACACAGACA	GAAACACCGGGGTTAGAGCTAGAAATAGCAAGTTAACCTAAGGCTAGTCC	4
GACACAGACA	GAAACACCGGTAGCAAGTGCGAGACGTGGGGTTAGAGCTTTATATATCTT	4
GACACAGACA	CAAAACACCGGTAGCAAGTGCGAGACGTGTTAAATAGCAAGTTAACCTAA	1
GACACAGACA	CAAAACACCGGTAGCAAGTGCGAGCGGTGCTTTTTTTCCTGCAGGTGTCT	1
GACACAGACA	CAAAACACCGGTAGCAAGTGCGGGGTTAGAGCTAGAAATAGCAAGTTAAC	1
GACACAGACA	CCGGTAAATTTGAGGCTCCGGCATGCAGGAGGCCGTGGGGTTAGAGCTAG	1
GACACAGACA	CTAAACACCGGTAGCAAGAGCTAGAAATAGCAAGTTAACCTAAGGCTAGT	1
GACACAGACA	CTAAACACCGGTAGCAAGTGCGAGACGTGTTAAATAGCAAGTTAACCTAA	1
GACACAGACA	GAAACACCGGCTTGAGAGTTATCAACTTTGAAAAGGGGCACGCTAGCGGT	1
GACACAGACA	GAAACACCGGCTTGTCCGTTATCAACCTTGGAAAGGGTCGCCCTAGCGGT	1
GACACAGACA	GAAACACCGGGGCTAGAGCTAGAAATAGCAAGTTAACCTAAGGCTAGTCC	1
GACACAGACA	GAAACACCGGGGTTAGAGCTAGAAATAGCAGGTTAACCTAAGGCTAGTCC	1
GACACAGACA	GAAACACCGGTAAATTTGAGGCTCCGGCATGCAGGAGGCCGTGGGGATAG	1
GACACAGACA	GAAACACCGGTAAATTTGAGGCTCCGGCATGCAGGAGGCCGTGGGGTTAG	1
GACACAGACA	GAAACACCGGTAAATTTGAGGCTCCGGCATGCAGGGGGCCGTGGGGTTAG	1
GACACAGACA	GAAACACCGGTAACTATATTCATGCGATACCGCCGTATCAGTGGGGTTAG	1
GACACAGACA	GAAACACCGGTAACTATATTCATGCGATATCGCCGTATCAGTGGGGTTAG	1
GACACAGACA	GAAACACCGGTACCTAGGTCGAGGCGTGGTGGTAGGGTTAGAGCGAGAGA	1
GACACAGACA	GAAACACCGGTAGCAAGAGCGAGGCGCGTCCGGGAGCTAGAGCTAGACGT	1
GACACAGACA	GAAACACCGGTAGCAAGTGCGAGACGCGTCCGGTAGCAAGTGCGAGACGT	1
GACACAGACA	GAAACACCGGTAGCAAGTGCGAGACGTGGGGTTAGAGCTTTATATAGCTT	1
GACACAGACA	GAAACACCGGTAGCAAGTGCGAGACGTGTCCGGTAGCAAGTGCGAGACGT	1
GACACAGACA	GAAACACCGGTAGCAAGTGCGAGACGTTTTTGTGGGGTAGAGCTAGAAAT	1
GACACAGACA	GAAACACCGGTAGCAAGTGGGTTAGAGCTAGAAATAGCAAGTTAACCTAA	1
GACACAGACA	GAAACACCGGTATCAACAACTAGGAATAGCAAGTTAAGCTAAGGCTAGCA	1
GACACAGACA	GAAACACCGGTGCATTCGAAAGTCCGGTCGTAGTGTGGACGTGGGGTTAG	1
GACACAGACA	GAAACACCGGTGTGGCTGAGAGTCCGGCAATGGTGTGGCTGTGGGGTTAG	1
GACACAGACA	GAAACACCGGTTACATTGAGGGTTAGAGCTAGAAATAGCAAGTTAACCTA	1
GACACAGACA	GAACACCGGTAGCAAGTGCGAGACGTGTTTTTGTGGGGTTAGAGCTAGAA	1
GACACAGACA	GCCGGGGTTAGAGCTAGAAATAGCAAGTTAACCTAAGGCTAGTCCGTTAT	1
GACACAGACA	TCGTGACCGGGGTTAGAGCTAGAAATAGCAAGTTAACCTAAGGCTAGTCC	1
GACACATGCC	GAAACACCGGTAGCAAGTGCGAGACGTTTTTGTGGGGGTAGCGCTAGAAA	1
GACACGGATC	GAAACACCGGTAGCAATCGCGAAACGTGGTAAATAGCAAGTTAACCTAAG	1
GACACTGCCT	GAAACACCGGTAGCAAGTGCGAGACGTTTTTGTGGGGTTAGAGCTAGAAA	1
GACAGTCGGT	GAAACACCGGTCGATTCATATCGAAACCTTCCCGTGACAGTGGGGTTAGA	1
GACAGTCTGC	GAAACACCGATTTGAACTACCTGGGGTTAGAGCTAGAAATAGCAAGTTAA	1
GACATAATCA	GAAACACCGGTAGCTGTATTGATTAGAGCTAGAAATATCAAGGTAACCTG	1
GACATCGAGA	GAAACACCGGTTACATGTGTAAGTAGACCTGGATATAGCAAGTTAACCTA	1
GACATGCGGT	GAAACACCGGTCGATTCATATCGAAACCTTCCCGTGACAGTGGGGTTAGA	1
GACATTCGAT	GAAACACCGGTCGATTCATATCGAAACCTTCCCGTGACAGTGGGGTTAGA	1
GACATTCTGT	GAAACACCGGTCGATTCATATCGAAACCTTCCCGTGACAGTGGGGTTAGA	1
GACCCAGAAC	GAAACACCGGTAGCAAGTGCGAGCTAGAAATAGCAAGTTAACCTAAGGCT	1
GACCCCTTGC	GAAACACCGGTAAACTTGAGGCTCCGGCATGCAGGAGGCCGGGGGGTTAG	1
GACCCTATAA	GAAACACCGGTAACTATATTCATGCGATATCGCCGTATCAGTGGGGTTAG	1
GACCGTCGCC	GAAACACCGGTGTACGTATGGACTGAACCATTGTGTGCAAGTGGGGTTAG	1
GACCTCCATT	GAAACACCGGTCCATAGAAAACCCGTTTGGCATTTTGCTCTGGGGGTAGG	1
GACGACACAC	GAAACACCGGTCGGCGGGTTAGAGCTAGAAATAGCAAGTTAACCTAAGGC	1
GACGACATAC	GAAACACCGGTGCCCTTACTCTCACCTGATTACTTAATCCGTGGGGTTGG	1
GACGACCAGA	GAAACACCGGTCGGCGGCAATCGTTAATCGGTTAATCGTGGGGTTAGAGC	1
GACGATCCTC	GAAACACCGGTCGGGGTTAGATCTAGAAATAGCAAGTTAACCTAAGGCTA	1
GACGGACAGC	GAAACACCGGTCGGCGGCAATCGTGGGTGGGGTTAGAGCTAGAAATAGCA	1
GACGTTCGGT	GAAACACCGGTCGATTCATATCGAAACCTTCCCGTGACAGTGGGGTTAGA	1
GACTACTCGG	GAAACACCGGTACCTTTGTTGATGCTGGGTGGAAGGAATTTGTGGGGTTA	1
GACTAGCCAT	GAAACACCGGTTCCCGTCCAGTGGGGATAGAGCTAGAAATAGCAAGTTAA	1
GACTGTACCG	GAAACACCGGTCGGGGCCACTCAGTGGTGGGGTTAGAGCTAGAAATAGCA	1
GACTTCTCGG	GAAACACCGGTACCTTTGTTGATGCTGGGTGGAAGGAATTTGTGGGGTTA	1
GACTTTACCG	GAAACACCGGTCGGGGCCACTCAGTGGTGGGGTTAGAGCTAGAAATAGCA	4
GACTTTACGG	GAAACACCGGTCGGGGCCACTCAGTGGTGGGGTTAGAGCTAGAAATAGCA	1
GAGAAAGAGC	GAAACACCGGTTTGAACTACCTTAGAGCTAGAAATAGCAAGTTAACCTAA	1
GAGAAGACCC	GAAACACCGGTCGGCGGCAATCGTGGGTGGGGTTAGAGCTAGAAATAGCA	1
GAGAAGCCAC	GAAACACCGGTTCGAGCCAAGTGGTGCTAGAGCTAGAAATTACAACTTGA	1
GAGAAGCGTC	GAAACACCGGTTCCCGTCCAGTGGGGTTAGAGCTAGAAATAGCAAGTTAA	1
GAGAAGGCTC	GCTAGAAATAGCGATTTCACCTAAGGCTAGTCCGTTTTCAACTTGAAAAA	1
GAGAATAATT	GAAACACCGGTCTCGAGTGCGGTGTTCAGGGTGGGGTTAGAGCTAGAAAT	1
GAGACACAGA	GAAACACCGGTAGCAAGTGGGGTTAGAGCTAGAAATAGCAAGTTAACCTA	1
GAGACAGTAA	GAAACACCGGTAGCAAGTGCGAGACGTGTTAAATAGCAAGGCAACCTTAG	1
GAGACCCACC	GAAACGCCGGTGTGGCTGAGAGTCCGGCAATGGTGTGGATGTGGGGTTAG	1
GAGACCCTAG	GAAACACCGGTGCATTCGAAAGTCCGGTCGTAGTGTGGACGTGGGGTTAG	1
GAGACCCTTG	GAAACACCGGTGCATTCGAAAGTCCGGTCGTAGTGTGGACGTGGGGTTAG	1
GAGACCTTCC	GGAACACCGGTGTGGCTGAGAGTCCGGCAATGGTGTGGCTGTGGGGCTAG	1
GAGACCTTCC	GAAGCACCGGTTTGGCTGAGAGTCCGCCAATGGTGTGGCTGTGGGGTTAG	1
GAGACGCGCA	GAAACACCGCTGTGCGGATGGCCTGAGTTGGGGGGGGTAAGGGGGGGAAA	1
GAGACGCTCG	GAAACACCGGTGCATTCGAAAGTCCGGTCGTAGTGTGGACGTGGGGTTAG	1
GAGACGGTCG	GAAACACCGGTGCATTCGAAAGTCCGGTCGTAGTGTGGACGTGGGGTTAG	1
GAGAGAATAA	GAAACACCGGTTAAGCCGAGGAGTTAGAGCTAGAAATAGCAAGTTAACCT	1
GAGATGTGGT	GAAACACCGGTCGACTCATATCGAAACCCTCCCGTGACAGTGGGGTTAGA	1
GAGATTCGGT	GAAACACCGGTCGATTCATATCGAAACCTTCCCGTGGGGTTAGAGCTAGA	1
GAGATTCTCG	GAAACACCGGTGCATTCGAAAGTCCGGTCGTAGTGTGGACGTGGGGTTAG	1
GAGCATAGCC	GAAACACCGGTCGGCGGCAATCGTGTGGGGGTGGGGTTAGAGCTAGAAAT	1
GAGCCTGCCT	GAAACACCGGTCCGTAGGAGACCCGTGTGGCATGTACCTGTGGGGTTAGA	1
GAGCGGACAA	GAAACACCGGTCCGTAGGAGACCCGTCCTGTTGTGGGGTTAGAGCTAGAA	1
GAGCTGTCGG	GAAACACCGGTAAAGGGCATATGAGGGAGGGAATCGATGTGTGGGGTTAG	1
GAGGAACAGT	GAAACACCGGTCGGCGGAAATTGTGGGTGGGGTTAGAGCTAGAAATAGCA	1
GAGGAAGACA	GAAACACCGGTTCCCGTCTAGTGGGGTTAGAGCTAGAAATAGCAAGCTAA	1
GAGGACGCAA	GAAACACCGGTTTGAACTAGAAATAGCAAGTTAACCTAAGGCTAGTCCGT	1
GAGGACGCTC	GAAACACCGGTTTCAACTAGAAGTAGCAAGAGAAACTAAGAGTAGTCCGA	1
GAGGACTCGT	GAAACACCGGTCGGCGGTGGGGTTAGAGCTAGAAATAGCAAGTTAACCTA	1
GAGGAGTATC	GAAACACCGGTTAAGCCGCGGGGTTAGAGCTAGAAATAGCAAGTTAACCT	1
GAGGATCGTC	GAAACACCGGTTCCCGTCCAGTGGGGTTAGAGCTAGAAATAGCAAGTTAA	1
GAGGATTAGC	GAAACACCGGTTTACAAGTTAACCTAAGGCTAGTCCGTTATCAACTTGAA	1
GAGGCACAGA	GAAACACCGGTCGGCGGCAATCGTGGGTGGGGTTAGAGCTAGAAATAGCA	1
GAGGCACCCT	GAAACACCGGTGTGGCTGAGAGTCCGGCAATGGTGTGGCTGGGGGGTTAG	1
GAGGCAGCTC	GAAACACCGGTTCCCGTCCAGTGGGGTTAGAGCTAGAAATAGCAAGTTAA	1
GAGGCGACTC	GAAACACCGGTTCCCGTCCAGTGGGGTTAGAGCTAGAAATAGCAAGTTAA	1
GAGGCGCTTC	GAAACACCGGTTCCCGTCCAGTGGGGTTAGAGCTAGAAATAGCAAGTTAA	1
GAGGCGGTCC	GAAACACCGGTATCAAGTGTGTGGGGGTAGAGCTAGAAATAGCAAGGTAA	1
GAGGCTCCGC	GAAACACCGGTTCCCGTCCAGTGGGGTTAGAGCTAGAAATAGCAAGTTAA	1
GAGGGCCTAA	GAAACACCGGTTAAGTCGCGGTGGCGTTAGTGCTAGAAATAGGAGGTTAA	1
GAGGGTCCAC	GAAACACCGGTCGGCGGCAATTAGAGCTAGAATTAGAATTAGAGCTAGAA	1
GAGTACCCTC	GAAACACCGGTTCCCGTCCAGTGGGGTTAGAGCTAGAAATAGCAAGTTAA	1
GAGTATGCCT	GAAACACCGGTCCGTAGGAGACCCGTGTGGCATGTACCTGTGGGGTTAGA	2
GAGTCGTACA	GAAACACCGGTCCGTAGGAGACCCGTGTGGCATGTACCTGTGGGGTTAGA	1
GAGTCTGCAT	GAAACACCGGTCCGTAGGAGACCCGTGTGGCATGTACCTGTGGGGTTAGA	1
GAGTCTGCTT	GAAACACCGGTCCGTAGGAGACCCGTGTGGCATGTACCTGTGGGGTTAGA	1
GAGTCTGGCG	GAAACACCGGTCCGTAGGAGACCCGTGTGGCATTTACCTGTGGGGTTAGA	1
GAGTCTGGCT	GAAACACCGGTCCGTAGGAGACCCGTGTGGCATGTACCTGTGGGGTTAGA	1
GAGTCTGGCT	GAAACACCGGTCCGTAGGAGACCCGTGTGGCATGTAACTGTGGGGTTAGA	1
GATAAGCCTA	GAAACACCGGTTCACGACCAGTCGGCTTAGAGCTAGAACTAGCAAGTTCA	1
GATACCCTCG	GAAACACCGGTGCATTCGAAAGTCCGGTCGTAGTGTGGACGTGGGGTTAG	1
GATAGTCGCT	GAAACACCGGTGTACGTATGGACTGAACCAGGGTGTGCAAGTGGGGTTAG	1
GATATATACA	GAAACACCGGTATCGTGTGCGTGTCGGGTTGGTTGGGGCAGAACTAGGCA	1
GATATCGTCT	GAGACACCGGTCCCATTTGGCAACAAGAGGGGGGATAGCTCTAAATATCA	1
GATATCTCGC	GAAACACCGGTCGGCGGCACACGTGTGGGGGTGGGGATAGAGCTAGAACT	1
GATCCTTCGT	GAAACACCGGTTATATTTGGAAGATCGCGGGGTTAGAGCTAGATATAGCA	1
GATCGGCGCC	GAAACACCGGTGTACGTATGGACTGAACCAGGGTGTGCAAGTGGGGTTAG	1
GATCGGCGTA	GAAACACCGGTGTACGTATGGACTGAACCAGGGTGTGCAAGCGGGGTTAG	1
GATGAGCATA	GAAACACCGGTTAAGCCGAGGAGTTAGAGCTAGAAATAGCAAGTTAACCT	1
GATGAGCTAT	GAAACACCGGTTACATTGAGGGTTAGAGCTAGAAATAGCAAGTTAACCTA	1
GATGCCTAGC	GAAACACCGGTTTACGTTGCATCGGTGTGGGGTTAGAGCTAGAAATAGCA	1
GATGGTAAGC	GAAACACCGGTTTACGTTGCGGTGGGGTTAGAGCTAGAAATAGCAAGTTA	1
GATGTGACAT	GAAACACCGGTCCGTAGGAGACCCGTGTGGCATGTACCTGTGGGGTTAGA	1
GATTAGCTAT	GAAACACCGGTTATTTGAGGGTTAGAGCTAGAAATAGCAAGTTATCCTAA	1
GATTAGCTAT	GAAACACCGGTTACATTGAGGGTTAGAGCTAGAAATAGCAAGTTAACCTA	1
GATTCCCCGC	GAAACACCGGTCGGCGGCAATCGTGGGGGGGGTTAGAGCTAGAAATAGCA	1
GATTTAGGGC	GAAACACCGGTCGGGGCCACTCAGTGGTGGGGTTAGAGCTAGAAATAGCA	1
GCAAAACGCC	GAAACACCGGTTTGAACTAGAAATAGCAAGTTAACCTAAGGCTAGTCCGT	1
GCAAAACGCC	GAAACACCGGTTTGAACTAGAAATAGCAAATTAACCTAAGGCTAGTCCGT	1
GCAACTCCTT	GAAACACCGGTCTCGAGTGAGGTGTTCAGGGTGGGGTTAGAGCTAGAAAT	1
GCAACTCGGC	GAAACACCGGTACCTTTGTTGATGCTGGGTGGAAGGAATGTGGGGTTAGA	1
GCAACTGATT	GAAACACCGGTAGCAAGTGCGAGACGTGTTGGTGGGGTTAGAGCTAGAAA	1
GCAAGCCGGT	GAAACACCGGTCGGCGGCCATCGGCGGTGGGGCTAGAGCTGGAAATAGCG	1
GCACAACGAC	GAAACACCGGTTTGAACTACCTAGGGGGTAGTTCAAACCGGGGTTAGAGC	1
GCACAACGAC	GAAACACCGGTTTGAACTACCGGGGTTAGAGCTAGAAATAGCAAGTTAAC	1
GCACAACGAC	GAAACACCGGTTTGAACTACCTAGTTCAAACCGGTGGGGTTAGAGCTAGA	1
GCACAACGCA	GAAACACGGGTTAGAGCTAGAAATAGCAAGTTAACCTAAGGCTAGTCCGT	1
GCACAGCGTA	GAAACACCGGTTTGAACTACCGGGGTTAGAGCTAGAGATAGCAAGTTAAC	1
GCACGACGCC	GAAACACCGGTTTGAACTACCTAGTTCAAACCGGTGGGGTTAGAGCTAGA	1
GCACGCCCTT	GAAACACCGGTGCCCTTACTCTCACCTGATTACTTAATCCGTGGGGTTAG	1
GCACTCGCAC	GAAACACCGGTACCTTTGTTGATGCTGGGTGGAAGGAATGTGGGGTTAGA	1
GCAGAACAGC	GAAACACCGGTCGGGGTTAGAGCTAGAAATAGCAAGTTAACCTAAGGCTA	1
GCAGAACGGC	GAAACACCGGTCGGCGGCAATCGTGGGTGGGGTTAGAGCTAGAAATAGCA	1
GCAGAACGGC	GAAACACCGGTCGGCGGCAATCGTGCTTTTTTTCCTGCAGGGCGGGTCTT	1
GCAGACACGA	GAAACACCGGTCGGCGGCAATCGTGGGTGGGGTTAGAGCTAGAAATAGCA	1
GCATACGCGG	GAAACACCGGTCGATTCATATCGAAACATTCCGGTGAAAGTGGGGATAGA	1
GCATATCCGC	GAAACACCGGTCGGCGGCAATCGTGGGTGGGGTTAGAGCTAGAAATAGCA	1
GCATCCCTAC	GAAACACCGGTGGGCTTACTCTAACCTGATGACTTAATCCGTGGAGATAG	1
GCATCGGATG	GAAACACCGGTGTACGTATGGACTGAACCAGGGTGTGCAAGTGGGGTTAG	1
GCATCGTCGA	GAAACACCGGTGTACGTATGGACTGAACCAGGGTGTGCAAGTGGGGTTAG	1
GCATCTGGTT	GAAACACCGGTCGATTCATATCGAAACCTTCCCGTGACAGTGGGGTTAGA	1
GCATGCGGGT	GAAACACCGGTCGACTCATATCGAAACCTTGCCGTGGCAGGGTAGCTAGA	1
GCATTTACAG	GAAACACCGGTCGGGGCCACTCAGTGGTGGGGTTAGAGCTAGAAATAGCA	1
GCCAACTACA	GAAACACCGGTAAATTTGAGGCTCCGGCATGCAGAAGGCCGTGGGGTTAG	1
GCCACTGGGA	GAAACACCGGTAGCAAGTGCGAGACGTGTTTGTGGGGTTAGAGCTAGAAA	1
GCCATTACCG	GAAACACCGGTCGGGGCCACTCAGTGGTGGGGTTAGAGCTAGAAATAGCA	1
GCCCAACGCC	GAAACACCGGTTTGAACTAGAAATAGCAAGTTAACCTAAGGCTAGTCCGT	1
GCCCACATCT	GAAACACCGGTGTGGCTGAGAGTCCTGCAATGGGGTGGCTGTAGAGTTAG	1
GCCCACGCCC	GAAACACCGGTTTGGGGTTAGAGCTAGAAATAGCAAGTTAACCTAAGGCT	1
GCCGACCCGA	GAAACACCGGTCGGCGGCTAGAGCTAGAAATCGCAAGGTAAACTAAAACT	1
GCCGACCTCC	GAAACACCGGTGCCCTTACTCTCACCTGATTACTTAATCCGTGGGGTTAG	1
GCCGCAGCGA	GAAACACCGGTAGGCGGGTGGGGGTAAAGCTAGAAATAGCAAGATAGCCA	1
GCCGCCGTCT	GAAACACCGGTCGATTCATATCGAAACCTTCCCGTGACAGTGGGGTTAGA	1
GCCGGGGGCG	GAAACACCGGTCTATTCATATCGAAACCTTCCCGTGACAGTAGGGAGAGA	1
GCCTATACCG	GAAACACCGGTCGGGGCCACTCAGTGGTGGGGTTAGAGCTAGAAATAGCA	1
GCCTCCCGCA	GAAACACCGGTAAATTTGATGCTCCGGCATGCAGGAGGCCCGTGGGGTTA	1
GCCTTTAACG	GAGACACCGGTCGGGGCCACTCAGTGGTGGGGTTAGAGCTAGAAATAGCA	1
GCCTTTACAT	GAAACAACGGTCGGGGCCACTCAGTGGTGGGGTTAGAGCTAGAAATAGCA	1
GCCTTTACTG	GAAACACCGGTCGGGGCCACTCAGTGGTGGGGTTAGAGCTAGAAATAGCA	2
GCGAATACTT	GAAACACCGGTCTCGAGTGAGGTGTTCAGGGTGGGGTTAGAGCTAGAAAT	1
GCGAATCATG	GAAACACCGGTCTCGAGTGAGGTGTTCAGGGTGGGGTTAGAGCTAGAAAT	1
GCGAATCATT	GAAACACCGGTCTCGAGTGAGGTGTTCAGGGTGGGGTTAGAGCTAGAAAT	1
GCGAATCGTT	GAAACACCGGTCTCGAGTGAGGTGTTCAGGGTGGGGTTAGAGCTAGAAAT	2
GCGACCTCTT	GAAACACCGGTCTCGAGTGAGGTGTTCAGGGTGGGGTTAGAGCTAGAAAT	1
GCGACTCCTT	GAAACACCGGTCTCGAGTGAGGTGTTCAGGTGGGGTTAGAGCTAGAAATA	1
GCGAGCCAAA	GAAACACCGGTTAAGCCGTGTGTGGTTAGAGCTAGAAATAGCAGGTTAAC	1
GCGAGGATAA	GAAACACCGGTTAAGCCGTGGGGTTAGAGCTAGAAATAGCAAGTTAACCT	1
GCGATACCGC	GAAACACCGGTCGGGGCCACCGGTGGGGTTAGAGCTAGAAATAGCAAGTT	1
GCGCCGCCTC	GAAACACCGGTTCCCGTCCAGTGGGGTTAGAGCTAGAAATAGCAAGTTAA	1
GCGGACACTT	GAAACACCGGTTCCCGTCCAGTGGGGTTAGAGCTAGAAATAGCAAGTTAA	1
GCGGAGTATC	GAAACACCGGTTCCCGTCCAGTGGGGTTAGAGCTAGAAATAGCAAGTTAA	1
GCGGAGTGTC	GAAACACCGGTTCCCGTCCAGTGGGGTTAGGGCTAGAAATAGCAAGTTAA	1
GCGGATGTTA	GAAACACCGGTTCCCGTCCAGTGGGGTTAGAGCTAGAAATAGCACGTTAA	1
GCGGCACCTC	GAAACACCGGTTCCCGTCCAGTGGGGTTAGAGCTAGAAATAGCAAGTTAA	1
GCGGCGGCTA	GAAACACCGGTTCCCGTCCAGTGGGGTTAGAGCTAGAAATAGCAAGTTAA	1
GCGTAGCCCT	GAAACACCGGTCGGCGGCAATCGTGGGTGGGGTTAGAGCTAGAAATAGCA	1
GCGTCGCCCT	GAAACACCGGTGTCCGCTGCCGGCTCCATTGTGGGGTTAGAGCTAGAAAT	2
GCGTCGTAGT	GAAACACCGGTGTACGTATGGACTGAACCAGGGTGTGCAAGTGGGGTTAG	1
GCTAACGAGT	GAAACACCGGTTATATTTGTAAGTGTGTGGGGTTAGAGCTAGAAATAGCA	1
GCTAATCGGC	GAAACACCGGTACCTTTGTTGATGCTGGGTGAAAGGAATTTGTGGGGTTA	1
GCTAATTGGC	GAAACACCGGTACCTTTGTCGATGCTGGGTGGATGGAGGGGTTAGGGTTA	1
GCTACGCGGC	GAAACACCGGTACCTTTGTTGATGCTGGGCTAGTCCGTTATCAACTTGAA	1
GCTACTCAGT	GAAACACCGGTACCTTTGTTGATGCTGGGTGGAAGGTACACCGGTACCTT	1
GCTACTCGGA	GAAACACTTAGAGCTAGAAATAGCAAGTTAACCTAAGGCTAGTCCGTTAT	1
GCTAGCGACG	GAAACACCGGTTATATTTGTAAGTGTTGTGGGGTTAGAGCTAGAAATAGC	1
GCTATACTCC	GAAACACCGGTGTGGCTGAGACTCCGGCAGTGGTGTGGCTGGGGGGATAG	1
GCTATAGCGC	GAAACACCGGTCGGGGCCACTCAGTGGTGGGGATAGAGCTATAAATAGCA	1
GCTATCCATT	GAAACACCGGTTATATTTGTAAGTGTGTGGGGTTAGAGCTAGAAATAGCA	1
GCTATTGAAC	GAAACACCGGTTATATTTGTAAGTGTGTGGGGTTAGAGCTAGAAATAGCA	1
GCTCAACGCC	GAAACACCGGTTTGAACCGGTGGGGTTAGAGCTAGAAATAGCAAGTTAAC	1
GCTCTACGCC	GAAACACCGGTGTACGTTGCATCGGGTGAGGGGTTAGAGCTAGAAATAGT	1
GCTCTCCGCC	GAAACACCGGTGAGGCTGATAGTACGGCAATGGTGGGGCTGTGGGGTTAG	1
GCTGCTCGGC	GAAACACCGGTACCTTTGTTGATGCTGGGTGGGAGCTAGAAATAGCAAGT	1
GCTGCTTAGC	GAAACACCGGTTTACGTTGCATCGGTTGTGGGGTTAGAGCTAGAAATAGC	1
GCTGGGGCCT	GAAACACCGGTTCCCGTCCAGTGGGGTTAGAGCTAGAAATAGCAAGTTAA	1
GCTGGTGGCT	GAAACACCGGTACCTTTGTTGAGGCTGTGGGGGTATAGAGCGAGAGATAG	1
GCTGTAAAGA	GAAACACCGGTCGGAGCCACTCCGGGGTGGGGTTAGAGCTAGAAATAGCA	1
GCTGTAGATC	GAAACACCGGTCGGGGCCACTCAGTGGTGGGGTTAGAGCTAGAAATAGCA	1
GCTGTCGGGG	GAAACACCGGTTATATTTGTAAGTGTGTGGGGTTAGAGCTAGAAATAGCA	1
GCTTAAGCGC	GAAACACCGGTCCGGGCCCCTCAGTGGTGGGGTTAGAGCTAGAAATAGCA	1
GCTTCAGAGA	GAAACACCGGTAGCAAGTGCGGGGTTAGAGCTAGAAATAGCAAGTCAACC	1
GCTTGTTGTA	GAAACACCGGTGACATTGGGTATGGGGTTAGAGCTAGAAATAGCAAGTTA	1
GCTTTAACGT	GAAACACCGGTCGGGGCCACTCAGTGGTGGGGTTAGAGCTAGAAATAGCA	1
GCTTTACAGA	GAAACACCGGTCGGGGCCACTCAGTGGTGGGGTTAGAGCTAGAAATAGCA	1
GCTTTCGGCC	GAAACACCGGTCGCTTCATATCGAAACCTTCCCGTGACAGTGGGGTTAGA	1
GCTTTCGGCT	GAAACACCGGTCGATTCATATCGAAACCTTCCCGTGAGAGTGGGGTTAGA	1
GGAAACAGGC	GTAGAAATAGCAAGTTAACCTAAGGCTAGTCCGTTATCAACTTGAAAAAG	1
GGAAACTACG	GAAACACCGGTAAATTTGAGGCTCCGGCATGCAGGAGGCCGTGGGGTTAG	1
GGAACACTCA	GAAACACCGGTGTGGCTGAGAGTCCGGCAATGGTGTGGCTGTGGGGTTAG	1
GGAACCGGCT	GAAACACCGGTGTGGCTGAGAGTCCGGCAATGGTGTGGCTGTGGGGTTAG	1
GGAACCTAAA	GAAACACCGGTAAATTTGAGGCTCCGGCATGCAGGAGGCCGTGGGGTTAG	1
GGAACCTACC	GAAACACCGGTAAATTTGAGGCTCCGGCATGCAGGAGGCCGTGGGGTTAG	1
GGAACCTTCA	GAAACACCGGTGTGGCTGAGAGTCCGGCAATGGTGTGGCTGTGGGGTTAG	1
GGAAGAATCG	GAAACACCGGTCGGCTAGAAATAGCAAGTTAACCTAAGGCTAGTCCGTTA	1
GGAAGAGCAT	GAAACACCGGTCGGCGGCAATCGTTTTTGTGGGGTTAGAGCTAGAAATAG	1
GGAAGCCGCT	GAAACACTGGTCTCGAGTGAGGTGTTCAGGGCGGGGTTAGAGCTAGAAAT	1
GGAAGTCCGG	GAAACACCGGTCGGCGGCAATCGTTAGAGCTAGAAATAGCTAGAAATAGC	1
GGAATCTCCC	GAAACACCGGTAAATCTGAGGCTCCGGCATGCAGGAGGCCGTGGGGTTAG	1
GGACACCTCT	GAAACACCGGTGTGGCTGAGAGTGCGGCTATGGTGTGGCTGTGGGGGTAA	1
GGACACGCGC	GAAACACCGGTACGTTCCAAAATCCGGTCGTAGTGTGGACGTGGGGTTAG	1
GGACCCTTCT	GAAACACCGGTAAATTTGAGGCTCCGGCATGCAGGAGGCCGTGGGGTTAG	1
GGACCGTAAA	GAAACACCGGTAAATTTGAGGCTCCGGCATGCAGGAGGCGTGGGGTTAGA	1
GGACGAACGC	GAAACACCGGTGCATTCGAAAGTCCGGTCGTAGTGTGGACGTGGGGTTAG	1
GGACGCCGGC	GAAACACCGGTGCATTCGAAAGTCCGGTCGTAGTGTGGACGTGGGGTTAG	1
GGACTCATCC	GATACACCGGTGTGGCTGAGAGTCCGGCAATGGTGTGGCTGTGGGGTTAG	1
GGAGACAGAC	GAAACCGGGGTTAGAGCTAGAAATAGCAAGTTAACCTAAGGCTAGTCCGT	1
GGAGACCTCC	GAAACACCGGTGTGGCTGAGAGTCCGGCAATGGTGTGGCTGTGGGGTTAG	1
GGAGACTGGT	CAAAACACCGGTCCATGCATAAGCACAGTCGTAGTGTGTAATGTCAGTAA	1
GGAGATCAGC	GAAACACCGGTCGGGGTTAGAGCTAGAAATAGCAAGTTAACCTAAGGCTA	1
GGAGATCTGC	GAAACACCGGTCACAGGCAATCCAGAGCTAGAAATAGCAAGTTAACCTAA	1
GGAGATGATT	GAAACACCGGTGACATTGGGTACAGAGCTAGAAATAGCAAGTTAACCTAA	1
GGAGCTACGA	GAAACACCGGTTACATTGAGATTAGAGCTAGAAAAGGCTAGTCCGTTACC	1
GGAGCTATGC	GAAACACCGGTTACATTGAGGGTTAGAGCTAGATATAGCAAGTTAACCTA	1
GGAGGAGCCT	GAAACACCGGTTCCCGTCCAGTGGGGTTAGAGCTAGAAATAGCAAGTTAA	1
GGATCGTCGT	GAAACACCGGTGTACGTATGGACTGAACCAGGGTGTACAAGTGGGGTTAG	1
GGATCGTTCA	GAAACACCGGTAAATTTGAGGCTCCGGCATGCAGGAGGCCGTGGGGTTAG	1
GGATCTCTAG	GAAACACCGGTGTGGCTGAGAGTCCGGCAATGGTGTGGCTGTGGGGTTAG	1
GGATTCTCGC	GAAACACCGGTGCATTCGAAAGTCCGGTCGTAGTGTGGACGTGGGGTTAG	1
GGCAACAAAT	GAAACACCGGTAAATTTGAGGCTCCGGCATGCAGGAGGCCGTGGGGTTAG	1
GGCAACATAC	GAAACACCGGTGTGGCTGAGAGTCCGGCAATGGTGTGGCTGTGGGGTTAG	1
GGCAACTCCA	GAAACACCGGTAAATTTGAGGCTCCGGCATGCAGGAGGCCGTGGGGTTAG	1
GGCAATTACA	GAAACACCGGTAAATTTGAGGCTCCGGCATGCAGGAGGCCGTGGGGTTAG	1
GGCACACCAC	GAAACACCGGTGTGGCTGAGAGTCCGGCAATGGTGTGGCTGTGGGGTTAG	1
GGCACACTAA	GAAACACCGGTGTGGCTGAGAGTCCGGCAATGGTGTGGCTGTGGGGTTAG	1
GGCACAGCCC	GAAACACCGGTAGCAAGTGCGAGCTAGAAATAACAAGTTAACCTAAGGCT	1
GGCACCCTCC	GAAACACCGGTGTGGCTGAGAGTCCGGCAATGGTGTGGCTGTGGGGTTAG	2007
GGCACCCTCC	GAAACACCGGTGTGGCTGAGAGTCCGGCAATGGTGTGGCGTGGGGTTAGA	24
GGCACCCTCC	GAAACACCGGTAAATTTGAGGCTCCGGCATGCAGGAGGCCGTGGGGTTAG	7
GGCACCCTCC	GAAACACCGGTCGGGGCCACTCAGTGGTGGGGTTAGAGCTAGAAATAGCA	3
GGCACCCTCC	CAAAACACCGGTGTGGCTGAGAGTCCGGCAATGGTGTGGCTGTGGGGTTA	2
GGCACCCTCC	GAAACACCGGTGCCCTTACTCTCACCTGATTACTTAATCCGTGGGGTTAG	2
GGCACCCTCC	GAAACACCGGTGTACGTATGGACTGAACCAGGGTGTGCAAGTGGGGTTAG	2
GGCACCCTCC	GAAACACCGGTGTGGCTGAGTGTGCGGCAGTGGTGTGGCTGGGGGTAGAG	2
GGCACCCTCC	GAAACACCGGTTATATTTGTAAGTGTGTGGGGTTAGAGCTAGAAATAGCA	2
GGCACCCTCC	CAAAACACCGGTGTGGCTGAGAGTCCGGCGATGGTGTGGCTGTGGGGTTA	1
GGCACCCTCC	CTAAACACCGGTGTGGCTGAGAGTCCGGCAATGGTGTGGCGTGGGGTTAG	1
GGCACCCTCC	GAAACACCGGTAACTATATTCATGCGATATCGCCGTATCAGTGGGGTTAG	1
GGCACCCTCC	GAAACACCGGTATGTCTGAGAGTCCGGCATTCAGGAGGCTGTGGGGTTAG	1
GGCACCCTCC	GAAACACCGGTCGGCGGCAATCGTTTTTGTGGGGTTAGAGCTAGAAATAG	1
GGCACCCTCC	GAAACACCGGTCGGCGGGGTTAGAGCTAGAAATAGCAAGTTAACCTAAGG	1
GGCACCCTCC	GAAACACCGGTGAGGCTAATGGGCCGGGAATGTAGAGCTAGAGGGATTAG	1
GGCACCCTCC	GAAACACCGGTGTAGCTGAGAGTGCGGCGGTGGTGTGGCTGGAGAGATAG	1
GGCACCCTCC	GAAACACCGGTGTGGCTGAGAGTCGGCAATGGTGTGGCTGTGGGGTTAGA	1
GGCACCCTCC	GAAACACCGGTGTGGCTGGGAGTCCGGCGATGGTGTGGCTGGGGGGAGCG	1
GGCACCCTCC	GAAACACCGGTGTGGCTGGGGGTCCGTCATTGATGGCGCTTTGGGGTTAG	1
GGCACCCTCC	GAAACACCGGTGTGGGGCAGAGTCGGGCAGGAGTGGGTGTGTGGGGTTAG	1
GGCACCCTCC	GAAACACCGGTTCATTCGAAAGTCCGGTCGTAATGTGGACGTGGGGTTAG	1
GGCACCCTCC	GAAACACCGGTTTGAACTACCGGGGTTAGAGCTAGAAATGGCAAGTTAAC	1
GGCACCCTCC	GAACACCGGTGTGGCTGAGAGTCCGGCAATGGTGTGGCGTGGGGTTAGAG	1
GGCACCGAAA	GAAACACCGGTAAATTTGAGGCTCCGGCATGCAGGAGGCCGTGGGGTTAG	1
GGCACTCGTC	GAAACACCGGTGTGGCTGAGAGTCCGGCAATGGTGTGGCTGTGGGGTTAG	1
GGCATCGTCG	GAAACACCGGTGTACGTATGGACTGAACCAGGGTGTGCAAGTGGGGTTAG	1
GGCATCTAAA	GAAACACCGGTAAATTTGAGGCTCCGGCATGCAGGAGGCCGTGGGGTTAG	2
GGCATCTACT	GAAACACCGGTAAATTTGAGGCTCCGGCATGCAGGAGGCCGTGGGGTTAG	1
GGCATTCGCC	GAAACACCGGTGTGGCTGAGAGTCCGGCAATGGTGTGGCTGTGGGGTTAG	1
GGCATTGTCA	GAAACACCGGTAGCAAGTGCGAGACGGTTGTGGGGTTAGAGCTAGAAATA	1
GGCCAATACC	GAAACACCGGTAAATTTGAGGCTCCGGCATGCAGGAGGCCGTGGGGTTAG	1
GGCCCCGTGC	GAAACACCGGTGTGGCTGAGAGTCCGGCAATGGTGTGGCTGTGGGGTTAG	1
GGCCCCTACA	GAAACACCGGTAAATTTGAGGCTCCGGCATGCAGGAGGCCGTGGGGTTAG	1042
GGCCCCTACA	GAAACACCGGTAAATTTGAGGCTCCGGCATGCAGGAGGCGTGGGGTTAGA	46
GGCCCCTACA	GAAACACCGGTAAATTTGAGGCTCCGGCACTAGAAATAGCAAGTTAACCT	17
GGCCCCTACA	GAAACACCGGTAAATTTGAGGCTCCGGCATGCAGGAGGCCCGTGGGGTTA	11
GGCCCCTACA	CCGGTAAATTTGAGGCTCCGGCATGCAGGAGGCCGTGGGGTTAGAGCTAG	7
GGCCCCTACA	CAAAACACCGGTAAATTTGAGGCTCCGGCATGCAGGAGGCCGTGGGGTTA	3
GGCCCCTACA	CTAAACACCGGTAAATTTGAGGCTCCGGCATGCAGGAGGCCGTGGGGTTA	1
GGCCCCTACA	GAAACACCAGTAAATTTGAGGCTCGGCATGCAGGAGGCCGTGGGGTTAGA	1
GGCCCCTACA	GAAACACCGGTAAAGCCGAGGTTAGTGCTAGAAATAGCAAGTTAACCTAA	1
GGCCCCTACA	GAAACACCGGTAAATTTGAGGCTCCGTCATGCCGGCGCTCGTCGGTTTAG	1
GGCCCCTACA	GAAACACCGGTAAATTTGAGGCTCGGGCGGGGATGGAGCTAGAGATAGAG	1
GGCCCCTACA	GAAACACCGGTAACTATATTCATGCGATATCGCCGTATCAGTGGGGTTAG	1
GGCCCCTACA	GAAACACCGGTACATTTTATCCTCACGCGGGCATAGAGCCAGAAATAGAG	1
GGCCCCTACA	GAAACACCGGTAGCAAGTGCGAGACGTATGGGGGTTAGAGCTAGAAATAG	1
GGCCCCTACA	GAAACACCGGTCGGCGGCAATCGTGGGTGGGGTTAGAGCTAGAAATAGCA	1
GGCCCCTACA	GAAACACCGGTGCATTCGAAAGTCCGGTCGTAGTGTGGACGTGGGGTTAG	1
GGCCCCTACA	GAAACACCGGTGTGGCTGAGAGTCCGGCAATGGTGTGGCTGTGGGGTTAG	1
GGCCCCTACA	GAAACACCGGTTAAGCCGAGGGTTAGAGCTAGAAATAGCAAGTTAACCTA	1
GGCCCCTACA	GAAACACCGGTTACATTGAGTGGGGTTAGAGCTAGAAATAGCAAGTTAAC	1
GGCCGCAACT	GAAACACCGGTAAATTTGAGGCCCCGGCATGCAGGAGGCCGTGGGGTTAG	1
GGCCGTCTCC	GAAACACCGGTGTGGCTGAGAGTCCGGCAATGGTGTGGCTGTGGGGTTAG	1
GGCCTCGACG	GAAACACCGGTAAATTTGAGGCTCCGGCATGCAGGAGGCCGTGGGGTTAG	1
GGCCTCTGCC	GAAACACCGGTAAATTTGAGGCTCCGGCATGCAGGAGGCCGTGGGGTTAG	1
GGCCTGTATA	GAAACACCGGTAAATTTGAGGCTCCGGCATGCAGGAGGCCGTGGGGTTAG	1
GGCCTTAACC	GAAACACCGGTAAGTTTGTTGCTCCGGCATGCCGGAGGCCGTGGGGTTAG	1
GGCCTTATCT	GAAACACCGGTTTACGTTACATTCGGTGTGTGGTTAGGGCTAGAAATAGC	1
GGCGAAGCCT	GAAACACCGGTTCCCGTCCAGTGGGGTTAGAGCTAGAAATAGCAAGTTAA	1
GGCGACTACT	GAAGCACCGGTAAATTTGAGGCTCCGGCATGCAGGAGGCCGTGGGGTTAG	1
GGCGCCATTA	GAAACACCGGTGTGGCTGAGAGTCCGGCAATGGTGTGGCTGTGGGGTTAG	1
GGCGCTGACA	GAAACACCGGTAAATTTGAGGCTCCGGCATGCAGGAGGAGTGGGGTTAGA	1
GGCGCTTGGT	GAAACACCGGTAACTTTGAGGCTCCGGCATGCAGGAGGCCGTGGGGATAG	1
GGCGTACTCC	GAAACACCGGTGTGGCTGAGAGTCCGGCAATGGTGTGGCTGTGGGGTTAG	1
GGCGTCCCGC	GAAACACCGGTCGGCGGCAATCGTGGGTGGGGTTAGAGCTAGAAATAGCA	1
GGCTAATACA	GAAACACCGGTAAATTTGAGGCTCCGGCATGCAGGAGGCCGTGGGGTTAG	1
GGCTCAGGCC	GAAACACCGGTGAGGCTGCTTTTCCGGCGGTGGTAGGGCTAGGGGTAGCA	1
GGCTCGCTAG	GAAACACCGGTGTGGTTGGGAGTTCGGCAGTGGTAGGGCTGGGGATATCA	1
GGCTCTTAAA	GAAACACCGGTAAATTTGAGGCTCCGGCATGCAGGAGGCCGTGGGGTTAG	1
GGCTGCCTGC	GAAACACCGGTGTGGCTGAGAGTCCGGCGATGGTGTGGCTGTGGGGCTAG	1
GGCTTTTGCC	GAAACACCGGTCGGGGCCACTCAGTGGTGGGGTTAGAGCTAGAAATAGCA	1
GGGAACTACA	GAAACACCGGTAAATTTGAGGCTCCGGCATGCAGGAGGCCGTGGGGTTAG	1
GGGACACGCC	GAAACACCGGTGTGGCTGAGAGTCCGGCAATGGTGTGGCTGTGGGGTTAG	1
GGGACAGTCC	GAAACACCGGTGTGGCTGAGAGTCCGGCAATGGTGTGGCTGGGGGGTTAG	1
GGGACCATCG	GAAACACCGGTGTGGCTGAGAGTACGGCAATGGTGTGGCTGTGGGGTTAG	1
GGGACCCGCG	GAAACACCGGTGCATTCGAAAGTCCGGTCGTAGTGTGGACGTGGGGTTAG	1
GGGACGCGCA	GAAACACCGGTGGGGCTGGGAGGCCGGCTATGGTGTGGCGGGGGGGTTAT	1
GGGACGCTTC	GAAACACCGGTGTGGCTGAGAGTCCGGCAATGGTGTGGCTGTGGGGTTAG	1
GGGAGCAAAC	GAAACACCGGTTAAGCCGAGGCGTTAGAGCTAGAAATAGCAAGTTAACCT	1
GGGAGCATAG	GAAACACCGGTGTGGCTGAGAGTCCGGCAATGGTGTGGCTGTGGGGTTAG	1
GGGAGCCATG	GAAACACCGGTGCGCTCAATAGCACGTTAGTACTTAAGCCGTGGGGTTAG	1
GGGAGTGTAA	GAAACACCGGTTAAGCCGAGGCGTTAATTAGAGCTAGAAATAGCAAGTTA	1
GGGATTCCTT	GAAACACCGGCCTCGAGTGAGGAGTTCAGGGTGGGGTTAGAGCTAGAAAT	1
GGGCAACCTC	GAAACACCGGTGTGGCTGAGAGTCCGGCAATGGTGTGGCTGTGGGGTTAG	1
GGGCACTCTA	GAAACACCGGTAAATTTGAGGCTCCGGCATGCAGGAGGCCGTGGGGTTAG	1
GGGCCCAGCA	GAAACACCGGTAAATTTGAGGCTCCGGCATGCAGGAGGCCGTGGGGATAG	1
GGGCCGTACT	GAAACACCGGTAAATTTTAGGCTCCGGCATGCAGGAGGCCGTGGGGTTAG	1
GGGCCTCTAC	GAAACACCGGTAAATTTGAGGCTCCGGCATGCAGGAGGCCGTGGGGTTAG	1
GGGCGCCGTC	GAAACACCGATGTGGCTGAGAGTCCGGCAATGGTGTGGCTGTGGGGTTAG	1
GGGCGCTGGG	GAGACACCGGTGCATTCAAAAGGCCGGTCTTAGCGTGCACGTGGGGTTAG	1
GGGCGTCGTC	GAAACACCGGTGTACGTATGGACTGAACCAGGGTGTGCAAGTGGGGTTAG	1
GGGCTAACTC	GAAACACCGGTCCGTAGGAGACCCGTGTGGCATGTACCTGTGGGGTTAGA	1
GGGCTGTCTC	GAAACACCGGTCCGTAGGAGACCCGTGTGGCATGTACCTGTGGGGTTAGA	1
GGGGACCATC	GAAACACCGGTTCCCGTACAGTGGGGTTAGAGCTAGAAATAGCAAGTTAA	1
GGGGAGAATC	GAAACACCGGTTCCCGTCCAGTGGGGTTAGAGCTAGAGATAGCAAGTTAA	1
GGGGCCCTAC	GAAACACCGGTAAATTTGAGGCTCCGGCATGCAGGAGGCCGTGGGGTTAG	1
GGGGCCGATA	GAAACACCGGTAAATTTGAGGCTCCGGCATGCAGGAGGCCCGCGGGGTTA	1
GGGGCGCCGC	GAAACACCGGTCGGCGGCAATCGTGGTATGAGCCACGTGGGGTTAGATCG	1
GGGGCGCCTA	GAAACACCGGTTCCCGTCCAGTGGGGTTAGAGCTAGAAATAGCAAGTTAA	1
GGGGCGTCTC	GAAACACCGGTTCCCGTCCAGTGGGGTTAGAGCTAGAAATAGCAAGTTAA	1
GGGGCTGTCT	ATAGCAAGTTAACCTAAGGCTAGTCCGTTATCAACTTGAAAAAGTGGCAC	1
GGGGGAGCCT	GAAACACCGGTTCCCGTCCAGTGGGGTTAGAGCTAGAAATAGCAAGTTAA	1
GGGGGGCCAC	GAAACACCGGTTCCCGTCCAGTGGGGCTAGAGCTAGAAATAGCAAGTTAA	1
GGGGGTGTCT	GAAACACCGGTTCCATTGGAGTGGGGTTAGAGCTAGAAATAGCAAGTTAA	1
GGGGTGGACT	GAAACACCGGTGACATTGGGTGTGGGGTTAGAGCTAGAAATAGGAAGTTA	1
GGGGTTGTTC	GAAACACCGGTTCCCGTCGGGCGGGGTTTAGACTAAAAAATACAAGTTAA	1
GGGTGCGACC	GAAACACGGGTTAGAGCTAGAAATAGCATGTTAACCTAAGGCTAGTCCGT	1
GGTACCGACA	GAAACACCGGTAAATTTTAGGCCCAGGCATGCAGAAGGCTGGGAGGATAG	1
GGTACGCCTC	GAAACACCGGTCCGTAGGAGACCCGTGTGGCATGTACCTGTGGGGTTAGA	1
GGTAGCGCCT	GAAACACCGGTTCCCGTCCAGTGGGGTTAGAGCTAGAAATAGCAAGTTAA	1
GGTAGCTATG	CAAAACACCGGTTACATTGAGATTGGGGTTAGAGCTAGAAATAGCAAGTT	1
GGTATCGACA	GAAACACCGGTTATATTTGTAAGAGATGTGGTGTTAGAGCTAGAAAAAGT	1
GGTCCCTTGA	GAAACACCGGTAAATTTGAGGCTCCGGCATGCAGGAGGCCGTGGGGTTAG	1
GGTCGCTAGA	GAAACACCGGTAAATTTGAGGCTCCGGCATGCAGGAGGCCGTGGGGTTAG	1
GGTCTGCATA	GAAACACCGGTCCGCAGGAGACCCGTGTGGCATGTGTGGGGTTAGAGCTA	1
GGTCTGTACC	GAAACACCGGTAAATTTGAGACCCCGGCATGCAGGACGCCGTGGGGTTAG	1
GGTGATCCTC	GAAACACCGGTTCCCGTCCAGTGGGGTTAGAGCTAGAAATAGCAAGTTAA	1
GGTGGAGACT	GAAACACCGGTTCCCGTCCAGTGGGGTTAGAGCTAGAAATAGCAAGTTAA	2
GGTGGATCCT	GAAACACCGGTTCCCGTCCAGTGGGGTTAGAGCTAGAAATAGCAAGTTAA	1
GGTGGGGCCA	GAAACACCGGTTCCCGTCCAGTGGGGTTAGAGCTAGAAATAGCAAGTTAA	1
GGTTTCCCCC	GAAACACCGGTTGGGGCCCCTCAGTGATAGAGCAAGTTCACCTAAGGCTA	1
GGTTTCTACA	GAAACACCGGTCGGGGCCACTCAGCGGTAGGGTTGGAGCTGGGAGTAGCA	1
GTAAAACTTT	GAAACACCGGTCTCGAGAGAGGTGGTCTTCTGGGGGGGGTTAGAGCTAGA	1
GTAAACACCC	GAAACACCGGTACCTCTGTTGATGCTGGGTGGATAGGAAATCGGGCCCAT	1
GTAAATTATA	GAAACACCGGTAACTATATTCATGCGATATCGCCGTATCAGTGGGGTTAG	1
GTAACAGCCT	GAAACACCGGTAGCAAGTGCGAGACGTGTTTTTGTGGGGTTAGAGCTAGA	1
GTAAGCTATG	GAAACACCGGTTACATTGAGGGGTTAGAGCTAGAAATAGCAAGTTAACCT	1
GTAATGCTTT	GAAACACCGGTTCCCGTCCAGTGGGTCTAGAGCTAGATATAGCTAGTTAT	1
GTACACCATT	GAAACACCGGTCCGAGGGAGTCGCGTGTGGCATTAGCCTGAGGGGTAGCA	1
GTACATTCGG	GAAACACCGGTCGATTCATATCGAAACCTTCCCGTGACAGTGGGGTTAGA	1
GTACCACACA	GAAGCACCGGTAAATTTGAGGCTCCGGCATGCAGGAGGCCGTGGGGTTAG	1
GTACCTAAGA	GAAACACCGGTTACATTAAGTGTTAGAGCTGGAAATAGCTAGTTATACTA	1
GTACTCGGTT	GAAACACCGGTTACTGTAAATTGGCTGGGTGGTGATAGAGCTAGAAATAG	1
GTAGAAACGC	GAAACACCGGTCGGCGGTGGGGGTAGAGCTAGAAATAGCAAGTTAACCTA	1
GTAGTCGACA	GAAACACCGGTACCTTTGTTGATGCTGGGTGGAAGGTACACCGGTACCTT	1
GTAGTCTGCC	GAAACACCGGTCCGTAGGAGACCCGTGTGGCATGTACCTGTGGGGTTAGA	1
GTATACGGAT	GAAACACCGGTCGATTCATATCGAAACCTTCCCGTGACAGTGGGGTTAGA	1
GTCAACCATT	GAAACACCGGTTAGAGTGAATTGCCGGCGATGGTAGGGCTAGAGATATCA	1
GTCACAGTAA	GAAACACCGGTTGCACGGGGGGTTATAACTAGAAGTAGCAAGTTAACATC	1
GTCACCGCCA	GAAACACCGGTAGCAAGTGCGAGACGTGTTTTTGTGGGGTTAGAGCTAGA	1
GTCACCTAAA	GAAACACCGGTTAAGCCGAGGAGTTAGAGCTAAAAATAGCGAGTTAACCT	1
GTCACCTACT	GAAACACCGGTTTGAACTACCTAGTTCAAACCGGTGGGGTTAGAGCTAGA	1
GTCACTATCC	GAAACACCGGTGTGGCTGAGAGCCCGGCAATGGTGGGGCTGTGGGGTTAA	1
GTCAGAGCCA	GAAACACCGGTAGCAAGTGCGAGCTAGAAATAGCAAGTTAACCTAAGGCT	1
GTCCCCCATA	GAAACACCGGTGTGGCTGAGAGTCCGGCAATGGTGTGGCTGTGGGGTTAG	1
GTCCCGTAAA	GAAACACCGGTAAATTTGAGGCTCCGGCATGCAGGAGGCCGTGGGGTTAG	1
GTCGAATCCT	GAAACACCGGTCTCGAGTGAGGTGTTCAGGGTGGGGTTAGAGCTAGAAAT	1
GTCGCATATA	GAAACACCGGTAACTATATTCATGCGATATCGCCGTATCAGTGGGGTTAG	1
GTCGTCAGTG	GAAACACCGGTTATGTTAGTAAGTGTGTGGGGTTAGAGTTAGAAATAGCA	1
GTCTAACGAG	GAAACACTGGTTATATCTGTAAGTGTTGTGGGGTTAGAGCTAGAAATAGC	1
GTCTACCTAC	GAAACACCGGTGTGGCTGAGAGTCCGGCAATGGTGTGGCTGTGGGGTTAG	1
GTCTATAGAG	GAAACACCGGTTATGTGGGGTTAGAGCTAGAAATAGCAAGTTAACCTAAG	1
GTCTATCGTG	GAAACACCGGTTATATTTGTAAGTGTGTGGGGTCAGAGCTAGAAATAGCA	1
GTGACAGTCA	GAAACACCGGTGACATTGGGTACAGGGTGGGGTTAGAGCTAGAAATAGCA	1
GTGACCATAC	GAAACACCGATTAAGCTGAGTGGGGTTAGAGCTAGAAACAGCAAGTTAAC	1
GTGACGCCCC	GAAACACCGGTGCGCCTCAAGTGAGGTTAGTGCTAGGACTGGCAGGTTAA	1
GTGAGAATCG	GAAACACCGGTTAAGCCGAGTGGGGTTAGAGCTAGAAATAGCAAGTTAAC	1
GTGAGAGTAA	GAAACACCGGTTAAGCCGAGTGGGGTTAGAGCTAGAAATAGCAAGTTAAC	1
GTGATGACTC	GAAACACCGGTTCCCGTCCTGTGGGCTTAGAACTAGAAATAGCAAGTTAA	1
GTGATGACTC	GAAACACCGGTTCCCGTATTCAGGGGTTAGAGCTAGATCTAGCAAGTTCA	1
GTGCACAAAA	GAAACACCGGTTAAGCCGAGGAGTTAGAGCCAGAAATAGCAAGTTAACCT	1
GTGCAGACTT	GAAACACCGGTTCACGTCCTGTGGGGTTAGAGCTAGAAAAAAGCAGTTAA	1
GTGCCCCCCC	GAAACACCGGTTTGGCTGAGTTTACGGCAATGGTATGGCTGGGAGGATAG	1
GTGCGTAGCA	GAAACACCGGTTTACGTTGCATCGGTGTGGGGTTAGAGCTAGAAATAGCA	1
GTGCTCATAA	GAAACACCGGTTAAGCCGAGGAGTTAGAGCTAGAAATAGCAAGTTAACCT	1
GTGCTTCGCC	GAAGCACCGGTTTACGTTGCATCGGTGTGGGGTTAGAGCTAGAAATAGCA	1
GTGGAAAGTC	GAAACACCGGCTCCCGTCCAGTGGGGTTAGAGCTAGAAATAGCAAGTTAA	1
GTGGACGATC	GAAACACCGGTTCCCGTCCAGAGGGGTTAGAGCTAGAAATAGCAAGTTAA	1
GTGGACTCGC	GAAACACCGGTGCATTCGAAAGTCCGGTCGTAGTGGAGACGTGGGGTTAG	1
GTGGACTCTA	GAAACACCGGTTCCCGTCCAGTGGGGTTAGAGCTAGAAATAGCAAGTTAA	1
GTGGAGCCTC	GAAACACCGGTTCCCGTCCAGTGGGGTTAGAGCTAGAAATAGCAAGTTAA	2685
GTGGAGCCTC	GAAACACCGGTTCCCGTAGCTAGAAATAGCAAGTTAACCTAAGGCTAGTC	24
GTGGAGCCTC	GAAACACCGGTTCCCGTCCAGTGGGTTAGAGCTAGAAATAGCAAGTTAAC	11
GTGGAGCCTC	GAAACACCGGTCGGCGGCAATCGTGGGTGGGGTTAGAGCTAGAAATAGCA	5
GTGGAGCCTC	CAAAACACCGGTTCCCGTCCAGTGGGGTTAGAGCTAGAAATAGCAAGTTA	2
GTGGAGCCTC	GAAACACCGGTAACTATATTCATGCGATATCGCCGTATCAGTGGGGTTAG	2
GTGGAGCCTC	GAAACACCGGTCGATTCATATCGAAACCTTCCCGTGACAGTGGGGTTAGA	2
GTGGAGCCTC	GAAACACCGGTGCATTCGAAAGTCCGGTCGTAGTGTGGACGTGGGGTTAG	2
GTGGAGCCTC	GAACACCGGTTCCCGTCCAGTGGGGTTAGAGCTAGAAATAGCAAGTTAAC	2
GTGGAGCCTC	CAAAACGCCGGTTCCCGTCCAGTGGGGTTAGAGCTAGAAATAGCAAGATA	1
GTGGAGCCTC	GAAACACCGGTAAATTTGAGGCTCCGGCATGCAGGAGGCCGTGGGGTTAG	1
GTGGAGCCTC	GAAACACCGGTCGGCGGCAATCGTGGGGAGGGGTTAGAGCTAGAAACAGC	1
GTGGAGCCTC	GAAACACCGGTCGGCGGCAATGTGGGGTTAGAGCTAGAAATAGCAAGTTA	1
GTGGAGCCTC	GAAACACCGGTCGTCGTCCATCGTGGGTGGGGTTAGAGCTAGAAATAGCA	1
GTGGAGCCTC	GAAACACCGGTGCCCGCTGCCAGCTCCGTTGTGGGGTTAGAGCTAGAAAT	1
GTGGAGCCTC	GAAACACCGGTGCCCTTACTCTCACCTGATTACTTAATCCGTGGGGTTAG	1
GTGGAGCCTC	GAAACACCGGTGTACGTATGGACTGAACCAGGGTGTGCAAGTGGGGTTAG	1
GTGGAGCCTC	GAAACACCGGTTAAGCCGATGTGCTTTTTTCGTGCAGGCTATGCTCAAGA	1
GTGGAGCCTC	GAAACACCGGTTACATTGAGGGGTTAGAGCTAGAAATAGCAAGTTAACCT	1
GTGGAGCCTC	GAAACACCGGTTACATTGAGGGTTAGAGCTAGAAATAGCAAGTTAACCTA	1
GTGGAGCCTC	GAAACACCGGTTAGAGCTAGAAATAGCAAGTTAACCTAAGGCTAGTCCGT	1
GTGGAGCCTC	GAAACACCGGTTATATTTGTAAGTGTGTGGGGTTAGAGCTAGAAATAGCA	1
GTGGAGCCTC	GAAACACCGGTTCCCGCCAAGGGGGGTTAGGGCTGGAAAAGCCAGGTTAA	1
GTGGAGCCTC	GAAACACCGGTTCCCGTAGAGTGAGAGTAGGGCTAGATATAGCAAGTTAA	1
GTGGAGCCTC	GAAACACCGGTTCCCGTCCTGTGAGGGTAGAGCTAGACATAGCATATTAA	1
GTGGAGCCTC	GAAACACCGGTTCCCGTCGGGTGAGGGTAGAGGTGGTAGTGCTAAGGTAA	1
GTGGAGCCTC	GAAACACCGGTTTACGTTGCATCGGTGTGGGGTTAGAGCTAGAAATAGCA	1
GTGGAGCCTC	GAAACACCGGTTTACGTTGCATCTAACCCCATCGTTGTGGGGTTAGAGCT	1
GTGGAGCCTC	GAAACACCGGTTTGAACTACCTAGTTCAAACCGGTGGGGTTAGAGCTAGA	1
GTGGAGCCTC	GAAACACTTAGAGCTAGAAATAGCAAGTTAACCTAAGGCTAGTCCGTTAT	1
GTGGAGCCTC	GACGAAACACCGGTTCCCGTCCAGTGGGGTTAGAGCTAGAAATAGCAAGT	1
GTGGAGCCTC	GGAACACCGGTTCCCCGTCCAGTGGGGTTAGAGCTAGAAATAGCAAGTTA	1
GTGGATATTT	GCAACACCCGTTCCCGTCCAGTGGCGTTAGAGCTAGAAATAGCAAATTAA	1
GTGGATGTTC	GAAACACCGGCGCCATTGGGTACATCGTGGGGTTAGAGCTAGAAATAGCA	1
GTGGCCAGTA	GAAACACCGGTTCCCGTCCAGTGGGGTTAGAGCTAGAAATAGCAAGTTAA	1
GTGGCCCCGC	GAAACACCGGTCGGCGGCAATCGTGGGTGGGGTTAGAGCTAGAAATAGCA	1
GTGGCTACTT	GAAACACCGGTTCCCGTCCAGTGGGGTTAGAGCTAGAACTAGCAAGTTCA	1
GTGGCTCTGT	GAAACACCGGTTACATTGAGTGGGGTTAGAGCTAGAAATAGCAAGTTAAC	1
GTGGGACATC	GAAACACCGGTTCCCGTCCAGTGGGGTTAGAGCTAGAAATAGCAAGTTAA	1
GTGGGCCCCC	GAAACACCGGTTCCCGTCCAGTGGGGTTAGAGCTAGAAATAGCAAGTTAA	1
GTGGTGCGTT	GAAACACCGGTTCACGTCCAGTGGGGTTAGAGCTAGAAATAGCAAGTTAA	1
GTGGTGGATC	GAAACACCGGTTCCCGTCCAGTGGGGTTAGAGCTAGAAATAGCAAGATAA	1
GTGGTTCCCC	GAAACACCGGTCGGCGGCACTCGTGGGTGGGGTTAGGGCTAGAAATAGCA	1
GTGTAGACTA	GAAACACCGGTTCCCGTCCAGTGGGGTTAGAGCTAGAACTAGCAAGTTAA	1
GTGTAGTCTA	GAAACACCGGTTCCCGTCCAGTGGGGTTAGAGCTAGAAATAGCAAGTTAA	1
GTGTATCCAT	GAAACACCGGTTCCCGTCCAGTGGGGTTAGAGCTAGAAATAGCAAGTTAA	1
GTGTCTCCGT	GAAACACCGGTTACATTTACGAGTACAGCTAGAAATATAAAGTTAGCCTA	1
GTGTGGAGCC	GAAACACCGGTTCCCGTCCAGTGGGGTTAGAGCTAGAAATAGCAAGTTAA	1
GTGTGTGTAA	GAAACACCGGTTAATCCGATGTGCTTTTTTGCGGCAGTATACGTAGAAGT	1
GTGTTTAGAG	GAAACACCGGTTTACGTTGCATCGGTGTGGGGTTAGATCTAGAAATAGCA	1
GTTACACCTG	GAAACACCGGTAAATTTGAGGCTCCGGCATGCAGGAGGCCGTGGGGTTAG	1
GTTATCTATG	GAAACACCGGTTACATTGAGATTAGAGCTAGAAAAGGCTAGTCCGTTATC	1
GTTCTACGCC	GAAACACCGGTTCCCGTTGCATCGGGGTTAGAGGTGGTAAAGCCAAGAAA	1
GTTGTTTTCC	GAAACACCGGTGACATTAGAGCTAGAAATAGCAAGTTAACCTAAGGCTAG	1
GTTTATCATA	GAAACACCGGTTAAGCCGAGGAGTTAGAGCTAGAAATAGCAAGTTAACCT	1
GTTTTCCCGT	GAAACACCGGTCGGGGCCACTCACGAGTGGGGTTAGAGCTAGAAATAGCA	1
TAAAATGACC	GAAACACCGGTTTGAACTAGAAATAGCAAGTTAACCTAAGGCTAGTCCGT	1
TAAACACCAC	GAAACACCGGTCGGCGGCAATCGTTAGAGCTAGAAATAGCAAGTTAACCT	1
TAAACTACAC	GAAACACCGGTCGGCGGCAATCGTGGGAGTGGGGTTAGAGCTAGAAATAG	1
TAAAGCCCTA	GAAACACCGGTGCCCTTACTCTCACCTGATTACTTAATCCGTGGGGTTAG	2
TAAATCCTCC	GAAACACCGGTGTGTCTGAGAGTCCGGCAATGGCGTGGCTGTGGGGTTAG	1
TAACACCCTA	GAAACACCGGTGCCCTTACTCTCACCTGATTACTTAATCCGTGGGGTTAG	1
TAACGAACTA	GAAACACCGGTGCCCTTACTCTCACCTGATTACTTAATCCGTGGGGTTAG	1
TAACGCACTA	GAAACACCGGTGCCCTTACTCTCACCTGATTACTTAATCCGTGGGGTTAG	1
TAACGCCTTT	GAAACACCGGTGCCCTTACTCTCACCTGATTACTTAATCCGTGGGGTTAG	1
TAACGGCCTA	GAAACACCGGTGCCCTTACTCTCACCTGATTACTTAATCCGTGGGGTTAG	2
TAACTGCGCT	GAAACACCGGTTAACGTGTGGGCTGGACCAGGGTTGGCATGTGGGGCTAG	1
TAACTTATAC	GAAACACCGGTAACTATATTCATGCGATATCGCCGTATCAGTGGGGTTAG	1033
TAACTTATAC	ACTTGAAAAAGTGGCACCGAGTCGGTGCTTTTTTTCCTGCAGGGTATAAG	37
TAACTTATAC	GAAACACCGGTAACTATATTCATGCGATATCGCCGTGGGGTTAGAGCTAG	34
TAACTTATAC	GAAACACCGGTAACTATATTCATGCGATATCGCCGTATCAAGTGGGGTTA	30
TAACTTATAC	GAAACACCGGTAACTATATTCATGCGATATCGCCGGTTATCGTGGGGTTA	16
TAACTTATAC	GAAACACCGGTAACTATATTCATGCGATATCGCCGTAGTGGGGTTAGAGC	13
TAACTTATAC	GAAACACCGGTAACTATATTCATGCGATATCGCCGTATATCGTGGGGTTA	13
TAACTTATAC	GAAACACCGGTAACTATATTCATGCGATATCGCGGGGTTAGAGCTAGAAA	12
TAACTTATAC	GAAACACCGGTAACTATATTCATGCGATATCGCCGTTAGATATGGGGTTA	8
TAACTTATAC	GAAACACCGGTCGGCGGCAATCGTGGAAGTGGGGTTAGAGCTAGAAATAG	5
TAACTTATAC	CAAAACACCGGTAACTATATTCATGCGATATCGCCGTATCAGTGGGGTTA	3
TAACTTATAC	ACTTGAAAAAGTGGCACCGAGTCGGTGCTTTTTTCCTGCAGGGTATAAGT	2
TAACTTATAC	AGGGGCGAAACACCGGTAACTATATTCATGCGATATGGCCGTATCAGTGG	1
TAACTTATAC	CAAAACACCGGTAACTATATTCATGCGATATCGCCGTATCAAGTGGGGTT	1
TAACTTATAC	GAAACACCGGTAACCATATTCATTCCATATCGCCAGATCAGGAAGGTGAA	1
TAACTTATAC	GAAACACCGGTCCCCGTCAATCCAGGAAGTGGGGTTAGAGCTAGAAATAG	1
TAACTTATAC	GAAACACCGGTCCGTAGGAGACCCGTGTGGCATGTACCTGTGGGGTTAGA	1
TAACTTATAC	GAAACACCGGTCGGCGGCAATCGTGGAAGTGGGGTTAGTGCTAGAAATAG	1
TAACTTATAC	GAAACACCGGTCGGCGGTTAGGGCTAGGAATAGCAAGTTAAACTAAGGCT	1
TAACTTATAC	GAAACACCGGTCGGGGCCACTCAGTGGTGGGGTTAGAGCTAGAAATAGCA	1
TAACTTATAC	GAAACACCGGTCGGTGGCAATCGTGGAAGTGGGGTTAGAGCTAGAAATAG	1
TAACTTATAC	GAAACACCGGTGCCCTTACTCTCACCTGATTACTTAATCCGTGGGGTTAG	1
TAACTTATAC	GAAACACCGGTGTGGCTGAGAGTCCGGCAATGGTGTGGCTGAGGGGTTAG	1
TAACTTATAC	GAAACACCGGTGTGGCTGAGAGTCCGGCAATGGTGTGGCTGTGGGGTTAG	1
TAACTTATAC	GAAACACCGGTTTACGTTGCATCGGTGTGGGGTTAGAGCTAGAAATAGCA	1
TAACTTATAC	GAAACACCGGTTTACGTTGCGGTGGGGTTAGAGCTAGAAATAGCAAGTTA	1
TAACTTATAC	GAAACACGGTAACTATATTCATGCGATATCGCCGTATCAGTGGGGTTAGA	1
TAACTTATAC	GGCTTGAAAAAGTGGCACCGAGTCGGTGCTTTTTTTCCTGCAGGGTATAA	1
TAACTTGTTA	GAAACACCGGTAATTATATTCATGCGATATCGCCGTATCAGGGGGGTTAG	1
TAAGATATCT	GAAACACCGGTTAGAGCTAGAAATAGCAAGTTAACCTAAGGCTAGTCCGT	1
TAAGATATTT	GAAACACCGGTTACATTGAGGGGTTGGAGCTAGAAATAGCAAGTTAACCT	1
TAAGGCATAA	GAAACACCGGTTAAGCCGAGGAGTTAGAGCTAGAAATAGCAAGTTAACCT	1
TAAGTCCCAC	GAAACACCGGTGCCCTTGCTCTCACCTGATTACTTAATCCGTGGGGTTAG	1
TAATACAGCC	GAAACACCGGTACCTTTGTTGATGCTGGGTGGAAGCTTGAAATAGCGAGT	1
TAATACCAGC	GAAACACCGGTCGGCGGCGGTGGGGTTAGAGCTAGAAATAGCAAGTTAAC	1
TAATACGCCC	GAAACACCGGTTTGAACTAGAAATAGCAAGTTAACCTAAGGCTAGTCCGT	1
TAATCGGCCT	GAAACACCGGTCCGTAGGAGACCCGTGTGGCATGTACCTTGTGGGGTTAG	1
TAATCGTCGT	GAAACACCGGTGTACGTATGGACTGAACCAGGGTGTGCAAGTGGGGTTAG	2
TAATGTCCTA	GAAACACCGGTGCCCTTACTCTCACCTGATTACTTAATCCGTGGGGTTAG	1
TAATTAGGTT	GAAACACCGGTCGATTCATATCGAAACCTTCCCGTGACAGTGGGGTTAGA	1
TAATTCGTGG	GAAACACCGGTTATATTTGTTAGTGTGTGGGGTTAGAGCTAGAAATTGCA	1
TACAAAGAGA	GAAACACCGGTAGCAAGTGCGAGACGTGTTTTTGTGGGGTTAGAGCTAGA	1
TACAAAGGCG	GAAACACCGGTTATATTTGTAAGTGTTTGTGGGGGTAGAGCTAGAAATAG	1
TACACCTGCA	GAAACACCGGTAAATTTGAGGCTCCGGCATGCAGGAGGCCGTGGGGTTAG	358
TACACCTGCA	GAAACACCGGTAAATTTGAGGCTCCGGCATGCAGGAGGCGTGGGGTTAGA	10
TACACCTGCA	GAAACACCGGTAAATTTGAGGCTCCGGCATGCAGGAGGCCTGGGGTTAGA	6
TACACCTGCA	GAAACACCGGTAAATTTGAGGCTCCGGCATGCAGGAGGCCCGTGGGGTTA	5
TACACCTGCA	CCGGTAAATTTGAGGCTCCGGCATGCAGGAGGCCGTGGGGTTAGAGCTAG	3
TACACCTGCA	GAAACACCGGTGTGGCTGAGAGTCCGGCAATGGTGTGGCTGTGGGGTTAG	2
TACACCTGCA	GAAACACCGGTAAATTTAAGGCTCCGGCACTAGAAATAGCAAGTTAACCT	1
TACACCTGCA	GAAACACCGGTAAATTTGAGGCTCCGGCACTAGAAATAGCAAGTTAACCT	1
TACACCTGCA	GAAACACCGGTAGAGTTGAGGCTACGGCATGCAGGGAGCCGGGAAGATAG	1
TACACCTGCA	GAAACACCGGTGCATTCGAAAGTCCGGTCGTAGTGTGGACGTGGGGTTAG	1
TACACCTGCA	GAAACACCGGTGCATTCGAAAGTCCGGTCTTAGTGTGGCCGTGGGGTTAG	1
TACACCTGCA	GAAACACCGGTTCGCGCGGAATGTTTGTGGGGTTAGAGCTAGAGATAGCA	1
TACACCTGCA	GAGAGATAGAAACAGCAAGTTAACTTGAGGGTATTCCGCTAGCAACAGCA	1
TACAGAGGCC	GAAACACCGGTAAATTTGAGGCTCCGGCATGCAGGAGGCCGTGGGGTTAG	1
TACATGCTCC	GAAACACCGGTTTGGCTGAGAGTCCGGACATGGTGTGGCTGTGGGGCTAG	1
TACATTATAA	GAAACACCGGTAACTATATTCATGCGATATCACCGTATCAGTGGGGTTAG	1
TACCTGTCCT	GAAACACCGGTAAATTTGAGCCCCGGGACTTCAGTAGGCCGTGGGGCTAG	1
TACCTTCGGT	GAAACACCGGTCGATTCATATCGAAACCTTCCCGTGACAGTGGGGTTAGA	1
TACGACGCTC	GAAACACCGGTCGGCGGCAATCGTGGGTGGGGTTAGAGCTAGAAATAGCA	1
TACGCAGTAA	GAAACACCGGTAGCAAGAGCGAGACGTATGGGGGTTAGAGCTAGAAATAG	1
TACGCCATAT	GAAACACCGGTTCCCTTACTCTCACCTGATTACCTAATCCGTGGGGTTAG	1
TACTTTACCG	GAAACACCGGTCGGGGCCACTCAGTGGTGGGGTTAGAGCTAGAAATAGCA	1
TAGAAGCCTC	GAAACACCGGTTCCCGTCCAGTGGGGTTAGAGCTCGAAATAGAAATATAA	1
TAGAATCCTT	GAAACACCGGTCTCGAGTGAGGTGTTCAGGGTGGGGTTAGAGCTAGAAAT	2
TAGACAATCA	GAAACACCGGTTAAGCCGAGGTTAGAGCTAAAAATATCAAGTTAACCTAA	1
TAGACCCGCG	GAAACACCGGTGCATTCGAAAGTCCGGTCGTAGTGTGGACGTGGGGTTAG	1
TAGAGTAGAC	GAAACACCGGTTAAGCCGAGGAGTTTCGTTAGAGCTAGAAATAGCAAGTT	1
TAGATAGAGG	GAAACACCGGTTATATTTGTAAGTGGGGTTAGAGCTAGAAATAGCAAGTT	1
TAGATAGAGG	GAAACACCGGTTATATTTGTAAGTGTGTGGGGTTAGAGCTAGAAATAGCA	1
TAGATCGACT	GAGACACCGGTTAACTTTGCATCGGTTTGGGGGTTGAACTTGAAATAACA	1
TAGCCTGCCT	GAAACACCGGTCCGTAGGAGACCCGTGTGGCATGTACCTGTGGGGTTAGA	1
TAGCGAATAT	GAAACACCGGTTAAGCCGAGGTTAGAGCTAGAAATAGCAAGTTAACCTAA	1
TAGCTAACTC	GAAACACCGGTGTACGTATGGACTGCACCAGGGAGTGTAAGTGGGGTTAG	1
TAGCTAGTAA	GAAACACCGGTAACGATATTCATGCAATATCGCCATATCAGAGAGGATAG	1
TAGCTATGAC	GAAACACCGGTTACATTGAGGGGTTAGAGCTAGAAATAGCAAGTTAACCT	1
TAGGATCCTT	GAAACACCGGTCTCGAGTGAGGTGTTCAGGGTGGGGTTAGAGCTAGAAAT	1
TAGGCCGGAC	GAAACACCGGTGCCCTTACTCCCACCTGATTACTTAATCCGTGGGGTTAG	1
TAGGCTGCCT	GAAACACCGGTCCGTAGGAGACCCGTGTGGCATGTACCTGTGGGGTTAGA	1
TAGGCTGGTT	GAAACACCGGTCCGTAGGAGACCCGTGTGGCATGTACCTGTGGGGTTAGA	1
TAGGTTACTC	GAAACACCGGTTCCCGTCCTGTGGGGTTAGAGCTAGAAATAGCAAGTTAA	1
TAGTCTGACT	GAAACACCGGTCCGTAGGAGACCCGTGTGGCATGTACCTGTGGGGTTAGA	1
TAGTCTGGCT	GAAACACCGGTCCGTAGGAGACCCGTGTGGCATGTACCTGTGGGGTTAGA	1
TAGTGTAGTC	GAAACACCGGTGACATTGGGAGCAAGTTAACCTAAGGCTAGTCCGTTATC	1
TAGTTTACCG	GAAACACCGGTCGGCGCCACTCAGTCGTGGGGTTAGAGCTAGAAATAGCA	1
TATAACGACC	GAAACACCGGTTTGAACTAGAAATAGCAAGTTAACCTAAGGCTAGTCCGT	1
TATAACGCGG	GAAACACCGGTTATATTTGTAAGTGTGTGGGGTTAGAGCTAGAAATAGCA	1
TATAACGTGG	GAAACACCGGTTATATTTGTAAGTTTGGGGTTAGAGCTAGAAATAGCACG	1
TATAATCGGC	GAAACACCGGTACCTTTGTTGATGCTGGGTGTTAGAGCTAGGTTAGAGCT	1
TATACAGAGG	GAAACACCGGTTATATTTGTAAGTGTGTGGGGTTAGAGCTAGAAATAGCA	1
TATAGCCTAA	GAAACACCGGTTAAGCCGAGGTTAGAGCTAGAAATAGCAAGTTAACCTAA	1
TATATAAGGG	GAAACACCGGTTATATTTGTAAGTGTGTGGGGTTAGAGCTAGAAATAGCA	1
TATATAGCGG	GAAACACCGGTTATATTTGTAAGTGTGTGGGGTTAGAGCTAGAAATAGCA	1
TATATCGCAG	GAAACACCGGTTATATTTGTAAGTGTGGGGTTAGAGCTAGAAATAGCAAG	1
TATATTCGGT	GAAACACCGGTCGATTCATATCGAAACCTTCCCGTGACAGTGGGGTTAGA	1
TATCGTATTT	GAAACACCGGTTACATTGAGGGTTAGAGCTAGAAATAGCAAGTTAACCTA	1
TATCTACGGC	GAAACACCGGTCGGGGCCACTCAGTGGTGGGGGTAGAGATAGAAATAGAA	1
TATCTTACTC	GAAACACCGGTAACTATATTCATGCGATATCGCCGTTAGATATGGGGTTA	1
TATGATATGT	GAAACACCGGTTACATTGAGGGTTAGAGCTAGAAATAGCAAGTTAACCTG	1
TATGATCGTC	GAAACACCGGTGTACGTATGGACTGAACCAGGGTGTGCAAGTGGGGTTAG	1
TATGATTATC	CTTAACCTAAGGCTAGTCCGTTATCAACTTGAAAAAGTGGCACCGAGTCG	1
TATGCATCGC	GAAACACCGGTTTACGTTGCATCGGGTTAGAGCTAGAAATAGCAAGTTAA	1
TATGCTCTAC	GAAACACCGGTGCCATTACTCTCACCTGATTACTTAATCCGTGGGGTTAG	1
TATTTAAAGC	GAAACACCGGTCGGGCCACTCAGTGGTGGGGTTAGAGCTAGAAATAGCAA	1
TCAACCGGCA	GAAACACCGGTAAATTTGAGGCTCCGGCATGCAGGAGGCCGTGGGGTTAG	1
TCAATCGGGT	GAAACACCGGTCGATTCATATCGAAACCTTCCCGTGACAAGTGGGGTTAG	1
TCACAATGCC	GAAACACCGGTTTGAACTAGAAATAGCAAGTTAACCTAAGGCTAGTCCGT	1
TCACACAGCC	GAAACACCGGTTTGAACTACCTGGGGTTAGAGCTAGAAATAGCAAGTTAA	1
TCACATAGAC	GAAACACCGGTAACTATATTCATGCGATATCGCCGTGTCAGTGGGGTTAG	1
TCACGCCCTC	GAAACACCGGTGCCCTTACTCTCACCTGATTACTTAATCCGTGGGGTTAG	1
TCACTCGAGT	GAAACACCGGTTATATTGGGGTTAGAGCTAGAAATAGCAGGTTAACCTAA	1
TCACTCGGGG	GAAACACCGGTTATATTTGTAAGTGGGGTTAGAGCTAGAAATAGCAAGTT	1
TCAGACGAGC	GAAAAACCGGTCGGCGGCAATCGTGGGTGGGGTTAGAGCTAGAAATAGCA	1
TCAGTGACGT	GAAACACCGGTGTACGTATGGACTGAACCAGGGTGTGCAAGTGGGGTTAG	1
TCATCGACGT	GAAACACCGGTGTACGTATGGACTGAACCAGGGTGTGCAAGTGGGGTTAG	1
TCATCGTCGA	GAAACACCGGTGTACGTATGGACTGAACCAGGGTGTGCAAGTGGGGTTAG	1
TCATCTACCG	GAAACACCGGTCGGGGCCACTCAGTGGTGGGGTTAGAGCTAGAAATAGCA	1
TCATTACAGC	GAAACACCGGTCGGGGCCACCGGTGGGGTTAGAGCTAGAAATAGCAAGTT	1
TCATTGGAGT	GAAACACCGGTGTACGTATGGACTGAACCAGGGTGTGCAAGTGGGGTTAG	1
TCCAACGCGC	GAAACACCGGTTATATTTGTATGGGTGTGGGGTTAGAGCTAGAAATAGCA	1
TCCACTCTAT	GAAACACCGGTTATATTTGTAAGTGTGTGGGGTTAGAGCTAGAAATAGCA	1
TCCAGTGAGG	GAAACACCGGTTATATTTGTAAGTGTGTGGGGTTAGAGCTAGAAATAGCA	1
TCCATAGATG	GAAACACCGGTTATATTTGTAAGTGGGGTTAGAGCTAGAAATAGCAAGTT	1
TCCATTAAGG	GAAACACCGGTCGGGGCCACTCAGTGGTGGGGTTAGAGCTAGAAATAGCA	1
TCCCTTAACG	GAAACACCGGTCGGGGCCACTCAGTGGTGGGGTTAGAGCTAGAAATAGCA	1
TCCTATACCG	GAAACACCGGTCGGGGCCACTCAGTGGTGGGGTTAGAGCTAGAAATAGCA	1
TCCTGTACCG	GAAACACCGGTCGGGGCCACTCAGTGGTGGGGTTAGAGCTAGAAATAGCA	1
TCCTTTAACG	GAAACACCGGTCGGGGCCACTCAGTGGTGGGGTTCGAGCTAGAAATAGCA	1
TCCTTTAACG	GAAACACCGGTCGGGGCCACTCAGTGGTGGGGTTAGAGCTAGAAATAGCA	1
TCCTTTACAG	GAAACACCGGTCGGGGCCACTCAGTGGTGGGGTTGGAGCTAGAAATAGCA	1
TCCTTTAGCG	GAAGCACCGGTCGGGGCCACTCAGTGGTGGGGTTAGAGCTAGAAATAGCA	1
TCCTTTCACG	GAAGCACCGGTCGGGGCCACTCAGTGGTGGGGTTAGAGCTAGAAATAGCA	1
TCGAAACGTT	GAAACACCGGTCTCGAGTGAGGTGTTCAGGTGGGGTTAGAGCTAGAAATA	1
TCGAATACTT	GAAACACCGGTCTCGAGTGAGGTGTTCAGGGTGGGGTTAGAGCTAGAAAT	3
TCGAATCATT	GAAACACCGGTCTCGAGTGAGGTGTTCAGGGTGGGGTTAGAGCTAGAAAT	2
TCGAGCTTCA	GAAACACCGGTTCAGCCGAGTGGGGTTAGAGCTAGAAATAGCAAGTTAAC	1
TCGAGGCCTA	GAAACACCGGTCTCGAGTGAGGTGTTCAGGGTGGGGTTAGAGCTAGAAAT	1
TCGAGTGAGG	GAAACACCGGTTATATTTGTAAGTGTTGTGGGGTTAGAGCTAGAAATAGC	1
TCGAGTTGTG	GAAACACCGGTGACATTGGGTATGGGGTTAGAGCTAGAAATAGCAAGTTA	1
TCGATAGCGG	GAAACACCGGTTATATTTGTATGTGGGGTTAGAGCTAGAAATAGCAAGTT	1
TCGATAGGGA	GAAACACCGGTTATATTTGTAAGTGTGTGGGGTTAGAGCTAGAAATAGCA	1
TCGATATTAG	GAAACACCGGTTATGTTTGGATGTGTGTGGGGTTAGAGCTAGAAATAGCA	1
TCGATTCCTT	GAAACACCGGTCTCGAGTGAGGTGTTCAGGGTGGGGTTAGAGCTAGAAAT	1
TCGCAACCTC	GAAACACCGGTCTCGAGTGAGGTGTTCAGGGTGGGGTTAGAGCTAGAAAT	1
TCGCACAAAA	GTAACACCGGTTAAGCCGATGTGCTTTTTTCCTGCAGGTTATGCTCAAGA	1
TCGCATCCTT	GAAACACCGGTCTCGAGTGAGGTGTTCAGGGTGGGGTTAGAGCTAGAAAT	1
TCGCCCTGCA	GAAACACCGGTGCATTCGAAAGTCCGGTCGTAGTGTGGACGTGGGGTTAG	4
TCGCCCTGCC	GAAACACCGGTGCATTCGAAAGTCCGGTCGTAGTGTGGACGTGGGGTTAG	1
TCGCCGTGCA	GAAACACCGGTGCATTCGAAAGTCCGGTCGTAGTGTGGACGTGGGGTTAG	1
TCGGATCCTG	GAAACACCGGTCTCGAGTGAGGTGTTCAGGGTGGGGTTAGAGCTAGAAAT	1
TCGGATCCTT	GAAACACCGGTCTCGAGTGAGGTGTTCAGGGTGGGGTTAGAGCTAGAAAT	1
TCGGGTCATT	GAAACACCGGTCTCGAGTGAGGTGTTCAGGGTGGGGTTAGAGCTAGAAAT	1
TCGGGTTGTC	GAAACACCGGTGACATTGGGTGCAGGGTGGGGTTAGAGCTAGAAATAGCA	1
TCGTGTTGCC	GAAACACCGGTGACAAGTGGGGTTAGAGCTAGAAATAGCAAGTTAACCTA	1
TCTAATCGGC	GAAACACCGGTACCTTTGTTGATGCTGGTGTGGGGTTAGAGCTAGAAATA	1
TCTACCTGCC	GAAACACCGGTAAATTTGAGGCTCCGGCATGCAGGAGGCCGTGGGGTTAG	1
TCTACTCGGA	GAAACACCGGTACCTTTGTTGATGCTGGGTGGCACCGAGTCGGTGCTTTT	1
TCTAGACGGC	GAAACACCGGTACCTTTGTTGGTGCTGGGTGGAAGGAATTTGTGGGGTTA	1
TCTAGCCTAC	GAAACACCGGTTAAGCCGAGGGTGGGGTTAGAGCTAGAAATAGCAAGTTA	1
TCTAGTTATG	GAAACACCGGTTACATTGAGATTGGGGTTAGAGCTAGAAATAGCAAGTTA	1
TCTATAGCGC	GAAACACCGGTTGTGGCTGCTCAGGGGTGAGGGTAAGGCTAGGAAAGGCA	1
TCTATCGAGG	GAAACACCGGTTATATTTGTAAGTGTGTGGGGTTAGAGCTAGAAATAGCA	1370
TCTATCGAGG	GAAACACCGGTTATATTTGTAAGTGGGGTTAGAGCTAGAAATAGCAAGTT	190
TCTATCGAGG	GAAACACCGGTTATATTTGTAAGTGTTGTGGGGTTAGAGCTAGAAATAGC	141
TCTATCGAGG	GAAACACCGGTTATATTTGTAAGTGCTTTTTTTCCTGCAGGCCTCGATAG	100
TCTATCGAGG	GAAACACCGGTTATATTTGTAAGTGTTTGTGGGGTTAGAGCTAGAAATAG	62
TCTATCGAGG	GAAACACCGGTTATATTTGTAGTGGGGTTAGAGCTAGAAATAGCAAGTTA	61
TCTATCGAGG	GAAACACCGGTTATATTTGTAAGTGTGGGGTTAGAGCTAGAAATAGCAAG	38
TCTATCGAGG	GAAACACCGGTTATATTGGGGTTAGAGCTAGAAATAGCAAGTTAACCTAA	37
TCTATCGAGG	AAACAACTTGAAAAAGTGGCACCGAGTCGGTGCTTTTTTTCCTGCAGGCC	30
TCTATCGAGG	GAAACACCGGTTAAGAAATAGCAAGTTAACCTAAGGCTAGTCCGTTATCA	29
TCTATCGAGG	GAAACACCGGTTATGTGGGGTTAGAGCTAGAAATAGCAAGTTAACCTAAG	28
TCTATCGAGG	CAATCCTAGCAAGTTAACCTAAGGCTAGTCCGTTATCAACTTGAAAAAGT	27
TCTATCGAGG	GAAACACCGGTTATATTTGTAAGTGTTTAGAGCTAGAAATAGCAAGTTAA	27
TCTATCGAGG	GAAACACCGGGTTAGAGCTAGAAATAGCAAGTTAACCTAAGGCTAGTCCG	26
TCTATCGAGG	GAAACACCGGTTATATTTGTAAGTAGAGCTAGAAATAGCAAGTTAACCTA	25
TCTATCGAGG	GAAACTAAGGCTAGTCCGTTATCAACTTGAAAAAGTGGCACCGAGTCGGT	25
TCTATCGAGG	GAAACACCGGTTATATTTGTGGGTTAGAGCTAGAAATAGCAAGTTAACCT	22
TCTATCGAGG	GAAACAAGTTAATATATAGCAAGTTAACCTAAGGCTAGTCCGTTATCAAC	20
TCTATCGAGG	GAAACACCGGTTATATTTGTAAGGGGTTAGAGCTAGAAATAGCAAGTTAA	17
TCTATCGAGG	GAAACACCGGTTATATTTGTATTAGAGCTAGAAATAGCAAGTTAACCTAA	16
TCTATCGAGG	GAAAGGTTAGAGCTAGAAATAGCAAGTTAACCTAAGGCTAGTCCGTTATC	16
TCTATCGAGG	GAAACACCGGTTATATTTGTAATATATTTGTGGGGTTAGAGCTAGAAATA	14
TCTATCGAGG	GAAACACCGGTTATATTTGTAAGTTAACCTAAGCAAGTTAACCTAAGGCT	13
TCTATCGAGG	GAAACACCGGTTATATTTGTATTGTACCGGTTATATATTGTGGGGTTAGA	13
TCTATCGAGG	GAAACACCGGTTATATTTGTAAGTGTTTTGTGGGGTTAGAGCTAGAAATA	12
TCTATCGAGG	GAAACACCGGTTATATTTGTAAGTGTTTTTGTGGGGTTAGAGCTAGAAAT	11
TCTATCGAGG	AAACAACTTGAAAAAGTAGCACCGAGTCGGTGCTTTTTTTCCTGCAGGCC	9
TCTATCGAGG	GAAACACCGGTTATATTTGTAAGTTTGGGGTTAGAGCTAGAAATAGCAAG	9
TCTATCGAGG	GAAACACCGGTTATATTTGTATGGGGTTAGAGCTAGAAATAGCAAGTTAA	9
TCTATCGAGG	GAAACACGGGTTGTGGGGTTAGAGCTAGAAATAGCAAGTTAACCTAAGGC	9
TCTATCGAGG	GAAACACCGGTTATATTAGAGCTAGAAATAGCAAGTTAACCTAAGGCTAG	7
TCTATCGAGG	GAAACACCAGTTATATTAGAGCTAGAAATAGCAAGTTAACCTAAGGCTAG	5
TCTATCGAGG	GAAACACCGGTTATATTTGTAAGTGTTATATTTGTAAGTGGGGTTAGAGC	5
TCTATCGAGG	CAAAACACCGGTTATATTTGTAAGTGTGTGGGGTTAGAGCTAGAAATAGC	3
TCTATCGAGG	GAAACACCGGTTATATTTGTAAAAAGTGGGGTTAGAGCTAGAAATAGCAA	3
TCTATCGAGG	GAAACACCGGCTATATTTGTAAGTGTTATATTTGTAAGTGGGGTTAGAGC	2
TCTATCGAGG	GAAACACCGGTCCGTAGGAGACCCGTGTGGCATGTACCTGTGGGGTTAGA	2
TCTATCGAGG	GAAACACCGGTGCATTCGAAAGTCCGGTCGTAGTGTGGACGTGGGGTTAG	2
TCTATCGAGG	GAAACACCGGTTAAGCCGAGGAGTTAGAGCTAGAAATAGCAAGTTAACCT	2
TCTATCGAGG	GAAACACCGGTTATATTGTAAGTGTGTGGGGTTAGAGCTAGAAATAGCAA	2
TCTATCGAGG	GAAACACCGGTTATATTTGTAAGTGGGGTATATTTGTAAGTGGGGTTAGA	2
TCTATCGAGG	AGGAACGAAACACCGGTTATATTTGTAAGTGTTGTGGGGTTAGAGCTAGA	1
TCTATCGAGG	CAAAACACCGGTTATATTTGTAAGTGTGTGGGGTTAGAGCTAGAAATCGC	1
TCTATCGAGG	GAAACACCGGTAAATTTGAGGCTCCGGCATGCAGGAGGCCGTGGGGTTAG	1
TCTATCGAGG	GAAACACCGGTCTCGAGTGAGGTGTTCAGGGTGGGGTTAGAGCTAGAAAT	1
TCTATCGAGG	GAAACACCGGTGACATTGGGTACAGGGTGGGGTTAGAGCTAGAAATAGCA	1
TCTATCGAGG	GAAACACCGGTGTACGTATGGACTGAACCAGGGTGTGCAAGTGGGGTTAG	1
TCTATCGAGG	GAAACACCGGTGTGGCTGAGAGTCCGGCAATGGTGTGGCTGTGGGGTTAG	1
TCTATCGAGG	GAAACACCGGTGTGGCTGAGAGTCCGGCGATGGTGTGGCTGTGGGGTTAG	1
TCTATCGAGG	GAAACACCGGTTAAGCCGAGGTGGGGTTAGAGCTAGAAATAGCAAGTTAA	1
TCTATCGAGG	GAAACACCGGTTAAGGGTTAGAGCTAGAAATAGCAAGTTAACCTAAGGCT	1
TCTATCGAGG	GAAACACCGGTTATATTGGTAAGCGGGGAGTGAGGTCTAGGAAGGGCAAG	1
TCTATCGAGG	GAAACACCGGTTATATTTATAAAAAGTGGGGTTAGAGCTAGAAATAGCAA	1
TCTATCGAGG	GAAACACCGGTTATATTTGTAAGTGCTTTTTTCCTGCAGGCCTCGAAAGA	1
TCTATCGAGG	GAAACACCGGTTATATTTGTAAGTGCTTTTTTTCCTGCAGCCTCGATAGA	1
TCTATCGAGG	GAAACACCGGTTATATTTGTAAGTGTGTGGGTTAGAGCTAGAAATAGCAA	1
TCTATCGAGG	GAAACACCGGTTATATTTGTAATGGTGTCGATGTCGCGCTATACATAGCA	1
TCTATCGAGG	GAAACACCGGTTGGCTGCATTCGTGGGTGGGGCCACAGCTAGAAATATCG	1
TCTATCGAGG	GAAACACCGGTTTACGTTGCATCGGGGTTAGAGCTAGAAATAGCAAGTTA	1
TCTATCGAGG	GAAACACCGGTTTGAACTAGAAATAGCAAGTTAACCTAAGGCTAGTCCGT	1
TCTATCGAGG	GAAACACCGGTTTTGTTTTTAGGTGAGGGTAGAGATAGAAGTAGCAAGTT	1
TCTATCGAGG	GAAACGCCGGTTATATTTGTAAGTGTTATATTTGTAAGTGGGGTTAGAGC	1
TCTATCGAGG	GAACACCGGTTATATTTGTAAGTGTGTGGGGTTAGAGCTAGAAATAGCAA	1
TCTCCTCGGC	GAAACACCGGTACCTTTGTTGATGCTGGGTGGTGGGGTTAGAGCTAGAAA	1
TCTCGCGCGG	GAAACACCGGTTATATTTGTAAGTGTTTGTGGGGTTAGAGCTAGAAATAG	1
TCTCGCGTGG	GAAACACCGGTTATATTTGTAAGCGTGTGGGGTTAGAGCTAGAAATAGCA	1
TCTCTACAGG	GAAACACCGGTTATATTTGTAAGTGTGTGGGGTTAGAGCTAGAAATAGCA	1
TCTCTCCTGG	GAAACACCGGTTATATTTGTAATTGTGTATGGTTAGAGATAGCAATAACA	1
TCTCTCCTTC	GAAACACCGGTCGGGGCCACTCAGTGGTGGGGTTAGAGCTAGAAATAGCA	1
TCTCTCGGGC	GAAACACCGGTTATATTTGTAAGTGTGTGGGGTCAGAGCTAGAAATAGCA	1
TCTCTCGTAG	GAAACACCGGTTATATTTTTAAGTGTGTGTGGTTAGAGCTATAAATATCA	1
TCTCTGGCGG	GAAACACCGGTTATAATTGTAAGTGCTTTTTTTCCTCCAGGCGGCGTTAG	1
TCTGCACGGC	GAAACACCGGAACCTTTGTTGATGCTGGGTGGAAGGAATTTTGTGGGGTT	1
TCTGCACTGC	GAAACACCGGTCGGGGCCACTCAGTGGTGGGGTTAGAGCTAGAAATAGCA	1
TCTGTTGTGT	GAAACACCGGTTATATTTATAACTGTGTGGGGTTAGAGCCAGAAATAGCA	1
TCTTGTTGTC	GAAACACCGGTGTACGTATGGACTGAACCAGGGTGTGCAAGTGGGGTTAG	1
TCTTTACCTG	GAAACACCGGTCGGGGCCACTCAGTGGTGGGGTTAGAGCTAGAAATAGCA	1
TCTTTAGATC	GAAACACCGGTCGAGGCCACTCAGCCGATAGCGCAAAGTGAGAAATAGCG	1
TCTTTCGGGT	GAAACACCGGTTATATTTGTAAGTGTGTGGGGTTAGAGCTAGAAATAGCA	1
TGAACAGAGC	GAAACACCGGTGCATTCGAAAGTCCGGTCGTAGTGTGGACGTGGGGTTAG	1
TGAAGCATTA	GAAACACCGGTCTCGAGTGAGGTGTTCAGGGTGGGGTTAGAGCTAGAAAT	1
TGAAGCGCGC	GAACCTAAAACTAGTCCGTTATCAACTTGAAAAAGTGGCACCGAGTCGGT	1
TGAATCGCGG	GAAACACCGGTTATATTTGTAAGCGGGTGGGGTTAGAGCTAGAAATAGCA	1
TGAATCTTCT	GAAACACCGGTCTCGAGCGAGGTGTTCTGCTGGCGGTTATAGCTAGATAT	1
TGACAAAGAC	GAAGCACCGGTAGCAAGTGGGGTTAGAGCTAGAAATAGCAAGTTAACCTA	1
TGACACAGGC	GAAACACCGGTAGCAAGTGCGAGACGTGTTAAATAGCAAGTTAACCTAAG	1
TGACGCTGGC	GAAACACCGGTGCATTCGAAAGTCCGGTCGTAGTGTGGACGTGGGGTTAG	1
TGAGACGTTT	GAAACACCGGTCTCGAGTGAGGCGTTCAGGGGGGGGTTAGAGCTAGAAAT	1
TGAGCCATGA	GAAACACCGGTTACAATTGGGGTTAGAGCTAGAAATAGCAAGTTAACCTA	1
TGAGCGATGC	GAAACACCGGTTACATTGAGGGGTTAGAGCTAGAAATGGCAAGTTAACCT	1
TGAGCGATGG	GAAACACCGGTTACATTGAGGGTTAGAGCTAGAAATAGCAAGTTAACCTA	1
TGAGCGTTGT	GAAACACCGGTTACATTGAGGGTTAGAGCTAGAGATAGCAAGTTAACCTA	1
TGAGCTGACT	GAAACACCGGGGTGGGGTTAGAGCTAGAAATAGCAAGTTAACCTAAGGCT	1
TGAGGAGCAT	GAAACACCGGTTCCCGTCCAGTGGGGTTAGAGCTAGAAATAGCAAGTTAA	1
TGAGTTGGAT	GAAACACCGGTGACATTGGGTACAGGGGGGGGGTTAGAGCTAGAAATAGC	1
TGCACGGGTC	GAAACACCGGTCCGTAGGAGACCCGTGTGGCATGTACCTGTGGGGTTAGA	1
TGCATCCCTG	GAAACACCGGTCCGTAGGAGATCCGTGTGGCATGTACCTGAGGAGGTTGA	1
TGCCACACTG	GAAACACCGGTCCGTAGGAGACCCGTGTGGCATGTACCTGTGGGGTTAGA	1
TGCCACAGAG	GAAACACCGGTAGCAAGTGCGAGACGTGTTTTGTGAGATTAGAGCTAAGC	1
TGCCCAGCGC	GAAACACCGGTGCATTCGAACTTCCGGTGGTAGTGGGGACGTGAGGATAG	1
TGCCCCTAGC	GAAACACCGGTGCATTCGAAAGTCCGGTCGTAGTGTGGACGTGGGGTTAG	1
TGCCTCGACA	GAAACACCGGTAAATTTGAGGCACCGGCATGCAGGAGGCCGTGGGGTTAG	1
TGCGCCATCC	GAAACACCGGTTACATTGAGGGGCTAGAGCTAGAAATAGCAAGTTAACAT	1
TGCGCCTTAC	GAAACACCGGTGCCCTTACTCTCACCTGATTACTTAATCCGTGGGGTTAG	1
TGCTGTACCA	GAAACACCGGTTCCCGTCCAGCGGGGTTAGAGCTAGAAATAGCAAGTTAA	1
TGGACCATAC	GAAACACCGGTAAATTTGAGGCTCCGGCATGCAGGAGGCCGTGGGGTTAG	1
TGGACCATAT	GAAACACCGGTTAAGCCGAGGAGTTAGAGCTAGAAATAGCAAGTTAACCT	1
TGGACCCGCA	GAAACACCGGTATAGCTTAGTGTCCGTCAATGGTGTGTCTAGCTGGTTAG	1
TGGAGAACAA	GAAACACCGGTTAAGCCGAGGGGGGTTAGAGCTAGAAATAGCAAGTTAAC	1
TGGAGCGTAC	GAAACACCGGTTAAGTAGAGCTAGAAATAGCAAGTTAACCTAAGGCTAGT	1
TGGATTATCC	GAAACACCGGTAACTATATTCATGCGATATCGCCGGAGCAGTAGTGTTAG	1
TGGCACCGTC	GAAACACCGGTGTGGCTGAGAGTCCGGCAATGGTGTGGCTGTGGGGTTAG	1
TGGCCCCTAT	GAAACACCGGTAAATTTGAGGCTCCGGCATGCAGGAGGCCGTGGGGTTAG	1
TGGGATGTAT	GAAACACCGGTGACATTGGGATGGGGTTAGAGCTAGAAATAGCAAGTTAA	1
TGTAGAGAAG	GAAACACCGGTTATATTTGTAAGTGTGTGGGGTTAGAGCTAGAAATAGCA	1
TGTAGCATAC	GAAACACCGGCTAAGCCGAGGAGTTAGAGCTAGAAATAGCAAGTTAACCT	1
TGTAGGGCCG	GAAACACCGGTCGGCGGTGGGGTTAGAGCTAGAAATAGCAAGTTAACCTA	1
TGTATAGTGG	GAAACACCGGTTATCTTTGTATGCGGGTGTGGTTAGGGCTAGAAGTAGCA	1
TGTCAGCATA	GAAACACCGGTTAAGCCGAGGGGTTAGAGCTAGAAATAGCAAGTTAACCT	1
TGTCTGATTA	GAAACACCGGTTCGTAGGAGACCCGTGAGGCATGTTAAGGGTTAGAGCTA	1
TGTCTGTGTA	GAAACACCGGTCCGTGGAAGACCCGTGTGGCATGTACCTGTGGGGTTAGT	1
TGTGCGCATA	GAAACACCGGTTAAGCCGAGTGGGGTTAGAGCTAGAAATAGCAAGTTAAC	1
TGTGGAGACT	GAAACACCGGTGACATTGGGTACATTGGGTACATTGGGTGGGGGTAGAGC	1
TGTGGAGCGT	GAAACACCGGTTCCCGTCCAGTGGGGTTAGAGCTAGAAATAGCAAGTTAA	1
TGTGGAGTCT	GAAACACCGGTTCCCGTCCAGTGGGGTTAGAGCTAGAAATAGCAAGTTAA	1
TGTGTAGTCA	GAAACACCGGTGACATTGGGTACAGGGTGGGGTTAGAGCTAGAAATAGCA	1
TGTGTTGTAA	GAAACACCGGTTACGTTGGGGACAGGGTGGGGTTAGAGCTAGAAATAGCA	1
TGTTGACCGC	GAAACACCGGTCGGGGCCACTCAGTGGTGGGGTTAGAGCTAGAAATAGCT	1
TGTTTACAGC	GAAACACCGGTCGGGGCCACTCAGTGGTGGGGTTAGAGCTAGAAATAGCA	1
TGTTTACGGC	AGTCTGTTAGAACTTGTAAAAGCGGCACCGAGTTGGTGGTTTTTTTCCTG	1
TTAACCATGC	GAAACACCGGTTAGGTTGAGGGTTAGGGCTTGATGTGGCAGGTTAGCTTA	1
TTAACGTATA	GAAACACCGGTAACTATATTCATGCGATATCACCGTATCAGTGGGGTTAG	1
TTAACTTTTA	GAAACACCGGTAACTATATTCATGCGATATCGCCGTATCAGTGGGGTTAG	1
TTAAGTATGC	GAAACACCGGTTAAGCCGAGGAGTGGGGTTAGAGCTAGAAATAGCAAGTT	1
TTAATCGTAC	GAAACACCGGTACCTTTGTTGATGCTGGTGTGGGGTTAGAGCTAGAAATA	1
TTACCCATGG	GAAACACCGGTTACATTGAGGGTTAGAGCTAGAAATAGCAAGTTAACCTA	1
TTACGATGGA	GAAACAACGGTACCTTTGTTGATGCTGGGTGGGGATAGAGCTAGAAATAG	1
TTACGCGGGC	GAAACACCGGTACCTTTGTTGATGCTGGGTGGGGTTAGAGCTAGAAATAG	1
TTACGCGGGC	GAAACACCGGTACCTTTGTTGATGCTGGGTGGAAGGAATTTGTGGGGTTA	1
TTAGATCGGT	GAAACACCGGTTACATTGAGGGTTAGAGCTAGAAATAGCAAGTTAACCTA	1
TTAGATCTGC	GAAACACCGGCTACATTGAGGGGTTAGAGCTAGAAATAGCAGGTTAACCT	1
TTAGATGCGT	GAAACACCGGTTACATTGAGGGGTTAGAGCTAGAAATAGCAAGTTAACCT	1
TTAGATGTGC	GAGTTGGGGTTAGAGCTAGAAATAGCAAGTTAACCTAAGGCCAGTCCGTT	1
TTAGCCAAGG	GAAACACCGGTTACAGGGGTTAGAGCTAGAAATAGCAAGTTAACCTAAGG	1
TTAGCCGAGT	GAAACACCGGTTACATTGTGATTAGAGCTAGACAAGGCAAGTCCGTTATA	1
TTAGCGATTA	GAAACACCGGTTACTCGTTGATTCGTTCTAGAGCTAGTAATACTAAGATA	1
TTAGCTATGT	GAAACACCGGTTACATTGAGGGTTAGAGCTAGAAATAGCAAGTTAACCTA	1404
TTAGCTATGT	GAAACACCGGTTACATTGAGGGGTTAGAGCTAGAAATAGCAAGTTAACCT	557
TTAGCTATGT	GAAACACCGGTTACATTGAGATTAGAGCTAGAAAAGGCTAGTCCGTTATC	226
TTAGCTATGT	GAAACACCGGTTACATTGAGATTGGGGTTAGAGCTAGAAATAGCAAGTTA	177
TTAGCTATGT	GAAACACCGGTTACATTGAGTGGGGTTAGAGCTAGAAATAGCAAGTTAAC	141
TTAGCTATGT	AGCTAGAAATAGCAAGTTAACCTAAGGCTAGTCCGTTATCAACTTGAAAA	40
TTAGCTATGT	GAAACACCGGTTACATTTGAGGGGTTAGAGCTAGAAATAGCAAGTTAACC	32
TTAGCTATGT	GAAACACCGAGCTAGAAATAGCAAGTTAACCTAAGGCTAGTCCGTTATCA	27
TTAGCTATGT	GAAACACCGGTTAAGGGTTAGAGCTAGAAATAGCAAGTTAACCTAAGGCT	22
TTAGCTATGT	GTGAGGGGTTAGAGCTAGAAATAGCAAGTTAACCTAAGGCTAGTCCGTTA	22
TTAGCTATGT	GGAGCTAGAAATAGCAAGTTAACCTAAGGCTAGTCCGTTATCAACTTGAA	21
TTAGCTATGT	GAAACACCGGTTACATTGAAGGGGTTAGAGCTAGAAATAGCAAGTTAACC	20
TTAGCTATGT	GAAACACCGGTTAGAGCTAGAAATAGCAAGTTAACCTAAGGCTAGTCCGT	20
TTAGCTATGT	GAAACACCGGTTATTTGAGGGTTAGAGCTAGAAATAGCAAGTTAACCTAA	19
TTAGCTATGT	GAAACACCGGTTACCATGGGGTTAGAGCTAGAAATAGCAAGTTAACCTAA	18
TTAGCTATGT	GAACACCGGTTACATTGAGATTGGGGTTAGAGCTAGAAATAGCAAGTTAA	17
TTAGCTATGT	GGGTAGAGCTAGAAATAGCAAGTTAACCTAAGGCTAGTCCGTTATCAACT	17
TTAGCTATGT	GAAACACCGGTTACAGGGGTTAGAGCTAGAAATAGCAAGTTAACCTAAGG	16
TTAGCTATGT	GAGTTGGGGTTAGAGCTAGAAATAGCAAGTTAACCTAAGGCTAGTCCGTT	15
TTAGCTATGT	GAAACACCGTGAGGGGTTAGAGCTAGAAATAGCAAGTTAACCTAAGGCTA	14
TTAGCTATGT	GAAACACCGGATTGGGGTTAGAGCTAGAAATAGCAAGTTAACCTAAGGCT	13
TTAGCTATGT	GAAAGGGGTTAGAGCTAGAAGTAGCAAGTTAACCTAAGGCTAGTCCGTTA	13
TTAGCTATGT	GAAAGGGGTTAGAGCTAGAAATAGCAAGTTAACCTAAGGCTAGTCCGTTA	12
TTAGCTATGT	GAAACACCGGTTACATTGAGATCTCTTTGTGGGGTTAGAGCTAGAAATAG	11
TTAGCTATGT	GGGGGGTTAGAGCTAGAAATAGCAAGTTAACCTAAGGCTAGTCCGTTATC	11
TTAGCTATGT	GGGTTAGAGCTAGAAATAGCAAGTTAACCTAAGGCTAGTCCGTTATCAAC	9
TTAGCTATGT	GAAACACCGGTTACATTGGGGTTAGAGCTAGAAATAGCAAGTTAACCTAA	8
TTAGCTATGT	GAACCGGGGTTAGAGCTAGAAATAGCAAGTTAACCTAAGGCTAGTCCGTT	5
TTAGCTATGT	AAAGGACGAAACACCGGTTAGAGCTAGAAATAGCAAGTTAACCTAAGGCT	3
TTAGCTATGT	CAAAACACCGGTTACATTGAGGGTTAGAGCTAGAAATAGCAAGTTAACCT	3
TTAGCTATGT	GAAACACCGGTTATTTGAGGGTTAGAGCTAGAAATAGCAAGTTATCCTAA	3
TTAGCTATGT	GAAACACCGGTTTACGTTGCATCGGTGTGGGGTTAGAGCTAGAAATAGCA	2
TTAGCTATGT	AGCTAGAAATAGCAAGTTAACCTAGGCTAGTCCGTTATCAACTTGAAAAA	1
TTAGCTATGT	AGGGTCGAAACACCGGTTACATTGAGGGTTAGAGCTAGAAATAGCAAGTT	1
TTAGCTATGT	CAAAACACCGGTTACATTGAGTGGGGTTAGAGCTAGAAATAGCAAGTTAA	1
TTAGCTATGT	CAAAACACGGGTAAAATTGAGTTTGGACTTAGAAAGGCCTGGCCGTTTAC	1
TTAGCTATGT	GAAACACCGGTAAATTTGAGGCTCCGGCATGCAGGAGGCCGTGGGGTTAG	1
TTAGCTATGT	GAAACACCGGTACATTGAGAGTTATAGCTAGAATTAACATGTTAACCTAA	1
TTAGCTATGT	GAAACACCGGTACCTTTGTTGATGCTGGGTGGAAGGAATTTTGTGGGGTT	1
TTAGCTATGT	GAAACACCGGTCCGTAGGAAACCCGTGTGGCATGTACCTGTGGGGTTAGA	1
TTAGCTATGT	GAAACACCGGTCGGGGCCACTCAGTGGTGGGGTTAGAGCTAGAAATAGCA	1
TTAGCTATGT	GAAACACCGGTGCATTCGAAAGTCCGGTCGTAGTGTGGACGTGGGGTTAG	1
TTAGCTATGT	GAAACACCGGTGCCCTTACTCTCACCTGATCACTTAATCCGTGGGGTTAG	1
TTAGCTATGT	GAAACACCGGTGCCCTTACTCTCACCTGATTACTTAATCCGTGGGGTTAG	1
TTAGCTATGT	GAAACACCGGTTAAAATTGAGGGGTAGAACGAGGAATAACAAGTTAACAT	1
TTAGCTATGT	GAAACACCGGTTACATGAGATTAGAGCTAGAAAAGGCTAGTCCGTTATCA	1
TTAGCTATGT	GAAACACCGGTTACATTGAGATTAGAGCTAGAAAGGCTAGTCCGTTATCA	1
TTAGCTATGT	GAAACACCGGTTACATTGAGGGTAAAACCAAGAAATACAAGGTAACCCAA	1
TTAGCTATGT	GAAACACCGGTTACATTTGAGGGTTAGAGCTAGAATAGCAAGTTAACCTA	1
TTAGCTATGT	GAAACACCGGTTACTTTGAGGCGCTAGCATTCAGGATGGCAAGGTAACCT	1
TTAGCTATGT	GAAACACCGGTTATATTGAGGGTTAGAGCTAGATATAGCTAGATATACTA	1
TTAGCTATGT	GAAACACCGGTTCCCGTCCAGTGGGGTTAGAGCTAGAAATAGCAAGTTAA	1
TTAGCTATGT	GAAACACCGGTTCCCTTAATCGCACCTGATTACTTAATGCGTGGGGTTAG	1
TTAGCTATGT	GACACACCTGTTACATTGAGGGGTTCGAGCTAGCAATCGCACGTTCACCT	1
TTAGCTATGT	GGGGGATAGATTTAGAAATAGCAAGTTAACCTAATTCTAGTCCGGTATAA	1
TTAGCTATGT	GGGGGTTAGAGCTAGAAATAGCAAGTTAACCTAAGGCTAGTCCGTTATCA	1
TTAGCTCAGA	GAAACACCGGTTACATTGAGGGGTTAGAGCTAGAAATAGCAAGTTAACCT	1
TTAGGCACAA	GAAACACCGGTTAAGCCGAGGAGTTAATTAGAGCTAGAAATAGCAAGTTA	1
TTATATAGGT	GAAACACCGGTTACATTGAGGGTTAGAGCTAGAAATAGCAAGTTAACCTA	1
TTATCAACGC	GAAACACCGGTTACATTGAGGGTTAGAGCTAGAAATAGCAAGTTAACCTA	1
TTATCCGCCG	GAAACACCGGTAACTTTTTTGATGCTGGGTGGATAGGACTTGGGACACCT	1
TTATCGATGA	GAAACACCGGTCGGGGCCACTCAGTGGTGGGGTTCTAGCTAGAAATAGCA	1
TTATCGTCGT	GAAACACCGGTGTACGTATGGCCTGAACCAGGGTGTGCAAGTGGGGTTAG	1
TTATTGGTCC	GAAACACCGGTACGTTTGTTGGTGCTGTACGGAAGTAATTTGGTGGGGAT	1
TTCAATAGTG	GAAACACCGGTTATATTTGTAAGTGTGTGGGGTTAGAGCTAGAAATAGCA	1
TTCATCGTAA	GAAACACCGGTTAAGCCGAGTGGGGTTAGAGCTAGAAATAGCAAGTTAAC	1
TTCATTATCC	GAAACACCGGTAACTATATTCATGCGATATCGCCGTATCAGTGGGGTTAG	1
TTCGACCTCT	GAAACACCGGTTACCATTGAGGTTCGAGGTGGATATAGCTAGGTAACTAA	1
TTCTATCGCG	GAAACACCGGTTATATTTGTAAGTGGGGTTAGAGCTAGAAATAGCAAGTT	1
TTCTCTATGC	GAAACACCGGTTACATTGAGGGTTAGAGCTAGAAATAGCAAGTTAACCTA	1
TTCTTGAACG	GAAACACCGGTCGGGGCCACTCAGTGGTGGAGTTAGAGCTAGAAATAGCA	1
TTGACTATGA	GAAACACCGGTTACGCCGAGGAGTTAGAGCTAGAAATAGCAAGTTAACCT	1
TTGAGCATAA	GAAACACCGGTTAAGCCGAGGAGTTAGAGCTAGAAATAGCAAGTTAACCT	1147
TTGAGCATAA	GAAACACCGGTTAAGCCGAGTGGGGTTAGAGCTAGAAATAGCAAGTTAAC	684
TTGAGCATAA	GAAACACCGGTTAAGCCGATGTGCTTTTTTCCTGCAGGTTATGCTCAAGA	221
TTGAGCATAA	GAAACACCGGTTAAGCCGAGGTGGGGTTAGAGCTAGAAATAGCAAGTTAA	216
TTGAGCATAA	GAAACACCGGTTAAGCCGAGGTTAGAGCTAGAAATAGCAAGTTAACCTAA	189
TTGAGCATAA	GAAACACCGGTTAAGCCGAGGGTTAGAGCTAGAAATAGCAAGTTAACCTA	89
TTGAGCATAA	GAAACACCGGTTCGGTGCTTTTTTCCTGCAGGTTATGCTCAAGAATTCGG	78
TTGAGCATAA	GAAACACCGGTTAGAGCTAGAAATAGCAAGTTAACCTAAGGCTAGTCCGT	68
TTGAGCATAA	GAAACACCGGTTAAGCCGAGGAGTTTCGTTAGAGCTAGAAATAGCAAGTT	67
TTGAGCATAA	GAAACACCGGTTAAGCCGAGGATTAGAGCTAGAAATAGCAAGTTAACCTA	37
TTGAGCATAA	GAAACACCGGTTAAGCCGAGGAGTGGGGTTAGAGCTAGAAATAGCAAGTT	36
TTGAGCATAA	GAAACACCGGTTAAGTGGGGTTAGAGCTAGAAATAGCAAGTTAACCTAAG	36
TTGAGCATAA	GAAACACCGGTTAAGCCGAGGGTGGGGTTAGAGCTAGAAATAGCAAGTTA	30
TTGAGCATAA	GAAACACCGGTTAAGCCGAGGATGGGGTTAGAGCTAGAAATAGCAAGTTA	27
TTGAGCATAA	GAAACACCGGTTAAGTAGAGCTAGAAATAGCAAGTTAACCTAAGGCTAGT	27
TTGAGCATAA	GAAACACCGGTTACGTGGGGTTAGAGCTAGAAATAGCAAGTTAACCTAAG	24
TTGAGCATAA	GAAACACCGGTTAGTGGGGTTAGAGCTAGAAATAGCAAGTTAACCTAAGG	17
TTGAGCATAA	GAAACACCGGTTAAGCCGAGAGCTAGAAATAGCAAGTTAACCTAAGGCTA	14
TTGAGCATAA	GAAACACCGGTTAAGCCGAGGAGTTAATTAGAGCTAGAAATAGCAAGTTA	14
TTGAGCATAA	GAAACACCGGTTAAGCCGAGGAAAAAAAAAAGTGGGGTTAGAGCTAGAAA	11
TTGAGCATAA	GAAACACCGGTTAAGCCGAGGAGGTTAGAGCTAGAAATAGCAAGTTAACC	10
TTGAGCATAA	GAAACACCGGTAGTGGGGTTAGAGCTAGAAATAGCAAGTTAACCTAAGGC	8
TTGAGCATAA	GAAACACCGGTTAAGCCGAGGAAAAAAAAAGTGGGGTTAGAGCTAGAAAT	8
TTGAGCATAA	GAAACACCGGTTAAGTAGAGCTAGAAATAGCGAGTTAACCTAAGGCTAGT	6
TTGAGCATAA	GAAACACCGGTTAAGCCGAATAAGCTAGAAATAGCAAGTTAACCTAAGGC	5
TTGAGCATAA	GAAACACCGGTTAAGCCGAGGTTAACCGGCTTAACCGGTGGGGTTAGAGC	4
TTGAGCATAA	CAAAACACCGGTTAAGCCGAGGAGTTAGAGCTAGAAATAGCAAGTTAACC	2
TTGAGCATAA	CAAAACACCGGTTAAGCCGAGGTTAGAGCTAGAAATAGCAAGTTAACCTA	2
TTGAGCATAA	GAAACACCGGTCCGTAGGAGACCCGTGTGGCATGTACCTGTGGGGTTAGA	2
TTGAGCATAA	GAAACACCGGTTAAGCCGAGGAGTTAGAGCTAGAATAGCAAGTTAACCTA	2
TTGAGCATAA	AGAGGTCGAAACACCGGTTAAGCCGAGGAGTTAGAGCTAGAAATAGCAAG	1
TTGAGCATAA	CAAAACACCGGTTAAGCCGAGGGGTTAGAGCTAGAAATAGCAAGTTAACC	1
TTGAGCATAA	CAAAACACCGGTTAAGCCGAGGGTTTAGAGCTAGAAATAGCAAGTTAACC	1
TTGAGCATAA	CAAAACACCGGTTAAGCCGAGGTTGGAGCTAGAAATAGCAAGTTAACCTA	1
TTGAGCATAA	CAAAACACCGGTTAGTGGGGTTAGAGCTAGAAATAGCAAGTTAACCTAAG	1
TTGAGCATAA	CCAAACACCGGTTAAGCCGAGGAGTTAGAGCTAGAAATAGCAAGTTAACC	1
TTGAGCATAA	CCAAACACCGGTTAAGCTAGAAATAGCAAGTTAACCTACGGCTAGTCCGT	1
TTGAGCATAA	GAAAAACGGGTAATCAGAGTGGGGTTAGCGCTAGAAATAGCCGGTTAACC	1
TTGAGCATAA	GAAACACCGGTAACTATATGCTTAGAATAAGACATTGTAAGTTAGCCTAG	1
TTGAGCATAA	GAAACACCGGTAAGCCGAGGAGTTAGAGCTAGAAATAGCAAGTTAACCTA	1
TTGAGCATAA	GAAACACCGGTAAGCCGAGTGGGGTTAGAGCTAGAAATAGCAAGTTAACC	1
TTGAGCATAA	GAAACACCGGTACCTTTGTTGATGCTGGGTGGAAGGAGTGGGGTTAGAGC	1
TTGAGCATAA	GAAACACCGGTCAAGCCGATGTGCTTTTTTCCCTGCAGGTTATGCTCAAG	1
TTGAGCATAA	GAAACACCGGTCCGTAGGAGACCCGTGTGGCATGTACCTGTGGGGTCAGA	1
TTGAGCATAA	GAAACACCGGTCCGTAGGAGACCCGTGTGGCATGTACCTTGTGGGGTTAG	1
TTGAGCATAA	GAAACACCGGTCGGCGGCAATCGTGGGTGGGGTTAGAGCTAGAAATAGCA	1
TTGAGCATAA	GAAACACCGGTCGGGGCCACTCAGTGGTGGGGTTAGAGCTAGAAATAGCA	1
TTGAGCATAA	GAAACACCGGTGCATTCGAAAGTCCGGTCGTAGTGTGGACGTGGGGTTAG	1
TTGAGCATAA	GAAACACCGGTTAAATTGAGGGGTTAGAGATCGAGATAGAACGTTAAACT	1
TTGAGCATAA	GAAACACCGGTTAAGCCGAATAAGATAGAAATAGCAAGTTAACCTAAGGC	1
TTGAGCATAA	GAAACACCGGTTAAGCCGAGGAAAAAAAAAAAGTGGGGTTAGAGCTAGAA	1
TTGAGCATAA	GAAACACCGGTTAAGCCGAGGCGGCGTTAGAGCTTGGAGCAGCAAGTTGA	1
TTGAGCATAA	GAAACACCGGTTAAGCCGAGGTTAACAGGCTTAACCGGTGGGGTTAGAGC	1
TTGAGCATAA	GAAACACCGGTTAAGCCGAGTGGGGTTAGGTAGAGAAATCGCGAGGTAAC	1
TTGAGCATAA	GAAACACCGGTTAAGCCGCGGGGTTAGAGCTAGTAGTACAGAGTTAACAT	1
TTGAGCATAA	GAAACACCGGTTAAGCCGCGGTTACAGCTAGAATAAGCATGTTAACCTCA	1
TTGAGCATAA	GAAACACCGGTTAGGCCGAGGATGGGTTTAGATCTAGATATAACAAGTTC	1
TTGAGCATAA	GAAACACCGGTTATATTTGTATGTGGGGTTAGAGCTAGAAATAGCAAGTT	1
TTGAGCATAA	GAAACACCGGTTCCCCTCCAGGGGGGGTACTGGTAGTAATAGCAAGATAA	1
TTGAGCATAA	GAAACACCGGTTCCCGTCCAGTGGGGTTAGAGCTAGAAATAGCAAGTTAA	1
TTGAGCATAA	GAAACACCGGTTCCCGTCCAGTGGGGTTAGAGCTGGAAATAGCAAGTTAA	1
TTGAGCATAA	GAAACACCGGTTTACGTTGCATCTAACCCCATCGTTGTGGGGTTAGAGCT	1
TTGAGCATAA	GAAACACCGGTTTGAACTACCGGGGTTAGAGCTAGAAATAGCAAGTTAAC	1
TTGAGCATAA	GAAACACGGTTTAGGCGAGGTGGGGTAAAACCTGGAATAACCAGGTTACC	1
TTGAGCATAA	GAAACATCGGTAGCAAGTGCGGGTTAGAGCTAGAAATAGCAAGTTAACCT	1
TTGAGCATAA	GAAACGCCGGTTACATTTGAGGGGTTAGAGCTAGAAATAGCAAGTTAACC	1
TTGAGCATAA	GACGAAACACCGGTTAAGCCGAGGAGTTAGAGCTAGAAATAGCAAGTTAA	1
TTGAGCATAA	GACGAAACACCGGTTAGTGGGGTTAGAGCTAGAAATAGCAAGTTAACCTA	1
TTGAGCGGCA	GAAACACCGGTTAAGCCGAGGGTTAGAGCTAGAAATAGCAAGTTAACCTA	1
TTGAGGCTCA	GAAACACCGGTTAGGCCGAGTGGGGTTAGAGCTAGAAATAGCAAGTTAAC	1
TTGAGTAGCT	GAAACACCGGTTAAGCCGAGGAGTTATAGCTAGAAATAGCAAGTTAAACT	1
TTGATATTGA	GAAACACCGGTTAAGCCGAGGTTAGAGCTAGAAATAGCAAGTTAACCTAA	1
TTGATCATTT	GAAACACCGGTTTAGCGTGAGGGGTTGAGGGAGGAGTAAGAGCTAGACCT	1
TTGATCGAGA	GAAACACCGGTTATATTTGTAGGTGTGTGGGGTTAGAGCTAGAAATAGCA	1
TTGATTATAC	GAAACACCGGTAACTATATTCATGCGATATCGCCGTATCAGTGGGGTTAG	1
TTGCAGCTTA	GAAACACCGGTTAAGGGAGACTACCCTTTCGTGTGGTTATAGCAAGTTAA	1
TTGCCCATCA	GAAACACCGGTTAAGCCGAGTGGCGTTAGAGCTAGAATTAGCAAGGTAAC	1
TTGCGAAATC	GAAACACCGGTTAAGCCGAGGAGTTAGAGATAGAAATAGCAAGTTAACCT	1
TTGCGTAGAC	GAAACACCGGTTAAGCCGAGGCGTTAGAGCTAGGAATAGCAGGTTAACCA	1
TTGCGTCCAA	GAAACACCGGTTAAGCCGAGTGGGGTTAGAGCTAGAAATAGCAAGTTAAC	1
TTGGCCATAC	GAAACACCGGTTAAGCCGCGGGGTTAGAGCTAGAAATAGCAAGTTAACCT	1
TTGGCGACGA	GAAACACCGGTTCCATTGCGGTAGTCGTTAGGTCTGAGCTTAGAATATTA	1
TTGTGCCAAA	GAAACACCGGTCGTCATCAACTCACGTGACTACTGAATACGTGTGGATAT	1
TTTAACGCGT	GAAACACCGGTTATATTTGTAAGTGTGTGGGGTTAGAGCTAGAAATAACA	1
TTTAGCCTTA	GAAACACCGGTCGTGGGGTTAGACCTAGAAATAGCAAGTTAACCTAAGGC	1
TTTAGCGTAC	GAAACACCGGTTAAGCCGAGTGGGGTTAGAGCTAGAAATAGCAAGTTAAC	1
TTTAGGCATG	GAAACACCGGTTACATTGAGGGGTTAGAGCTAGAAATAGCAAGTTAACCT	1
TTTATACTGC	GAAACACCGGTCGAGGCGACTCATTGGGCTAGATATAGCTAGAGATAGTA	1
TTTGAGCGTA	GAAACACCGGTTAAGCCGAGGAGTTAGAGCTAGAAATAGCAAGTTAACCT	1
TTTGATCATA	GAAACACCGGTTAAGCCGAGGAGTTAGAGCTAGAAATAGCAAGTTAACCT	1
TTTGCTGTGG	GAAACACCGGTTATATTGAGGGGATAGAGCTAGAAATAGCAAGAAAATCA	1
