CTCCCCTGCA	GAAACACCGGTGTGGCTGAGAGTCCGGCAATGGTGTGGCTGTGGGGTTAG	4	bc
AAACGACCTA	GAAACACCGGTGCCCTTACTCTCACCTGATTACTTAATCCGTGGGGTTAG	3	bc
ACATCGTAGT	GAAACACCGGTGTACGTATGGACTGAACCAGGGTGTGCAAGTGGGGTTAG	2	bc
AAGTCTGACT	GAAACACCGGTCCGTAGGAGACCCGTGTGGCATGTACCTGTGGGGTTAGA	2	bc
ACATAGTCGT	GAAACACCGGTGTACGTATGGACTGAACCAGGGTGTGCAAGTGGGGTTAG	2	bc
AGAACTTATA	GAAACACCGGTAACTATATTCATGCGATATCGCCGTATCAGTGGGGTTAG	2	bc
TATGATTAGC	GAAACACCGGTTTACGTTGCATCGGTGTGGGGTTAGAGCTAGAAATAGCA	2	bc
AAACGCCGTA	GAAACACCGGTGCCCTTACTCTCACCTGATTACTTAATCCGTGGGGTTAG	2	bc
AAACGCCATA	GAAACACCGGTGCCCTTACTCTCACCTGATTACTTAATCCGTGGGGTTAG	2	bc
AACTTTACCG	GAAACACCGGTCGGGGCCACTCAGTGGTGGGGTTAGAGCTAGAAATAGCA	2	bc
AGGCACACTC	GAAACACCGGTGTGGCTGAGAGTCCGGCAATGGTGTGGCTGTGGGGTTAG	2	bc
GAGACCATCG	GAAACACCGGTGCATTCGAAAGTCCGGTCGTAGTGTGGACGTGGGGTTAG	2	bc
AGTGGAGACT	GAAACACCGGTTCCCGTCCAGTGGGGTTAGAGCTAGAAATAGCAAGTTAA	2	bc
GAGACACTCG	GAAACACCGGTGCATTCGAAAGTCCGGTCGTAGTGTGGACGTGGGGTTAG	2	bc
AAACGCACTA	GAAACACCGGTGCCCTTACTCTCACCTGATTACTTAATCCGTGGGGTTAG	2	bc
TCCTTTAACG	GAAACACCGGTCGGGGCCACTCAGTGGTGGGGTTAGAGCTAGAAATAGCA	2	bc
ATAATCGGGC	GAAACACCGGTACCTTTGTTGATGCTGGGTGGAAGGAATTTGTGGGGTTA	2	bc
AGGGGAGCCT	GAAACACCGGTTCCCGTCCAGTGGGGTTAGAGCTAGAAATAGCAAGTTAA	2	bc
TAGTCTGACT	GAAACACCGGTCCGTAGGAGACCCGTGTGGCATGTACCTGTGGGGTTAGA	2	bc
ACCTTGACCG	GAAACACCGGTCGGGGCCACTCAGTGGTGGGGTTAGAGCTAGAAATAGCA	2	bc
CTGTTTAGGT	GAAACACCGGTTTACGTTGCATCGGTGTGGGGTTAGAGCTAGAAATAGCA	2	bc
AGTGGAGCAT	GAAACACCGGTTCCCGTCCAGTGGGGTTAGAGCTAGAAATAGCAAGTTAA	2	bc
GAACAACGCC	GAAACACCGGTTTGAACTAGAAATAGCAAGTTAACCTAAGGCTAGTCCGT	2	bc
GACCACTCCA	GAAACACCGGTAAATTTGAGGCTCCGGCATGCAGGAGGCCGTGGGGTTAG	2	bc
TTCGCTATTA	GAAACACCGGTTACTTGAGGGTTAGAGCTAGAAATAACAAGTTAACCTAA	1	bc
AGAATCACTT	GAAACACCGGTCTCGAGTGAGGTGTTCAGGGTGGGGTTAGAGCTAGAAAT	1	bc
ATAATTCGTT	GAAACACCGGTCTCGAGTGAGGTGTTCAGGGTGGGGTTAGAGCTAGAAAT	1	bc
CATCGTAGAG	GAAACACCGGTGTACGTATGGAATGAACCAGGGTGTGCAAGTGGGGTTAG	1	bc
GAGAATCCTT	GAAACACCGGTCTCGAGTGAGGTGTTCAGGGTGGGGTTAGAGCTAGAAAT	1	bc
CGTGATTTCG	GAAACACCGGTGACATTGGGTACGAGCTAGAGATAGCAAGTTAACCTAAG	1	bc
GAGTCAGTAA	GAAACAACGGTAGCAACGTGGGGTTAGAGCTAGAAATAGCAAGTTAACCT	1	bc
CTTTTACCTA	GAAACACCGGTCGGGGCCACTCAGTGGCGGGGGTAGAGCTAGATATAGCA	1	bc
CTTATACAGC	GAAACACCGGTCGGGGCCACTCAGTGGTGGGGTTAGAGCTAGAAATAGCA	1	bc
GGAAACCTAC	GAAACACCGGTGTGGCTGAGAGTCCGGCAATGGTGTGGCTGTGGGGTTAG	1	bc
AAGAAAGCCA	GAAACACGGGTTAGAGCTAGAAATAGCAAGTTAACCTAAGGCTAGTCCGT	1	bc
AAAGACATAC	GAAACACCGGTGCCCTTACTCTCACCTGATTACTTAATCCGTGGGGTTAG	1	bc
GATCGTACTC	GAAACACCGGTGTACGTATAGACTGAACCAGGGTGTGCAAGTAGGGTTAG	1	bc
CCTATTTCAG	GAAACACCGGTGTACGTATGGGCTGAAACTGGGTTTGGAAGTGGGGGTTA	1	bc
GGGACTCCAC	GAAACACCGGTTGGGCAGATAGTCGGGTAGTGGGGTGGGAGTGGGGTTAG	1	bc
ATTGAGAATA	GAAACACCGGTTAAGCCGAGTGGGGTTAGAGCTAGAAATAGCAAGTTAAC	1	bc
CGGATACGTT	GAAACACCGGTCTCGAGTGAGGTGTTCAGGGGGGGGTTAGAGATAGAAAT	1	bc
GCCAACACCC	GAAACACCGGTTTAGCGGAGTGTCCGGCAGTGGTATAGCTGGGGGGAGCA	1	bc
AATGGTGGTC	GAAACACCGGTATTGGGGTTAGAGCTAGAAATATCAAGTTAACCTAAGGC	1	bc
AATTCACCGC	GAAACACCGGTCGGGGCCACTCAGTGGTGGGGTTAGAGCTAGAAATAGCA	1	bc
CAATTCGGTG	GAAACACCGGTCGATTCATATCGAAACCTTCCCGTGACAGTGGGGTTAGA	1	bc
GAGTAAACTC	GAAACACCGGTTCCCGTCCAGTGGGGTTAGAGCTAGAAATAGCAAGTTAA	1	bc
CCCAACACTC	GAAACACCGGTTTGAACTACCTAGGGGGTAGTCCAAACCGGGGTTAGAAC	1	bc
GCATTTATCG	GAAACACCGGTCGGGGCCACTCAGTGGTGGGGTTAGAGCTAGAAATAGCA	1	bc
CGCGTTGTAC	GAAACACCGGTGACATTGGGTTAGAGCTAGAAATAGCAAGTTAACCTAAG	1	bc
GAGGGGGACA	GAAACACCGGTAGCAAGTGCGAAATAGCAAGTTAACCTAAGGCTAGTCCG	1	bc
AGAGCATCGA	GAAACACCGGTGTATTCGAAAGTACTGTCGTAGGGGGTACGGGGAGATAT	1	bc
AGGCCAGGGC	GAAACACCGGTGCATTCGAAAGTCCGGTCGTAGTGTGGACGTGGGGTTAG	1	bc
AAAATACTTT	GAAACACCGGTCTCGAGTGAGGTGTTCAGGGTGGGGTTAGAGCTAGAAAT	1	bc
AGTCCTGCGC	GAAACACCGGTGACATTGAAATACAGCTAGAAATATCAAGGTAAGCTAAG	1	bc
ATAACAACGC	GAAACACCGGTGCATTCGAAAGTCCGGTCGTAGTGTGGACGTGGGGTTAG	1	bc
GTCTTTACCG	GAAACACCGGTCGGGGCCACTGGGGTTAGAGCTAGAAATAGCAAGTTAAC	1	bc
ACCCAAAGCC	GAAACACCGGTTTGAACTACCGGGGTTAGAGCTAGAAATAGCAAGTTAAC	1	bc
AGGTTACCCC	GAAACACCGGTCGCGCCCGCTCAGTGGGGGGGGTATCGTTAGAAATAGCC	1	bc
TCCTTCACTG	GAAACACCGGTCGGGGCCACTCAGTGGTGGGGTTAGAGCTAGAAATAGCA	1	bc
CCTCGCTTTA	GAAACACCGGTGTACGTATGGACTGAACCAGGGTGTGCAAGTGGGGTTAG	1	bc
GGACACAGAT	GAAACACCGGTAGCAAGTGCGAGACGTGTTTAGCAAGTTAACCTAAGGCT	1	bc
CATGGTTGCT	GAAACACCGGTGAACTTGGGTACTGGGTGGGGTTAGAGCTGGAAGTAGCA	1	bc
GACAGCGCCG	GAAACACCGGTTTGCACTCAATAGTTCAAACGTGGGGTTAGAGCTGGTAA	1	bc
AAGCGCTGTC	GAAACACCGGTGACATTGGGCGTGGGGTTTGAGCTAGTAATAGCAAGTTA	1	bc
ACATTGTCGT	GAAACACCGGTGTACGTATGGACTGAACCAGGGTGTGCAAGTGGGGTTAG	1	bc
TGTGTTGATT	GAAACACCGGTGACATTGGGTACAGGCACCGAGCCGGTGCTTTTTTTCCT	1	bc
CGGCCCCTTT	GAAACACCGGTCTCGAGTGAGGTGTTCAGGGTGGGGTTAGAGCTAGAAAT	1	bc
AATATCGATG	GAAACACCGGTTATATTTGTAAGTGTGTGGGGTTAGAGCTAGAAATAGCA	1	bc
GCCAACGGTC	GAAACACCGGTTTGAACTACCTAGTTCAAGTGGGGTTAGAGCTAGAAATA	1	bc
GACCAAGCCA	GAAACACCGGTAGCAAGGGGGTTAGAGCTAGAAATAGCAAGTTAACCTAA	1	bc
GGGACACGCC	GAAACACCGGTGTGGCTGAGAGTCCGGCAATGGTGTGGCTGTGGGGTTCG	1	bc
TTGACTATGA	GAAACACGTGGGACTAGAGCTAGTAATAGCAAGATAACCTAAGGCTACTC	1	bc
ATCCCCTGCA	GAAACACCGGTGTGGCTGAGAGTCCGGCAATGGTGTGGCTGTGGGGTTAG	1	bc
ACTACTAGGC	GAAACACCGGTACCTTTGTTGATGCTGGGTGGAAGGAATGTGGGGTTAGA	1	bc
TTAGCAGTGC	GAAACACCGGTGACATGAGTTGCTAGAGCTAGAAATAGCAAGATAACCTA	1	bc
AATGGTCTAA	GAAACACCGGTGCCCTTACTCTCACCTGATTACTTAATCAGTGGGGTTAG	1	bc
AAATAGACGT	GAAACACCGGTGTACGTATGGACTGAACCAGGGTGTGCAAAGTGCGGTTA	1	bc
CACGACCTAA	GAAACACCGGTGCCCTTACTCTCACCTGATTACTTAATCCGTGGGGTTAG	1	bc
TTTGAGAATA	GAAACACCGGTTAAGCCGAGTGGGGTTAGAGCTAGAAATAGCAAGTTAAC	1	bc
AAACGACCTA	GAAACACCGGCGCCCTTACTCTCACCTGATTACTTAATCCGTGGGGTTAG	1	bc
GCTCCCTGAA	GAAACACCGGTATATTTGAGGCTCCGGCTTGCAGGAGGGTTAGAGCTAGA	1	bc
AGAATTGTTT	GAAACACCGGTCTCGTGGGAGGTGTTCAGGGGGTATTAGTACTAGAAATG	1	bc
GGCTCCTATT	GAAACACCGGTAGATTTGAGGCGCCGGCATGCCGGGAGCCGGGGGGTTAA	1	bc
TTAGGCATAT	GAAACACCGGTTACATTGAGGGTTAAAACTAGGAATTGCCAGGTAACCTA	1	bc
GAAGATTATT	GAAACACCGGTCTCGAGTGAGGTGTTCAGGGTGGGGTTAGAGCTAGAAAT	1	bc
TAGCGCAGAA	GAAACACCGGTTAAGCCGATGAGCTTTTTTCCTGCAGGTTATGCTCAAGA	1	bc
CCTAGTCGAC	GAAACACCGGTGTACGTATGGACTGAACCAGGGTGTGCAAGTGGGGTTAG	1	bc
TAGCGTCGCC	GAAACACCGGTGTACGTATGGACTGAACCAGGGTGTGCAAGTGGGGTTAG	1	bc
ATTTTTCGCT	GAAACACCGGTTGGGGTTACTTCGGGGTGGGGTTAGAGCTAGAAATAGCA	1	bc
TTGCAATGCT	GAAACACCGGTTCCCGTCCAGTGGGGTTAGAGCTAGAAATAGCAAGTTAA	1	bc
TATAGCGTCC	GAAACACCGGTTAAGCAGGGGTTAGAGCTAGAAATAGCAAGGTAACCTAA	1	bc
TGTGTCGTAC	GAAACACCGGTTAAGCCGAGGAGTTAGAGCTAGAAATAGCAAGTTAACCT	1	bc
ACTTTACGGA	GAAACACCGGTCGGGGCCACGGGTTAGAGCTAGAAATAGCAACTTAACCT	1	bc
TCTTTCCCGA	GAAACACCGGTCGGGGCCACTCAGTGGTGGGGTTAGAGCTAGAAATAGCA	1	bc
TTGGTTAGGT	GAAACACCGGTTACATTGAGGTGTTAGAGCTAGAAATAGCAAGTTAACCT	1	bc
CTAACGCCCT	GAAACACCGGTGCCCTTACTCTCACCTGATTACTTAATCCGTGGGGTTAG	1	bc
AGACCCAGAC	GAAACACCGGTAGCAAGTTAACCTAAGGCTAGTCCGTTATCAACTTGAAA	1	bc
TATATGGTGC	GAAACACCGGTAACTATATTCATGCGATATCGCCGTATCAGTGGGGTTAG	1	bc
GAGGATCCTT	GAAACACCGGTCTCGAGTGAGGTGTTCAGGGTGGGGTTAGAGCTAGAAAC	1	bc
AGCGCCGACA	GAAACACCGGTGTGGCTGAGAGTCCGGCAATGGTGTGGCTGTGGGGTTAG	1	bc
ACCTTTCCCG	GAAACACCGGTCGGGGCCACTCAGTGGTGGGGTTAGAGCTAGAAATAGCA	1	bc
GTGGATCTTA	GAAACACCGGTTCCCGTCCAGTGGGGTTAGAGCTAGAAATAGCAAGTTAA	1	bc
AAACGACATA	GAAACACCGGTGCCCTTACTCCCACCTGATTACTTAATCCGTGGGGTTAG	1	bc
TTCCCTATGC	GAAACACCGGTTACATTGAGGGATACAGCTAGAAATAGCAATTTAACCAA	1	bc
GGCGCGCCTC	GAAACACCGGTTCCCGTCCAGTGGGGTTAGAGCTAGAAATAGCTAGTTAT	1	bc
AGCATGCCTG	GAAACACCGGTCCGTAGGAGACCCGTGTGGCATGTACCTGTGGGGTTAGA	1	bc
TCATCGATGT	GAAACACCGGTTACATTGAGGGTTAGAGCTAGAAATAGCAAGTTAACCTA	1	bc
AATGCTGAGT	GAAACACCGGTTTACGTTGCATCGGTGTGGGGTTAGAGCTAGAAATAGCA	1	bc
ACGCAATGCC	GAAACACCGGTTTGAACTAGAAATAGCAAGTTAACCTAAGGCTAGTCCGT	1	bc
AGGCCCCTAT	GAAACACCGGTAAATTTGAGGCTCCGGCATGCAGGAGGCCGTGGGGTTAG	1	bc
AGGTGTTGTC	GAAACACCGGTGACGTGGGGTTAGAGCTAGAAATAGCAAGTTAACCTAAG	1	bc
ATGGAGCAGA	GAAACACCGGTTAAGCCGAGTGGGGTTAGAGCTAGAAATAGCAAGTTAAC	1	bc
CAGATACCGT	GAAACACCGGTCGGGGCCACTCAGTGGTGGGGTTAGAGCTAGAAATAGCA	1	bc
CGACGCGTTT	GAAACACCGGTCTCGAGTGAGGTGTTCAGGGTGGGGTTAGAGCTAGAAAT	1	bc
AAGACCCTTG	GAAACACCGGTGCATTCGAAAGTCCGGTCGTAGTGTGGACGTGGGGTTAG	1	bc
CTCGTGGTCC	GAAACACCGGCGTGGGGTTAGAGCTAGAAATAGCAAGTTAACCTAAGGCT	1	bc
ACTACTAGGC	GAAACACCGGTACCTTTGTTGATGCTGGGTGGGGTTAGAGCTAGAAATAG	1	bc
AAGAATCCTT	GAAACACCGGTCTCGAGTGAGGTGTTCAGGGTGGGGTTAGAGCTAGAAAT	1	bc
CCTTACTGCC	GAAACACCGGTCGGGGCCACTCAGTGGTGGGGTTAGAGCTAGAAATAGCA	1	bc
CGGAACCCTC	GAAACACCGGTCCGTAGGAGACCCGTGTGGCATGTACCTCTGTGGGGGTA	1	bc
AGTACGCCTA	GAAACACCGGTCCGTAGGAGACCCGTGTGGCATGTACCTGTGGGGTTAGA	1	bc
ACTGTCGGGT	GAAACACCGGTCGATTCATATCGAAACCTTCCCGTGACAGTGGGGTTAGA	1	bc
CATGCTCCAC	GAAACACCGGTGCCCTTACTCTCACCTGATTACTTAATCCGTGGGGTTAG	1	bc
AAGGCCATCG	GAAACACCGGTGCATTCGAAAGTCCGGTCGTAGTGTGGACGTGGGGTTAG	1	bc
TATATCTCGG	GAAACACCGGTTATATTTGTAAGTGGGTGGGGTTAGAGCTAGAAATAGCA	1	bc
ATTAGCTACG	GAAACACCGGTTACATTGAGGGGTTAGAGCTAGAAATAGCAAGTTAACCT	1	bc
ACACAACGCA	GAAACACGGGTTAGAGCTAGAAATAGCAAGTTAACCTAAGGCTAGTCCGT	1	bc
CGTCTGCTTT	GAAACACCGGTCCGTAGGAGACCCGTGTGGCATGTACCTGTGGGGTTAGA	1	bc
TAGACCTTCG	GAAACACCGGTGCATTCGAAAGTCCGGTCGTAGTGTGGACGTGGGGTTAG	1	bc
AATAGGCGTT	GAAACACCGGTGTACGTATGGACTGAACCAGGGTGTGCAAGTGGGGTTAG	1	bc
GTGCTGCGGG	GAAACACCGGTTTACGCTGCATCGGTGTGGGGTTAGAGCTAGAAATAGCA	1	bc
ACCACAGCCA	GAAACACCGGTTTGAACTACCTAGAGCTAGAAATAGCAAGTTAACCTAAG	1	bc
AAACGGCCGA	GAAACACCGGTGCCCTTACTCTCACCTGATTACTTAATCCGTGGGGTTAG	1	bc
AATACTTAGC	GAAACACCGGTTTACGTTGCATCGGTGTGGGGTTAGAGCTAGAAATAGCA	1	bc
CATGGTATCA	GAAACACCGGCGTGGGGTTAGAGCTAGAAATAGCAAGTTAACCTAAGGCT	1	bc
AGCTATAGAG	GAAACACCGGTTATATTTGTAAGTGTGTGGGGTTAGAGCTAGAAATAGCA	1	bc
AACGATTGAT	GAAACACCGGTTATATTTGTAAGTGTGTGGGGTTAGAGCTAGAAATAGCA	1	bc
AGACCTGCGA	GAAACACCGGTGCATTCGAAAGTCCGGTCGTAGTGTGGACGTGGGGTTAG	1	bc
AGTGAGCATA	GAAACACCGGTTAAGCCGTGGGGTTAGAGCTAGAAATAGCAAGTTAACCT	1	bc
CACGCTATGT	GAAACACCGGTTACATTTGAGGGTTAGAGCTAGAAATAGCAAGTTAACCT	1	bc
TCCAACGCTC	GACACCCCGGTTTGAACTACCGGGGTTAGAGCTAGAAATAGCAAGTTAAC	1	bc
ATGAATCGCT	GAAACACCGGTTTACGTTGCATCGGGGTTAGAGCTAGAAATAGCAAGTTA	1	bc
ACGTCTTGTC	GAAACACCGGTGACATTGGGTACAGGGTGGGGTTAGAGCTAGAAATAGCA	1	bc
AGGATACGTT	GAAACACCGGTCTCGAGTGAGGTGTTCAGGGTGGGGTTAGAGCTAGAAAT	1	bc
CCACGACGTC	GAAACACCGGTGTACGTATGGACTGAACCAGGGTGTGCAAGTGGGGTTAG	1	bc
ACGAATCCAT	GAAACACCGGTCTCGAGTGAGGTGTTCAGGGTGGGGTTAGAGCTAGAAAT	1	bc
AACCTTTACC	GAAACACCGGTCGGGGCCACTCAGTGGTGGGGTTGGAGCTAGAAATAGCA	1	bc
GAGACACGCG	GAAACACCGGTGCATTCGAAAGTCCGGTCGTAGTGTGGACGTGGGGTTAG	1	bc
GCGTCTGCCT	GAAACACCGGTCCGTAGGAGACCCGTGTGGCATGTACCTGTGGGGTTAGA	1	bc
ACCATTCGGG	GAAACACCGGTCAATTCATATCGAAACCTTCCCGTGACAGTGGGGTTAGA	1	bc
TCTCTCGCAG	GAAACACCGGTTATATTTGTAAGTGGGGTTAGAGCTAGAAATAGCAAGTT	1	bc
CGTGCCGTGC	GAAACACCGGTGACATTGGGTGGGGGTAGAGCTAGAAATAGCAAGTTAAC	1	bc
GGAACACCCC	GAAACACCGGTGTGGCTGAGAGTCCGGCAATGGTGTGGCTGTGGGGTTAG	1	bc
GCGTCCGGCT	GGAACACCGGTCTATGCAGCTCGATACCTTCCGGTGATAGAGGTGGTAAT	1	bc
GAGACCGACG	GAAACACCGGTGTACGTATGGACTGAACTAGGGTTTGCAAGTGGGGTTAG	1	bc
CATAGTAGAA	GAAACACCGGTGTACGTATGGACTGAACCAGGGTGTGCAAGTGGGGTTAG	1	bc
ACACAACGCA	GAAACACCGGTTTGAACTACCTAGTTCAAACCGGAGCTAGAAATAGCAAG	1	bc
AACCACGCCA	GAAACACCGGTTTGAACTACCTAGAGCTAGAAATAGCAAGTTAACCTAAG	1	bc
CCTACAGCGC	GAAACACCGGTTTGAACCGGTGGGGTTAGAGCTAGAAATAGCAAGTTAAC	1	bc
GCTCAACCGC	GAAACACCGGTCGGGGCCAGAAATAGCAAGTTAACCTAAGGCTAGTCCGA	1	bc
ATAGACGCGC	GAAACACCGGTGCATTCGAAAGTCCGGTCGTAGTGTGGACGTGGGGTTAG	1	bc
GCAGGCACGC	GAAACACCGGTCGGCGGATATCGAGGCTGGCGTTAGAGCTAGAACTAGCA	1	bc
CATAGCACCC	GAAACACCGGTTTGAAATAGAGCTAGCCAGTTAAACTACGGCTAGTCCGT	1	bc
ACCTTTATCG	GAAACACCGGTCGGGGCCACTCAGTGGTGGGGTTAGAGCTAGAAATAGCA	1	bc
CCAGTTATGT	GAAACACCGGTTACATTGTGGGTTAGAGTTAGAGATAGCAAGTTAACATT	1	bc
GAGGATACTC	GAAACACCGGTTCCCGTCCAGTGGGGTTAGAGCTAGAAATAGCAAGTTAA	1	bc
CGACGACGTT	GAAACACCGGTCTCGAGTGAGGTGTTCAGGGTGGGGTTAGAGCTAGAAAT	1	bc
ATAAACGGCA	GAAACACCGGTACCTTTGTTGATGCTGGGTGGAAGGAAGGTGCTTTTTTT	1	bc
GCATAGTCGT	GAAACACCGGTGTACGTATGGACTGAACCAGGGTGTGCAAGTGGGGTTAG	1	bc
GCGCTGAGCT	GAAACACCGGTGGCAGCAAGCTAACCCATTGCTAGGCCGGTATTAACTTG	1	bc
GATCGCCGGC	GAAACACCGGTGTACGTATGGACTGAACCAGCAAGTTAACCTAAGGCTAG	1	bc
GTTAGCTATA	GAAACACCGGTTACATTGAGTGGGGTTAGAGCTAGAAATAGCAAGTTAAC	1	bc
AAGTCTGTAT	GAAACACCGGTCCGTAGGAGACCCGTGTGGCATGTACCTGTGGGGTTCGA	1	bc
TTAGTTGGCC	GAAACACCGGTACCTTTGTTGATGCTGGGTGGAAGGATTTTTGTGGGGTT	1	bc
TGTGATGGAT	GAAACACCGGTGGGGTCAGATCTATAAATAGCATATTAACATAAAGCTAG	1	bc
ACGCGCCCTC	GAAACACCGGTGTGGCTGAGAGTCCGGCAATGGTGTGGCTGTGGGGTTAG	1	bc
GAAGAACGGA	GAAACACCGGTAGGCGGCAATCGTGGGGGGGGATAGAGCTAGAAATCGTA	1	bc
AAGACCCCCT	GAAACACCGGTGCATTCGAAAGTCCGGTCGTAGTGTGGACGTGGGGTTAG	1	bc
GATGCTATGT	GAAACACCGGTTACATTGAGATTGGGGTTAGAGCTAGAAATAGCAAGTTA	1	bc
TGAAGTCCGC	GAAACACCGGTCGGCGGCAATCGTGGGTGGGGTTAGAGCTAGAAATAGCA	1	bc
GTGAGCTATG	GAAACACCGGTTACTTTGAGTGGGGTTAGAGCTAGAAATAGCAAGTTAAC	1	bc
AGGATACTTT	GAAAAACCGGTCTCGAGAGAGGTGTTCAGGGTGGGGTTAGAGCTAGACAT	1	bc
GGCCCCCTTA	GAAACACCGGTGTGGCTGAGAGTCCGGCAATGGTGTGGCTGTGGGGTTAG	1	bc
CCGTACTTCT	GAAACACCGGTGCTCCGGAAGGCCAAGTGGGGTTAGAGCTAGAAATAGCA	1	bc
ACTACTCGGA	GAAACACCGGTACCTTTGTTGATGCTGGGTGGGGTTAGAGCTAGAAATAG	1	bc
ATCTATCGCG	GAAACACCGGAGTGGGGTTAGAGCTAGAAATAGCAAGTTAACCTAAGGCT	1	bc
CTGCGTCCTC	GAAACACCGGTCCGTAGGAGACCCGTGTGGCATGTACATTGTGAGGTTAG	1	bc
AAGACCCTCA	GAAACACCGGTGCATTCGAAAGTCCGGTCGTAGTGTGGATGTGGGGTTAG	1	bc
TGCTCCTTGC	GAAACACCGGTGCATTCGAAAGTCCGGTCGTAGTGTGGACGTGGGGTTAG	1	bc
ATCTATCTCG	GAAACACCGGTTATATTTGTAAGTGGGGTTAGAGCTAGAAATAGCAAGTT	1	bc
CGCATAATTT	GAAACACCGGTCTCGAGTGAGGTGTTCAGGGGTGGGGTTAGAGCTAGAAA	1	bc
CGTAGGCATC	GAAACACCGGTCCGTAGGAGACCCGTGTGGCATGTACCTGTGGGGTTAGA	1	bc
GAAGAAGCAT	GAAACACCGGTCTCGAGTGAGGTGTTCAGGGTGGGGTTAGAGCTAGAAAT	1	bc
TATATAGGCA	GAAACACCGGTTATATTTGTAAGCGTTCGGGGGTAGATCTAGAAATAGCA	1	bc
CAGTAAACGC	GAAACACCGGTCGGGGCCACTCAGTGGTGGGGTTAGAGCTAGAAATAGCA	1	bc
CACCTTGCAC	GAAACACCGGTTTGAACTACCTAGTTCAAAGAGCTAGAAATAGCAAGTTA	1	bc
AACAGCGCTC	GAAACACCGGTTTGAACCGGTGGGGTTAGAGCTAGAAATAGCAAGTTAAC	1	bc
TTGCGCAGTA	GAAACACCGGTTAAGCCGAGTGGGGTTAGAGCTAGAAATAGCAAGTTAAC	1	bc
CCTGCTCTCT	GAAACACCGGTGGAATTGGGTCGGGTTAGAGCTAGAAATAGCATGTTAAC	1	bc
AGGATTTTAT	GAAACACCGGTCTCGAGCGAGGTGTTCTGGGTGGGGTTAGAGCTAGATAT	1	bc
ATGCACAGCA	GAAACACCGGTTTACGTTGCATCGGTGTGGGGTTAGAGCTAGAAATAGCA	1	bc
ACCTTTACAG	GAAACACCGGTCGGGGCCACTCAGTGGTGGGGTTAGAGCTAGAAATAGCA	1	bc
GACACCCCCA	GAAACACCGGTCTGACTGAAAGTCACGTAATGGTGTAGCTGGGGGGTGCT	1	bc
GTCACCCCAC	GAAACACCGGTGTGGCTGAGAGTCCGGCAATGGTGTGGCTGTGGGGTTAG	1	bc
CCGAGCCGCC	GAAACACTGGTTAGCAGACAATTGCGTGGCTTCTAGAGGTGGGGGGTTAG	1	bc
AGGACCTTGC	GAAACACCGGTGCATTCGAAAGTCCGGTCGTAGTGTGGACGTGGGGTTAG	1	bc
CGAGCCAAGC	GAAACACCGGTGCATTCGAAAGTCCGGTCGTAGTGTGGACGTGGGGTTAG	1	bc
AGAACGTCGA	GAAACACCGGTGCATTCGAAAGTCCGGTAGTAGTGTGGTCGTGGGGTTAG	1	bc
ACGAATCGTT	GAAACACCGGTCTCGAGTGAGGTGTTCAGGGTGGGGTTAGAGCTAGAAAT	1	bc
TAAACATGCC	GAAACACCGGTAAATTTGAGGCTCCGGCATGCAGGAGGCCGTGGGGTTAG	1	bc
TCAATCGCGC	GAAACACCGGTTATATTTGGTTAGAGCTAGAAATAGCAAGTTAACCTAAG	1	bc
AGACAACCGC	GAAACACCGGTGCATTCGAAAGTCCGGTCGTAGTGTGGACGTGGGGTTAG	1	bc
GAAATGCTCC	GAAACACCGGTAACTATATTCATGCGATATCGCCGTATCAGTGGGGTTAG	1	bc
GCGTGTTGTA	GAAACACCGGTGACATTGGGTACAGGGTGGGGTTAGAGCTAGAAATAGCA	1	bc
CGTAAAAAGG	GAGACACCGGTAGCAAGTGCGAGCTAGAAATAGCAAGTTAACCTAAGGGG	1	bc
GGTGTTGACA	GAAACACCGGTAATTTGAGGCTCCGGCATGCAGGAGGCCGAGGAGTTAGA	1	bc
TATGCTAAGC	GAAACACCGGTTTACGTTGCATCGGTTGTGGGGTTAGAGCTAGAAATAGC	1	bc
GTGGCATGTC	GAAACACCGGTTCTGGCAAAGTGGCGTTAGGTTAGAGCTAGACATGGTAA	1	bc
GAAACCCCGA	GAAACACCGGTCCAAAATGTCGCTACATCTAGATATAGCTAGAAAAACCA	1	bc
GGTGGCGCCT	GAAACACCGGTTCCCAACCAGTGGGGTTAGAGCTGGAAATAGCAAGTTAA	1	bc
AGCAGCCGCT	GAAACACCGGTTCATTCCCAAGTCCGGTCGTAGTGGGGACGTGGGGTTAG	1	bc
GCAATAGACA	GAAACACCGGTAGCAAGTGCGAAATAGCAAGTTAACCTAAGGCTAGTCCG	1	bc
GGCCCGCTTC	GAAACACCGGTCCGTAGGAGACCCGTGTGGCATGTACCTGTGGGGTTAGA	1	bc
AGAGTTCTTT	GAAACGCCGGTCTCGAGTGAGGTGTTCAGGGTGGGGTTAGAGCTAGAAAT	1	bc
ACCATGTGGT	GAAACACCGGTCGATTCATATCGAAACCTTCCCGTGACAGTGGGGTTAGA	1	bc
CTCATTGCCC	GAAACACCGGTTTACGTTGCATCGGTTGTGGGGTTAGAGCTAGAAATAGC	1	bc
AGAAGACACG	GAAACACCGGTCGGCGGCTAGAAATAGCAAGTTAACCTAAGGCTAGTCCG	1	bc
AATGTGCATA	GAAACACCGGTTAAGCCGAGTGGGGTTAGAGCTAGAAATAGCAAGTTAAC	1	bc
GGACACCTAT	GAAACACCGGTGCGGGTGTGAGCCCGGCACTGGAGTGGCTGTGGGGTTAG	1	bc
ACAGAACGCC	GAAACGCCGGTTTGAACTAGAAATAGCAAGTTAACCTAAGGTTAGTCCGT	1	bc
ATACATGGTC	GAAGCACCGGTACCTTTGTTGATGCTGGGTGGAAGGAATTTTGTGGGGTT	1	bc
GCACAACGCA	GAAACACGGGTTAGAGCTAGAAATAGCAAGTTAACCTAAGGCTAGTCCGT	1	bc
GAGACCCTCT	GAAACACCGGTGCATTCGAAAGTCCGGTCGTAGTGTGGACGTGGGGTTAG	1	bc
AGTGGGGTCT	GAAACACCGGTTCCCGTACCGTGGCGGTAGAGCTAGAACTAGCAAGTTCA	1	bc
CAACGTTGTA	GTAGCAAGTTAACCTAAGGCTAGTCCGTTATCAACTTGAAAAAGTGGCAC	1	bc
GACACCCCCA	GAAACACCGGTGTGGCTGAGAGTCCGGCAATGGTGTGGCTGGGGGGATCG	1	bc
ATAGTCTGCC	GAAACACCGGTCCGTAGGAGACCCGTGTGGCATGTACCTGTGGGGTTAGA	1	bc
ACCTATACCG	GAAACACCGTTAGAGCTAGAAATAGCAAGTTAACCTAAGGCTAGTCCGTT	1	bc
AGACTCATTT	GAAACACCGGTCTCGAGTGAGGCGTTCTGGGGGGGGATAGAGCTAGAAAA	1	bc
CGCCTCTTTT	GAAACACCGGTCTCGAGTGAGGTGTTCAGGGGGGGTTAGAGCTAGAAATA	1	bc
CGGCTATCGA	GAAACACCGGTGCATTCGAAAGCCCGGTCGTATTGTGGACATGGGGTTAG	1	bc
ATCGTTACCG	GAAACACCGGTCGGGGCCACTCAGTGGTGGGGTTAGAGCTAGAAATAGCA	1	bc
AAGTGTTGCC	GAAACACCGGTGACATTGGGGTGGGGTTAGAGCTAGAAATAGCAGGTTAA	1	bc
TTGATGATAT	GAAACACCGGTTACGCCGGTGTGCTTTTTTCCTGCGGGATATGCTCAAGT	1	bc
TAGGCGCCTA	GAAACACCGGTTCCAGTCCGGTGGGATTAGAGCTAGAACTAGAAAGATCA	1	bc
CAACGTGGTT	GAAACACCGGTGTACGTATGGACCGAACCAGGGTGTGCAGGGTGTGGGGT	1	bc
GTGCCACCCT	GAAACACCGGTGTGGCTGAGAGTCCGGCAATGGTGTGGCTGGGGGGTTAG	1	bc
GCGTAGACTC	GAAACACCGGTTCCCGTCCAGTGGGGTTAGAGCTAGAAATAGCAAGTTAA	1	bc
GTATACGGGT	GAAACACCGGTCGATTCATATCGAAACCTTCCCGTGACAGTGGGGTTAGA	1	bc
CACCAATGCC	GAAACACCGGTGTACGTATGGACTGAACCAGGGTGTGCAAGTGGGGATAG	1	bc
TAGCCTATTC	GACACACCGGTAACTATATTCATGCGATATCGCCGTATCAGTGGGGGTAG	1	bc
TTGAGCCTCC	GAAACACCGGTTAAGCCGAGGAGTTAGAGCTAGAAGTAGCAAGTTAACCT	1	bc
CAGACCGGAC	GAAACACGGGTTAGAGCTAGAAATAGCAAGTTAACCTAAGGCTAGTCCGT	1	bc
AAGCTCAGCA	GAAACACCGGTTTACACCTAAGGCTAGTCCGTTATCAACTTGAAAAAGTG	1	bc
CAACGCGGTC	GAAACACCGGTGTACGTATTGACTGAACCAGGGTGTGCAAGTGGGGTTAG	1	bc
GACGCCGAAA	GAAACACCGGTACCATTACTGTCATCTGAATATTTCATACGTCTGGTTAG	1	bc
GCCTCAGCCA	GAAACACCGGTAGCAAGTGCGAAAAAGAAAGCTAAGCTAAGGGGAGTCCG	1	bc
AGTGTTTTAC	GAAACACCGGTGACATTGGGTTAGAGCTAGAAATAGCAAGTTAACCTAAG	1	bc
TACCTTCTCC	GAAACACCGGTAACTATCTTCATGCGATATCGCCGTATCAGTGGGGTTAG	1	bc
TCAATAACGC	GAAACACCGGTCGGGGCCACTCAGTGGTGGGGCTAGAGCTAGAAATAGCA	1	bc
ATAGAGCATA	GAAACACCGGTTAAGCCGAGGAGTTAGAGCTAGAAATAGCAAGTTAACCT	1	bc
GTTGGGCGGT	GAAACACCGGTTACAGACGCTGCGGGGTAGGGTTAGAGATAGCAAGAGCA	1	bc
CGAATAAGTT	GAAACACCGGTCTCGAGTGAGGGGTTCAGGTGGGGGTTAGGGCTAAAAAT	1	bc
GTAGAAACGC	GAAACACCGGTCGGCGGCAATCGTGGGTGGGGTTAGAGCTAGAAATAGCA	1	bc
ATCTATCGCG	GAAACACCGGTTATATTTGTAAGTGGGGTTAGAGCTAGAAATAGCAAGTT	1	bc
GCCAACACGC	GAAACACCGGTCTGCTGCAATCGTGGTATGAGCCACGTGGGGTTAGATCG	1	bc
GAGCCTTAGC	GAAACACCGGTTTACGTTGCATCGGAGTGGGGTTAGAGCTAGAAATAGCA	1	bc
ATAACTCACA	GAAACACCGGTAACTATATTCATGCGATATCGCCGTATCAGTGGGGTTAG	1	bc
TCACTTAAAT	GAAACACCGGTAACTATATTCATGCGATATCGCCGTATCAGTGGGGTTAG	1	bc
CGACCTGGCC	GAAACACCGGTACCTTTGTTGATGCTGGGTGGAAGGATTTTTGTGGGGTT	1	bc
TCACTCGGGC	GAAACACCGGTACCTTTGTTGATGCTGGGTGGAAGGAATTTTGTGGGGTT	1	bc
CTCCCCTGAA	GAAACACCGGTGTGGCTGAGAGTCCGGCAATGGTGTGGCTGTGGGGTTAG	1	bc
TCGATAGTTG	GAAACACCGGTTATATTTGTAAGTGTGTGGGGTTAGAGCTAGAAATAGCA	1	bc
ACCCTCGCCC	GAGACACCGGTGCATTCGAAAGTCCGGTCGTAGTGTGGACGTGGGGTTAG	1	bc
CTGCGCATAT	GAAACACCGGTTAAGCCGAGGGGGTAGAGCTAGAAATAGCAAGTTAACCT	1	bc
ACTACGCGGC	GAAACACCGGTACCTTTGTTGATGCTGGTTGTGGGGTTAGAGCTAGAAAT	1	bc
TGAAGCGTTT	GAAACACCGGTCTCGAGTGAGGTGTTCAGGGTGGGGTTAGAGCTAGAAAT	1	bc
ACCTTTACAG	GAAACACCGGTCGGGGCCACTCAGTGTGGGGTTAGAGCTAGAAATAGCAA	1	bc
GAAGTTAGGT	GAAACACCGGTCGATTCATGTCGAAACCTTCCCGTGACAGTGGGGTTAGA	1	bc
ATGATTATCC	GAAACACCGGTTTACGTTGCATCGGTTGTGGGGTTAGAGCTAGAAATAGC	1	bc
ACACAACGAC	GAAACACCGGTTTGAACCGGTGGGGTTAGAGCTAGAAATAGCAAGTTAAC	1	bc
ACGTCTGCGT	GAAACACCGGTCCGTAGGAGACCCGTGTGGCATGTACCTGCGGGGTTAGA	1	bc
AGGACGCGAC	GAAACACCGGTGTGGCTGGGAGTCCGGCAATGGTGTGGCTGTGGGGTTAG	1	bc
GCAGAAACGC	GAAACACCGGTTGGCGGCAATCGTGGGATGAGCCACGTGGGGATAGATCG	1	bc
ACGTGATGTC	GAAACACCGGTGACATTGGGTACAATAGCAAGTTAACCTAAGGCTAGTCC	1	bc
GGATACGGTT	GAAACACCGGTCGATTCATATCGAAACCTTCCCGTGACAGTGGGGTTAGA	1	bc
CGTCGGTCTC	GAAACACCGGTCCGTAGGAGACCCGTGTGGCATGTACCTTGTGGGGTTAG	1	bc
TTTATTTGGT	GAAACACCGGTTATATTTGTAAGTTTGTGGGGTTAGAGCTAGAAATAGCA	1	bc
AAGGAAGCGC	GAAACACCGGTCGGCGGCAATCGTGGTTAGAGCTAGAAATAGCAAGTTAA	1	bc
ATCTTCGGGT	GAAACACCGGTCGATTCATATCGAAACCTTCCCGTGACAGTGGGGGTAGA	1	bc
ATGGCACGTT	GAAACACCGGTGTACGGTTGATAGGGTCTGAGGGGGTAATGGCTAGAAAT	1	bc
GTGGATATTC	GAAACACCGGTTCCCGTCCAGTGGGGTTAGAGCTAGAAATAGCAAGTTAA	1	bc
CCTTTCCATC	GAAACACCGGGCGGGGCCGCTCCGTGGTGGGGTTAGAGCTAGAGATAGAA	1	bc
ACCTTTGACG	GAAACACCGGTCGGGGCCACTCAGGGTTAGAGCTAGAAATAGCAAGTTAA	1	bc
ACGAATACTG	GAAACACCGGTCTCGAGTGAGGTGTTCAGGGTGGGGTTAGAGCTAGAAAT	1	bc
GGCTCCATCA	GAAACACCGGTGTGGCTGAGAGTCCGGCAATGGTGTGGCTGTGGGGTTAG	1	bc
GCCCCATGCA	GAAACACCGGTAGCAAGTGCGAGACGTGTTAAATAGCAAGTTAACCTAAG	1	bc
AAATCTGCCT	GAAACTCCGGTCCGTAGGAGACCCGTGTGGCATGTACCTGTGGGGTTAGA	1	bc
CATAGTGGCC	GAAACACCGGTGTACGTATGGACTGAACCAGGGTGTGCAAGTGGGGTTAG	1	bc
ATACACTTCC	GAAACACCGGTACCTTTGTTGATGCTGGGTGGAAGGAATTTGTGTGGGGT	1	bc
ATAATCGGCA	GAAACACCGGTACCTTTGTTGATGCTGGGTGGAAGGGGTTAGAGCTAGAA	1	bc
GGAAACCTCA	GAAACACCGGTGTGGCTGAGAGTCCGGCAATGGTGTGGCTGTGGGGTTAG	1	bc
TAACATATGT	GAAACACCGGTTACATTAAGGGTTAGAGCTAGACATAGCAAGTTAACCTA	1	bc
GGCGCCATCA	GAAACACCGGTGTGGCTGAGAGTCAGGCAATGGTGTGGCTGTGGGGTTAG	1	bc
CACATAGCGC	GAAACACCGGTTTGAACTAGAAATAGCAAGTTAACCTAAGGCTAGTCCGT	1	bc
CATAGCCGTA	GAAACACCGGTGTACGTATGGACTGAACCAGCAAGTTAACCTAAGGCTAG	1	bc
CGTAGCATAA	GAAACACCGGTTAAGCCGAGGAGTTAGAGCTAGAAATAGCAAGTTAACCT	1	bc
GGCCATCTCC	GAAACACCGGTGTGGCTGAGAGTCCGGCAATGGTGTGGCTGTGGGGTTAG	1	bc
GTTAGCTACG	GAAACACCGGTTACATTGAGGGTTAGAGCTAGAAATAGCAAGTTAACCTA	1	bc
TTCGCTCTGG	GGAACACCGGTTACATTGAGTGGGGTTAGAGCTAGAAATAGCAAGTTAAC	1	bc
GGCGCCGTCA	GAAACACCGGTGTGGCTGAGAGTCCGGCAATGGTGTGGCTGTGGGTTAGA	1	bc
CATCTTCTAC	GAAACACCGGTAACTATATTCATGCGATATCGCCGTATCAGTGGGGTTAG	1	bc
TCGAATACTT	GAAACACCGGTCTCGAGTGAGGTGTTAGAGCTAGAAATAGCAAGTTAACC	1	bc
AACGCTTAGC	GAAACACCGGTTTACGTTGCATCGGTGTGGGGTTAGAGCTAGAAATAGCA	1	bc
AGCCAGAGCC	GAAACACCGGTAGCAAGTGCGAGACGTGTTTGTGGGGTTAGAGCTAGAAA	1	bc
AAACGACCTT	GAAACACCGGTGCCCTTACTCTCACCTGATTACTTAATCCGTGGGGTTAG	1	bc
ACTAGCGCGG	GAAACACCGGTTATATTTGTAAGTGTGTGGGGTTAGAGCTAGAAATAGCA	1	bc
GGGTGGTCTC	GAAACACCGGTTCCCGTCCAGTGGGGTTAGAGCTAGAAATAGCAAGTCAA	1	bc
ATGCTAAGTA	GAAACACCGGTTTACGTTGCCTCGGTGTGGGGTTAGAGCTAGAAATAGCA	1	bc
GAACGCTGTA	GAAACACCGGTGCCCTTACTCTCACCTGATTACTTAATCCGTGGGGTTAG	1	bc
ACGGCCACGC	GAAACACCGGTGCATTCGAAAGTCCGGTCGTAGTGCGGACGAGGGGTTAG	1	bc
CAAAACGATC	GAAACACCGGTTTGAACTAGAAATAGCAAGTTAACCTAAGGCTAGTCCGT	1	bc
AAATTAGTTT	GAAACACCGGTCGATTCATATCGAAACCTTCCCGTGACAGTGGGGTTAGA	1	bc
GGAAACAGAC	GAAACACCGGTAGCAAGTGCGAGACGTTTTGTGGGGTTAGAGCTAGAAAT	1	bc
AATGCTAAGC	GAAACACCGGTGGTAGCAAGTTAACCTAAGGCTAGTCCGTTATCAACTTG	1	bc
GAAACCTGCT	GAAACGCCGGTAAATTTGAGGCTCCGGCATGCAGGAGGCCGTGGGGTTAG	1	bc
TAAATTCAAC	GAAACACCGGTAACTATATTCATGCGATATCGCCGTATCAAGTGGGGTTA	1	bc
GAATAATCGC	GAAACACCTAAGGCTAGTCCGTTATCAACTTGAAAAAGTGGCACCGAGTC	1	bc
CCCACAGCCG	GAAACACCGGTTTGAACTACCTAGTTCAAACCGGGGGTTAGAGCTAGAAA	1	bc
CTGAAGACAC	GAAACACCGGTCGGCGTGGGGTTAGAGCTAGAAATAGCAAGTTAACCTAA	1	bc
AAGTGCATAT	GAAACACCGGTGCCCTTACTCTCACCTGATTACTTAATCCGTGTGGTTAG	1	bc
ACGTGTTGTA	GAAACACCGGTGACATTGGGCACAGGTTAGAGCTAGAAATAGCAAGTTAA	1	bc
GCTAGCGCGG	GAAACACCGGTTATATTTGTACGTGTGTGGGGTTAGAGCTAGAAATAGCA	1	bc
TCATCCGTGT	GAAACACCGGTTACATTAAGATCTCTTTGTGGGGTTAGAGCTAGAAATAG	1	bc
AGGGGTGTCA	GAAACACCGGCGTGGGGTTAGAGCTAGAAATAGCAAGTTAACCTAAGGCT	1	bc
ACACAACGCT	ATGTGGGGTTATAGCTAGAAATAGCAAGTTAACCTAAGGCTAGTCCGTTA	1	bc
AACAGCATAC	GAAACACCGGTGCCCTTACTCTCACCTGATTACTTAATCCGTGGGGTTAG	1	bc
GAAGAAACTC	GAAACACCGGTCGGCGGCAATCGTGGAAATAGCAAGTTAACCTAAGGCTA	1	bc
TCTGTTGTGG	GAAACACCGGTTATATTTGTAAGAGGGTGGGGTTAGAGCTAGAAATAGCA	1	bc
AACACCGCGC	GAAACACCGGTGCATTCGAAAGTCCGGTGGTATTGAGGACGAGGGGTTAA	1	bc
AAGAATCGTT	GAAACACCGGTCTCGAGTGAGGTGTTCAGGGTGGGGTTAGAGCTAGAAAT	1	bc
CGTATACCTT	GAAACACCGGTCTCGTGTGAGGAGTTCAGGGGGGGGTTAGAGCTAGAAAT	1	bc
GACGCCGTAT	GAAACACCGGTGCCCTTACTCTCACCTGATTACTTAATCCGTGGGGTTAG	1	bc
AAACTATAGC	GAAACACCGGTGCATTCGAAAGTCCGGTCGTAGTGTGGACGTGGGGTTAG	1	bc
TGTTGAGCCT	GAAACACCGGTTCCCGTCCAGTGGGGTTAGAGCTAGAAATAGCAAGTTAA	1	bc
CATGGTGGTA	GAAACACCGGTGTACGGATGGACTGAACCAGGGTGTGCAAGTGGGGTTAG	1	bc
AGCCTCTCGA	GAAACACCGGTGCATTCGAAAGTCCGGTCGTAGTGTGGACGTGGGGTTAG	1	bc
GATAGTCGCA	GAAACACCGGTCCAAAAAGGCACTACGTGGGGTTAGACCTGGAGAGATCG	1	bc
TGTATCAGAA	GAAACACCGGTTAAGCCGAGTGGGGTTAGAGCTAGAAATAGCAAGTTAAC	1	bc
ACGAGTTGTC	GAAACACCGGTGACATTGGGCTAGAGCTAGAAATAGCAAGTTAACCTAAG	1	bc
GCTTTACAGA	GAAACACCGATCGGGGCCACTCAGTGGTGGGGTTAGAGCTAGAAATAGCA	1	bc
ACGTGTCGTC	GAAACACCGGTGACATTAGAGCTAGAAATAGCAAGTTAACCTAAGGCTAG	1	bc
GTCACCTGCT	GAAACACCGGTGTGGCTGAGAGTCCGGCAATGGTGTGGCTGTGGGGTTAG	1	bc
AGTCAATCGC	GAAACACCGGTGCATTCGAAAGTCCGGTCGTAGTGTGGACGTGGGGTTAG	1	bc
CTTGCTATCC	GAAACACCGGTTACATTTGAGGGGTTAGAGCTAGAAATAGCAAGTTAACC	1	bc
TACTTTACCG	GAAACACCGGTCGGGGCCACTCAGTGGTGGGGTTAGAGCTAGAAATAGCA	1	bc
AGACACCTAC	GAAACACCGGTAAATTTGAGGCTCCGGCATGCAGGAGGCCGTGGGGTTAG	1	bc
GCCTTTATCG	GAAACACCGGTCGGGGCCACTCAGTGGTGGGGTTAGAGCTAGAAATAGCA	1	bc
GACTACCCTC	GAAACACCGGTCGGTGGCAATCGAGGGAGGGGTTAGAGCTAGGAATAGCA	1	bc
ACGGAGCCTT	GAAACACCGGTCTCGAGTGAGGTGTTCAGGGTGGGGTTAGAGCTAGAAAT	1	bc
AGACCATAGA	GAAACACCGGTGCATTCGAAAGTCCGGTCGTAGTGTGGACGTGGGGTTAG	1	bc
ACATTCTCGC	GAAACACCGGTGCATTCGAAAGTCCGGTCGTAGTGTGGCCGGGGGGATAG	1	bc
GCGGATCCTT	GAAACACCGGTCTCGAGTGAGGTGTTCAGGGTGGGGTTAGAGCTAGAAAT	1	bc
TCTCTACTGC	GAAACACCGGTCGGGGCCACTCAGTGGTGGGGTTAGAGCTAGAAATAGCA	1	bc
ACCGACCTGC	GAAACACCGGTGCCCTTACTCTCACCTGATTACTTAATCCGTGGGGTTAG	1	bc
GAGACGCCTA	GAAACACCGGTTCCCGTCCAGTGGGGTTAGAGCTAGAAATAGCAAGTTAA	1	bc
AGGCGCACGC	GAAACACCGGTGCATTCGAAAGTCCGGTCGTAGTGTGGACGTGGGGTTAG	1	bc
ACATAACGCC	GCTAGAAATAGCAAGTTAACCTAAGGCTAGTCCGTTATCAACTTGAAAAA	1	bc
AAGATCATCG	GAAACACCGGTGCATTCGAAAGTCCGGTCGTAGTGTGGACGTGGGGTTAG	1	bc
CATAACGGCG	GCTGGAAATAGCAAGTTAACCTAAGGCTAGTCCGTTATCAACTTGAAAAA	1	bc
GCAAACCAGC	GAAACACCGGTCGGCGGCAATGTGGGGTTAGAGCTAGAAATAGCAAGTTA	1	bc
CACCAAGCAC	ATGTGGGGTTAGAGCTAGAAATAGCAAGTTAACCTAAGGCTAGTCCGTTA	1	bc
GGCAACCCGC	GAAACACCGGTCGGCGGCAATCGTGGGTGGGGGTAGAGCTAGAAATAGCA	1	bc
TGCGGGGCCT	GAAACACCGGTTCCCGTCCAGTGGGGTTAGAGCTAGAAATAGCAAGTTAA	1	bc
GGCTCGCCGA	GAAACACCGGTAGATTTGAGGCTCCGGCATGCAGGAGGCCGTGGGGTTAG	1	bc
AGTGGAGGCG	GAAACACCGGTTCCCGTCCAGTGGGGTTAGAGCTAGAAATAGCAAGTTAA	1	bc
AGACACAGGC	GAAACACCGGTGGGGTTAGAGCTAGAAATAGCAAGTTAACCTAAGGCTAG	1	bc
CGGCGCTCGC	GAAACACCGGTGCATTCGAAAGTCCGGTCGTAGTGTGGACGTGGGGTTAG	1	bc
CACGCACTAT	GAAACACCGGTGCCCTTACTCTCACCTGATTACTTAATCCGTGGGGTTAG	1	bc
AACAAAGCCA	GAAACACCGGTTTGAACTACCGGGGTTAGAGCTAGAAATAGCAAGTTAAC	1	bc
AGGTGTTGAC	GAAACACCGGTGACATTGGGTACAGGGGTGGGGTTAGAGCTAGAAATAGC	1	bc
AATCGTAGAC	GAAACACCGGTGTACGTATGGACTGAACCAGGGTGTGCAAGTGGGGTTAG	1	bc
AGTGGTGCCT	GAAACACCGGTTCCCGTCCAGTGGGGTTAGAGCTAGAAATAGCAAGTTAA	1	bc
ATACCTTGGC	GAAACACCGGTGCATTCGAAAGTCCGGTCGTAGTGTGGACGTGGGGTTAG	1	bc
CACCCCGCCA	GCTAGAAATAGCAAGTTAACCTAAGGCTAGTCCGTTATCAACTTGAAAAA	1	bc
TGACTCATGT	GACACACCGGTCTCGAGTGAGGCGTTCAGGGAGGTGTTACAGCTAGACAT	1	bc
TGTTGTGTCT	GAAACACCGGTGACATTGGGTACAGGGTTAGAGCTAGAAATAGCAAGTTA	1	bc
ACACAACGCA	GAGAGCTAGAAATAGCAAGTTAACCTAAGGCTAGTCCGTTATCAACTTGA	1	bc
GGTAATCGGC	GAAACACCGGTACCTATTGTGATGCTGGGGGGGGTTAGAGCTAGAAATAG	1	bc
ATTATTGTCT	GAAACACCGGTAACATTGGGTGCATCGAGAGCTAGAAATAACAAGTTAAC	1	bc
AACGCCGCCC	GAAACACCGGTTTGAACTAGAAATAGCAAGTTAACCTAACGCTAGTCCGT	1	bc
GATGCGACTC	CCAAACACCGGTTCCCGTACAGTGGGGTTAAAGCTAGAAATAGCAAGTTA	1	bc
AAGTGTTGTC	GAAACACCGGTGACATTGGGGTTAGAGCTAGAAATAGCAAGTTAACCTAA	1	bc
TGTGGAGACT	GAAACACCGGTTCCCGTCCAGTGGGGTTAGAGCTAGAAATAGCAAGTTAA	1	bc
AGGCCCCCTC	GAAACACCGGTGTGGCTGAGAGTCCGGCAATGGTGTGGCTGTGGGGTTAG	1	bc
GGCGCCCGCA	GAAACACCGGTGTGGCTGAGAGTCCGGCAATGGTGTGGCTGTGGGGTTAG	1	bc
GAACACCGCC	GAAACACCGGTTTGAACTACCGGGGTTAGAGCTAGAAATAGCAAGTTAAC	1	bc
AGGCACCGTC	GAAACACCGGTGTGGCTGAGAGTCCGGCAATGGTGTGGCTGTGGGGTTAG	1	bc
AATGCTTAGA	GAAACACCGGTTTACGTTGCATCGGTGTGGGGTTAGAGCTAGAAATAGCA	1	bc
GATTTCCCGC	GAAACACCGGTCGGCGGGACTCAGGGAGCTAGTAATAGGATGACAACCTA	1	bc
AGATCTTTGA	GAAACACCGGTTCAGTCGAAAATCCGATCGGTGAGAGTAAGTGAGGTTAG	1	bc
CGTGGCGAGC	GAAACACCGGTGACATTGGGTAGAGGGGTTGGAGCTAGAAATAGCAAGTT	1	bc
GGGCCCCTAG	GAAACACCGGTAAATTTGAGGCTCCGGCATGCAGGAGGCCGTGGGGTTAG	1	bc
ACAAAACGCC	GAAACACCGGTTTGAACTAGAAATAGCAAGTTAACCTAAGGCTAGTCCGT	1	bc
AACATTCGGA	GAAACACCGGTCGATTCATATCGAAACCTTCCCGTGACAGTGGGGTTAGA	1	bc
ATGTTTGTTT	GAAACACCGGTCTCGAGTGAGGTGTGCAGGGGGGGGTTAGAGCTAGAAAT	1	bc
TTTTTTATGT	GAACACCTTGAGGGCTAGAGCTAGAAATAGCAAGTTAACCTAAGGCTAGT	1	bc
ATATATCGAG	GAAACACCGGTTATATTTGTAAGTGTGTGGGGTTAGAGCTAGAAATAGCA	1	bc
ATATATCGAG	GAAACACCGGAGTGGGGTTAGAGCTAGAAATAGCAAGTTAACCTAAGGCT	1	bc
GTGGAGTGTT	GAAACACCGGTTCCCGTCCAGTGGGGTTAGAGCTAGAAATAGCAAGTTAA	1	bc
AGCAACCCTC	GAAACACCGGTTTGAACTAGAAATAGCAAGTTAACCTAAGGCTAGTCCGT	1	bc
AGACTACTTT	GAAACACCGGTCTCGAGTGAGGTGTTCAGGGTGGGGTTAGAGCTAGAAAT	1	bc
AACAACGAAC	GAAACACCGGTTTGAACTACCTAGTTCAAACCGGTGGGGTTAGAGCTAGA	1	bc
AGGGGAGGCT	GAAACACCGGTTCCCGTCCAGTGGGGTTAGAGCTAGAAATAGCAAGTTAA	1	bc
AATGCTTCGC	GAAACACCGGTTTACGTTGCATCGGTTGTGGGGTTAGAGCTAGAAATAGC	1	bc
AGTGGTGGCT	GAAACACCGGTGACATTGGGTTAGAGCTAGAAATAGCAAGTTAACCTAAG	1	bc
TGGGGAATCA	GAAACACCGGTTAAGCCGAGGAGTTAGAGCTAGAAATAGCAAGTTAACCT	1	bc
TTGATCACTC	GAAACACCGGTTAAGGTGAGGGGGGTTAAAGCTAAAAATAACCAATTAAC	1	bc
CAGCGGTGTC	GAAACACCGGTGTACGTATGGTCTGAACCAGGGGGTTCAAGTGTGGTTAG	1	bc
TGGGTTGTCA	GAAACACCGGTGACATCGTGGGGTTAGAGCTAGAAATAGCAAGTTAACCT	1	bc
AACATTAGGT	GAAACACCGGTCGATTCATATCGAAACCTTCCCGTGACAGTGGGGTTAGA	1	bc
TCATCAATGC	GAAACACCGGTCGGGGCCACTCAGTGGTGGGGATAGAGCTAGAAATAGCA	1	bc
ACGTGGTGTA	GAAACACCGGTGACATTGGGTACAGGGTGGGGTTAGAGCTAGAAATAGCA	1	bc
GACGCCTAGC	GAAACACCGGTAAATGTGAGACCCCGGCATGCAGGAGGCCGTGGGGTTAG	1	bc
ACTAGCGAAG	GAAACACCGGTTATATTTGTAAGTGTGTGGGGTTAGAGCTAGAAATAGCA	1	bc
GAGACACAGA	GAAACACCGGTAGCAAGTGCGAGATGTGTTTGTGGGGTTAGAGCTAGAAA	1	bc
AAAACGCTCT	GAAACACCGGTGCCCTTACTCTCACCTGATTACTTAATCCGTGGGGTTAG	1	bc
GTGCAGGCTA	GAAACACCGGTTCATGTGCAGCGGAGGTAGAGCTAGAAATAGGAAGTTAA	1	bc
CACCTTAGTC	GAAACACCGGTGTACGTATGGACTGAACCAGGGGGTGCAAGTGGGGTTAG	1	bc
AGAGGCTCTC	GAAACACCGGTGCATTCGAAAGTCCGGTCGTAGTGTGGACGTGGGGTTAG	1	bc
GCATAACGAC	GAAACACCGGTTTGAACTACCTAGAGCTAGAAATAGCAAGTTAACCTAAG	1	bc
AACGTGTTGT	GAAACACCGGTGACGCTAGACCGTTATCAACTTGAAAAAGTGGCACCGAG	1	bc
GTCTATCGCG	GAAACACCGGTTATATTTGTAAGTGTGTGGGGTTAGAGCTAGAAATAGCA	1	bc
ATTGAGAATA	GAAACACCGGTTAAGCCGATGTGCTTTTTTCCTGCAGGTTATGCTCAAGA	1	bc
TAGCGTTCTC	GAAACACCGGTGCCCTTACTCTCACCTGATTACTTAATCCGTGGGGTTAG	1	bc
ACCGACATGC	GAAACACCGGTGCCCTTACTCTCACCTGATTACTTAATCCGTGGGGTTAG	1	bc
AGACCTCCTA	GAAACACCGGTCCGTAGGAGACCCGTGTGGCATGTACCTGTGGGGTTAGA	1	bc
CCTATCGCTT	GAAACACCGGTTATATTTGTAAGTGTGTGGGGTTAGAGCTAGATATAGCA	1	bc
TCTGAGCCTC	GAAACACCGGTTCCCGTCCAGTGGGGTTAGAGCTAGAAATAGCAAGTTAA	1	bc
CCTTCCGAGG	GAAACACCGGTTATATTTGTAAGTGTTGTGGGGTTAGAGCTAGAAATAGC	1	bc
AGAAGACACG	GAAACACCGGTCGGCGGCAATCGTGGTTAGAGCTAGAAATAGCAAGTTAA	1	bc
GCAGTCGAGT	GAAACACCGGTTATATTTGTAAGTGTGTGGGGTTAGAGCTAGAAATAGCA	1	bc
GAGACACACG	GAAACACCGGTGCATTCGAAAGTCCGGTCGTAGTGTGGACGTGGGGTTAG	1	bc
ACTGGTATTC	GAAACACCGGTAATCCGAAAGGCCAAGGGGGGTTAAACCTGGAATAAGCA	1	bc
AGAAGCCTGT	GCTAGAAATAGCAAGTTAACCTAAGGCTAGTCCGTTATCAACTTGAAAAA	1	bc
CGGGCCATCT	GAAACACCGGTTACATTGGGTACAGGGTGGGGTTAGAGCTAGAAATAGCA	1	bc
AGAAGTCCCG	GAAACACCGGTCGGCGGCAATCGTGGGTGGGGTTAGAGCTAGAAATAGCA	1	bc
ACATGCGGAC	GAAACACCGGTCGATTCATATCGAAACCTTCCCCGTGGGGTTAGAGCTAG	1	bc
TTAGCGAGTT	GAAACACCGGTTACATTGAGATTGGGGTTAGAGCTAGAAATAGCAAGTTA	1	bc
CAAAAGGGCC	GAAACACCGGTTTGAACTAGAAATAGCAAGTTAACCTAAGGCTAGTCCGT	1	bc
CTAGTTGGCA	GAAACACCGGTACCTTTGTTGATGCTGGGTGGAAGGAATTTGTGGGGTTA	1	bc
ACACAACACA	GAAACACCGGTTTGAACTACCTACGGGTTAGAGCTAGAAATAGCAAGTTA	1	bc
AAACTCTACA	GAAACACCGGTAAATTTGAGGCTCCGGCATGCAGGAGGCCGTGGGGTTAG	1	bc
ACGCTCGAGT	GAAACACCGGTTTACGTTGCATCGGTGTGGGGTTAGAGCTAGAAATAGCA	1	bc
AGCGTCATAC	GAAACACCGGTGCCCTTACTCTCACCTGATTACTTAATCCGTGGGGTTAG	1	bc
ACCAAAGCCC	GAAACACGGGTTAGAGCTAGAAATAGCAAGTTAACCTAAGGCTAGTCCGT	1	bc
ACCAGTCGGT	GAAACACCGGTCGATTCATATCGAAACCTTCCCGTGACAGTGGGGTTAGA	1	bc
AAGACACTCG	GAAACACCGGTGCATTCGAAAGTCCGGTCGTGGTGTGGACGTGGGGTTAG	1	bc
ATGGAGGCGC	GAAACACCGGTTCCCGTCCAGTGGGGTTAGAGCTAGAAATAGCAAGTTAA	1	bc
GCACAGCCCT	GAAACACCGGTCGGCGGCACTCGAGGGAGTGGATAGAGCTAGAAATAGCA	1	bc
GAGACAGATC	GAAACACCGGTAGCAAGTGGGGTTAGAGCTAGAAATAGCAAGTTAACCTA	1	bc
AGACACGAGC	GAAACACCGGTGCATTCGAAAGTCCGGTCGTAGTGTGGACGTGGGGTTAG	1	bc
GACTGCGACA	GAAACACCGGTAGCAAGTGGGGTTAGAGCTAGAAATAGCAAGTTAACCTA	1	bc
TTTCCTGCAG	GAAACACCGGTCTCGAGTGAGGTGTTCAGGGTGGGGTTAGAGCTAGAAAC	1	bc
GAGTGGCGCC	GAAACACCGGTTCCCGTCCAGTGGGGTTAGAGCTAGAAATAGCAAGTTAA	1	bc
AGGCACCATC	GAAACACCGGTGTGGCTGAGAGTCCGGCAATGGTGTGGCTGTGGGGTTAG	1	bc
GAGCAGCGTA	GAAACACCGGTTCCCGTACCGAGGGGTTAGAGCTAGAAATAGCAAGATAA	1	bc
AATACTCGGC	GAAACACCGGTACCTTTGTTGATGCTGGGTGGAAGGATTTTTGTGGGGTT	1	bc
TAAGGTATGA	GAAACACCGGTTACATTGAGGGGTTAGAGCTAGAAATAGCAAGTTAACCT	1	bc
GGCCCCTCTG	GAAACACCGGTAAATTTGAGGCTCCGGCATGCAGGAGGCCGTGGGGTTAG	1	bc
AAGGGTTGTT	GAAACACCGGTGACATTGGGTGGGGTTAGAGCTAGAAATAGCAAGTTAAC	1	bc
ACTTCCCCGC	GAAACACCGGTCGGGGCCACTCAGTGGTGGGGTTAGAGCTAGAAATAGCA	1	bc
AGTCTATCGC	GAAACACCGGTGCATTCGAAAGTCCTGTCGGAGAGGGGACGTGGGGTTAG	1	bc
TGTCCCCTCT	GAAACACCGGTGTGGCTGAGAGTCCGGCAATGGTGTGGCTGTGGGGTTAG	1	bc
AATTTACCGT	GAAACACCGGTCGGGGCAACTCAGTGGTGGGGTTAGAGCTAGAAATAGCA	1	bc
AGGCACACTC	GAAACACCGGTGTGGCTGAGAGTCCGGCAGTGGTGTGGCTGTGGGGTTAG	1	bc
ATCGCTATGC	GAAACACCGGTTACATTGAGGGTTAGAGCTAGAAATAGCAAGTTAACCTA	1	bc
ATCGCTGTGT	GAAACACCGGTTACAGTGAGACATAGATCTACAAATATCAATTTAACCAG	1	bc
TCGAGATGTA	GAAACACCGGTAGCAAGTGCGAGACCGGTAGCGGTGCTTTTTTTCCTGCA	1	bc
CTCCCCTGCC	GAAACACCGGTGTGGCTGAGAGTCCGGCAATGGTGTGGCTGTGGGGTTAG	1	bc
CTCCTCTGCA	GAAACACCGGTGTGGCTGAGAGTCCGGCAATGGTGTGGCTGTGGGGTTAG	1	bc
AGACTCCTTG	GAAACACCGGTCTCGAGTGAGGTGTTCAGGGTGGGGTTAGAGCTAGAAAT	1	bc
ATGCGAAGTT	GAAACACCGGTTTACGTTGCATCGGTTGTGGGGTTAGAGCTAGAAATAGC	1	bc
GACATTAGGT	GAAACACCGGTCGATTCATATCGAAACCTTCCCGTGACAGTGGGGTTAGA	1	bc
TTCTATAGAG	GAAACACCGGTTATATTTGTAAGTGTTTGTGGGGTTAGAGCTAGAAGTAG	1	bc
CAGTTACCGT	GAAACACCGGTCGGGGCCACTCAGTGGTGGGGTTAGAGCTAGAAATAGCA	1	bc
AGGAACCCTC	GAAACACCGGCGTGGCTGAGAGTCCGGCGATGGTGTGGCTGTGGGGTTAG	1	bc
ATGAGACTAA	GAACCACCGGTTAAGCCGAGTGGGGTTAGAGCTAGAAATAGCAAGTTAAC	1	bc
ATTGAGCTTA	GAAACACCGGTTAAGCCGATGTGCTTTTTTCCTGCAGGTTAAGCTCAAGA	1	bc
TTGGGTCTAC	GAAACACCGGTTAAGCCGAGTGGGGTTAGAGCTAGAAATAGCAAGTTAAC	1	bc
AGAAGACACG	GAAACACCGGTCGGCGGCGTTAGAGCTAGAAATAGCAAGTTAACCTAAGG	1	bc
TTAAGCATTT	GAAACACCGGTGATAACCTAGGGCTAGTCCGTTTACAACTTGAAAAAGCG	1	bc
GTCAAAGACC	GAAACACCGGTAGCAAGTGCGAGACGTTTGTGGGGTTAGAGCTAGAAATA	1	bc
AACTCGGCCG	GAAACACCGGTACCCTCGGATTAGCGGTGGGGTTAGAACGATAAATAGCG	1	bc
TAACGCTCTA	GAAACACCGGTGCCCTTACTCTCACCTGATTACTTAATCCGTGGGGTTAG	1	bc
TTACGCGTAC	GAAACACCGGTACCTTTGTTGATGCTGGGGGGATGGATGGGGTTAGAGCT	1	bc
TCATTTGGGC	GTAACACCGGTCGATTCATATCGAAACCTTCCCGTGACAGTGGGGTTAGA	1	bc
ATATAGCGAG	GAAACACCGGTTATATTTGTAAGTGTTGTGGGGTTAGAGCTAGAAATAGC	1	bc
TCCCCTTGCA	GAAACACCGGTAAATTTGAGGCTCCGGCATGCAGGAGGCCGTGGGGTTAG	1	bc
GACGCCGCGC	GAAACACCGGTCGCAGGTGCGAGCGGTGCTATTTTTCCTGCAGGAGTCTG	1	bc
TTGTAGCCGC	GAAACACCGGTTCCCGTCCAGTGGGGTTAGAGCTAGAAATAGCAAGTTAA	1	bc
AGACGCAGAC	GAAACACCGGTAGCAAGTGCGAGACCGGTAGCGGTGCTTTTTTTCCTGCA	1	bc
GAGAAATTGC	GAAACACCGGTCGGCGGCAATCGTGGTATGAGCCACGTGGGGTTAGATCG	1	bc
AGCAAAACGC	GAAACACCGGTGCATTCGAATGTCTGGTCGTGGTGTGGCTGTGGGGATCG	1	bc
TCATTTACGG	GAAACACCGGTCGACGCCACTCAGTGGTGGGGTTAGAGCTAGAAATAGCA	1	bc
GGTGAGTCTC	GAAACACCGGTTCCCGTCCAGTGGGGTTAGAGCGAGAAATAGCAAGTTAA	1	bc
AGACCTACTC	GAAACACCGGTTCCTAGGAGAACCGTGTGGCGTTTACCTGTGGAGTTAGA	1	bc
ATGAGAATCA	GAAACACCGGTTAAGCCGATGTGCTTTTTTCCTGCAGGTTATGCTCAAGA	1	bc
ATATAGTGCG	GAAACACCGGTTTTATTGTGGGGTTAGAGCTAGAAATAGCAAGTTAACCT	1	bc
AGTAGGACTC	GAAACACCGGTCCGTAGGAGACCCGTGTGGCATGTACCTGTGGGGTTAGA	1	bc
ACACAACGCA	GAAACACCGGTTTGAACTAGAAATAGCAAGTTAACCTAAGGCTAGTCCGT	1	bc
GGTGTTATGC	GAAACACCGGTGACATTGGGTATGGGGTTAGAGCTAGAAATAGCAAGTTA	1	bc
ACACTCACTC	GAAACACCGGTGCATTCGAAAATCCTGTTGTAGGGGGGACGGGTGGTTAG	1	bc
ATAACATATA	GAAACACCGGTAACTATATTCGTGCGATATCGCCAGAAATAGCAAGTTAA	1	bc
AGCCACTGAC	GAAACACCGGTAGCAAGTGCGAGACCGGTAGCGGTGCTTTTTTTCCTGCA	1	bc
ACACAACGTA	GAAACACCGGTTTGAACTACCTAGAAATAGCAAGTTAACCTAAGGCTAGT	1	bc
AGACACAGCG	GAAACACCGGTAGCAAGTGCGAGACGTGTTTGTGGGGTTAGAGCTAGAAA	1	bc
GAGGAGCAGC	GAAACACCGGTTCCCGTCCAGTGGGGTTAGAGCTAGAAATAGCAAGTTAA	1	bc
CGACACGCGC	GAAACACCGGTGCATTCGAAAGTCCGGTCGTAGTGTGGACGTGGGGTTAG	1	bc
AGCATTATTT	GAAACACCGGTCTCGAGTGAGGTGTTCAGGTGGGGTTAGAGCTAGAAATA	1	bc
GATGATTAGC	GAAACACCGGTTTACGTTGCATCGTTTTGGGGTTAGAGCTAGAAATAGCA	1	bc
GCGGTGTCTC	GAAACACCGGTTCCCGTCCAGTGGGGTTAGAGCTAGAAATAGCAAGTTAA	1	bc
ACCTTTGCCG	GAAACACCGGTCGGGGCCACTCAGTGGTGGGGTTAGAGCTAGAAATAGCA	1	bc
GCAAAAGACA	GAAACACCGGTAGCAAGTGCGAGACGTGTTTGTGGGGTTAGAGCTAGAAA	1	bc
ACTTTACGTC	GAAACACCGGTCGGAGCCACTGAAGGCTTGGGGTAGATCTAGCAAGAAAT	1	bc
ACAATAGATT	GAAACACCGGTCGATTCATATCGAAACCTTCCTCGTGGGGTTAGAGCTAG	1	bc
TACATAGCCA	GAAACACCGGTAGCAAGTGCGAGCAAGTTTGTGGGGTTAGAGCTAGAAAT	1	bc
GGGGAGCGAC	GAAACACCGGTTCCAGTGCGGCGGGGTTAGGGCTAGAACTAGAAATTTCA	1	bc
AAGACCCTAG	GAAACACCGGTGCATTCGAAAGTCCGGTCGTAGTGTGGACGTGGGGTTAG	1	bc
CAAACCGGCC	GAAACACCGGTTTGAACTAGAAGTAGCAAGTTAACCTAAGGCTAGTCCGT	1	bc
GTGAGACTCC	GAAACACCGGTTCCCGTCCAGTGGGGTTAGAGCTAGAAATAGCAAGTTAA	1	bc
ACACAACGCA	GAAACACCGGTTTGAACTACCTAGAAATAGCAAGTTAACCTAAGGCTAGT	1	bc
CGCCTTTCCC	GAAACACCGGTCGGGGCCACTCAGTGGTGGGGTTAGAGCTAGAAATAGCA	1	bc
AGTGGGGCCA	GAAACACCGGTTCCCGTCCAGTGGGGTTAGAGCTAGAAATAGCAAGTTAA	1	bc
ACGTGTTGTA	GAAACACCGGTGACATTGGGTAGAGCTAGAAATAGCAAGTTAACCTAAGG	1	bc
AGGCTTGTCT	GAAACACCGGTTTACGTTGCATCGGTTGTGGGGTTAGAGCTAGAAATAGC	1	bc
ATGCTAAACA	GAAACACCGGTTTACGTTGCATCGGTTGTGGGGTTAGAGCTAGAAATAGC	1	bc
GTACAACGCT	GGAACACCGGTTTGAACTACCTAGAGCTAGAAATAGCAAGTTAACCTAAG	1	bc
AATGCTTAGG	GAAACACCGGTTTACGAGCTAGAAATAGCAAGTTAACCTAAGGCTAGTCC	1	bc
TGGCACCCTT	GAAACACCGGTGTGGCTGAGAGTCCGGCAATGGTGTGGCTGTGGGGTTAG	1	bc
GTAGATAGGT	GAAACACCGGTTACATTGAGGGGTTAGAGCTAGAAATAGCAAGTTAACCT	1	bc
TCCTATAGAG	GAAACACCGGTTATATTTGTAAGTGTGTGGGGTTAGAGCTAGAAATAGCA	1	bc
AGCACGTTGC	GAAACACCGGTGCACTCGAAAGTCCGGTCGTAGTGTGGACGTGGGGTTAG	1	bc
ACCCTTACCG	GAAACACCGGTCGGGGCCACTCAGTGGTGGGGTTAGAGCTAGAAATAGCA	1	bc
GTATTAGTAA	GAAACACCGGTACCCGGTGGGGTTAGAGGTAGAAATAGCAAGTTAACGTA	1	bc
GAATTGCCGC	GAAACACCGGTCGGCGGCAATCGTGGGTGGGGTTAGAGCTAGAAATAGCA	1	bc
GAAACAGCTA	GAAACACCGGTAGCAAGTGCGAGACGTGTTTGTGGGGTTAGAGCTAGAAA	1	bc
TGTGAGAATA	GAAACACCGGTTAAGCCGAGGAAAGTGGGGTTAGAGCTAGAAATAGCAAG	1	bc
GAAGCTCAGC	GAAACACCGGTCGGCGGCAATCGTGGGTGGGGTTAGAGCTAGAAATAGCA	1	bc
GACATAGTAA	GAAACACCGGTAGCAGGTTAGAGCTAGAAATAGCAAGTTAACCTAAGGCT	1	bc
AATGCTAAGC	GAAACACCGGTTTACGTTGCATCGGTGTGGGGTTAGAGCTAGAAATAGCA	1	bc
ATACTGGTAA	GAAACACCGGTACCTTTGTTGATTGGGGTTAGAGCTAGAAATAGCAAGTT	1	bc
CAATTCGGGT	GAAACACCGGTCGATTCATATCGAAACCTTCCCGTGACAGTGGGGTTAGA	1	bc
GAAGAGGCGA	GAAACACCGGTCGGTGGGGTTAGAGCTAGAAATAGCAAGTTAACCTAAGG	1	bc
GATTAGCTAT	GAAACACCGGTTACATTGAGATTAGAGCTAGAAAAGGCTAGTCCGTTATC	1	bc
ACCCTCGGTC	GAAACACCGGTCGATTCATATCGAAACCTTCCCGTGACAGTGGGGTTAGA	1	bc
AGTAGCTAGG	GAAACACCGGTTACATTGAGGGTTAGAGCTAGAAATAGCAAGTTAACCTA	1	bc
ACTAATGGGC	GAAACACCGGTAATGTTTATATGAGGGAGGGAATCGATGTGGGGGGATAG	1	bc
AATATCGGGG	GAAACGCCGGTTATATTTGTAAGTGTGTGGGGTTAGAGCTAGAAATAGCA	1	bc
CTCCCCTGCA	GAAACACCGGTGTGGCTGAGAGTCCGGCAATGATGTGGCTGTGGGGTTAG	1	bc
ACTACTCCGC	GAAACACCGGTACCTTTGTTGATGCTGGTTAACCTAAGGCTAGTCCGTTA	1	bc
GCCTTGACCG	GAAACACCGGTCGGGGCCACTCAGTGGTGGGGTTAGAGCTAGAAATAGCA	1	bc
GATGAACAGC	GAAACACCGGTCGGCGGCGGGGGGGCTATAGCTAGAAATAGCGGGTTAAC	1	bc
ATGCGCATCA	GAAACACCGGTTAAGCCGAGGAGTTAGAGCTAGAAATAGCAAGTTAACCT	1	bc
TCGACTACTT	GAAACACCGGTCTCGAGTGAGGTGTTCAGGGTGGGGTTAGAGCTAGAAAT	1	bc
CAGTGTCGTA	GAAACACCGGTGTACGTATGGACTGAACCAGGGTGTGCAAGTGGGGTTAG	1	bc
GGGCACTCTC	GAAACACCGGTGAGGCTGAGAGCCCGGCAATGGTGTGGCTGGGGGGTGAA	1	bc
GCCACCATCG	GAAACACCGGTGCATTCGAAATGCCGGGCGTAGGGTTGGCGCGGGGATAG	1	bc
AAGAATGCGC	GAAACACCGGTGCATTCGAAAGTCCGGTCGTAGTGTGGACGTGGGGTTAG	1	bc
GGCTAGTCGT	GAAACACCGGTACCTTTGTTGATGCTGGGTGGAAGGAATTTGTGGGGTTA	1	bc
GTGATCCTCA	GAAACACCGGTTCCTGTTCTGTGGGGTTAGAGATAGAAATAGCACGATAT	1	bc
TAGATTATAA	GAAACACCGGTAACTATATTCATGCGATATCGCCGTATCAGTGGGGTTAG	1	bc
ACTATTCGGA	GAAACACCGGTACCTTTGGGTTAGAGCTAGAAATAGCAAGTTAACCTAAG	1	bc
ACGAAGCCTT	GAAACACCGGTCTCGAGTGAGGTGTTCAGGGTGGGGTTAGAGCTAGAAAT	1	bc
AACAACGACA	GAAACACCGGTTTGAACTAGAAATAGCAAGTTAACCTAAGGCTAGTCCGT	1	bc
GGCCCACCAC	GAAACACCGGTCCGTAGGAGACCCGTGTGGCATGTACCTGCGGGGTTAGA	1	bc
ACAACTCGGC	GAAACACCGGTACCTTTGTTGATGCTGGGTGGAAGGAATTTGTGGGGTTA	1	bc
CGGGGCGTAT	GAAACACCGGTTAAGTTGGGGTGGGGTTAGAGCTAGAAATAGCAAGTTAA	1	bc
AGACTCATGC	GAAACACCGGTGCATTCGAAAGTCCGGTCGTAGTGTGGACGTGGGGTTAG	1	bc
CTATAGTTGT	GAAACACCGGTTACATTGAGGGTTAGAGCTAGAAATAGCAAGTTAACCTA	1	bc
GCCACGGCCC	GAAACACGGGTTACAGCTGCCAATAGCAAGGTAACCTAAGGCTAGGCCGT	1	bc
GTGAGCATTC	GAAACACCGGTTCCCGTCCAGTGGGGTTAGAGCTAGAAATAGCAAGTTAA	1	bc
CATCACGCCA	GAAACACCGGTTTGAACTGCCTAGAGCTAGAAATAGCAAGTTAACCTAAG	1	bc
TCGATTGGGG	GAAACACCGGTTATATTTGTAAGTGTGTGGGGTTAGAGCTAGAAATAGCA	1	bc
GAGGAAGACA	GAAACACCGGTAGCAAGTGCGAGCAAGTTTTGTGGGGTTAGAGCTAGAAA	1	bc
ATTGCGCGCA	GAAACACCGGTTAAGCCGAGGGGTTAGAGCTAGAAACAGCAAGTTAACCT	1	bc
AACATCGCCA	GAAACACGGGTTAGAGCTAGAAATAGCAAGTTAACCTAAGGCCAGTCCGT	1	bc
AGAAACAGCG	GAAACACCGGTCGGCGGCAATCGTGGTTAGAGCTAGATATAGCAATCTAA	1	bc
GCGTAGTATC	GAAACACCGGTTCCCGTCCAGTGGGGTTAGAGCTAGAAATAGCAAGTTAA	1	bc
AGACTTCATC	GAAACACCGGTCCGTAGGAGACCCGTGTGGCATGTACCTGTGGGGTTAGA	1	bc
CATTTCATTT	GAAACACCGGTCTCGAGTGAGGTGTTCAGGGTGGGGTTAGAGCTAGAAAT	1	bc
ATTTTAGCGC	GAAACACCGGTCGGGGCCACTCAGTGGTGGGGTTAGAGCTAGAAATAGCA	1	bc
AGGCTATACC	GAAACACCGGTTTACGTTGCATCGGGGTGGGGATAAAGCTGGAAATAGAA	1	bc
GACTCCTATA	GAAACACCGGTAAATTTGAGGCTCCGGCATGCAGGAGGCCGTGGGGTTAG	1	bc
AGAACCCTTC	GAAACACCGGTCTCGAGTGAGGTGTTCAGGGTGGGGATAGAGCTAGAAAT	1	bc
AGAAAATCGC	GAAACACCGGTGCATTCGAAAGTCCGGTCGTAGTGTGGACGTGGGGTTAG	1	bc
AGACAACCGC	GAAACACCGGTGCATTCGAAAGTCCGGTCGTAGTGTGGACGTGGGGATAG	1	bc
TCGTGGTGTC	GAAACACCGGTGACATTGGGTACAGGGTGGGGTTAGAGCTAGAAATAGCA	1	bc
CTGCTGATCT	GAAACACCGGTTTACGTTGCATCGGGTTAACTCAGTGGGGTTAGAGCTAG	1	bc
GATGCCGAGC	GAAACACCGGTTTTCGGTGCATCGTGCGTTTTGCGCTGAGAGCTAGACAC	1	bc
ATGGAGCATA	GAAACACCGGTTAAGCCGAGTGGGGGTAGAGCTAGAAATAGCAAGTTAAC	1	bc
CACAGAGACC	GAAACACCGGTTTGAACTAGAAATAGCAAGTTAACCTAAGGCAAGTCCGT	1	bc
CATCTAGGTC	GAAACACCGGTGTACGTACGGACTGAACCAGGGTGTGCAAGTGGGGTTAG	1	bc
ATAAGCCCTG	GAAACACCGGTTACATTGAGGGTTAGAGCTAGAAATAGCAAGTTAACCTA	1	bc
AATCATAGTC	GAAACACCGGTGAACGGATGGACTGACCAAGGGTGTGCAGGTGTAGTAAT	1	bc
ACGAGTTGTC	GAAACACCGGTGACATTGGGTATGTTAGAGCTAGAAATAGCAAGTTAACC	1	bc
ATCCTCGGAA	GAAACACCGGTACCTTTGTTGATGCTGGGTGGAAGGAATTTGGGGTTAGA	1	bc
GCCGTTACAG	GAAACACCGGTCGGGGCCACTCAGTGGTGGGGTTAGAGCTAGAAATAGCA	1	bc
GGCATCGACG	GAAACACCGGTGTGGCTGAGAGTCCGGCAATGGTGTGGCTGTGGGGTTAG	1	bc
AGTACTCGGC	GAAACACCGGTACCTTTGTTGATGCTGGTTAACCTAAGGCTAGTCCGTTA	1	bc
ACAGTAGTAC	GAAACACCGGTGAAATTGGGTACAGGGTGGGGTTAGAGCTAGAAATAGCA	1	bc
GCATGATAGA	GAAACACCGGTCGGGGCCACTCTGCGGCGTGCTTAGAGCCAGGAATATAG	1	bc
GATTTAGAGA	GAAACACCGGTAGCAAGTGCGAGACGTGTTTGTGGGGTTAGAGCTAGAAA	1	bc
GTGGCTCATC	GAAACACCGGTTCCCGTCCAGTGGGGTTAGAGCTAGAAATAGCAAGTTAA	1	bc
CTCCCAGACA	GAAACACCGGTAGCAAGTGCGAGACGTGTTTGTGGGGTTAGAGCTAGAAA	1	bc
AGTCACCATC	GAAACACCGGTGTGGCTGAGAGTCCGGCAATGGTGTGGCTGTGGGGTTAG	1	bc
GATAGTAGAA	GAAACACCGGTGTACGTATGGACTGAACCAGGGTGTGCAAGTGGGGTTAG	1	bc
GTAAGTTATA	GAAACACCGGTAACTATATTCATGCGATATCGCCGTATCAGTGGGGTTAG	1	bc
GAGGAATCGC	GAAACACCGGTGCACTCGAAAGGGGGTTCGAAGTAGAGATAGCGAGTTAA	1	bc
TATAAAGACA	GAAACACCGGTAGCAAGTGCGAGACGTGTTTGTGGGGTTAGAGCTAGAAA	1	bc
TAAGCACCGC	GAAACACCGGTCGGCGGCAATCGTGGGGTTAGAGCTAGAAATCGTGGGGT	1	bc
AGAACAGCTC	GAAACACCGGTGCATTCGAAATTCCGGTCGTAGTGTGGCCGGGGGGATAG	1	bc
ACACAACGCT	GAAACACCGGTTTGAACTACCTGGGGTTAGAGCTAGAAATAGCAAGTTAA	1	bc
ACCGTTACCG	GAAACACCGGTCGGGGCCACGGGTTAGAGCTAGAAATAGCAAGTTAACCT	1	bc
GGAGGAGCTT	GAAACACCGGTTCCCGTCCAGTGGGGTTAGAGCTAGAAATAGCAAGTTAA	1	bc
ATACAAAGCC	GAAACACCGGTTTGAACTACCTAGTTCAAACCGGTGGGGTTAGAGCTAGA	1	bc
AGGGACCCGC	GAAACACCGGTGTGGCTGAGAGTCCGGCAATGGTGTGGCTGTGGGGTTAG	1	bc
GGCAAACCAC	GAAACACCGGTGTGGCTGAGAGTCCGGCAATGGTGTGGCTGTGGGGTTAG	1	bc
CTAAGAGGCC	GAAACACCGGTACCTTTGTTGTGGGGTTAGAGCTAGAAATAGCAAGTTAA	1	bc
CACTTCGGAT	GAAACACCGGTCGATTCATATCGAAACCTTCCCGTGACAGTGGGGTTAGA	1	bc
CGAGTCGGCT	GAAACACCGGTGACATTGGTCATGCGGTTAGAGCTAGAAATAGCAAGATA	1	bc
ACCTATCGAG	GACACCGGTTATATTTGTAAGTGTGTGGGGTTAGAGCTAGAAATAGCAAG	1	bc
CAGCGTTTTC	GAAACACCGGTGTAAGTATGGACTGAACCAGGGTATGCATGTGAAGATAG	1	bc
GTGATTAGAT	GAAACACCGGTTTACGTTGCATCGGTGTGGGGTTAGAGCTAGAAATAGCA	1	bc
GTCACAGAAC	GAAACACCGGTAGCAAGTGCGAGACGTGTTTGTGGGGTTAGAGCTAGAAA	1	bc
AGGTTTGTCT	GAAACACCGGTGACATTGGGTACAGGGGTGGGGTTAGAGCTAGAATTAGA	1	bc
TACATTATCC	GAAACACCGGTAACTATATTCATGCGATATCGCCGTATCAGTGGGGTTAG	1	bc
GTCTATCGTG	GGAACACCGGTTATATTTGTAAGTGTGTGGGGTTAGAGCTAGAAATAGCA	1	bc
AAAACCCTAG	GAAACACTAGAAATAGCAAGTTTACCTAAGGCTAGTCCGTTATCAACTTG	1	bc
AGGCACGCTC	GAAACACCGGTGTGGCTGAGAGTCCGGCAATGGTGTGGCTGTGGGGTTAG	1	bc
AGGCCCATAC	GAAACATCGGTAAATTTGAGGCTCCGGCATGCAGGAGGCCGTGGGGTTAG	1	bc
ATACTTGTGA	GAAAAACCGGTTTCATTGAGGGGGTAGTGCTAGAAGTGGCAAGATAACCT	1	bc
AGAATCGTTA	GAAACACCGGTCTCGAGTGAGGTGTTCAGGGTGGGGTTAGAGCTAGAAAT	1	bc
TAAGGCCCTA	GAAACAACGGCGCCCTTACTCTCACCTGATTACTTAATCCGTGGGGTTAG	1	bc
AGTAGAGACG	GAAACACCGGTTACATTGAAGGGTAGAGCTAGAAATAGCAAGTTAACCTA	1	bc
CGTTCTTTCT	GAAGCACCGGTGACATTGGGTAGAGCTAGAAATAGCAAGTTAACCTAAGG	1	bc
GGCACATTCA	GAAGCACCGGTATGGCTTAGTGCTCCGCGGTGGTAGAGCTAGAAATAGCA	1	bc
ACGTGGTGTC	GAAACACCGGTGACATTGGGTACAGGGTGGGGTTAGAGCTAGAAATAGCA	1	bc
ATTGTTGTCG	GAAACACCGGTGACAATTGGGGTTAGAGCTAGAAATAGCAAGTTAACCTA	1	bc
ACGTTCGGAA	GAAACACCGGTCGATTCATATCGAAACCTTCCCGTGACAGTGGGGTTAGA	1	bc
GATGTGCCTC	GAACCACTGGTTCCCGTCCAGTGGGGTTAGAGCTAGAAATAGCAAGTTAA	1	bc
TCTAGCAGGG	GAAACACCGGTTATATTTGTAAGTGTGTGGGGATAGAGCTAGAAATAGCA	1	bc
AGCCACTACG	GAAACACCGGTAAATTTGAGGCTCCGGCATGCAGGAGGCCGTGGGGTTAG	1	bc
ACGTGATGTC	GAAACACCGGTGACATTGGGTTAAAGCTAGAAATAGCAAGTTAACCTAAG	1	bc
GGACTCACGC	GAAACACCGGTCGGTTGGAAAGGCGGGTAGAGGTAGGAACAGGAAGTTAG	1	bc
AGCTTCAACG	GAAACACCGGTCGGGTTCACAAGTTCGAGCTAGTAATGGCAAGATAACCT	1	bc
ATCTCTCGAG	GAAACACCGGTTATATTTGTAAGTGTGTGGGGTTAGAGCTAGAAATAGCA	1	bc
TAGACACTCG	GAAACACCGGTGCATTCGAAAGTCCGGTCGTAGTGTGGACGTGGGGTTAG	1	bc
AGTGCAGCCT	GAAACACCGGTTCCCGTCCAGTGGGGGTAGAGCTAGAGATAGCAAGTTAA	1	bc
GTGGATGGTT	GAAACACCGGTTCCCGTACAGTGGGGTTAGAGCTAGACATAGCGGGTTAA	1	bc
GCACCACGCC	GAAACACCGGTTTGAACTAGAAATAGCAAGTTAACCTAAGGCTAGTCCGT	1	bc
AGAGGAGCAT	GAAACACCGGTTCCCGTCCAGTGGGGTTAGAGCTAGAAATAGCAAGTTAA	1	bc
TCAAAAGAGG	GAAACACCGGTTATATTTGTAAGTGTGTGGGGTTAGAGCTAGAAATAGCA	1	bc
GTTGAGAATA	GAAACACCGGTTAAGTGGGGTTAGAGCTAGAAATAGCAAGTTAACCTAAG	1	bc
GAGCACCCGA	GAAACACCGGTCGGGGCTACAGCTAGGAATAGCAAGTTCACCTAAGGCTA	1	bc
GTGGGTACTC	GAAACACCGGTTCCCGTCCAGTGGGGTTAGAGCTAGAAATAGCAAGTTAA	1	bc
CGAAACACGC	GAAACACCGGTGCATTCGAAAGTCCGGTCGTAGTGTGGACGTGGGGTTAG	1	bc
CGACGCTCGA	CAAACACCGGTGCATTCGAAAGTCCGGTCGTAGTGTGGACGTGGGGTTAG	1	bc
AATACCCGGA	GAAACACCGGTACCTTTGTTGATGCTGGGTGGAAGGAATGTGGGGTTAGA	1	bc
AATGGAACCT	GAAACACCGGTTCCCGTCCAGTGGGGTTAGAGCTAGAAATAGCAAGTTAA	1	bc
CTGATACGCC	GAAACACCGGTTTACGTTGCATCGGTGTGGGGGTAGAGCTAGAAATAGCA	1	bc
GCGGTACCGC	GAAACGCCGGTTGGGGCCACTCAGTGGTGGGGCTAGAGCTAGAAATAGCA	1	bc
CTCCCTTGCA	GAAACACCGGTGTGGCTGAGAGTCCGGCAATGGTGTGGCTGTGGGGTTAG	1	bc
AAGTGTTGTA	GAAACACCGGTGACATTGGTGGGGTTAGAGCTAGAAATAGCAAGTTAACC	1	bc
CGACCATAGC	GAAACACCGGTGCATTCGAAAGTCCGGTCGTAGTGTGGACGTGGGGTTAG	1	bc
ATAAGCCTTT	GAAACACCGGTCTCGAGTGAGGTGTTCAGGTGGGGTTAGAGCTAGAAATA	1	bc
GGCACGCGAC	GAAACACCGGCGTGGCTGAGAGTCCGGCAATGGTGTGGCTGTGGGGTTAG	1	bc
ATGCCTACAC	GAGACACCGGTTTACGCTGCATCGGTGTGGGGTTAGAGCTAGAAATAGCA	1	bc
AACTGTGGTT	GAAACACCGGTCGATTCATATCGAAACCTTCCCGTGACAGTGGGGTTAGA	1	bc
AAGTCTGCAT	GAAACACCGGTCCGTAGGAGACCCGTTTGGCATGTACCTGTGCGGTTAGA	1	bc
GAGCCACTGG	GAAACACCGGTGCATTCGAAAGTCCGGTCGTAGTGTGGACGTGGGGTTAG	1	bc
ATAACTTAAA	GAAACACCGGTAACTATATTCATGCGATATCGCCGATATCGTGGGGTTAG	1	bc
GCTAGTCGTA	GAAACACCGGTGTACGTATGGACTGAACCAGGGTGTGCAAGTGGGGTTAA	1	bc
AGCGCCCCGC	GAAAAACCGGTGCATTAGAAAGTCCGGTCGTAGTGTGGACGTGGGGTTAG	1	bc
CTGAACGCCA	GCTAGAAATAACAAGTTAACCTAAGGCTAGTCCGTTATCAACTTGAAAAA	1	bc
CGACTCCCCA	GAAACGCCGGTCTCGAGTGAGGTGTTCTGGGGGGGGATAGAGCTATAAAT	1	bc
ATTGCGAAAA	GAAACACCGGTTAGAGCTAGAAATAGCAAGTTAACCTAAGGCTAGTCCGT	1	bc
ACACTCGGGC	GAAACACCGGTACCTTTGTTGATGCTGGGTGGGGTTAGAGCTAGAAATAG	1	bc
GGGAGCTGGC	GAAACACCGGTGTGGCTGAGAGTCCGGCAATGGTGGGGCTGTGGGGATAG	1	bc
GCCATGACCG	GAAACACCGGTCGGGGCCACTCAGTGGTGGGGTTAGAGCTAGAAATAGCA	1	bc
CCGTCCCTCC	GAAACACCGGTGCCCTTACTCTCACCTGATTACTTAATCCGTGGGGATAG	1	bc
TACCTTATTT	GAAACGCCGGTAGCTATATTCATGCGATATCGCCGTATCAGTGGGGTTAG	1	bc
ACGTGTTGTA	GAAACACCGGTGACATTGGGTACAGGGTGGGGTTAGAGCTAGAAATAGCA	1	bc
TCTTTTATCG	GAAACACCAGTCGGGGCCACTCAGTGGTGGGGTTAGAGCTAGAAATAGCA	1	bc
ATGCACCCTC	GAAACACCGGTGTGGCTGAGAGTCCGGCAATGGTGTGGCTGTGGGGTTAG	1	bc
GTGAATCCTT	GAAACACCGGTCTCGAGTGAGGTGTTCAGGGTGGGGTTAGAGCTAGAAAT	1	bc
ACGCCGCGTC	GAAACACCGGTACGACGGAGACCAGAGTGGGATGTATCTGAGGGGGTAGT	1	bc
AACAACCGCC	GAAACACCGGTTTGAACTAGAAATAGCAAGTTAACCTAAGGCTAGTCCGT	1	bc
GTGGCGCGGC	GAAACACCGGTTCACGACGAGCGGGATTAGAGCTAGAAATAGCTAGTTAT	1	bc
ATGCTTCGGC	GAAACACCGGTTTACGGTGCATCGGTGTGGGGTTAAAGCTAGAAATAGCA	1	bc
CGACGCGTAG	GAAACACCGGTCTCGAGTGAGGTGTTCAGGGTGGGGTTAGAGCTAGAAAT	1	bc
CGACATTCGG	GAAACACCGGTCGATTCATATCGAAACCTTCCCGTGACAGTGGGGTTAGA	1	bc
TCAGCTCTGC	GAAACACCGGTTACATTGAGTGGGGTTAGAGCTAGAAATAGCAAGTTAAC	1	bc
AGCGAAGGGC	GAAACACCGGTTTGAACTAGAAATAGCAAGTTAACCTAAGGCTAGTCCGT	1	bc
TGAAGACACG	GAAACACCGGTCGGCGGCAATCGTGGGTGGGGTTAGAGCTAGAAATAGCA	1	bc
ATAACTTAGA	GAAACACCGGTAACTATATTCATGCGATATCGCCGTATCAGTGGGGTTAG	1	bc
AGGCCACTAC	GAAACACCGGTAAATTTGAGGCTCCGGCATGCAGCAGGAGGCTCCGGCAT	1	bc
GTGTGGAGTC	GAAACACCGGTTCCCGTCCAGTGGGGTTAGAGCTAGAAATAGCAAGTTAA	1	bc
AATCGCCGTA	GAAACACCGGTGTACGTATGGACTGAACCAGGGTGTGCAAGTGGGGTTAG	1	bc
GAAGACCATT	CAAAACACCGGTCGGCGGCAATCGTGGGTGGGGTTAGAGCTAGAAATAGC	1	bc
ATACGTATAC	GAAACACCGGTAACTCTATTCATGCGATATTGCCGTAGCGGTGGGGTTAG	1	bc
AGACCGGCGA	GAAACACCGGTGCATTCGAAAGTCCGGTCGTAGTGTGGACGTGGGGTTAG	1	bc
GACGACACGA	GAAACACCGGTCGGCGGCAATCGTGGGTGGGGTTAGAGCTAGAAATAGCA	1	bc
ACCCCAGCCA	GAAACACCGGTAGCAAGTGCGAAATAGCAAGTTAACCTAAGGCTAGTCCG	1	bc
AGATTCTAGA	GAACCACCGGTGCATTCGAAAGTCCGGTCGTAGTGTGGACGTGGGGTTAG	1	bc
GAGGGGCCCA	GAAACACCGGTTCCCGTCCAGTGGGGTTAGAGCTAGAAATAGCAAGTTAA	1	bc
CTGATCCCTT	GAAACACCGGTCTCGAGAGAGGTGTTCAGGGGGGGGTTAGAGCTAGAAAT	1	bc
CCTCGGCCTC	GAAACACCGGTCCGTAGGAGACCCGTGTGGCATGTACCTGTGGGGTTAGA	1	bc
TAATACTCGC	GAAACACCGGTCGGCGGCAATGTGGGGTTAGAGCTAGAAATAGCAAGTTA	1	bc
GTGGCGGATC	GAAACACCGGTTCTCGTCCAGTGGTGGTGGAGCTAGAAATAGCAAGTTAA	1	bc
GTAACCGGCC	GAAACACCGGTACCTTTGTTGATGCTGGGTGGAAGGAATTTTTGTGGGGT	1	bc
TCACGTCTAC	GAAACACCGGTAACTATATTCATGCGATATCGCCGTATCAGTGGGGTTAG	1	bc
AGTCACACGA	GGAACACCGGTGCATTCGAAAGTCCGGTCGTAGTGTGGACGTGGGGTTAG	1	bc
AGACAATCGA	GAAACACCGGTGCATTCGAAAGTCCGGTCGTAGTATGGACGTGGGGTTAG	1	bc
ACACAACGCT	GAAACACCGGTTTGAACTAGAAATAGCAAGTTAACCTAAGGCTAGTCCGT	1	bc
CATTCCGGTC	GAAACACCGGTGCACGTATGTACTGAACCAGGGTGTGTAAGTGGGGATAG	1	bc
GGGAGAGACG	GAAACACCGGTAGCAAGTGCGGGGTTAGAGCTAGAAATAGCAAGTTAACC	1	bc
TCCTTGACCG	GAAACACCGGTCGGGGCCACTCAGTGGTGGGGTTAGAACTAGAAATAGCA	1	bc
GGGCACGCTC	GAAACACCGGTGTGGCTGAGAGTCCGGCAATGGTGTGGCTGTGGGGTTAG	1	bc
ACGGAGCCTA	GAAACACCGGTTCCCGTCCAGTGGGGTTAGAGCTAGAAATAGCAAGTTAA	1	bc
AATAATGCCG	GAAACACCGGTTTGAACTAGAAATAGCAAGTTAACCTAAGGCTAGTCCGT	1	bc
AGTATGGATC	GAAACACCGGTCCGTAGGAGACCCGTAGCAAGTTAACCTAAGGATAGGCC	1	bc
CTCTCCGGCA	GAAACACCGGTGTGGCTGAGAGTCCGGCAATGGTGTGGCTGTGGGGTTAG	1	bc
GGGACACTCA	GAAACACCGGTGTGGCTGAGAGTCCGGCAATGGTGTGGCTGTGGGGTTAG	1	bc
AGAGTCATTT	GAAACACCGGTCTCGAGTGAGGTGATCATGGTGGGGTTAGAGCTAGAAAT	1	bc
GTCCCCCTAC	GAAACACCGGTGTGGCAGAGAGTCCGGCAATGGTGTGGCTGTGGGGTTAG	1	bc
AAATACGATT	GAAACACCGGTCGATTCATATCGAAACCTTCCCGTGACAGTGGGGTTAGA	1	bc
AAAATTCGGG	GAAACACCGGTCGATTCATATCGAAACCTTCCCGTGACAGTGGGGTTAGA	1	bc
CTACGCGGAA	GAAACACCGGTACCTTTGTTGATGCTGGGTGGAAGGAATTTTGTGGGGTT	1	bc
GGAGGAGCCT	GAAACACCGGTTCCCGTCCAGTGGGGTTAGAGCTAGAGATAGCAAGTTAA	1	bc
GAAGAACCTA	GAAACACCAAGTTAACCTAAGGCTAGTCCGTTATCAACTTGAAAAAGTGG	1	bc
GTTTGAGCAT	GAAACACCGGTTAAGCCGAGTGGGGTTAGAGCTAGAAATAGCAAGTTAAC	1	bc
AGTGGAGCCA	GAAACACCGGTTCCCGTCCAGTGGGGTTAGAGCTAGAAATAGCAAGTTAA	1	bc
AAATCCGTTA	GAAACACCGGTCGATTCATATCGAAACCTTCCCGTGACAGTGGGGTTAGA	1	bc
ACGTTTACCG	GAAACACCGGTCGGGGCCACTCAGTGGTGGGGTTAGAGCTAGAAATAGCA	1	bc
ATCTATCGCG	GAAACACCGGTTATATTTGTAAGTGTTGTGGGGTTAGAGCTAGAAATAGC	1	bc
ATAGACTATC	GAAACACCGGCGCATTCGAAAGTCCGGTCGTAGTGTGGACGTGGGGTTAG	1	bc
ACTACTCGTC	GAAACACCGGTACCTTTGTTGATGCTGGGTGGAAGGATGGGGTTAGAGCT	1	bc
ATAACATATA	GAAACACCGGTAACTATATTCATGCGATATCGCCGTATCAGTGGGTTAGA	1	bc
GATTAGCTAT	GAAACACCGGTTAGAGCTAGAAATAGCAAGTTAACCTAAGGCTAGTCCGT	1	bc
GAGATCCTCG	GAAACACCGGTGCATTCGAAAGTCCGGTCGTAGTGTGGACGTGGGGTTAG	1	bc
CCTCGACGCC	GAAACACCGGTGTACGTATGGACTGAACCAGGGTGTGCAAGTGGGGTTAG	1	bc
AGGAGAACCG	GAAACACCGGTCGGCGGCAATCGTGGGTGGGGTTAGAGCTAGAAATAGCA	1	bc
AAGACAGTAG	GAAACACCGGTGCATTCGAAAGTCCGGTCGTAGTGTGGACGTGGGGTTAG	1	bc
GCCTGTACCG	GAAACACCGGTCGGGCCCACTCAGTGGTGGGGTTAGAGCTAGAAATAGCA	1	bc
TTGAGGGCAC	GAAACACCGGTTAAGCAGGGGTTAGAGCTAGAAATAGCAAGTTAACCTAA	1	bc
CCTATCCCCC	GAAACACCGGTCGTGGCCACTCCGCGGTGGGGTTAGAGCTAGAAATAGCA	1	bc
AGGCCTCTAC	GAAACACCGGTAAATTTGAGGCTCCGGCATGCAGGAGGCCGTGGGGTTAG	1	bc
TATATTGGTT	GAAACACCGGTTATATTTGTTAGAGAGTGGGGTTAGAGCTAGAAATAGCA	1	bc
GAATGGGGTA	GAAACACCGGTGCCCTTACTCTCACCTGATTACTTAATCTGTGGGGTTAG	1	bc
GATATCCCCT	GAAACACCGGTCTCGGATGAGGCGATCAGGGGGTAGTTATAGCTAGAACT	1	bc
ATGCCTCCCT	GAAACACCGGTTTACGTTGCATCGGTGTGGGGTTAGAGCTAGAAATAGCA	1	bc
TCTCTAGGGG	GAAACACCGGAGTGGGGTTAGAGCTAGAAATAGCAAGTTAACCTAAGGCT	1	bc
CGCACAACGC	ATGTGGGGTTAGAGCTAGAAATAGCAAGTTAACCTAAGGCTAGTCCGTTA	1	bc
CAAGCCTTTA	GAAACACCGGTGCCCTTACTCTCACCTGATTACTTAATCCGTGGGGTTAG	1	bc
ATCTTTACCG	GAAACACCGGTCGGGGCCACTCAGTGGTGGGGTTAGAGCTAGAAATAGCA	1	bc
ATTAAGTAAG	GAAACACCGGTTACATTGAGATTGGGGTTAGAGCTAGAAATAGCAAGTTA	1	bc
TAATTTATTA	GAAACACCGGTAACTATATTCATGCGATATCGCCGTATCAGTGGGGTTAG	1	bc
TAGCACAGAC	GAAACACCGGTAGCAAGTGGGGTTAGAGCTAGTAATAGCGACTTAACCTA	1	bc
AGCCTCTTGC	GAAACACCGGTTCATTCGAAGGTCCGGTCGTAGTGTGGACGTGGGGTTAG	1	bc
TACACGGCCC	GAAACACGGGTTAGAGCTAGAAATAGCAAGTTAACCTAAGGCTAGTCCGT	1	bc
GGCATACTTC	GAAACACCGGTGTGGCTGAGAGTCCGGCAATGGTGTGGCTGGGGGGTTAG	1	bc
GCATTGTCGT	GAAACACCGGTGTACGTATGGACTGAACCAGGGTGTGCAAGTGGGGTTAG	1	bc
AAGTCGGCCT	GAAACACCGGTCCGTAGGAGACCCGTGTGGCATGTACCTGTGGGGTTAGA	1	bc
ACAAAACGCC	GAAACACCGGTTTGAACTACCTAGTTGTTAGAGCTAGAAATAGCAAGTTA	1	bc
GCACATCCTT	GAAACACCGGTCTCGAGTGAGGTGTTCAGGGTGGGGTTAGAGCTAGAAAT	1	bc
TACCCTTCAC	GAAACACCGGTAACTATCTTCATGCGATATCGCCGTATCAGTGGGGTTAG	1	bc
GGAAGACACG	GAAACACCGGTAAGGCTAGTCCGTTATCAACTTGAAAAAGTGGCACCGAG	1	bc
AGACACCGGG	GAAACACCGGTGCATTCGAAAGTCCGGTCGTAGTGTGGACGTGGGGTTAG	1	bc
CACTTAAGAC	GAAACACCGGTAACTATATTCATGTGTTATGGTAGAGCCAGAGGGACCAG	1	bc
TTTTGTATGT	GAAACACCGGTTACATTGAGATTAGAGCTAGAAAAGGCTAGTCAGTTATC	1	bc
CAGCGCATAA	GAAACACCGGTTAAGCCGAGTGGGGTTAGAGCTAGAAATAGCAAGTTAAC	1	bc
AAGTGATGAC	GAAACACCGGTGACATTGAATAGCAAGTTAACCTAAGGCTAGTCCGTTAT	1	bc
GACGACACTG	GAAACACCGGTCGGCGGCAACGTGGGGTTAGAGCTAGAAATAGCAAGTTA	1	bc
AGTAGCATAA	GAAACACCGGTTAAGCCGATGTGCTTTTTTCCTGCAGGTTATGCTCAAGA	1	bc
AATCGCTCGC	GAAACACCGGTGCATTCGAAAGTCCGGTCGTAGTGTGGACGTGGGGTTAG	1	bc
ACGCATCCTT	GAAACACCGGTCTCGAGTGAGGCGTTCAGGGTGGGGTTAGAGCTAGAAAT	1	bc
CCGTTCGGGA	GAAACACCGGTCGATTCATATCGACACCTTCGCGTGACAAAGGGGGATAG	1	bc
ATCAATCGAG	GAAACACCGGTTATATTTGTAAGTGGGGTTAGAGCTAGAAATAGCAAGTT	1	bc
AAACAAAGCC	GAAACACGGGTTAGAGCTAGAAATAGCAAGTTAACCTAAGGCTAGTCCGT	1	bc
TAAACTAAGT	GAAACACCGGTTACATTTAGGGCTAGAGCTAGAAATAGCAAGTTAAACTA	1	bc
AATTGAGCAT	GAAACACCGGTTAAGCCGAGGTGGGGTTAGAGCTAGAAATAGCAAGTTAA	1	bc
TAACAACGCC	GCTAGAAATAGCAAGTTAACCTAAGGCTAGTCCGTTATCAACTTGGAAAA	1	bc
ATTCGCATAA	GAAACACCGGTTAAGCCGAGGAAAGTGGGGTTAGAGCTAGAAATAGCAAG	1	bc
GTGCTTCCTC	GAAACACCGGTTCCCGTCCAGTGGGGTTAGAGCTAGAAATAGCAAGTTAA	1	bc
ACGAATACTT	GAAACACCGGTCTCGAGTGAGGTGTTCAGGTGGGGTTAGAGCTAGAAATA	1	bc
CTACACGCCT	GAAACACCGGTACCTTTGATGATGCTGGGTGGAAGGAATGGTGGGGATAG	1	bc
GGCATAGTCA	GAAACACCGGTAGCAAGTGAGTCGGTGCTTTTTTTCCTGCAGGCGTCTTT	1	bc
AGGAGACCGC	GAAACACCGGTCGGGGCCACTCAGTGGTGGGGTTAGAGCTAGAAATAGAA	1	bc
GGACTCATCC	GAAACACCGGTGTGGCTGAGAGTCCGGCAACGGTGTGGCTGTGGGGGTAG	1	bc
AGCCACGCGC	GAAACACCGGTGCATTCGAAAGTCCGGTCGTAGTGTGGACGTGGGGTTAG	1	bc
AAATCGTCGT	GAAACACCGGTGTACGTATGGACTGAACCAGGGTGTGCAAGTGGGGTTAG	1	bc
GTAAAAGCCC	GAAACACCGGTTTGAACTAGAAATAGCAAGTTAACCTAAGGCTAGTCCGT	1	bc
GCATACCGGT	GAAACACCGGTCGGCGGCAATCGTGGGTGGGGTTAGAGCTAGAAATAGCA	1	bc
CGAGTTACCT	GAAACACCGGTGACATTGGGTACAGGTTAGAGCTAGAAATAGCAAGTTAA	1	bc
CGATCATCTA	GAAACACCGGTGCATTCGAAAGTCCGGTCGTAGTGTGGACGTGGGGGTAG	1	bc
AGTGGATCAT	GAAACACCGGTTCCCGTCCAGTGGGGTTAGAGCTAGAAATAGCAAGTTGA	1	bc
ATCAACAAGC	GAAACACCGGTTATATTTGTAAGTGTGTGGGATTATAGCTAGAAATAGCA	1	bc
GGCAGACTTC	GAAACACCGGTGTAGCTGAGAGTCCGGCAATGGTATGGCTGGGGGGATCA	1	bc
AATGACGTAC	GAAACACCGGTGCCCTTACTCTCACCTGATTACTTAATCCGTGGGGTTAG	1	bc
ACCTCGTCGT	GAAACACCGGTGTACGTATGGACTGAACCAGGGTGTGCAAGTGGGGTTAG	1	bc
TTACTTAGCC	GAAACACCGGTAACTATATTCATGCGATATCGCCGTATCAGTGGGGTTAG	1	bc
GAACCTTCGT	GAAACACCGGTGCATTCGAAAGTCCGGTCGTAGTGTGGACGTGGGGTTAG	1	bc
ACACCCGAGA	GAAACACCGGTTCGTTCGAAAGTCCGGTCGTAGTGTGGACGTGGGGTTAG	1	bc
AGCACACGCC	GAAACACCGGTGTGGCTGAGAGTCCGGCAATGGTGTGGCTGTGGGGGTAG	1	bc
GATCGAGAGA	GAAACACCGGTAGCAAGTGCGAGACGTGTTTGTGGGGTTAGAGCTCGAAA	1	bc
ATGTTACGCA	GAAACACCGGTTTACGTTGCATCGGGGTTAGAGCTAGAAATAGCAAGTTA	1	bc
GGAAACTACA	GAAACACCGGTAAATTTGAGGCTCCGGCATGCAGGAGGCCGTGGGGTTAG	1	bc
GATGACGAGC	GAAACACCGGTCGGGGTTAGAGCTAGAAATAGCAAGTTAACCTAAGGCTA	1	bc
GGACCCCTTC	GAAACACCGGTGTGGCTGAGAGTCCGGCAATGGTGTGGCTGTGGGGTTAG	1	bc
GATGACAAGC	GAAACACCGGTCGGCGGGTGGGGTTATAGCTAGAAAGAGGAAGTTAAACT	1	bc
CGGTTCGGTT	GAAACACCGGTCGATTCATATCGAAACCTTCCCGTGACAGAGGGGTTAGA	1	bc
AATTCTTGTC	GAAACACCGGTGTACGTATGGACTGAACCAGGGTGTGCAAGGGGGGTTAG	1	bc
CAGCTTAGTC	GAAACACCGGTTTACGGTGCATCGGGGTGTGGTTAGAGCTAGTAATAGCA	1	bc
AACTCGTCGT	GAAACACCGGTGTACGTATGGACTGAACCAGGGTGTGCAAGTGGGGTTAG	1	bc
AACGTTAGAC	GAAACACCGGTGCCCTTACTCTCACCTGATTACTTAATCCGTGGGGTTAG	1	bc
CGGTTTCTTC	GAAACACCGGTCTCGAGTGGGGGGTTCAGAGCGGGGTTAGAGCTAGAAAT	1	bc
ACCGTCCCAC	GAAACACCGGTGCCCTTACTCTCACCTGATTACTTAATCCGTGGGGTTAG	1	bc
CGAAGCGTTC	GAAACACCGGTCTCGCGTGAGGTGATCAGGTTGGGGTTAGAGCTAGAAAT	1	bc
ACGATTGGAT	GAAAAACCGGTTTACGTTGCATCGGTGTGGGGTTAGAGCTAGAAATAGCA	1	bc
AAACACGCCC	GAAACACCGGTTTGAACTAGAAATAGCAAGTTAACCTAAGGCTAGTCCGT	1	bc
TTAATTATGG	GAAACACCGGTTACATTGAGGGGTTAGAGCTAGAAATAGCAAGTTAACCT	1	bc
TTTGGCTATG	GAAACACCGGTTACATTGAGATTGGGGTTAGAGCTAGAAATAGCAAGTTA	1	bc
GCTAGCGAGA	GAAACACCGGTTATATTTGTAAGTGTTGTGGGGTTAGAGCTAGAAATAGC	1	bc
AACGGCCCAG	GAAACACCGGTGCCCTTACTCTCACCTGATTACTTAATCCGTGGGGTTAG	1	bc
AAAAACATAC	GAAACACCGGTAACTATATTCATGCGATATCGCCGTATCAGTGGGGTTAG	1	bc
ACAAAATGCA	GCTAGAAATAGCAAGTTAACCTAAGGCTAGTCCGTTATCAACTTGAAAAA	1	bc
TCACTTATGA	GAAACACCGGTAACTATATTCATGCGATATCGCCGTATCAGTGGGGTTAG	1	bc
ACGAATCATT	GAAACACCGGTCTCGAGTGAGGTGTTCAGGGTGGGGTTAGAGCTAGAAAT	1	bc
ACACAGCGCC	GAAACACCGGTTTGAACTAGAAATAGCAAGTTAACCTAAGGCTAGTCCGT	1	bc
ACTAAAGTGG	GAAACACCGGTTATATTTGTAAGCGTGTGGGGTTAGAGCTAGAAATAGCA	1	bc
GAGGCCACGC	GAAACACCGGTCGGCGGCAATCGTGGTTTTTTTCCTGCAGGGCGGGTCTT	1	bc
TTGAGCGTGT	GAAACACCGGTTAAGCCGAGTGGGGTTAGAGCTAGAAATAGCAAGTTAAC	1	bc
ATTAGCAATG	GAAACACCGGTTACATTGAGGGTTAGAGCTAGAAATAGCAAGTTAACCTA	1	bc
AAGACGCGCC	GAAACACCGGTACCTTTGTTGAGGCTGGGTGGGGTTAGAGCTAGATATAG	1	bc
CGCATGGCTC	GAAACACCGGTTTGAACTACCTAGTTCAAGTGGGGATAGAGCTAGAAATA	1	bc
GAACCCCTCC	GAAACACCGGTGTGGCTGAGAGTCCGGCAATGGTGTGGCTGTGGGGTTAG	1	bc
CAGTGAACGC	GAAACACCGGTCGGGGCCACTCAGTGGTGGGGTTAGAGCTAGAAATAGCA	1	bc
ACGAATAGCT	GAAACACCGGTCTCGAGTGAGGTGTTCAGGTGGGGTTAGAGCTAGAAATA	1	bc
ACGAGTCCTT	GAAACACCGGTCTCGAGTGAGGTGTTCAGGGTGGGGTTAGAGCTAGAAAT	1	bc
GGTGCCGTCC	GAAACACCGGTGTGGCTGAGAGTCCGGCAATGGTGTGGCTGTGGGGTTAG	1	bc
GGGCAACCTC	GAAACACCGGTGTGGCTGAGAGTCCGGCAATGGTGTGGCTGTGGGGTTAG	1	bc
ATAAACATGT	GAAACACCGGTTACATTGAGTGGGGTTAGAGCTAGAAATAGCAAGTTAAC	1	bc
GTTCCGCCTC	GAAACACCGGTTCCCGTCCAGTGGGGTTAGAGCTGGAAAAAGCAAGCTAA	1	bc
ATCTATCGCT	GAAACACCGGTTATATTTGTAAGTGTTGTGGGGTTAGAGCTAGAAATAGC	1	bc
GTGCATGCTC	GAAACACCGGTTCCCGTCCAGTGGGGTTAGAGCTAGAAATAGCAAGTTAA	1	bc
AGCTTTATCT	GAAACACCGGTGACATTGGGTACAGGGGTGGGGTTAGAGCTAGAAATAGC	1	bc
ATCCTCCTTT	GAAACACCGGTCTCGAGTGAGGTGTTCAGGGTGGGGTTAGAGCTAGAAAT	1	bc
ACGTGCTGTC	GAAACACCGGTGACATTGGGTTAGAGCTAGAAATAGCAAGTTAACCTAAG	1	bc
CGACTTGGCT	GAAACACCGGTTACATTTGGATCAGAGTCCGGTATGAACTTGAAAAAGCG	1	bc
CTATACGCTC	GAAACACCGGTACCTTTTCTGATTGGGGTTAGAGCTAGAAATAGCAAGTT	1	bc
GAGGTCTATA	GAAACACCGGTAAATTTGAGGCTCCGGCATGCAGGAGGCCGTGGGGTTAG	1	bc
AACCACACCC	GAAACACCGGTTTGAACTACCTAGTTCAAACCGGAGGGGTTAGAGCTAGA	1	bc
AGACCGGAGC	GAAACACCGGTGCATTCGAAAGTCCGGTCGTAGTGTGGACGTGGGGTTAG	1	bc
ATCTGTAACG	GAAACACCGGTCGGGGCCACTCAGTGGTGGGGTTAGAGCTAGAAATAGCA	1	bc
GCATCGGCGT	GAAACACCGGTGTACGTATGGACTGAACCAGGGTGTGGGGTTAGAGCTAG	1	bc
GCAGCGTGGT	GAAACACCGGTGTACGTATGGACTGAACCAGGGTGTGCAAGTGGGGTTAG	1	bc
AAAGACGCGA	GAAACACCGGTCGGCTGCTATCGAGAGCTTGGTGAGAGCGAGGAATTACA	1	bc
CACATCACAC	GAAACACCGGTTTGAACTACCTAGTTCAAACCGGTGGGGTTAGAGCTAGA	1	bc
GTACCCAATA	GAAACACCGGTAAATTTGAGGCTCCGGCATGCAGGAGGCCGTGGGGCTAG	1	bc
TGTACTGTCT	GAAACACCGGTGACATTGGGTGGGGTTAGAGCTAGAAATAGCAAGTTAAC	1	bc
CAGATCCTAT	GAAACACCGGTGTGGCTGAGAGTCCGGCAATGGTGTGGCTGTGGGGATCG	1	bc
CATCGGGGAC	GAAACACCGGTGTACGTATGGACTGAACCAGGGTGTGCAAGTGGGGTTAG	1	bc
TCGTGGTGTC	GAAACACCGGTGACATTGGGTACAGGGTTAGAGCTAGAAATAGCAAGTTA	1	bc
GATGTCGAGG	GAAACACCGGTTATATTTGTAAGTGTGTGGGGTTAGAGCTAGAAATAGCA	1	bc
AGCGCCTCGG	GAAACACCGGTGCATTCGCACGTACGTTCGTAGTGTGGACGTGGGGTTAG	1	bc
AATTAGCTAT	GAAACACCGGTTACATTGAGGGGTTAGAGCTAGAAATAGCAAGTTAACCT	1	bc
AGACTGCTGC	GAAACACCGGTGCATTCGAAAGTCCGGTCGTAGTGTGGACGTGGGGTTAG	1	bc
GTAGCTACGC	GAAACACCGGTCGGCGGCGGAGGGGCTAGGGGTTGGAATTGGAAGTTACA	1	bc
ATGAGACTAA	GAAACACCGGTTAAGCCGAGTGGGGTTAGAGCTAGAAATAGCAAGTTAAC	1	bc
TGGCTTATCC	GAAACACCGGTAACTATATTCATGCGATATCGCCGTATCAGTGGGGTTAG	1	bc
AGATTTGTCT	GAAACACCGACAGGGTGGGGTTAGAGCTAGAAATAGCAAGTTAACTTAAG	1	bc
CACGGCCGAC	GAAACACCGGTGCCCTTACTCTCACCTGATTACTTAATCCGTGGGGTTAG	1	bc
ATTGAGAATA	GAAACACCGGTTAAGCCGAGGTTAGAGCTAGAAATAGCAAGTTAACCTAA	1	bc
ATGCTGAGGC	GAAACACCGGTTTCCGGTGCATCGGTTGTGGGGTTAGAGCTAGAAATAGC	1	bc
CAGCGTTGAC	GAAACACCGGTGTACGTCTGGACTGAACCAGGGGGTGCAAGTGGGGTTAG	1	bc
AGGCCACTAC	GAAACACCGGTAAATTTGAGGCTCCGGCATGCAGGAGGCCGTGGGGTTAG	1	bc
GACTTTACCG	GAAACACCGGTCGGGGCCACTCAGTGGTGGGGTTAGAGCTAGAAATAGCA	1	bc
AGGCTACTAC	GAGACACCGGTAAATTTGAGGCTCCGGCATGCAGGAGGCCGTGGGGTTAG	1	bc
AGAGGAGCCT	GAAACACCGGTTCCCGTCCAGTGGGGTTAGAGCTAGAAATAGCAAGTTAA	1	bc
GGGCGCAGTA	GAAACACCGGTGTGGCTGAGAGTCCGGCAATGGTGTGGCTGTGGGGTTAG	1	bc
TGTTATTGGG	GAAACACCGGTTTTCGTTGCATCGGTGTGGGGTTAGAGCTAGAAATAGCA	1	bc
ACATGGGGGT	GAAACACCGGTCGATTCATATCGAAACCTTCCCGTGACAGTGGGGTTAGA	1	bc
TTCGATATGA	GAAACACCGGTTACATTGAGGGTTAGAGCTAGAGATAGCAAGTTAACCTA	1	bc
ATTAGCTGTG	GAAACACCGGTGGGGATAGAGCTAGAAATAGCAAGTTAACCTAAGGCTAG	1	bc
AGTGGGGCGT	GAAACACCGGTTCCCGTCCAGTGGGGTTAGAGCTAGAAATAGCAAGTTAA	1	bc
AAGACGGCTG	GAAACACCGGTTACATTGAGGGTTAGAGCTAGAAATAGCAAGTTAACCTA	1	bc
GGAGCTCTCC	GAAACACCGGTGTGGCTGAGAGTCCGGCAATGGTGTGGCTGTGGGGTTAG	1	bc
GACAAAGTCC	GAAACACCGGTAGCAAGTGAGTCGGTGCTTTTTTTCCTGCAGGTGTCTGT	1	bc
TCTACCCGGT	GAAACACCGGTACCTTTGTTGATGCTGGGTGGAAGGTGGGGTTAGAGCTA	1	bc
ATTAGTTATG	GAAACACCGGTTACATTGAGGGGTTAGAGCTAGAAATAGCAAGTTAACCT	1	bc
ACCCCCTGCA	GAAACACCGGTGTGGCTGAGAGTCCGGCAATGGTGGGGCTGTGGGGTTAG	1	bc
TGGCGAATAA	GAAACACCGGTTAAGCCGAGGAGTTAGAGCTAGAAATAGCAAGTTAACCT	1	bc
ATGCGTAGAG	GAAACACCGGTTTACGTTGCATCGGTGTGGGGTTAGAGCTAGAAATAGCA	1	bc
CAGCAAAGCT	GAAACACCGGTTTACGTTGCATCGGTGTGGGGTTAGAGCTAGAAATAGCA	1	bc
ATGGTTGTCT	GAAACACCGGTTTACGTTGCATCGGTTGTGGGGTTAGAGCTAGAAATAGC	1	bc
AGGAAGACCC	GAAACACCGGTCGGCGGCAATCGTGGGTGGGGTTAGAGCTAGAAATAGCA	1	bc
AACAAAGGCT	GAAACACCGGTAAATTTGAGGCTCCGGCATGCAGGAGGCCGTGGGGTTAG	1	bc
GGTGAAGTCC	GAAACACCGGTGACATTGGGTGGGGGTAGAGCTGGAAAAAGCAAGTTAAT	1	bc
GCTACTGGGC	GAAACACCGGTACCTTTGTTGATGCTGGGTGGGGTTAGAGCTAGAAATAG	1	bc
GAGAACACCC	GAAACACCGGTTTGAACCGGTGGGGTTAGAGCTAGAAATAGCAAGTTAAC	1	bc
GCCTTTCCCG	GAAACACCGGTCGGGGCCAGAAATAGCAAGTTAACCTAAGGCTAGTCCGT	1	bc
AGACACCGAC	GAAACACCGGTAGCAAGTGGGGTTAGAGCTAGAAATAGCAAGTTAACCTA	1	bc
AAGTTACCGC	GAAACACCGGTCGGGGCCACTCAGTGGTGGGGTTAGAGCTAGAAATAGCA	1	bc
CGCGTTTGCT	GAAACACCGGTGACATTGGGTACGGGGTGGGGTTAGAGCTAGAAATAGCA	1	bc
GTAGAGCTAC	GAAACACCGGTTCCCGTCCAGTGGGGTTAGAGCTAGAAATAGCAAGTTAA	1	bc
CGCTTTGTTT	GAAACACCGGTGACATTGGGTACGGGGACAGAGCTAGTAATAGCAAGCTA	1	bc
ATGCCTAGTA	GAAACACCGGTGGTAGCAAGTTAACCTAAGGCTAGTCCGTTATCAACTTG	1	bc
ACAGCACTAC	GAAACACCGGTGCCCTTACTCTCACCTGATTACTTAATCCGTGGGGTTAG	1	bc
CATAGTTGTT	GAAACACCGGTGTACGTATGGACTGAACCAGGGTGTGCAAGTGGGGTTAG	1	bc
TATGCTATGC	GAAACACCGGTTACATTGAGGGTTAGAGCTAGAAATAGAAAGTTATCCTA	1	bc
ATACTCGGAA	GAAACACCGGTACCTTTGTTGATGCTGGGTGGGGTTAGAGCTGGAAATAG	1	bc
AACACGGCCC	GAAACACCGGTTTGAACTACCTAGAAATAGCAAGTTAACCTAAGGCTAGT	1	bc
GGTCTGCGTT	GAAACACCGGTCCGTAGGAGACCCGTGTGGCATGTACCTGTGGGGTTAGA	1	bc
GTGCTACTGC	GAAACACCGGTTTACGCCGCACAGGGTGGGGGGTTAGAGTTAGAAATAGA	1	bc
ATAAATTATA	GAAACACCGGTAACTATATTCATGCGATATCGCCGTATCAGTGGGGTTAG	1	bc
TGTGTTACGC	GAAACACCGGTTACATTGAGGGTTAGAGCTAGAAATAGCAAGTTAACCTA	1	bc
GACGACCGGA	GAAACACCGGTCGGCGGCAATCGTGGGTGGGGTCAGAGCTAGAAATAGCA	1	bc
ACTAAGCGGC	GAAACACCGGTACCTTTGTTGATGCTGGGATGATGGAGGTTAGAGCTAGA	1	bc
CGGAGTTTTT	GAAACACCGGTCTCGAGCGAGGTGGTAGGGGTGGGGTTAGAGCTAGAAAT	1	bc
GCCTGTATTC	GAAACACCGGTGACATTGGGTTCAGGGTTAGAGCTAGAAATACCAAGTTA	1	bc
TTATCGTCGT	GAAACACCGGTGTACGTATGGACTGAACCAGGGTGTGCAAGTGGGGTTAG	1	bc
CACGAACGGT	GAAACACCGGTGCCCTTACTCTCACCTGATTACTTAATCCGTGGGGTTAG	1	bc
TCATCGGCGT	GAAACACCGGTGTACGTATGGACTGAACCAGGGTGTGCAAGTGGGGTTAG	1	bc
CTTAGGCCTC	GAAACACCGGTCCGTAGGAGACCCGTGTGGCATGTACCTTGTGGGGATAG	1	bc
ACGAGTTGTC	GAAACACCGGTGACATTGGGTACAAATAGAGCTAGAAATAGCAAGTTAAC	1	bc
CGGATCGTTA	GAAACACCGGTCTCGAGTGAGGTGTTCAGGGTGGGGTTAGAGCTAGAAAT	1	bc
CGCCTCGCCC	GAAACACCGGTTTCAACTAACTCGTTCAAACCGGTGGGGTTAGAGCTAGA	1	bc
ATTCTGACTT	GAAACACCGGTCCGTAGGAGACCCGTGTGGGGTGAGACCGAGGGGTAACA	1	bc
CACGTCCCAC	GAAACACCGGTGCCCTTACTCTCACCTGATTACTTAATCCGTGGGGTTAG	1	bc
TCGAATCATT	GAAACACCGGTCTCGAGTGAGGTGTTCAGGGTGGGGTTAGAGCTAGAAAT	1	bc
AACTACGGCT	GAAACACCGGTCTGTTCTTATCGAAACCTTCCCATGTCAGTGGGGTTAGA	1	bc
ACTACTCCTT	GAAACACCGGTCTCGAGTGAGGTGTTCAGGGTGGGGTTAGAGCTAGAAAT	1	bc
AATATCGCGG	GAAACACCGGTTATATTTGTAAGTGTGTGGGGTTAGAGCTAGAAATAGCA	1	bc
GTGGGCATGA	GAAACACCGGTTAAGCCGAGGAGTTAGAGCTAGAAATAGCAAGTTAACCT	1	bc
ATGACTAGAT	GAAACACCGGTTTACGTTGCATCGGTGTGGGGTTAGAGCTAGAAATAGCA	1	bc
ACTACTCGGT	GAAACACCGGTACCTTTGTTGATGCTGGGTGGAAGGGGTTAGAGCTAGAA	1	bc
AATGCGCTTC	GAAACACCGGTGCCCTTACTCTCATCTGATTACTTAATCCGTGGGGTTAG	1	bc
GGAACACTCA	GAAACACCGGTGTGGCTGAGAGTCCGGCAATGGTGTGGCTGTGGGGTTAG	1	bc
TAGGGTATGT	GAAACACCGGTTACATTTGAGGGTTAGAGCTAGAAATAGCAAGTTAACCT	1	bc
GAAAACAAGC	GAAACACCGGTCGGCGGCAATGTGGGGTTAGAGCTAGAAATAGCAAGTTA	1	bc
GACATGCGGT	GAAACACCGGTCGATTCATATCGAAACCTTCCCGTGACAGTGGGGTTAGA	1	bc
AAACGACCTC	GAAACACCGGTGCCCTTACTCTCACCTGATTACTTAATCCGTGGGGTTAG	1	bc
GCCATTCGGT	GAAACAAGTTAACCTAAGGCTAGTCCGTTATCAACTTGAAAAAGTGGCAC	1	bc
ATTAGATATG	GAAACACCGGTTACATTGAGGGGTTAGAGCTAGAAATAGCAAGTTAACCT	1	bc
AACTTTACCG	GCAACACCGGTCGGGGCCACTCAGTGGTGGGGTTAGAGCTAGAAATAGCA	1	bc
AGGGTTGGCC	GAAACACCGGTGACATTGGGTACAGGGTGGGGTTAGAGCTAGAAATAGCA	1	bc
ATACAACGCC	GAAACACCGGTTTGAACTAGAAATAGCAAGTTAACCTAAGGCTAGTCCGT	1	bc
AGTGGCAACT	GAAACACCGGTTCCCGTCCAGTGGGGTTAGAGCTAGAAATAGCAAGTTAA	1	bc
AGTGTGGCCC	GAAACACCGGTGACATTGGGTGGGGTTAGAGCTAGAAATAGCAAGTTAAC	1	bc
TACATTCGCA	GAAACACCGGTAAATTTGAGGCTCCGGCATGCAGGAGGCGTGGGGTTAGA	1	bc
CTTGTGTTCT	GAAACACCGGTGACCTTGGGTGGGGTTAGAGCTCGAAATAGCAGGTTAAC	1	bc
GGCATAGTCC	GAAACACCGGTGTGGCTGAGAGTCCGGCAATGGTGTGGCTGTGGGGTTAG	1	bc
AACATTGTCG	GAAACACCGGTGTACGTATGGACTGAACCAGGGTGTGCAAGTGGGGTTAG	1	bc
AACATTAGCT	GAAACACCGGTTTACGTTGCATCGGTGTGGGGTTAGAGCTAGAAATAGCA	1	bc
ATGTATCGAG	GAAACACCGGTTATATTTGTAAGGGGGTTAGAGCTAGAAATAGCAAGTTA	1	bc
GCTGCATAGC	GAAACACCGGTTTACGTTGCATCGGGGTTAGAGCTAGAAATAGCTAGTTA	1	bc
TTTGAGCCTA	GAAACACCGGTTAAGCCGATGTGCTTTTTTCCTGCAGGTTATGCTCAAAA	1	bc
AAGGCTGTAC	GAAACACCGGTGCCCTTACTCTCACCTGATTACTTAATCCGTGGGGTTAG	1	bc
AAACGCAATA	GAAACACCGGTGCCCTTACTCTCACCTGATTACTTAATCCGTGGGGTTAG	1	bc
GCGAGACAGG	GAAACACCGGTTATATTTGCAAGAGTGTGGGGTTAGAGCTAGAAATAGCA	1	bc
ATGTATGCCT	GAAACACCGGTCCGTAGGAGACCCGTGTGGCATGTACCTGTGGGGTTAGA	1	bc
ATAAACTAGA	GAAACACCGGTGCATTCGAAAGTCCGGTCGTAGTGTGGACGTGGGGTTAG	1	bc
AAAGTTCTAC	GAAACACCGGTGCCCTTACTCTCACCTGATTACTTAATCCGTGGGGTTAG	1	bc
TGAGACAGAC	GAAACACCGGTAGCAAGTGGGGTTAGAGCTAGAAATAGCAAGTTAACCTA	1	bc
GATTGAGCAT	GAAACACCGGTTAAGCCGAGGGGTTAGAGCTAGAAATAGCAAGTTAACCT	1	bc
ACTACTCGGA	GAAACACCGGTTTGAACTACCGGGGTTAGAGCTAGAAATAGCAAGTTAAC	1	bc
ATTAGATATG	GAAACACCGGTTACATTGAGTGGGGTTAGAGCTAGAAATAGCAAGTTAAC	1	bc
GCTCGTCGCT	GAAACACCGGTGTACGTATGGACTGAACCAGGGTGTGCAAGTGGGGTTAG	1	bc
GGCAGCGTTC	GAAACACCGGTGTGGCTGAGAGTCCGGCAATGGTGTGGCTGTGGGGTTAG	1	bc
AACTTTACCG	GAAACACCGGTCGGGGCCACTCAGTGGTGGGGTTAGAGCTAGAAGTAGCA	1	bc
CATTGAGCAT	GAAACACCGGTTAAGCCGAGTGGGGTTAGAGCTAGAAATAGCAAGTTAAC	1	bc
CAACATTCGG	GAAACACCGGTCGATTCATATCGAAACCTTCCCGTGACAGTGGGGTTAGA	1	bc
ACACAACGCT	GCTAGAAATAGCAAGTTAACCTAAGGCTAGTCCGTTATCAACTTGAAAAA	1	bc
CCCCCCGCCC	GAAACACCGGTTATATTTGTAAGTGTGTGGGGATAGAGCTAGAAATAGCA	1	bc
TAGTCTGCAT	GAAACACCGGTCCGTAGGAGACCCGTGTGGCATGTACCTGTGGGGTTAGA	1	bc
AGCTTTACCG	GAAACACCGGTCGGGGCCACTCAGTGGTGGGGTTAGAGCTAGAAATAGCA	1	bc
ACATGCAGTA	GAAACACCGGTCGATTCCTATCGAAACCTTCCCGAGACAGTGGGGTTAGA	1	bc
ACATTCTGAC	GAAACACCGGTCGATTCATATCGAAACCTTCCCGTGACAAGTGGGGTTAG	1	bc
CAATACGGGC	GAAGCACCGGTTTGAACTACCTAGAGCTAGAAATAGCAAGTTAACCTAAG	1	bc
TGGATTGTCT	GAAACACCGGTGACATTGGGAGAGCTAGAAATAGCAAGTTAACCTAAGGC	1	bc
GTGGAACCGA	GAAACACCGGTTCCCGTCCCGTGGGGTTAGAGCTAGAACTAGCAAGTTCA	1	bc
CAATTGCTGA	GAAACACCGGTCGGGGCCACTCAGTGGTGGGGTTAGAGTTAGAAATATAG	1	bc
GACGCTCTAT	GAAACACCGGTGCCCTTACTCTCACCTGGTTACTTAATCCGTGGGGTTAG	1	bc
ACTATGCCTG	GAAACACCGGTCCGTAGGAGACCCGTGTGGCATGTCCCTGTGGGGTTAGA	1	bc
AGTCGTCCGA	GAAACACCGGTCCGTAGGAGACCCGTGTGGCATGTACCTGTGGGGTTAGA	1	bc
GAGGACTGGG	GAAACACCGGTCGGCGGCAATCGGGGGTGGGGGTAGAGCTAGGAATAGCA	1	bc
TAGAGCCTCA	GAAACACCGGTTAAACCGAGGGGGGTTAGAGCTAGAAATAGCAAGTTAAC	1	bc
GGCAACACAC	GAAACACCGGTGTGGCTGAGAGTCCGGCAATGGTGTGGCTGTGGGGTTAG	1	bc
AGCGCTGTGT	GAAACACCGGTGACATTGGGTACGTGGGGTTAGAGCTAGAAATAGCAAGT	1	bc
ATCTAGCGAG	GAAACACCGGTTATATTTGTAAGTGTGTGGGGTTAGAGCTAGAAATAGCA	1	bc
CACACTGTCC	GAAAAACCGGTTTGAACCGGTGGGGTTAGAGCTAGAAATAGCAAGTTAAC	1	bc
ATGACTTATA	GAAACACCGGTAACTATATTCATGCGATATCGCCGTATCAGTGGGGTTAG	1	bc
CCGGTGCCTC	GAAACACCGGTTCCCGTCCAGTGGGGTTAGAGCTAGAAATAGCAAGATAA	1	bc
ACTATCGCGC	GAAACACCGGTCGGGGCCACTCAGTGGTGGGGTTAGAGCTAGAAATAGCA	1	bc
AGTCTCCTTT	GAAACACCGGTCTCGAGTGAGGTGTTGGGGGTGGGGTTAGAGCTAGAAAT	1	bc
ATTGAGTATA	GAAACACCGGTTAGAGCTAGAAATAGCAAGTTAACCTAAGGCTAGTCCGT	1	bc
GTAGATCTTC	GAAACACCGGTCCCATCCAGAGGGGTTAGAGCTAGGAATTGGAAGTTAAA	1	bc
TCGCCCTGCA	GAAACACCGGTGCATTCGAAAGTCCGGTCGTAGTGTGGACGTGGGGTTAG	1	bc
GGCACAGCCC	GAAACACCGGTGTGGCTGAGAGTCCGGCAATGGTGTGGCTGTGGGGTTAG	1	bc
ACATAGTCGT	CACCGGTGTACGTATGGACTGAACCAGGGTGTGCAAGTGGGGTTAGAGCT	1	bc
GCGATCGCGG	GAAACACCGGTTATATTTGTAAGTGTGTGGGGTTAGAGCTAGAAATAGCA	1	bc
TTGAACACAC	GAAACACCGGTTAAGCCGTGGGGTTAGAGCTAGAAATAGCAAGTTAACCT	1	bc
GACGATGCAC	GAAACACCGGTCGGCGGCAATCGTGGTATGAGCCACGTGGGGTTAGATCG	1	bc
GACATCGCGC	GAAACACCGGTTTGAACTACCTGGGGTTAGAGCTAGAAATAGCAAGTTAA	1	bc
AAAAGCCCTA	GAAACACCGGTGCCCTTACTCTCACCTGATTACTTAATCCGTGGGGTTAG	1	bc
AATAGTCTTT	GAAACACCGGTGTACGTATGGACTGAACCAGGGTGTGCAAGTGGGGTTAG	1	bc
GACCCTTACC	GAAACACCGGTAAATTTGAGGCTCCGGCATGCAGGAGGCCGTGGGGTTAG	1	bc
ACGTTACGGC	GAAACACCGGTCGGGGCCACTCAGTGGTGGGGTTAGAGCTAGAAATAGCA	1	bc
TGGCTGATAC	GAAACACCGGTAACTATATTCATGCGATATAGAAATATCGAGTTAACCTA	1	bc
GGGGAGTCCC	GAAACACCGGTTCCCGTCCAGTGGGGTTAGAGCTAGAAATAGCAAGTTAA	1	bc
GACTCTTACA	GAAACACCGGTAAATTTGAGGCTCCGGCATGCAGGAGGCCGTGGGGTTAG	1	bc
ACCAGCGCCC	GAAACACCGGTTTGAACTACCTAGTTCAAACCGGTGGGGTTAGAGCTAGA	1	bc
GCACACGATC	GAAAAACCGGTCGGCGGCAATCGTGGGTGGGGGTAGAGCTAGAAATAGCA	1	bc
CTCACTTGCA	GAAACACCGGTGTGGCTGAGAGTCCGGCAATGGTGTGGCTGTGGGGTTAG	1	bc
ATCACTAGCT	GAAACACCGGTTTACGTTGCATCGGTGTGGGGTTAGAGCTAGAAATAGCA	1	bc
GGGGATCTGC	GAAACACCGGTGGGCGGGAATAGTGGGGTGGTGTTAATTGTAGAATTACC	1	bc
ACACACCGCC	GAAACACCGGTTTGAACTACCTAGTTCAAACCGGTGGGGTTAGAGCTAGA	1	bc
AAGAACGCTC	GAAACACCGGTATGAACTACCTAGTTCAAACCGGTGGGGTTAGAGCTAGA	1	bc
AGGCAGATAC	GAAACACCGGTAAATTTGAGGCTCCGGCATGCAGGAGGCCGTGGGGTTAG	1	bc
CGCATTCTTG	GAAACACCGGTCTAGAGAGAGCAGATCTGGACGGGGGTAGATCTAGAAAT	1	bc
CCCTATGCCG	GAAACACCGGTTTGAACTAGAAATAGCAAGTTAACCTAAGGCTAGTCCGT	1	bc
GCACAAAGCC	GAAACACCGGTTTGAACTAGAAATAGCAAGTTAACCTAATGCTAGTCCGT	1	bc
CACGCACTAA	GAAACACCGGTGCCCTTACTCTCACCTGATTACTTAATCCGTGGGGTTAG	1	bc
GGCAGCTCCA	GAAACACCGGTGTGGCTGAGAGTCCGGCAATGGTGTGGCTGTGGGGTTAG	1	bc
GCTGACTGGC	GAAACACCGGTCGGCGGCAATCGTGGGTGGGGTTAGAGCTAGAAATAGCA	1	bc
GCATCATACA	GAAACACCGGTAAATTTGAGGCTCCGGCATGCAGGAGGCCGTGGGGTTAG	1	bc
AAATTTGTAG	GAAACACCGGTACGAGCCCCTCAGGGGGGGGGGTAGAGATAGATATAGCT	1	bc
AATACCCTTG	GAAACACCGGTGCATTCGAAAGTCCGGTCGTAGTGTGGACGTGGGGTTAG	1	bc
GTGAAGGCCA	GAAACACCGGTACCCGGCCAGAGAGGTGTTAGAGCGAGAAAGCAAGATAT	1	bc
TTTAGCATGC	GAAACACCGGTTAAGCCGAGTGGGGTTAGAGCTAGAAATAGCAAGTTAAC	1	bc
CCGCGTTGTA	GAAACACCGGTATTCGGGTAGACTGAGCGAGGGTATGGCTGGAAAGAGCA	1	bc
AACAAAGACC	GAAACACCGGTTTGAACTACCGGGGTTAGAGCTAGAAATAGCAAGTTAAC	1	bc
AACTTTACAG	GAAACACCGGTCGGGGCCACTCAGTGGTGGGGTTAGAGCTAGAAATAGCA	1	bc
AATACTCGGC	GAAACACCGGTACCTTTGTTGATGCTGGGTGGGGTTAGAGCTAGAAATAG	1	bc
AGACATTCGA	GAAACACCGGTGCATTCGAAAGTCCGGTCGTAGTGTGGACGTGGGGTTAG	1	bc
CGGGTCGGAT	GAAACACCGGTGACATTGGGTACAGGGTTAGAGCTAGAAATAGCAAGTTA	1	bc
ATGTACAGGT	GAAACACCGGTTTACGGCACATCGGTGTGGGGTTAGAGTTAGAAATAGCA	1	bc
ACTCAAGAGG	GAAACACCGGTTATATTTGTAAGTTTTGTGGGGTTAGAGCTAGAAATAGC	1	bc
CGGGTGCGTC	GAAACACCGGTTTACGTTGCATAGGAGTGGGGTTAGAGCTAGAAATAGCA	1	bc
GCCACCGGCA	GAAACACCGGTAACAAGCGAATTGCGTGTTTGCTAGAGTAGTGGTAGTAA	1	bc
ATATATCGAG	GAAACACCGGCTATATTGTAAGTGTGTGGGGTTAGAGCTAGAAATAGCAA	1	bc
GTTACACTCC	GTAATGGACGAAACACCGGTGTGGCTGAGAGTCCGGCAATGGAGTGGCTG	1	bc
ATGAATCGCT	GAAACACCGGTTTACGTTGCATCGGTGTGGGGTTAGAGCTAGAAATAGCA	1	bc
AACAAAGCTC	GAAACACCGGTTTGAACTACCTAGTTCAAACGTGGGGTTAGAGCTAGAAA	1	bc
ACGCTACGCC	GAAACACCGGTTTGAACTAGAGCTAGAAATAGCAAGTTAACCTAAGGCTA	1	bc
CGGATGCCTC	GAAACACCGGTCTCGAGTGAGGTGTTCAGGGTGGGGTTAGAGCTAGAAAT	1	bc
AGTGTTGGAT	GAAACACCGGTGACATTGGGTACAGGGTGGGGTTAGATCTAGAAATAGCA	1	bc
ATGATTTGTT	GAAACACCGGTTTACGTTGCATCGGTGGGGGGTTAGAGATAGCAATAGCA	1	bc
TATACACCTG	GAAACACCGGTAAATTTGAGGCTCCGGCATGCAGGAGGCCGTGGGGTTAG	1	bc
GATGAGCATA	GAAACACCGGTTAAGCCGAGGAGTTAGAGCTAGAAATAGCAAGTTAACCT	1	bc
GGTATCCCGA	GAAACACCGGTCCGTAGGAGACCCGTGTGGCATGTACCTGTGGGGTTAGA	1	bc
CCCATCCTTC	GAAACACCGGTCTCGAGTGAGGTGTTCAGGGTGGGGTTAGAGCTAGAAAT	1	bc
ATCGTTCCTC	GAAACACCGGTTCCAATGGGATTAGAGATACATATAGCAGGTGAACCTAA	1	bc
AAGAACCTCG	GAAACACCGGTGCATTCGAAAGTCCGGTCGTAGTGTGGACGTGGGGTTAG	1	bc
GCTTTGCCCC	GAAACACCGGTGGGGGCTACTCGGTGGAGTGGTTAGAGATAGAAATAACA	1	bc
GAGGCTGCCT	GAAACACCGGTCCGTAGGAGACCCGTGTGGCATGTACCTGTGGGGTTAGA	1	bc
GTAGCTCCGC	GAAACACCGGTCGGCGGCAATCGTGGGTGGGGTTAGAGCTAGAAATAGCA	1	bc
ATGTCTATGT	GAAACACCGGTTACATTGGGGCTAGAGCTAGAAATAGCAGGTTAACCTAA	1	bc
CGTCAGGATC	GAAACACCGGTCCGTAGGAGACCCGTGTGGCATGTACGTGGGGTTAGAGC	1	bc
AAGAGCGCCC	GAAACACCGGTTTGAACCGGATGGGTTAGAGCTAGAAGTAGCAAGTTAAC	1	bc
CTTCTTAGCC	GAAACACCGGTGTACGTATGGACTGAACCAGGGTGTGCAAGTGGGGTTAG	1	bc
TAAATTGTAG	GAAACACCGGTTATTTTTTTAAGGGTGTAGGGCTGGAGCTAGAAAGATCA	1	bc
AGATACTCGA	GAAACACCGGTGCGTTCGAAAGTCCGGTCGTAGTGTGGACGTGGGGTTAG	1	bc
ATTGCTATAT	GAAACACCGGTTACATTGAGTGGTACAGCTAGAAATAGCAAGTTAACTTA	1	bc
GAGGAATGCC	GAAACACCGGTCGGCGGCACTAGCGGGTGGGGTTAGAGATAGAAATAGCA	1	bc
ATATATAGAG	GAAACACCGGTTATATTTGTAAGTGTGTGGGGTTAGAGCTAGAAATAGCA	1	bc
AGAAGCTCTC	GAAACACCGGTGCATTCGAAAGTCCGGTCGTAGTATGGACGTGGGGTTAG	1	bc
GCATCGGAGT	GAAACACCGGTGTACGTATGGACTGAACCAGGGTGTGCAAGTGGGGTTAG	1	bc
CACTATTCGC	GAAACACCGGTTTGAACGACCTAGAAATAGCAAGGTAACCTAAGGCTAGT	1	bc
GACCGCCCTA	GAAACACCGGTGCCCTTACTCTCACCTGATTACTTAATCCGTGGGGTTAG	1	bc
ACTAGGCCTC	GAAACACCGGTACGACGGAGTCCAGAGTGGCATGTACCTGTGGGGTTAAA	1	bc
TACACAATGT	GAAACACCGGTTACATTGAGTGGGGTTAGAGCTAGAAATAGCAAGTTAAC	1	bc
ATGCTTCGTC	GAAACACCGGTTTACGTTGCATCGGAGTGGGGTTAGGGCTAGAAATAGCA	1	bc
GGTGGCCTCC	GAAACACCGGTGTGGCTGAGAGTCCGGCAATGGTGTGGCTGTGGGGTTAG	1	bc
AATGATTAGC	GAAACACCGATTTACGTTGCATCGGTGTGGGGTTAGAGCTAGAAATAGCA	1	bc
AAGAGCACTA	GAAACACCGGTGCCCTTACTCTCACCTGATTACTTAATCCGTGGGGTTAG	1	bc
AAGGACGTAC	GAAACACCGGTGCCCTTACTCTCACCTGATTACTTAATCCGTGGGGTTAG	1	bc
AGGCAACGCT	GAAACACCGGCGGGGTTAGAACTAGAAATACCTAGTTAACCTAAGGCTAG	1	bc
ATGTATAGAT	GAAACACCGGTTTACGTTGCATCGGGTTAACTCAGTGGGGTTAGAGCTAG	1	bc
ACTGAGCATA	GAAACACCGGTTAAGCCGAGTGGGGTTAGAGCTAGAAATAGCAAGTTAAC	1	bc
AGAAACAGAC	GAAACACCGGTAGCAAGTGGGGTTAGAGCTAGAAATAGCAAGTTAACCTA	1	bc
ACGTGTTGGT	GAAACACCGGTGACATTGGGTACAGGGTGGGGTTAGAGCTAGAAATAGCA	1	bc
GTAACCCTTA	GAAACCCCGGTGTGGCTGAGAGTCCGGCAATGGTGTGGCTGTGGGGGTAG	1	bc
CGTGCTGTTC	GAAACACCGGTGACAGACAACACGGAATTCGGGCCCATTGGTATGGCAGA	1	bc
ACAAAGCGCA	GCTAGAAATAGCAAGTTAACCTAAGGCTAGTCCGTTATCAACTTGAAAAA	1	bc
AAGGTTGCCT	GAAACACCGGTTGCATTCGTCACCGGGTGGGTCTATAGCTAGGAATAGCA	1	bc
AATGGCTAGT	GAAACACCGGTTTACGTTGCGTCGGTTTGGAGTTAGAGCTAGAAATAGCA	1	bc
AAATAGTCGT	GAAACACCGGTGTACGTATGGACTGAACCAGGGTGGGGTTAGAGCTAGAA	1	bc
TTGATCATCC	GAAACACCGGTGTGGCTGAGAGTCCGGCAATGGTGTGGCTGTGGGGTTAG	1	bc
AGAAAAATAT	GAAACACCGGTGACATTGGGTACAGGTTAGAGCTAGAAATAGCAAGTTAA	1	bc
ATAATCGGTC	GAAACACCGGTACCTTTGTTGATGCTGGGTGGAAGGAATTTGTGGGGTTA	1	bc
ACGAATGCCT	GAAACACCGGTCTGAAGATCGGCAGTCATGCATGGGCTTGAGCTAGTAAT	1	bc
ATTCTTAGAA	GAAACACCGGTTTACGTTGCATCGGTTGTGGGGTTAGAGCTAGAAATAGC	1	bc
ATTAGCAATT	GAAACACCGGTTTAGAGCTAGAAATAGCAAGTTAACCTAAGGCTAGTCCG	1	bc
CTACGGGGGC	GAAACACCGGTACCTTTGTTTATGCTGGGGGGAAAGAATTAGAAATAGCA	1	bc
TCTACTGAAA	GAAACACCGGTTCTATTTGTAAGTGTGTGGGGTTAGAGCTAGAAATAGCA	1	bc
ACCTCTAACG	GAAACACCGGTCGGGGCCACTCAGTGGTGGGGTTAGAGCTAGAAATAGCA	1	bc
