AAAAACCGTG	GAAACACCGGTAGCAAGTGAGGAGTTCAGGTGGGGTTACAACTAGAAGTA	1
AAAAACCTAC	GAAACACCGGTGCCCTTACTCTCACCTGATTACTTAATCCGTGGGGTCAG	1
AAAAACGCCA	GAAACACCGGTTTGAACTAGAAATAGCAAGTTAACCTAAGGCTAGTCCGT	1
AAAAAGTCGA	GAAACACCGGTGTACGTATGGACTGAACCAGGGTGTGCAAGTGGGGTTAG	1
AAAACCCCGG	GAAACACCGGTGTGGCTGAGTGTCCGGCAATGGTGTGGCTGTGGGGTTAG	1
AAAACCCTCG	GAAATACCGGTGCATTCGAAAGTCCGGTCGTAGTGTGGACGTGGGGTTAG	1
AAAACCGCGC	GAAACACCGGTGCATTCGAAAGTCCGGTCGTAGTGTGGACGTGGGGTTAG	1
AAAACCTAGC	GAAACACCGGTGCATTCGAAAGTCCGGTCGTAGTGTGGACGTGGGGTTAG	1
AAAACTTATA	GAAACACCGGTAACTATATTCATGCGATATCGCCGTATCAGTGGGGTTAG	1
AAAAGACACG	GAAACACCGGTCGGCGGCAATCGTGGGTGGGGTTAGAGCTAGAAATAGCA	1
AAAAGACCTA	GAAACACCGGTGCCCTTACTCTCACCTGATTACTTAATCCGTGGGGTTAG	1
AAAAGATACG	GAAACACAAGTTAACCTAAGGCTAGTCCGTTATCAACTTGAAAAAGTGGC	1
AAAAGCAGTA	GAAACACCGGTGCCCTTACTCTCACCTGATTACTTAATCCGTGGGGTTAG	1
AAAAGCCCTA	GAAACACCGGTGCCCTTACTCTCACCTGATTACTTAATCCGTGGGGTTAG	3
AAAAGCGCTA	GAAACACCGGTGCCCTTACTCTCACCTGATTACTTAATCCGTGGGGTTAG	1
AAAAGTCGTC	GAAACACCGGTGTACGTATGGACTGAACCAGGGTGTGCAAGTGGGGTTAG	1
AAACAACGAC	GAAACACCGGTTTACCGGGGTTAGAGCTAGAAATAGCAAGTTAACCTAAG	1
AAACAACGCC	GAAACACCGGTTAGAGCTAGAAATAGCAAGTTAACCTAAGGCTAGTCCGT	1
AAACAACGCC	GAAACACCGGTTTGAACTACCTAGTTCAAACCGGTGGGGTTAGAGCTAGA	1
AAACAACGCC	GAAACACCGGTTTGAACCGGTGGAGTTAGAGCTAGAAATAGCAAGTTAAC	1
AAACAACGGC	GAAACACCGGCCGATTAATAACGAAACCTTCCCGTGACAGTGGGGTTAAA	1
AAACATAGAC	GAAACACCGGTTTACGTTGCATCGGTGTGGGGTTAGAGCTAGAAATAGCA	1
AAACATAGAC	GAAACACCGGTAACTATACTCATGCGATATCGCCGTATCAGTGGGGTTAG	1
AAACCACTAC	GAAACACCGGTGCCCTTACTCTCACCTGATTACTTAATCCGTGGGGTTAG	1
AAACCTGTAC	GAAACACCGGTAACTATATTCATGCGATATCGCCGTATCAGTGGGGTTAG	1
AAACGAACTA	GAAACACCGGTGCCCTTACTCTCACCTGATTACTTAATCCGTGGGGTTAG	2
AAACGCACTA	GAAACACCGGTGCCCTTACTCTCACCTGATTACTTAATCCGTGGGGTTAG	1
AAACGCCCCA	GAAACACCGGTGCCCTTACTCTCACCTGATTACTTAATCCGTGGGGTTAG	2
AAACGCCCTT	GAAACACCGGTGCCCTTACTCTCACCTGATTACTTAATCCGTGGGGTTAG	1
AAACGGTCTA	GAAACACCGGTGCCCTTACTCTCACCTGATTACTTAATCCGTGGGGTTAG	1
AAACGTATAA	GAAACACCGGTAACTATATTCATGCGATATCGCCGTATCAGTGGGGTTAG	1
AAACGTCGTA	GAAACACCGGTGCCCTTACTCTCACCTGATTACTTAATCCGTGGGGTTAG	1
AAACTCCCTA	GAAACACCGGTGCCCTTACTCTCACCTGATTACTTAATCCGTGGGGTTAG	1
AAACTCGTCG	GAAACACCGGTGTACGTATGGACTGAACCAGGGTGTGCAAGTGGGGTTAG	1
AAACTCTCCC	GAAACACCGGTGCATTCGAAAGTCCGGTCGTAGTGTGGACGTGGGGTTAG	1
AAAGAACTAC	GAAACACCGGTGCCCTTACTCTCACCTGATTACTTAATCCGTGGGGTTAG	1
AAAGACATAC	GAAACACCGGTGCCCTTACTCTCACCTGATTTTGGGGTTAGAGCTAGAAA	1
AAAGACGTAC	GAAACACCGGTGCCCTTACTCTCACCTGATTACTTAATCCGTGGGGTTAG	1
AAAGATCTAC	GAAACACCGGTGCCCTTACTCTCACCTGATTACTTAATCCGTGGGGTTAG	1
AAAGCACAGC	GAAACACCGGTCGGCGGCAATCGTGGGTGGGGTTAGAGCTAGAAATAGCA	1
AAAGCCATAA	GAAACACCGGTAAATTTGAGGCTCCGGCATGCAGGAGGCCGTGGGGTTAG	1
AAAGCCTCAC	GAAACACCGGTGCCCTTACTCTCACCTGATTACTTAATCCGTGGGGTTAG	1
AAAGCTCTAT	GAAACACCGGTGCCCTTACTCTCACCTGATTACTTAATCCGTGGGGATAG	1
AAAGCTTAGC	GAAACACCGGTTTACGTTGCATCGGTGTGGGGTTAGAGCTAGAAATAGCA	1
AAAGGAGGTA	GAAACTAGAAATAGCAAGTTAACCTAAGGCTAGTCCGTTATCAACTTGAA	1
AAAGTACTAC	GAAACACCGGTGCCCTTACTCTCACCTGATTACTTAATCCGTGGGGTTAG	1
AAAGTCTCAT	GAAACACCGGTCGGCGGCAAATGGGGTTAGAGCTAGAAATAGCAAGTTAA	1
AAAGTGCCTA	GAAACACCGGTGCCCTTACTCTCACCTGATTACTTAATCCGTGGGGTTAG	1
AAATAACTAG	GAGAAACCGGTGCATTCGCAAGTCCGTTCTTAGTGTTGACGTGGACTTCG	1
AAATAGTCGT	GAAACACCGGTGTACGTATGGACTGAACCAGGGTGTGCAAGTGGGGTTAG	1
AAATATACCG	GAAACACCGGTCGGGGCCACTCAGTGGTGGGGTTAGAGCTAGAAATAGCA	1
AAATCGTAGT	GAAACACCGGTGTACGTATGGACTGAACCAGGGTGTGCAAGTGGGGTTAG	2
AAATCGTCGT	GAAACACCGGTGTACGTATGGACTGAACCAGGGTGTGCAAGTGGGGTTAG	2
AAATCGTCGT	GAAACACCGGCGTACGTATGGACTGAACCAGGGTGTGCAAGTGGGGTTAG	1
AAATGCCCTA	GAAACACCGGTGCCCTTACTCTCACCTGATTACTTAATCCGTGGGGTTAG	2
AAATGCGTTA	GAAACACCGGTTAAGCCGAGTGGGGATATAGCTAGAAATAGCAAGCTAAC	1
AAATGCTTAG	GAAACACCGGTTTACGTTGCATCGGTGTGGGGTTAGAGCTAGAAATAGCA	1
AAATTAGCTC	GAAACACCGGTCGATTCATATCGAAACCTTCCCGTGACAGTGGGGTTAGA	1
AAATTCGCCT	GAAACACCGGTCGATTCATATCGAAACCTTCCCGTGACAGTGGGGTTAGA	1
AAATTTACCG	GAAACACCGGTCGGGGCCACTCAGTGGTGGGGTTAGAGCTAGAAATAGCA	1
AACAAAGAAA	GAAACACCGGTAGCAAGTGCGAGACGTGTTTGTGGGGTTAGAGCTAGAAA	1
AACAAAGCAC	GAAACACCGGTTTGAACTAGAAATAGCAAGTTAACCTAAGGCTAGTCCGT	1
AACAACAACC	GAAACACCGGTTTGAACTAGAAATAGCAAGTTAACCTAAGGCTAGTCCGT	1
AACAACGTTC	GAAACACCGGTTTGAACTACCTAGTTCAAACCGGTGGGGTTAGAGCTAGA	1
AACAATGTCC	GAAACACCGGTTTGAACTAGAAATAGCAAGTTAACCTAAGGCTAGTCCGT	1
AACACACCGG	GAAACACGGGTTAGAGCTAGAAATAGCAAGTTAACCTAAGGCTAGTCCGT	1
AACACTGCTA	GAAACACCGGTAGCAAGTGCGGGGTTAGTGCTAGAAATAGCAATATAACC	1
AACAGACCTC	GAAACACCGGTGCCCTTACTCTCACCTGATTACTTAATCCGTGGGGTTAG	1
AACAGTCGGT	GAAACACCGGTCGATTCATATCGAAACCTTCCCGTGACAGTGGGGTTAGA	1
AACATAAGGT	GAAACACCGGTCGATTCATATCGAAACCTTCCTGTGACAGTGGGGTTAGA	1
AACATACGAT	GAAACACCGGTCGATTCATATCGAAACCTTCCCGTGACAGTGGGGTTAGA	1
AACATACGGT	GAAACACCGGTCGATTCATATCGAAACCTTCCCGTGACAGTGGGGTTAGA	1
AACATATCCC	GAAACACCGGTTTGAAATAGAAATAGCAAGTTAACCTAAGGCTAGTCCGT	1
AACATCCGGT	GAAACACCGGTCGATTCATATCGAAACCTTCCCGTGACAGTGGGGTTAGA	1
AACATGCCTC	GAAACACCGGTCCGTAGGAGACCCGTGTGGCATGTACCTGTGGGGTTAGA	1
AACATGGCCC	GAAACACCGGTTTGAACTAGAAATAGCAAGTTAACCTAAGGCTAGTCCGT	1
AACATTCGGA	GAAACACCGGTCGATTCATATCGAAACCTTCCCGTGACAGAGGGGTTAGA	1
AACCTTACCG	GAAACACCGGTCGGGGCCACTCAGTGGTGGGGTTAGAGCTAGAAATAGCA	1
AACCTTCGGT	GAAACACCGGTCGATTCATATCGAAACCTTCCCGTGACAGTGGGGTTAGA	1
AACCTTTACC	GAAACACCGGTCGGGGCCACTCATGTGGGGTTAGAGCTAGAAATAGCAAG	1
AACCTTTACC	GAAACACCGGTCGGGGCCACTCAGTGGTGGGGTTAGAGCTAGAAATAGCA	1
AACGAATAAT	GAAACACCGGTCTCGAGTGAGGTGTTCAGGGTGGGGTTAGAGCTAGAAAT	1
AACGACTTAT	GAAACACCGGTGCCCTTACTCTCACCTGATTACTTAATCCGTGGGGTTAG	1
AACGAGTGGC	GAAACACCGGTGCATTCGAAAGGCCGGTCGTAGTGGGTACGTGGGGTTAG	1
AACGCACAAA	GAAACACCGGTGCCCTTACTCTCACCTGATTACTTAATCCGTGGGGTTAG	1
AACGCCATGT	GAAACACCGGTTCCCTTACTCTCACCTGATTACTTAATCCGTGGGGTTAG	1
AACGCCCTAC	GAAACACCGGTGCCCTTACTCTCACCTGATTACTTAATCCGTGGGGTTAG	527
AACGCCCTAC	GAAACACCGGTGCCCTTACTCTCACCTGATTACTTGGGGTTAGAGCTAGA	6
AACGCCCTAC	GAAACACCGGTGCCCTTACTCTCACCTGATTTTGGGGTTAGAGCTAGAAA	5
AACGCCCTAC	GGTGCCCTTACTCTCACCTGATTACTTAATCCGTGGGGTTAGAGCTAGAA	5
AACGCCCTAC	GAAACACCGGTGCCCTCACTCTCACCTGATTACTTGGGGTTAGAGCTAGA	3
AACGCCCTAC	ACACCGGTGCCCTTACTCTCACCTGATTACTTAATCCATAGCAAGTTAAC	2
AACGCCCTAC	GAAACACCGGTGTGGCTGAGAGTCCGGCAATGGTGTGGCTGTGGGGTTAG	2
AACGCCCTAC	GAAACACCGGTAAATTTGAGGCTCCGGCATACAGGAGGCCGTGAGGTTAG	1
AACGCCCTAC	GAAACACCGGTAACTATATTCATGCGATATCGCCGTATCAGTGGGGTTAG	1
AACGCCCTAC	GAAACACCGGTCCGTAGGAGACCCGTGTGGCATGTACCTGTGGGGTTAGA	1
AACGCCCTAC	GAAACACCGGTCGGGGCCACTCAGTGGTGGGGTTAGAGCTAGAAATAGCA	1
AACGCCCTAC	GAAACACCGGTGCCCTTACTCTCACCTGATTACTAATCCGTGGGGTTAGA	1
AACGCCCTAC	GAAACACCGGTGCCCTTACTCTCACCTGATTACTTATCCGTGGGGTTAGA	1
AACGCCCTAC	GAAACACCGGTGCCCTTAGCTAGAAATAGCAAGTTAACCTAAGGCTAGTC	1
AACGCCCTAC	GACACCGGTGCCCTTACTCTCACCTGATTACTTAATCCATAGCAAGTTAA	1
AACGCCGTTA	GAAACACCGGTGCCCTCACTCTCACCTGATTACTTAATCCGTGGGGTTAG	1
AACGCCTAAG	GAAACACCGGTGCCCTTACTCTCACCTGATTACTTAATCCGTGGGGTTAG	1
AACGCTAAGC	GAAACACCGGTCTACGTTGCATCGGTGTGGGGTTAGAGCTAGAAATAGCA	1
AACGCTCTTA	GAAACACCGGTGCCCTTACTCTCACCTGATTACTTAATCCGTGGGGTTAG	1
AACGCTTAGA	GAAACACCGGTTTACGTTGTGGGGTTAGAGCTAGAAATAGCAAGTTAACC	1
AACGCTTGGT	GAAACACCGGTGTACGTATGGACTGAACCAGGGTGTGCAAGTGGGGTTAG	1
AACGGACTCC	GAAACACCGGTGCCCTTGCTCTCACCTGATTACTTAATCCGTGGGGTTAG	1
AACGGCGGAC	GAAACACCGGTGCCCTTACTCTCACCTGATTACTTAATCCGTGGGGTTAG	1
AACGGTCTAT	GAAACACCGGTGCCCTTACTCTCACCTGATTACTTAATCCGTGGGGTTAG	1
AACGTGCTCC	GAAACACCGGTGCCCTTACTCCCACCTGATTACTTAATCCGTGGGGTTAG	1
AACGTTACCG	GAAACACCGGTCGGGGCCACTCAGTGGTGGGGTTAGAGCTAGAAATAGCA	1
AACGTTCGGT	GAAACACCGGTCGATTCATATCGAAACCTTCCCGTGACAGTGGGGTTAGA	1
AACTACTTGG	GAAACACCGGTACCTTTGTTGATGCTGGGTGGAAGGAATCTGTGGGGTTA	1
AACTATAGTG	GAAACACCGGTTATATTTGGGGTTAGAGCTAGAAATAGCAAGTTAACCTA	1
AACTCGTCGT	GAAACACCGGTGTACGTATGGACTGAACCAGGGTGTGCAAGTGGGGTTAG	1
AACTCTACAG	GAAACACCGGTCGGGGCCACTCAGTGGTGGGGTTAGAGCTAGAAATAACA	1
AACTGCTTAA	GAAACACCGGTGCCCTTACTCTCACCTGATTACTTAATCCGTGGGGTTAG	1
AACTTAACGC	GAAACACCGGTCGGGGCCACTCAGTGGTGGGGTTAGAGCTAGAAATAGCA	1
AACTTGAGCG	GAAACACCGGTCGGGGCCACTCAGTGGTGGGGTTAGAGCTAGAAATAGCA	1
AACTTTACCG	GAAACACCGGTCGGGGCCACTCAGTGGTGGGGTTAGAGCTAGAAATAGCA	5
AACTTTACCG	GAAATACCGGTCGGGGCCACTCAGTGGTGGGGTTAGAGCTAGAAATAGCA	1
AACTTTTGGT	GAAACACCGGTCGATTCATATCGAAACCTTCCCGTGACAGTGGGGTTAGA	1
AAGAACCTCG	GAAACACCGGTGCATTCGAAAGTCCGGTCGTAGTGTGGACGTGGGGTTAG	1
AAGAAGACCC	GAAACACCGGTCGGCGGCAATCGTGGTATGAGCCACGTGGGGTTAGATCG	1
AAGAAGACCC	GAAACACCGGTCGGCGGCAATCGTGGGTGGGGTTAGAGCTAGAAATAGCA	1
AAGAAGCCTC	GAAACACCGGTTCCCGTCCAGTGGGGTTAGAGCTAGAAATAGCAAGTTAA	1
AAGAATCATT	GAAACACCGGTCTCGAGTGAGGTGTTCAGGGTGGGGTTAGAGCTAGAAAT	1
AAGAATCATT	GAAACACCGGTCTCGAGTGAGGTGTTCAGGGCGGGGTTAGAGCTAGAAAT	1
AAGAATCCTT	GAAACACCGGTCTCGAGTGAGGTGTTCAGGGTGGGGTTAGAGCTAGAAAT	2
AAGACAATCG	GAAACACCGGTGCATTCGAAAGTCCGGTCGTAGTGAGGACGTGGGGTTAG	1
AAGACACTCG	GAAACACCGGTGCATTCGAAAGTCCGGTCGTAGTGTGGACGTGGGGTTAG	2
AAGACACTCG	GAAACACCGGTGCATTCGAAAGTCCGGTCGTAGTGTGGACGCGGGGTTAG	1
AAGACAGCAT	GAAACACCGGTCCGTAGGAGACCCGTGTGGCATGTACCTGTGGGGTTAGA	1
AAGACCATCG	GAAACACCGGTGCATTCGAAAGTCCGGTCGTAGTGTGGACGTGGGGTTAG	1
AAGACCATCT	GAGACACCGGTGCATTCGAAAGTCCGGTCGTAGTGTGGACGTGGGGTTAG	1
AAGACCTTCG	GAAACACCGGTGCATTCGAAAGTCCGGTCGTAGTGTGGACGTGGGGTTAG	1
AAGACGCTCG	GAAACACCGGTGCATTCGAAAGTCCGGTCGTAGTGTGGACGTGGGGTTAG	2
AAGAGACGAA	GAAACACCGGTGTACGTATGGACTGAACCAGGGTGGGGTTAGAGCTAGAA	1
AAGAGCCTCG	GAAACACCGGTGCATTCGAAAGTCCGGTCGTAGTGTGGACGTGGGGTTAG	1
AAGATAGGCA	GAAACACCGGTAGCAAGTGCTGGGTTAGAGCTAGAAATAGCAAGTTAACC	1
AAGCACTCTA	GAAACACCGGTGCCCTTACTCTCACCTGATTACTTAATCCGTGGGGTTAG	1
AAGCCAGAAA	GAAACACCGGTAAATTTGAGGCTCCGGCATGCAGGAGGCCGTGGGGTTAG	1
AAGCCCATCG	GAAACACCGGTGCATTCGAAAGTCCGGTCGTAGTGTGGACGTGGGGTTAG	1
AAGCCGCGCG	GAAACACCGGTGTACCTAAGGACTGAACCGGGGTGTGCCTGTGGGGATCG	1
AAGCCTCGAA	GAAACACCGGTTTACGTTGCATCAGCTAGAAATAGCAAGTTAACCTAAGA	1
AAGCGTGGTC	GAAACACCGGTGTACGTATGGACTGAACCAGGGTGTGCAAGTGGGGTTAG	1
AAGGACTTGA	GAAACACCGGTCGGCGGCAATCGTGGGGTGGGGTTAGAGCTAGAAATAGC	1
AAGGAGCGTC	GAAACACCGGTTCCCGTCCAGTGGGGTTAGAGCTAGAAATAGCAAGTTAA	1
AAGGATAGAC	GAAACACCGGTAATTATATTCATGCGATATCGTCGTATTAGTGGTGGTAG	1
AAGGCCTTCG	GAAACACCGGTGCATTCGAAAGTCCGGTCGTAGTGTAGACGTGGGGTTAG	1
AAGGCTTTAC	GAAACACCGGTGCCCTTACTCTCACCTGATTACTTAATCCGTGGGGTTAG	1
AAGGGGCGTC	GAAACACCGGTGTACGTATGGACTGAACCAGGGTGGGCAAATGGAGTTAG	1
AAGGGTTGTC	GAAACACCGGTGACATTAGAGCTAGAAATAGCAAGTTAACCTAAGGCTAG	1
AAGGGTTTAA	GAAACACCGGTGCCCTTACTCTCACCTGATTACTTAATCCGTGGGGTTAG	1
AAGGTTCTTC	GAAACACCGGTGTACGTATGGACTGAACAAGGGTGTGAAAGAGAGGTTAG	1
AAGTATCGCG	GAAACACCGGTTATATTTGTAAGTGTGTGGGGTTAGAGCTAGAAATAGCA	1
AAGTATGCCT	GAAACACCGGTCCGTAGGAGACCCGTGTGGCATGTACGTGGGGTTAGAGC	1
AAGTATGCCT	GAAACACCGGTCCGTAGGAGACCCGTGTGGCATGTACCTGTGGGGTTAGA	1
AAGTCAGTCA	GAAACACCGGTGGGGTTAGAGCTAGAAATAGCAAGTTAACCTAAGGCTAG	1
AAGTCGGCCT	GAAACACCGGTCCGTAGGAGACCCGTGTGGCATGTACCTGTGGGGTTAGA	1
AAGTCTGACT	GAAACACCGGTCCGTAGGAGACCCGTGTGGCATGTACCTGTGGGGTTAGA	2
AAGTCTGAGT	GAAACACCGGTCCGTAGGAGACCCGTGTGGCATGTACCTGTGGGGTTAGA	1
AAGTCTGGCT	GAAACACCGGTCCGTAGGAGACCCGTGTGGCATGTACCTGTGGGGTTAGA	1
AAGTCTTAAT	GAAACACCGGTCGATTCATATCTAAACCTTCCCGTGACAGTGGGGGTAGT	1
AAGTCTTCCT	GAAACACCGGTCCGTAGGAGACCCGTGTGGCATGTACCTGTGGGGTTAGA	1
AAGTGATGGC	GAAACACCGGTGACAATGGGACGTGTGTTTAACGCTAGCCATGGCGAGAT	1
AAGTGCGGTT	GAAACACCGGTCGATTCATATCGAAACCTTCCCGTGACAGTGGGGTTAGA	1
AAGTGGAGCA	GAAACACCGGTTCCCGTCCAGTGGGGTTAGAGCTAGAAATAGCAAGTTAA	1
AAGTGGAGGA	GAAACACCGGTTCCCGTCCAGTGGGGTTAGAGCTAGAAATAGCAAGTTAA	1
AAGTGTGCCT	GAAACACCGGTCCGTAGGAGACCCGTGTGGCATGTACCTGTGGGGTTAGA	1
AAGTGTTGTA	GAAACACCGGTGACATTTGGGGTTAGAGCTAGAAATAGCAAGTTAACCTA	1
AAGTGTTGTC	GAAACACCGGTGACATTGGGTAAAATAGCAAGTTAACCTAAGGCTAGTCC	1
AAGTGTTGTC	GAAACACCGGTGACATTGGGAGTGGGGTTAGAGCTAGAAATAGTAAGTTA	1
AAGTGTTTTA	GGTTAGAGCTAGAAATAGCAAGTTAACCTAAGGCTAGTCCGTTATCAACT	1
AAGTTTGCCT	GAAACACCGGTCCGTAGGAGACCCGTGTTGTGGGGTTAGAGCTAGAAATA	1
AATACTAGGC	GAAACACCGGTACCTTTGGTGGGGTTAGAGCTAGAAATAGCAAGTTAACC	1
AATACTCGGC	GAAACACCGGTACCTTTGTTGATGCTGGGTGGAAGGAAGGAAGGTGGGGT	1
AATACTCGTC	GAAACACCGGTACCTTTGTTGATGCTGGGTGGAAGGAATGTGGGGTTAGA	1
AATACTTCGC	GAAACACCGGTACCTTTGTTGATGCTAGAAATAGCAAGTTAACCTAAGGC	1
AATAGAAGGC	GAAACACCGGTACCTTTGTTGATGCTGGGTGGGGTTAGAGCTAGAAATAG	1
AATAGACGTC	GAAACACCGGTGTACGTATGGACCGAACCAGGGTGTGCAAGTGGGGTTAG	1
AATAGACGTC	GAAACACCGGTGTACGTATGGACTGAACCAGGGTGTGGGTTAGAGCTGGA	1
AATAGATATG	GACACACCGGTTACATTGAGGGGTTAGAGCTAGAAATAGCAAGTTAACCT	1
AATAGCAGTC	GAAACACCGGTGTACGTATGGACTGAACCAGAAATAGCAAGTTAACCTAA	1
AATAGCGAGG	GAAACACCGGTTATATTTGTAAGTGTGTGGGGTTAGAGCTGGAAATAGCA	1
AATAGCTATG	GAAACACCGGTTACATTGAGGGGTTAGAGCTAGAAATAGCAAGTTAACCT	1
AATAGGAGTC	GAAACACCGGTGTACGTATGGACTGAACCAGGGTGTGCAAGTGGGGTTAG	1
AATAGTAGTC	GAAACACCGGTGTACGTATGGACTGAACCAGGGTGTGCAAGTGGGGTTAG	1
AATAGTCGTA	GAAACACCGGTGTACGTATGGACTGAACCAGGGTGTGCAAGTGGGGTTAG	1
AATATACTAT	GAAACACCGGTCTCGAGTGAGGTGTTCAGGGTGGGGTTAGAGCTAGAAAT	1
AATCAATAAA	GAAACACCGGTAGCAAGTGCGAGACGTGTTTGTGGGGTTAGAGCTAGAAA	1
AATCAATCGA	GAAACACCGGTTATATTTGTAAGTGGGGTTAGAGCTAGAAATAGCAAGTT	1
AATCAGCGCC	GAAACACCGGTTTGAACTAGAAATAGCAAGTTAACCTAAGGCTAGTCCGT	1
AATCCAGAAA	GAAACACCGGTATCAAGAGCGAGACGCGTTGAATGGCAAGTTATCCTAAT	1
AATCGAAGTC	GAAACACCGGTGTACGTATGGACTGAACCAGGGTGTGCAAGTGGGGTTAG	1
AATCGTGATC	GAAACACCGGTGTACGTATGGACTGAACCAGGGTGTGCGAGTGGGGTTAG	1
AATCGTTCGC	GAAACACCGGTGCATTCAAAAGTCCGGTCGTAGTGTGGACGTGGGGTCAG	1
AATCTACGTC	GAAACACCGGTGTACGTATGGACTGAACCAGGGTGTGCAAGTGGGGTTAG	1
AATCTACTGC	GAAACACCGGTCGGGGCGGGTTAGAGCTAGAAATAGCAAGTTAACCTAAG	1
AATCTAGCTA	GAAACACCGGTCCGTAGGAGACCCGTGTGGCATGTACCTGTGGGGTTAGA	1
AATCTCCGTC	GAAACACCGGTGTACGTATGGACTGAACCAGGGTGTGCAAGTGGGGTTAG	1
AATCTGAATA	GAAACACCGGTCCGTAGGAGACCCGTGTGGCATGTACCTGTGGGGTTAGA	1
AATGAATCAT	GAAACACCGGTTCCCGTCCAGTGGGGTTAGAGCTAGAAATAGCAAGTTAA	1
AATGAGACTA	GAAACACCGGTTAAGCCGAGTGGGGTTAGAGCTAGAAATAGCAAGTTAAC	1
AATGAGCATA	GAAACACCGGTTAAGCCGAGTGGGGTTAGAGCTAGAAATAGCAAGTTAAC	1
AATGATTAGA	GAAACACCGGTTTACGTTGCATCGGTGTGGGTTAGAGCTGGAAATAGCAA	1
AATGATTAGC	GAAACACCGGTTTACGTTGCATCGGTGTGGGGTTAGAGCTAGAAATAGCA	2
AATGATTAGC	GAAACACCGGTTTACGTTGGGGGTTAGAGCTAGAAATAGCAAGTTAACCT	1
AATGCGATCG	GAAACACCGGTGCATTCGAAAGTCCGGTCGTAGTGTGGACGTGGGGTTAG	1
AATGCGTAGC	GAAACACCGGTTTACGTTGCATCGGTGTGGGGTTAGAGCTAGAAATAGCA	1
AATGCTAAGC	GAAACACCGGTTTACGTTGCATCGGTGTGGGGTCAGAGCTAGAAATAGCA	1
AATGCTGAGC	GAAACACCGGTTTACGTTGCATCGGTGTGGGGTTAGAGCTAGAAATAGCA	1
AATGCTTAGA	GAAACACCGGTTTACGTTGCATCGGTGTGGGGTTAGAGCTAGAAATAGCA	1
AATGCTTATC	GAAACACCGGTTTACGTTGCATCGGGTTAGAGCTAGAAATAGCGAGTTAA	1
AATGCTTCAC	GGAACACCGGTTTACGTTGCATTGGTGTGGGGTTAGAGCTAGAAATAGCA	1
AATGGAACTA	GAAACACCGGTGCCCTTACTCTCACCTGATTACTTAATCCGTGGGGTTAG	1
AATGTCGTAC	GAAACACCGGCGCCCTTACTCTCACCTGATTACTTAATCCGTGGGGTTAG	1
AATGTGGGAC	GAAACACCGGTCCGTCGCAGACCCGTGTGGCATGTACCTTGTGGGGTTAG	1
AATGTTCGGC	GAAACACCGGTACCTTTGTTGATGCTGGGTGGGGTTAGAGCTAGAAATAG	1
AATGTTTAAC	GAAACACCGGTTTACGTTGCATCGGTGTGGGGTTAGAGCTAGAAATAGCA	1
AATGTTTAGC	GAAACACCGGCTTACGTTGCATCGGTGTGGGGTTAGAGCTAGAAATAGCA	1
AATTTACCCC	GAAACACCGGTCGGGGCCACTCAGTGGTGGGGTTAGAGCTAGAAATAGCA	1
AATTTAGCGC	GAAACACCGGTCGGGGCCAGTGGGGTTAGAGCTAGAAATAGCAAGTTAAC	1
ACAAAACGCA	GAAACACCGGTTTGAACTAGAAATAGCAAGTTAACCTAAGGCTAGTCCGT	1
ACAAAACGCC	GAAACACCGGTTTGAACTAGAAATAGCAAGTTAACCTAAGGCTAGTCCGT	2
ACAAAACGCC	GAAACACCGGTTTACCGGGGTTAGAGCTAGAAATAGCAAGTTAACCTAAG	1
ACAAAAGCCC	GAAACACCGGTTAGAGCTAGAAATAGCAAGTTAACCTAAGGCTAGTCCGT	1
ACAAAGCGCC	GAAACACGGGTTAGAGCTAGAAATAGCAAGTTAACCTAAGGCTAGTCCGT	1
ACAAAGTATT	GAAACACCGGTGTACGTATGGACTGAACCAGGGTGTGCAAGTGGGGTTAG	1
ACAACCCGGC	GAAACACCGGTACCTTTGTTGATGCTGGGTGGAAGGAAAAAGTGGCACCG	1
ACAACTCGGA	GAAACACCGGTACCTTTGTTGATGCTGGGTGGAAGGAATTTGTGGGGTTA	1
ACAACTTATA	GAAACACCGGTAACTATATTCATGCGATATCGCCGTATCAGTGGGGTTAG	2
ACAATACTTT	GAAACACCGGTCTCGAGTGAGGTGTTCAGGGTGGGGTTAGAGCTAGAAAT	1
ACACAAAGCC	GAAACACGGGTTAGAGCTAGAAATAGCAAGTTAACCTAAGGCTAGTCCGT	1
ACACAAAGCC	GAAACACCGGTTTGAACTACCTAGTTCAAACCGGTGGGGTTAGAGCTAGA	1
ACACAACGCA	GAAACCACGGGTCAGAGCTAGAAATAGCAAGTTAACCTAAGGCTAGTCCG	1
ACACAACGCG	GAAACACCGGTTTGAACTAGAAATAGCAAGTTAACCTAAGGCTAGTCCGT	1
ACACAACGCG	GAAACACGGGTTAGAGCTAGAAATAGCAAGTTAACCTAAGGCTAGTCCGT	1
ACACAACGCT	GAAACACCGGTTTGAACTACCGGGGTTAGAGCTAGAAATAGCAAGTTAAC	1
ACACAACGTC	GAAACACCGGTTTGAACCGGTGGGGTTAGAGCTAGAAATAGCAAGTTAAC	1
ACACAATGCC	GAAACACCGGTTTGAACTAGAAATAGCAAGTTAACCTAAGGCTAGTCCGT	1
ACACAGCGCC	GAAACACCGGTTTGAACTAGAAATAGCTAGATAACCTAAGGCTAGTCCGA	1
ACACAGCGCC	GAAACACGGGTTAGAGCTAGAAATAGCAAGTTAACCTAAGGCTAGTCCGT	1
ACACAGCGGG	GAAACACCGGTTTGAACTACCTAGTAGCAAGTTAACCTAAGGCTAGTCCG	1
ACACCAATCC	GAAACACCGGTTTGAACTACCTAGTAGCAAGTTAACCTAAGGCTAGTCCG	1
ACACCACGCC	GAAACACCGGTTTGAACTAGAAATAGCAAGTTAACCTAAGGCTAGTCCGT	1
ACACCCAGCC	GAAACACGGGTTAGAGCTAGAAATAGCAAGTTAACCTAAGGCTAGTCCGT	1
ACACCCGCCC	GAAACACCGGTGCATTCGAAAGTCCGGTCGTAGTGTGGACGTGGGGTTAG	1
ACACTCAGCC	GAAACACCGGTACCTTTGTTGATGATAGCAAGTTAACCTAAGGCTAGTCC	1
ACAGAACGCC	GCTAGAAATAGCAAGTTAACCTAAGGCTAGTCCGTTATCAACTTGAAAAA	1
ACAGATGGAC	GAAACACCGGTTTGAACTAGAAATAGCAAGTTAACCTAAGGCTAGTCCGT	1
ACAGCCCTAA	GAAACACCGGTGCCCTTACTCTCACCTGATTACTTAATCCGTGGGGTTAG	1
ACAGCGTCGT	GAAACACCGGTGTACGTATGGACTGAACCAGGGTGTGCAAGTGGGGTTAG	1
ACAGCGTCGT	GAAACACCGGTGTACGTATGGACTGAACCAGGGTGTTATCAACTTGAAAA	1
ACATAACGCA	GAAACACGGGTTAGAGCTAGAAATAGCAAGTTAACCTAAGGCTAGTCCGT	1
ACATAACGCC	GAAACACCGGTTTGAACTAGAAATAGCAAGTTAACCTAAGGCTAGTCCGT	1
ACATAGTCGT	GAAACACCGGTGTACGTATGGACTGAACCAGGGTGTGCAAGTGGGGTTAG	1
ACATATCGAG	GAAACACCGGTTATATTTGTAAGTGTGTGGGGTTAGAGCTAGAAATAGCA	1
ACATCACCCC	GAAACACCGGTCCGTACGAGACCCGGGTGGCATGTACCTGGGGGGTTAGA	1
ACATCAGCCT	GAAACACCGGTCCGTAGGAGACCCGTGTGGCATGTACCTGTGGGGTTAGA	1
ACATCATCGT	GAAACACCGGTTAACGTATGGACTGAACGGGGGTGGGCAAGTGGAGATAG	1
ACATCGTAGT	GAAACACCGGTGTACGTATGGACTGAACCAGGGTGTTATCAACTTGAAAA	1
ACATCGTAGT	GAAACACCGGTGTACGTATGGACTGAACCAGGGTGTGCAAGTGGGGTTAG	1
ACATCTGCGT	GAAACACCGGTGTACGTATGGACTGAACCAGGGTGTGCAAAGTGGGGTTA	1
ACATCTGGGT	GAAACACCGGTCGATTCATATCGAAACCTTCCCGTGACAGTGGGGTTAGA	1
ACATCTGTTT	GAAACACCGGTCGATTCATATCGAAACCTTCCCGTGACAGTGGGGTTAGA	1
ACATCTTCGA	GAAACACCGGTGTACGTATGGACTGAACCAGGGTGTGCAAAGTGGGGTTA	1
ACATGGTCGC	GAAACACCGGTGTACGTATGGACTGAACCAGGGTGTGCAAGTGGGGTTAG	1
ACATTACAGC	GAAACACCGGTCGGGGCCACTCAGTGGTGGGGTTAGAGCTAGAAATAGCA	1
ACATTCATCT	GAAACACCGGTCGATTCATATAGAAACCTTCCCGTGACAGTGGGGTTAGA	1
ACATTCGAGG	GAAACACCGGTTAGCAAGTTAACCTAAGGCTAGTCCGTTATCAACTTGAA	1
ACATTCGGTT	GAAACACCGGTCGATTCATATCGAAACCTTCCCGTGACAGTGGGGTTAGA	359
ACATTCGGTT	GAAACACCGGTCGATTCATATCGAAACCTTCCCGTGACAAGTGGGGTTAG	20
ACATTCGGTT	GAAACACCGGTCGATTCATATCGAAACCTTCCCGTGAGTGGGGTTAGAGC	3
ACATTCGGTT	CAAAACACCGGTCGATTCATATCGAAACCTTCCCGTGACAGTGGGGTTAG	2
ACATTCGGTT	GAAACACCGGTCGATTCATATCGAAACCTTCCCGTGGGGTTAGAGCTAGA	2
ACATTCGGTT	GAAACACCGGTCGATTCATATCGAAGCCTTCCCGTGGGGTTAGAGCTAGA	2
ACATTCGGTT	GAAACTAGAAATAGCAAGTTAACCTAAGGCTAGTCCGTTATCAACTTGAA	2
ACATTCGGTT	GAAACACCGGTCGATTCATATCAAACCTTCCCGTGACAGTGGGGTTAGAG	1
ACATTCGGTT	GAAACACCGGTCGATTCATATCGAAACCTTCCCCGTGGGGTTAGAGCTAG	1
ACATTCGGTT	GAAACACCGGTCGATTCATATCGAAACCTTCCCGTGACAAAGTGGGGTTA	1
ACATTCGGTT	GAAACACCGGTCGATTCATATCGCTAGAAATAGCAAGTTAACCTAAGGCT	1
ACATTCGGTT	GAAACACCGGTCGATTCATATCGCTAGAAATAGCAAGTTAACCTGAGGCT	1
ACATTCGGTT	GAAACACCGGTTTACGTTGCATCGGTGTGGGGTTAGAGCTAGAAATAGTA	1
ACATTCGGTT	GAAACACCGGTTTGAACTACCTAGTAGCAAGTTAACCTAAGGCTAGTCCG	1
ACATTCGGTT	GAAACTAGAAATAGCAAGTTAACCTAAGGCTAGTCAGTTATCAACTTGAA	1
ACATTCGGTT	GAAGCACCGGTCGATTCATATCGAAACCTTCCCTGACCGTGGGGTTTGAG	1
ACATTGATGC	GAAACACCGGTCGGGGCCACTCAGTGGTGGGGTTAGAGCTAGAAATAGCA	1
ACATTTACAG	GCACCGGTCGGGGCCACTCAGTGGTGGGGTTAGAGCTAGAAATAGCAAGT	1
ACATTTAGCG	GAAACACCGGTCGGGGCCACTCAGTGGTGGGGTTAGAGCTAGAAATAGCA	1
ACATTTTCCC	GAAACACCGGTCGGGGCCACTCAGTGGTGGGGATAGAGCTAGAAATAGCA	1
ACCAACGCGC	GAAACACAGCAAGTTAACCTAAGGCTAGTCCGTTATCAACTTGAAAAAGT	1
ACCATGCCTA	GAAACACCGGTCCGTAGGAGACCCGTGTGGCATGTACCTGTGGGGTTAGA	1
ACCATTACCG	GAAACACCGGTCGGGGCCACTCAGTGGTGGGGTTAGAGCTAGAAATAGCA	1
ACCCAACGCC	GAAACACGGGTTAGAGCTAGAAATAGCAAGTTAACCTAAGGCTAGTCCGT	1
ACCCAATGCG	GACACGGGTTAGAGCTAGAAATAGCAAGTTAACCTAAGGCTAGTCCGTTA	1
ACCCACGCCC	GAAACACCGGTTAGAGCTAGAAATAGCAAGTTAACCTAAGGCTAGTCCGT	1
ACCCCCGGCG	GAAACACCGGTGTGGCTGAGAGTTCGGCAATGGTGTGGCTGTGGGGTTAG	1
ACCCTTACCG	GAAACACCGGTCGGGGCCACTCAGTGGTGGGGTTAGAGCTAGAAATAGCA	1
ACCGCCACAC	GAAACACCGGTGCCCTTACTCTCACCTGATTACTTAATCCGTGGGGTTAG	1
ACCGGCGCTA	GAAACACCGGTGCCCTTACTCCCACCTGATTACTTAATCCGTGGGGTTAG	1
ACCGTTACCG	GAAACACCGGTCGGGGCCACTCAGTGGTGGGGTTAGAGCTAGAAATAGCA	1
ACCTATACCG	GAAACACCGGTCGGGGCCACTCAGTGGTGGGGTTAGAGCTAGAAATAGCA	2
ACCTCGTCGT	GAAACACCGGTGTACGTATGGACTGAACCAGGGTGTGCAAGTGGGGTTAG	2
ACCTTAACCG	GAAACACCGGTCGGGGCCACTCATGTGGGGTTAGAGCTAGAAATAGCAAG	1
ACCTTAGGAT	GAAACACCGGTCGATTCATATCGAAACCTTCCCGTGACAGTGGGGTTAGA	1
ACCTTCGGAC	GAAACACCGGTCGATTCATATCGAAACCTTCCCGTGACAGTGGGGTTAGA	1
ACCTTTAACG	GAAACACCGGTCGGGGCCACTCAGTGGTGGGGTTAGAGCTAGAAATAGCA	1
ACCTTTACAG	GAAACACCGGTCGGGGCCACTCAGTGGTGGGGTTAGAGCTAGAAATAGCA	1
ACCTTTACGG	GAAACACCGGTCGGGGCCACTCAGTGGTGGGGTTAGAGCTAGAAATAGCA	1
ACCTTTAGCG	GAAACACCGGTCGGGGCCACTCAGTGGTGGGGTTAGAGCTAGAAATAGCA	1
ACCTTTATCG	GAAACACCGGTCGGGGCCACTCAGTGGTGGGGTTAGAGCTAGAAATAGCA	1
ACGAAGCCTT	GAAACACCGGTCTCGAGTGAGGTGTTCAGGTGGGGTTAGAGCTAGAAATA	1
ACGAAGCCTT	GAAACACCGGTCTCGAGTGAGGTGTTCAGGGTGGGGTTAGAGCTAGAAAT	1
ACGAATACTT	GAAACACCGGTCTCGAGTGAGGTGTTCAGGGTGGGGTTAGAGCTAGAAAT	1
ACGAATCATT	GAAACACCGGTCTCGAGTGAGGTGTTCAGGGTGGGGTTAGAGCTAGAAAT	2
ACGAATCCCT	GAAACACCGGTCTCGAGTGAGGTGTTCAGGGTGGGGTTAGAGCTAGAAAT	1
ACGAATCCTA	GAAACACCGGTCTCGAGTGAGGTGTTCAGGGTGGGGTTAGAGCTAGAAAT	1
ACGAATCCTC	GAAACACCGGTCTCGAGTGAGGTGTTCAGGGTGGGGTTAGAGCTAGAAAT	1
ACGAATCGTT	GAAACACCGGTCTCGAGTGAGGTGTTCAGGGTGGGGTTAGAGCTAGAAAT	2
ACGAGCAGAA	GAAACACCGGTTAAGCCGAGTGGGGTTAGAGCTAGAAATAGCAAGTTAAC	1
ACGAGTTGGA	GAAACACCGGTGACATTGGGTACAGGGGTGGGGTTAGAGCTAGAAATAGC	1
ACGAGTTGTC	GAAACACCGGTGACATTGGGTACAGGGTGGGGTTAGAGCTAGAAATAGCA	1
ACGATCGGGG	GAAACACCGGTTATATTTGCAAGGGTTGTGGGTTTAAAGCTGGAAATAGC	1
ACGCATCCTT	GAAACACCGGTCTCGAGTGAGGTGTTCAGGGTGGGGTTAGAGCTAGAAAT	2
ACGCATGCTT	GAAACACCGGTCTCGAGTGAGGTGTTCAGGGTGGGGTTAGAGCTAGAAAT	1
ACGCCAACCG	GAAACACCGGTTTACGTTGCATCGGTGGGGGGTTAGAGCTAGAAATAGCA	1
ACGCGCACAA	GAAACACCGGTTAAAGCCGAGGTTAGAGCTAGAGATAGCAAGTTAACCTA	1
ACGCGTTGTA	GAAACACCGGTGACATTGGGTAGGGTTAGAGCTAGAAATAGCAAGTTAAC	1
ACGCGTTTTC	GAAACACCGGTGACATTGGGTACAGGGGGTGGGGTTAGAGCTAGAAATAG	1
ACGCTACTCC	GAAACACCGGTGCCCTTACTCTCACCTGATTACTTAATCCGTGGGGTTAG	1
ACGCTGATCT	GAAACACCGGTTTACGTTGCATCGGTGTGGGGTTAGAGCTAGAAATAGCA	1
ACGCTGCCGA	GAAACACCGGTCCGTAGGAGACCCGATTGGCATGTACCTGTGCTGGTAGA	1
ACGCTGCGCC	GAAACACCGGTCCGTAGGAGACCCCCTAAGGCTAGTCCGTTATCAACTTG	1
ACGCTGTCTA	GAAACACCGGTCCGTAGGAGACCCGTGTGGCATGTACCTGTGGGGTTAGA	1
ACGGGCCTCC	GAAACACCGGTGCCCTTACTCTCACCTGATTACTTAATCCGTGGGGTTAG	1
ACGGTCCTAC	GAAACACCGGTGCCCTTACTCTCACCTGATTACTTAATCCGTGGGGTTAG	1
ACGTATCCTT	GAAACACCGGTCTCGAGTGAGGTGTTCAGGGTGGGGTTAGAGCTAGAAAT	1
ACGTCCGGTG	GAAACACCGGTCGATTCATATCGAAACCTTCCCGTGACAGTGGGGTTAGA	1
ACGTCGTAGG	GAAACACCGGTGTACGTATGGACTGAACCAGGGTGTGCATGTGGGGTTAG	1
ACGTGCTGTC	GGGTTAGAGCTAGAAATAGCAAGTTAACCTAAGGCTAGTCCGTTATCAAC	1
ACGTGGCGTC	GAAACACCGGTGACATTGGGTTAGAGCTAGAAATAGCAAGTTAACCTAAG	1
ACGTGGTGTC	GAAACACCGGTGACATTAGAGCTAGAAATAGCAAGTTAACCTAAGGCTAG	1
ACGTGGTGTC	GAAACACCGGTGACATTGGGTACGGGTAGAGCTAGAAATAGCAAGTTAAC	1
ACGTGTCGTC	GAAACACCGGTGACATTGGGTAGTGGGGTTAGAGCTAGAAATAGCAAGTT	1
ACGTGTTGTG	GTTAGAGCTAGAAATAGCAAGTTAACCTAAGGCTAGTCCGTTATCAACTT	1
ACGTGTTTTC	GAAACACCGGTGACATTGGGTAGTGGGGTTAGAGCTAGAAATAGCAAGTT	1
ACTAATAGGC	GAAACACCGGTACCTTTGTTGATGCTGGGTGGAAGGAATTTGTGGGGTTA	1
ACTAATCGGG	GAAACACCGGTACCTTTGTTGATGCTGGGTGGGGTTAGAGCTAGAAATAG	1
ACTACACGGT	GAAACACCGGTACCTTTGTTGATGCTGGGTGGAAGGAATTTGTGGGGTTA	1
ACTACTAGGC	GAAACACCGGTACCTTAGAGCTAGAAATAGCAAGTTAACCTAAGGCTAGT	1
ACTACTAGGC	GAAACACCGGTACCTTTGTTGATGCTGGGTGGAAGTGTGGGGTTAGAGCT	1
ACTACTCGGA	GAAACACCGGTACCCTTGTTGATGCTGGGTGGAAGGAATGTGGGGTTAGA	1
ACTACTCGGA	GAAACACCGGTACCTTTGTTGATGCTGGGTGGGGGGTTAGAGCTAGAAAT	1
ACTACTTGGA	GAAACACCGGTACCTTTATTGATGCTGGGTGCCACTTGAAAAAGTGGCAC	1
ACTAGAGAGG	GAAACACCGGTTATATTTGTAAGTGGGGTTAGAGCTAGAAATAGCAAGTT	1
ACTATACAGC	GAAACACCGGTCGGGGCCACTCAGTGGTGGGGTTAGAGCTAGAAATAGCA	1
ACTATAGAGT	ATAGCAAGTTAACCTAAGGCTAGTCCGTTATCAACTTGAAAACGTGGCAC	1
ACTATCCCGC	GAAACACCGGTTATATTTGTACGTGTGTGGGGTTAGAGCTAGAAATAGCA	1
ACTCAACGCC	GAAACACCGGTTTGAACTAGAAATAGCAAGTTAACCTAAGGCTAGTCCGT	1
ACTCAACGGC	GAAACACCGGTTTGAACTAGAAATAGCAAGTTAACCTAAGGCTAGTCCGT	1
ACTCACGAGG	GAAACACCGGTTATATTTGTAAGTGTGTGGGGTTAGAGCTAGAAACAGCA	1
ACTCCGCGTC	GAAACACCGGTGTACGTATGGACTGAACCAGGGTGTGCAAAGTGGGGTTA	1
ACTCCTCGGA	GAAACACCGGTACCTTAGAGCTAGAAATAGCAAGTTAACCTAAGGCTAGT	1
ACTCGACCCA	GAAACACCGGTCGATTCATATCGAAACCTTCCCGTGACAGTGGGGGTAGA	1
ACTCGCCGGG	GAAACACCGGTGTACGTATGGACTGAACCAGGGTGTGCAAGTGGGGTTAG	1
ACTCTAACGC	GAAACACCGGTCGGGGCCACTCAGTGGTGGGGTTAGAGCTAGAAATAGCA	1
ACTGAGAATA	GAAACACCGGTTAAGCCGAGGGTTAGAGCTAGAAATAGCAAGTTAACCTA	1
ACTGATCGCT	GAAACACCGGTTTGAACCGGTGGGGTTAGAGCTAGAAATAGCAAGTTAAC	1
ACTGATCGGG	GAAACACCGGTACCTTTGTTGATGCTGGGTGGGGTTAGAGCTAGAAATAG	1
ACTGCGTAGA	GAAACACCGGTTTACGTTGCATCGGTGTGGGGTTGGAGCTAGAAATAGCA	1
ACTTAAAAGG	GAAACACCGGTCGGGGCCACTCAGTGGTGGGGTTAGAGCTAGAAATAGCA	1
ACTTACCGCC	GAAACACCGGTCGGGGCCACTCAGTGGTGGGGTTAGAGCTAGAAATAGCA	1
ACTTCTCGGA	GAAACACCGGTACCTTTGTTGATGCTGGGTGGAAGGAATTTGTGGGGTTA	1
ACTTGACCAC	GAAACACCGGTCGGGGCCACTCAAGTGGGGTTAGAGCTAGAAATAGCAAG	1
ACTTTAACGA	GAAACACCGGTCGGGCAAGTTAACCTAAGGCTAGTCCGTTACAACTTGAA	1
ACTTTACAGA	GAAACACCGGTCGGGGCCACTCAGTGGTGGGGTTAGAGCTAGAAATAGCA	1
ACTTTAGCGT	GAAACACCGGTCGATTCATATCGAAACCTTCCCGTGACAAGTGGGGTTAG	1
ACTTTATGGC	GAAACACCGGTCGGGGCCACTCAAGTGGGGTTAGAGCTAGAAATAGCAAG	1
AGAAACAGAA	GAAACACCGGTAGCAAGTGCGAGACGTTTGTGGGGTTAGAGCTAGAAATA	1
AGAAACCGGC	GAAACACCGGTGCATTCGAAAGTCCGGTCGTAGTGTGGACGTGGGGTTAG	1
AGAAACTCGA	GAAACACCGGTGCATTCGAAAGTCCGGTCGTAGTGTGGACGTGGGGTTAG	1
AGAAAGTCTA	GAAACACCGGTGCATTCGAAAGTCCGGTCGTAGTGTGGACGTGGGGTTAG	1
AGAACATCGA	GAAACACCGGTGCATTCGAAAGTCCGGTTGTAGTGTGGACGTGGGGTTAG	1
AGAACATGAA	GAAACACCGGTAGCAAGTGCGAGACGTGTTAAATAGCAAGTTAACCTAAG	1
AGAACCAGTC	GAAACACCGGTAGCAAGTGCGTGGGGTTAGAGCTAGAAATAGCAAGTTAA	1
AGAACCTAGT	GAAACACCGGTGCATTCGAAAGTCCGGTCGTAGTGTGGACGTGGGGTTAG	1
AGAACGCCCT	GAAACACCGGTGCCCTTACTCTCACCTGATTACTTAATCCGTGGGGTTAG	1
AGAACTATCC	GAAACACCGGTGTGGCTGAGAGTCCGGCAATGGTGTGGCTGTGGGGTTAG	1
AGAAGAACCG	GAAACACCGGTCGGCGGCAATCGTGGGTGGGGTTAGAGCTAGAAATAGCA	1
AGAAGACACG	GAAACACCGGTCGGCGGCAATCGTGGGGTGGGGTTAGAGCTAGAAATAGC	1
AGAAGACACG	GACCGGTGTTTCGTGGGGTTAGAGCTAGAAATAGCAAGTTAACCTAAGGC	1
AGAAGACCAG	GAAACACCGGTCGGCGGCAATCGTGGGTGGGGTTAGAGCTAGAAATAGCA	1
AGAAGACTCG	GAAACACCGGTCGGTGGGGTTAGAGCTAGAAATAGCAAGTTAACCTAAGG	1
AGAAGCATTC	GAAACACCGGTCTCGAGTGAGGTGTTCAGGGTGGGGTTAGAGCTAGAAAT	1
AGAAGCCGCG	GAAACACCGGTCGGCGGCAATCGTGGGGTGGGGTTAGAGCTAGAAATAGC	1
AGAAGGCCCG	GAAACACCGGTCGGCGGCAATCGTGGGTGGGGTTAGAGCTAGAAATAGCA	1
AGAATAACCG	GAAACACCGGTCGGCGGCAATCGTGGGTGGGGTTAGAGCTAGAAATAGCA	1
AGAATACCCG	GAAACACCGGTCGGCGGCAATCGTGGGTGGGGTTAGAGCTAGAAATAGTA	1
AGAATCGGCC	GAAACACCGGTACCTTTGTTGATGCTGGGGTGGGGTTAGAGCTAGAAATA	1
AGAATCTTGT	GAAACACCGGTCTCGAGTGAGGTGTTCAGGGTGGGGTTAGAGCTAGAAAT	1
AGAATGAATC	GAAACACCGGTCCGTAGGAGACCCGTGTGGCATGTACCTTGTGGGGTTAG	1
AGAATGTCTC	GAAACACCGGTCCGTAGGAGACCCGTGTGGCATGTACCTGGGGTTAGAGC	1
AGAATTTCGC	GAAACACCGGTGCATTCGAAAGTCCGGTCGTAGTGTGGACGTGGGGTTAG	1
AGACAACGCC	GAAACACCGGTTTGAACTACCTAGTAGCAAGTTAACCTAAGGCTAGTCCG	1
AGACACAGCC	GAAACACCGGTAGCAAGTGCGAGACGTGTTTGTGGGGTTAGAGCTAGAAA	1
AGACACAGCC	GAAACACCGGTAGCAAGTGCGGGGTTAGAGCTAGAAATAGCAAGTTAACC	1
AGACACGAGC	GAAACACCGGTGCATTCGAAAGTCCGGTCGTAGTGTGGACGTGGGGTTAG	1
AGACACGCGA	GAAACACCGGTGCATTCGAAAGTCCGGTCGTAGTGTGGACGTGGGGTTAG	1
AGACAGAGAC	GAAACACCGGTAGCAAGTGCGAGACGTGTTAAATAGCAAGTTAACCTAAG	1
AGACAGCCGT	GAAACACCGGTGCATTCGAAAGTCCGGTCGTAGTGTGGACGTGGGGTTAG	1
AGACAGGCTA	GAAACACCGGTCCGTAGGAGACCCGTGCGGCATGTACCTGTGGGGTTAGA	1
AGACATAGAC	GAAACACCGGTGCAAGTTAACCTAAGGCTAGTCCGTTATCAACTTGAAAA	1
AGACCCAGCC	GAAACACCGGTAGCAAGTGCGAGCAAGTTGTGGGGTTAGAGCTAGAAATA	1
AGACCCGGTC	GAAACACCGGTGCATTCGAAAGTCCGGTCGTAGTGTGGACGTGGGGTTAG	1
AGACCCTCGC	GAAACACCGGTGCATTCGAAAGTCCGGTCGTAGTGTGGACGTGGGGTTAG	631
AGACCCTCGC	GAACACCGGTGCATTCGAAAGTCCGGTCGTAGTGTGGACGTGGGGTTAGA	5
AGACCCTCGC	GAAACACCGGTCCGTAGGAGACCCGTGTGGCATGCACCTGTGGGGTTAGA	1
AGACCCTCGC	GAAACACCGGTGTGGCTGAGAGTCCGGCAATGGTGTGGCTGTGGGGTTAG	1
AGACCCTCGC	GAAACACCGGTTACATTGAGGGGTTAGAGCTAGGAATAGCAAGTTAACCT	1
AGACCCTCGC	GAACACCGGTGCACTCGAAAGTCCGGTCGTAGTGTGGACGTGGGGTTAGA	1
AGACCCTCGC	GAACACCGGTGCATTCGAAAGTCCGGTCGTAGTCTGGACGTGGGGTTAGA	1
AGACCCTCGC	GACGAAACACCGGTGCATTCGAAAGTCCGGTCGTAGTGTGGACGTGGGGT	1
AGACCTACGT	GAAACACCGGTTTACGCTGCATCGCGGTAGAGCTGGAGATAGCAAGTTAG	1
AGACCTCTAC	GAAACACCGGTAAATTTGAGGCTCCGGCATGCAGGAGGCCGTGGGGTTAG	1
AGACGCAGAC	GAAACACCGGTAGCAAGTGCGAGACGTGTTTGTGGGGTTAGAGCTAGGAA	1
AGACGCAGAC	GAAACACCGGTAGCAAGTGCGAGACGTGTTTGTGGGGTTAGAGCTAGAAA	1
AGACGCGCGA	GAAACACCGGTGCCCTTACTCTCACCTGATTACTTAATCCGTGGGGTTAG	1
AGACGCGCGT	GAAACACCGGTGCATTCGAAAGTCCGGTCGTAGTGTGGACGTGGGGTTAG	1
AGACGGCCAG	GAAACACCGGTCGGCGGCAATCTGGGGTTAGAGCTAGAAATAGCAAGTTA	1
AGACTAGTGC	GAAACACCGGTGCATTCGAAAGTCCGGTCGTAGTGTGGACGTGGGGTTAG	1
AGACTCATTC	GAAACACCGGTCTCGAGTGAGGTGTTCAGGGTGGGGTTAGAGCTAGAAAT	1
AGACTCCCAC	GAAACACCGGTGTGGCTGAGAGTCCGGCAATGGTGTGTCTGGCGGGATAT	1
AGACTCGGAC	GAAACACCGGTACCTTTGTTGGTGGGGTTAGAGCTAGACATAGCAAGTTA	1
AGACTGCATA	GAAACACCGGTAGCAAGTGCGAGACGTGTTAAATAGCAAGTTAACCTAAG	1
AGACTGTATC	GAAACACCGGTCCGTAGGAGACCCGTGTGGCATGTACCTGGGGTTAGAGC	1
AGACTTTCCC	GAAACACCGGTGACATTGGGTACACAGTGGGGTTGGAGCTAGAAATAGCA	1
AGAGAACGCC	GAAACACCGGTTTGAACTAGAAATAGCAAGTTAACCTAAGGCTAGTCCGT	1
AGAGACAGAC	GAAACACCGGTAGCAAGTGCGAGACGTGTTTGTGGGGTTAGAGCTAGAAA	1
AGAGGAGACT	GAAACACCGGTTCCCGTCCAGTGGGGTTAGAGCTAGAAATAGCAAGTTAA	3
AGAGGAGCCT	GAAACACCGGTTCCCGTCCAGTGGGGTTAGAGCTAGAAATAGCAAGTTAA	1
AGAGGTGCCT	GAAACACCGGTTCCCGTCCAGTGGGGTTAGAGCTAGAAATAGCAAGTTAA	1
AGAGTATCGA	GAAACACCGGTGACATTGGGAATAGGGGCGTGGTTAGGGCTAGAAATAGC	1
AGAGTGCCTA	GAGACACCGGTCCGTAGGAGACCCGTGTGGCATGTACCTGTGGGGTTAGA	1
AGATAAAGAC	GAAACACCGGTAGCAAGTGCGAGACGTTAGAGCTAGAAATAGCAAGTTAA	1
AGATACTAGC	GAAACACCGGTGCATTCGAAAGTCCGGTCGTAGTGTGGACGTGGGGTTAG	1
AGATACTCGG	GAAACACCGGTACCTTTGTTGATGCTGGGTGGGGTTAGAGCTAGAAATAG	1
AGATATCTGT	GAAACACCGGTCTCGAGTGAGGGGTTCAGGGTGGGGTTAGAGCTAGAAAT	1
AGATCCGATA	GAAACACCGGTGAATTTGAGGCTCCGGCATGCAGGAGGCCCGTGGGGTTA	1
AGATCCTTTT	GAGACACCGGTGCATTCGAAAGTCCGGTCGTAGTGTGGACGTGGGGTTAG	1
AGATCGTCGT	GAAACACCGGTGTACGTATGGACTGAACCAGGGTGTGCAAGTGGGGTTAG	1
AGATGACAAG	GAAACACCGGTCGGGGTTAGAGCTAGAAATAGCAAGTTAACCTAAGGCTA	1
AGATGTACGT	GAAACACCGGTGTACGTATGGACTGAACCAGGGTGTGCAAGTGGGGTTAG	1
AGATTCCGTA	GAAACACCGGTTTGAACTAGAAATAGCAAGTTAACCTAAGGCTAGTCCGT	1
AGATTGTGTT	GAAACACCGGTCGATTCATATCGAAACCTTCCCGTGACAAGTGGGGTTAG	1
AGCAAGGCTC	GAAACACCGGTTTGAACTAGAAATAGCAAGTTAACCTAAGGCTAGTTCGT	1
AGCAGACCCG	GAAACACCGGTCGGCGGGTTAGAGCTAGAAATAGCAAGTTAACCTAAGGC	1
AGCAGCATCA	GAAACACCGGTTACGCCGAGGCGATAGAGTTAGAAATAGCAAGTTAACCT	1
AGCATCATTT	GAAACACCGGTCTCGAGTGAGGTGTTCAGGTGGGGTTAGAGCTAGAAATA	1
AGCCAACCTC	GAAACACCGGTGTGGCTGAGAGTCCGGCAATGGTGTGGCTGTGTGGTTAG	1
AGCCACTACT	GAAACACCGGTAAATTTGAGGCTCCGGCATGCAGGAGGCCGTGGGGTTAG	1
AGCCACTACT	GAAACACCGGTAAATTTGAGGCTCCGGCATGCAGGGGGCCGTGGGGTTAG	1
AGCCCCGAGC	GAAACACCGGTGCATTCGAAAGTCCGGTCGTAGTGTGGACGTGGGGTTAG	1
AGCCCTCTTC	GAAACACCGGTCCGTAGGAGACCCGTGTGGCATGTACCTGTGGGGTTAGA	1
AGCCGCAGTC	GAAACACCGGTAGCAAGTGCGAGACGTGTTAACTAGCACGTTAACCTAAG	1
AGCCGGCCAC	GAAACACCGGTCCGTAGGAGACCCGTGTGGCATGTACCTGAGGGGTTACA	1
AGCCTCCCTT	GAAACACCGGTTCCCGTCCAGTGGGGTTAGAGCTAGAAATAGCAAGTTAA	1
AGCCTCTAGC	GAAACACCGGTGCATTCGAAAGTCCGGTCGTAGTGTGGACGTGGGGTTAG	1
AGCGAATAGT	GAAACACCGGTCTCGAGTGAGGTGTTCAGGGTGGGGTTAGAGCTAGAAAT	1
AGCGAGCTAC	GAAACACCGGTGCCCTTACTCTCACCTGATTACTTAATCCGTGGGGTTAG	1
AGCGGCCTAG	GGTGCCCTTACTCTCACCTGATTACTTAATCCGTGGGGTTAGAGCTAGAA	1
AGCGTGGTGT	GAAACACCGGTGACATTGGGTACAGGGTGGGGTTAGAGCTAGAAATAGCA	1
AGCGTTAGAG	GAAACACCGGTAGCAAGTGCGAGACGTGTTAAATAGCAAGTTAACCTAAG	1
AGCGTTGTAT	GAAACACCGGTGCCCTTACTCTCACCTAATTACATCATCCGTGGGGTTAG	1
AGGAAAGGCC	GAAACACCGGTTTGAACTAGAAATAGCAAGTTAACCTAAGGCTAGTCCGT	1
AGGAACACTC	GAAACACCGGTGTGGCTGAGAGTCCGGCAATGGTGTGGCTGTGGGGTTAG	1
AGGAACCATC	GAAACACCGGTGTGGCTGAGAGTCCGGCAATGGTGTGGCTGTGGGGTTAG	1
AGGAACCCGA	GAAACACCGGTGTGGCTGAGAGTCCGGCAATGGTGTGGCTGTGGGGTTAG	1
AGGAACCCTC	GAAACACCGGTGTGGCTGAGAGTCCGGCAATGGTGTGGCTGTGGGGTTAG	1
AGGAACCGTC	GAAACACCGGTGTGGCTGAGAGTCCGGCAATGGTGTGGCTGTGGGGTTAG	1
AGGAAGCCTC	GAAACACCGGTCCGTAGGAGACCCGTGTGGCATGTACCTGTGGGGTTAGA	1
AGGAATAGCT	GAAACACCGGTTTACGTTGCATCGGTTGTGGGGTTAGAGCTAGAAATAGC	1
AGGAATCCTT	GAAACACCGGTCTCGAGTGAGGTGTTCAGGGTGGGGTTAGAGCTAGAAAT	1
AGGACGATGC	GAAACACCGGTAAATTTGAGGCTCCGGCATGCAGGAGGCCGTGGGGTTAG	1
AGGAGAATAA	GAAACACCGGTTAAGCCGAGGGGTTAGAGCTAGAAATAGCAAGTTAACCT	1
AGGAGCCTTT	GAAACACCGGTCTCGAGTGAGGAGTTTCGGGTGGGGTTAGAGCTAGCAAT	1
AGGATACCCC	GAAACACCGGTACGCAGGGAATCCGCATGGCATGAACCTGAGGGGGTAGA	1
AGGATCCTCC	GAAACACCGGTTTACGTTGCATCGGTGTGGGGTTAGAGCTAGAAATAGCA	1
AGGCAACCTC	GAAACACCGGTGTGGCTGAGAGTCCGGCAATGGTGTGGCTGTGGGGTTAG	2
AGGCAACGTC	GAAACACCGGTGTGGCTGAGAGTCCGGCAATGGTGTGGCTGTGGGGTTAG	1
AGGCAACTAT	GAAACACCGGTAAATTTGAGGCTCCGGCATGCAGGAGGCCGTGGGGTTAG	1
AGGCAACTTC	GAAACACCGGTGTGGCTGAGAGTCCGGCAATGGTGTGGTTGTGGGGTTAG	1
AGGCACATAC	GAAACACCGGTAAATTTGAGGCTCCGGCATGCAGGAGGCCGTGGGGTTAG	1
AGGCACCATC	GAAACACCGGTGTGGCTGAGAGTCCGGCAATGGTGTGGCTGTGGGGTTAG	2
AGGCACCGTC	GAAACACCGGTGTGGCTGAGAGTCCGGCAATGGTGTGGCTGAGGGGTTAG	1
AGGCACCTAC	GAAACACCGGTAAATTTGAGGCTCCGGCATGCAGGAGGCCGTGGGGTTAG	3
AGGCACCTAC	GAAACACCGGTAAATTTGAGGCTCCGGCATGCAGGAGGCCCGTGGGGTTA	1
AGGCACGAGC	GAAACACCGGTGCATTCGAGAGTCCGGTCGTAGTGTGGACGTGGGGTTAG	1
AGGCACTATC	GAAACACCGGTGTGGCTGAGAGTCCGGCAATGGTGTGGCTGTGGGGTTAG	1
AGGCAGCGTC	GAAACACCGGTGTGGCTGAGAGTCCGGCAATGGTGTGGCTGTGGGGTTAG	1
AGGCATCATC	GAAACACCGGTGTGGCTGAGAGTCCGGCAATGGTGCGGCTGAGGGGCCAG	1
AGGCCACGAC	GAAACACCGGTAAATTTGAGGCTCCGGCATGCAGGAGGCCGTGGGGTTAG	1
AGGCCACTAC	GAAACACCGGTGAATTTGAGGCTCCGGCATGCAGGAGGCCGTGGGGTTAG	1
AGGCCACTAC	GAAACACCGGTAAATTTGAGGCTCCGGCATGCAGGAGGCCGTGGGGTTAG	1
AGGCCCATAA	GAAACACCGGTAAATTTGAGGCTCCGGCATGCAGGAGGCCGTGGGGTTAG	1
AGGCCCCAAA	GAAACACCGGTAAATTTGAGGCTCCGGCATGCAGGAGGCCGTGGGGTTAG	1
AGGCCCCCTC	GAAACACCGGTGTGGCTGAGAGTCCGGCAATGGTGTGGCTGTGGGGTTAG	1
AGGCGGACTA	GAAACACCGGTCCGTAGGAGACCCGTGTGGCATGTACCTGTGGGGTTAGA	1
AGGCGGCCAC	GAAACACCGGTCCGTAGGAGACCCGTGTGGCATGTACCTGTGGGGTTAGA	1
AGGCTCTAGA	GAAACACCGGTGCATTCGACAGTCCGGTCGTAGTGTGGACGTGGGGTTAG	1
AGGCTGCATA	GAAACACCGGTCCGTAGGAGACCCGTGTGGCATGTACCTGTGGGGTTAGA	1
AGGCTGCTAC	GAAACACCGGTAAATTTGAGGCTCCGGCATGCAGGAGGCGTGGGGTTAGA	1
AGGGACCCTC	GAAACACCGGTGTGGCTGAGAGTCCGGCAATGGTGTGGCTGTGGGGTTAG	1
AGGGATACAT	GAAACACCGGTTCACGTTGCGTCGGCGTGGGGTTAGAGCTAGAAATAGCA	1
AGGGGAGCTC	GAAACACCGGTTCCCGTCCAGTGGGGTTAGAGCTAGAAATAGCAAGTTAA	1
AGGGGAGTCT	GAAACACCGGTTCCCGTCCAGTGGGGTTAGAGCTAGAAATAGCAAGTTAA	1
AGGGTCCATC	GAAACACCGGTGTGGCTGGGAGTCCGGCAATGGTGTGGCTGTGGGGTTAG	1
AGGGTTGCTC	GAAACACCGGTTCCCGTCCAGTGAGGGTAGAGTTAGAGATAGCAAGTTAA	1
AGGGTTGTAT	GAAACACCGGTGACGTGGGGTTAGAGCTAGAAATAGCAAGTTAACCTAAG	1
AGGTACACTA	GAAGCACCGGTGTGGCTGAGAGTCCGGCAATGGTGTGGCTGTGGGGTTAG	1
AGGTACACTC	GAAACACCGGTGTGGCTGAGAGTCCGGCAATGGTGTGGCTGTGGGGTTAG	1
AGGTCATCGC	GAAACACCGGTGCATTCGAAAGTCCGGTCGAAGTGTGGACGTGGGGTTAG	1
AGGTGGCTCC	GAAACACCGGTCAGTAGGAGAGCCGTGTGGAATGTTCCTTTGTGGGGCTA	1
AGGTTCGGTG	GAAACACCGGTCGATTCATATCGAAACCTTCCCGTGGGGTTAGAGCTAGA	1
AGTAAAGGCA	GAAACACCGGTTTGCAGTAAATATAGAGAGTTATACTAAGGCTAGGCCGT	1
AGTAAGTCTC	GAAACACCGGCCCGTAGGAGACCCGTGTGGCATGTACCTGTGGGGTTAGA	1
AGTACCTAGC	GAAACACCGGTGCATTCGAAAGTCCGGTCGTAGTGTGGACGTGGGGTTAG	1
AGTAGCGATG	GAAACACCGGTTACAATTGGGGTTAGAGCTAGAAATAGCAAGTTAACCTA	1
AGTAGCTATG	GAAACACCGGTTACATTGAGGGTTAGAGCTAGAAATAGCAAGTTAACCTA	1
AGTAGGAATC	GAAACACCGGTCCGTAGGAGACCCGTGTGGCATGTACCTGTGGGGTTAGA	1
AGTAGTCCTC	GAAACACCGGTCCGTAGGAGACCCGTGTGGCATGTACCTGTGGGGTTAGA	1
AGTATGACTA	GAAACACCGGTCCGTAGGAGACCCGTGTGGCATGTACCTGTGGGGTTAGA	1
AGTATGATTC	GAAACACCGGTCCGTAGGAGACCCGTGTGGCATGTACCTGTGGGGTTAGA	1
AGTCACCCTG	GAAACACCGGTGTGGCTGAGAGTCCGGCAATGGTGTGGCTGTGGGGTTAG	1
AGTCCCCTAC	GAAACACCGGTAAATTTGAGGCTCCGGCATGCAGGAGGCCGTGGGGTTAG	2
AGTCCGAGCC	GAAACACCGGTTTACGTTGCATCGGTGTGGGGTTAGAGCTAGAAATAGCA	1
AGTCGAGACT	GAAACACCGGTTCCCGTCCAGTGGGGTTAGAGCTAGAAATAGCAAGTTAA	1
AGTCGGACTT	GAAACACCGGTCCGTAGGAGACCCGTGTGGCATGTACCTGTGGGGTTAGA	1
AGTCGGAGAC	GAAACACCGGTTCCCGTCCAGTGGGGTTAGAGCTAGAAATAGCAAGTTAA	1
AGTCGGGATG	GAAACACCGGTCCGTAGGAGACCCGTGTGGCATGTACCTGGGGTTAGAGC	1
AGTCGGTGTC	GAAACACCGGTTCGTAGGAGACCCGTGTAGCATGTACCTGTGGGGTTAGA	1
AGTCTAATCT	GAAACACCGGTTTACGTTGCATCGGTGTGGGGTTAGAGCTAGAAATAGCA	1
AGTCTGATTT	GAAACACCGGTCCGTAGGAGACCCGTGTGGCATGTACCTGTGGGGTTAGA	1
AGTCTGCCTC	GAAACACCGGTCCGTAGGAGACCCGTGTGGCATGTACCTGTGGGGTTAGA	512
AGTCTGCCTC	GAAACACCGGTCCGTAGGAGACCCGTGTGGCATGTACCTTGTGGGGTTAG	27
AGTCTGCCTC	GAAACACCGGTCCGTAGGAGACCCGTGTGGCATGTGGGGTTAGAGCTAGA	7
AGTCTGCCTC	GAAACACCGGTCCGTAGGAGACCCGTGTGGCATGTACCTCTGTGGGGTTA	6
AGTCTGCCTC	GAAACACCGGTCCGTAGGAGACCCGTGTGGCATGTACCTGGGGTTAGAGC	6
AGTCTGCCTC	GAAACACCGGTCCGTAGGAGACCCCCTAAGGCTAGTCCGTTATCAACTTG	4
AGTCTGCCTC	GAAACACCGGTCCGTAGGAGACCCGTGTGGCATGTACGTGGGGTTAGAGC	4
AGTCTGCCTC	GAAACACCGGTCCGTAGGAGACCCGTTGTGGGGTTAGAGCTAGAAATAGC	4
AGTCTGCCTC	GAAACACCGGTCCGTAGGAGACCCGTGTTGTGGGGTTAGAGCTAGAAATA	3
AGTCTGCCTC	GAAACACCGGTCCGTGGCATGTTAGAGCTAGAAATAGCAAGTTAACCTAA	3
AGTCTGCCTC	GAAACACCGGTCCGTAGGAGACCCGTGTGTGGGGTTAGAGCTAGAAATAG	2
AGTCTGCCTC	GAAACACCGGTGTGGCTGAGAGTCCGGCAATGGTGTGGCTGTGGGGTTAG	2
AGTCTGCCTC	GAAACACCGGTCCGTAGGAGACCCGTGTGGCATGTAGTGGGGTTAGAGCT	1
AGTCTGCCTC	GAAACACCGGTCCGTAGGAGACCCGTGTGGCATGTTGTGGGGTTAGAGCT	1
AGTCTGCCTC	GAAACACCGGTCCGTAGGAGACCGTGTGGCATGTACCTGTGGGGTTAGAG	1
AGTCTGCCTC	GAAACACCGGTCCGTAGGAGATCCGTGTGGCGTTAGAGTGAGGGATAAGA	1
AGTCTGCCTC	GAAACACCGGTCGGGGCCACTCAGTGGTGGGGTTAGAGCTAGAAATAGCA	1
AGTCTGCCTC	GAAACACCGGTCGGGGCCACTCAGTTGTGGGGTTAGAGCTAGAAATAGCA	1
AGTCTGCCTC	GAAACACCGGTCTGTGGCATGTTAGAGCTAGAAATAGCAAGTTAACCTAA	1
AGTCTGCCTC	GAAACACCGGTGTGGCTGAGAGTCCGGCAATGGTGTGGCTGTGGGGGTAG	1
AGTCTGCCTC	GAAACACCGGTTCCCGTCCAGTGGGGTTAGAGCTAGAAATAGCAAGTTAA	1
AGTCTGCCTC	GAAACACCGGTTTGAACTAGAAATAGCAAGTTAACCTAAGGCTAGTCAGT	1
AGTCTTGCTA	GAAACACCGGTCCGTAGGAGACCCGTGTGGCATGTACCTCTGTGGGGTTA	1
AGTGAGCATA	GAAACACCGGTTAAGCCGAGGAGTTAGAGCTAGAAATAGCAAGTTAACCT	2
AGTGAGCATA	GAAACACCGGTTAAGCCGAGGGTTAGAGCTAGAAATAGCAAGTTAACCTA	1
AGTGATGCCT	GAAACACCGGTTCTCGGGCAGGGGGGTTAGGGCTAGAAATAGCAAGTTAA	1
AGTGATTAGC	GAAACACCGGTTTGCGTTGCATCGGTGTGGGGTTAGAGCTAGAAATAGCA	1
AGTGCCGTCT	GAAACACCGGTGACATTGGGTACAGGGTGGGGTTAGAGCTAGAAATAGCA	1
AGTGGAACCT	GAAACACCGGTTCCCGTCCAGTGGGGTTAGAGCTAGAAATAGCAAGTTAA	1
AGTGGAGACT	GAAATAGCAAGTTAACCTAAGGCTAGTCCGTTATCAACTTGAAAAAGTGG	1
AGTGGAGCAT	GAAACACCGGTTCCCGTCCAGTGGGGTTAGAGCTAGAAATAGCAAGTTAA	1
AGTGGAGCTT	GAAACACCGGTTCCCGTCCAGTGGGGTTAGAGCTAGAAATAGCAAGTTAA	1
AGTGGAGGCC	GAAACACCGGTTCCCGTCCAGTGGGGTTAGAGCTAGAAATAGCAAGTTAA	1
AGTGGAGGCT	GAAACACCGGTTCCCGTCCAGTGGGGTTAGAGTTAGAAATAGCAAGTTAA	1
AGTGGAGTCT	GAAACACCGGTTCCCGTCCAGTGGGGTTAGAGCTAGAAATAGCAAGTTAA	1
AGTGGGGACA	GAAACACCGGTTCCCGTCCAGTGGGGTCAGAGCTAGAAATAGCAAGTTAA	1
AGTGGGGCCT	GAAACACCGGTTCCCGTCCAGTGGGGTTAGAGCTAGAAATAGCAAGTTAA	1
AGTGGGGCCT	CAAAACACCGGTTCCCGTCCAGTGGGGTTAGAGCTAGAAATAGCAAGTTA	1
AGTGGTGCCT	GAAACACCGGTTCCCGTCCAGTGGGGTTAGAGCTAGAAATAGCAAGTTAA	1
AGTGTCGCCT	GAAACACCGGTTCCCGTCCAGTGGGGTTAGAGCTAGAAATAGCAAGTTAA	1
AGTGTGCTCG	GAAACACCGGTGACATTGGGTACGCTAGAAATAGCAAGTTAACCTAAGGC	1
AGTGTTGGTT	GAAACACCGGTCCGTAGGAGACCCGTGTGGCATGTACCTGTGGTGTTAGA	1
AGTTAACAAC	GAAACACCGGTAAATTTGAGGCTCCGGCATGCAGGAGGCCGTGGGGTTAG	1
AGTTAGTCGC	GAAACACCGGTGCATTCGAAAGTCCGGTCGTAGTGTGGACGTGGGGTTAG	1
AGTTCGACTC	GAAACACCGGTCCGTAGGAGACCCGTGTGGCATGTACCTGTGGGGTTAGA	1
AGTTTGCTAC	GAAACACCGGTCCGTAGGAGACCCGTGTGGCATGTACCTGTGGGGTTAGA	1
ATAAATTATT	GAAACACCGGTAACTATATTCATGCGATATCGCCGTATCAAGTGGGGTTA	1
ATAACTTAAA	GAAACACCGGTAACTATATTCATGCGATATCGCCGTATCAGTGGGGTTAG	1
ATAACTTCTA	GAAACACCGGTAACTATATTCATGCGATATCGCCGTATCAGTGGGGTTAG	2
ATAAGGTATA	GAAACACCGGTTACATTGAGGGTTAGAGCTAGAAATAGCAAGTTAACCTA	1
ATAATAGGCC	GAAACACCGGTACCTTTGTCGATGCTGGTGGGGTTAGAGCTAGAAATAGC	1
ATAATCGAGG	GAAACACCGGTTATATTTGTAAGTGGGTGGGGTTAGAGCTAGAAATAGCA	1
ATAATCGCCC	GAAACACCGGTGTCTCTGTTGGTGGGTCTAGAGCTGGTATTGGCAGATTA	1
ATAATCGGGA	GAAACACCGGTCGATTCATATCTAATCCTTCCCGTGACGGTGGAGATAGA	1
ATAATTCTCT	GAAACACCGGTTTCGAGTGAGGTGTTCAGGGTTGGGTTAGAGCTATAACT	1
ATAATTTATT	GAAACACCGGTAACTATATTCACGCGATATCGCCGTATCAGTGGGGTTAG	1
ATACAACGCC	GAAACACCGGTTTGAACTAGAAATAGCAAGTTAACCTAAGGCTAGTCCGT	1
ATACAACGCC	GAAACACCGGTTTGAACTACCTAGTTCAAACCGGTGGGGTTAGAGCTAGA	1
ATACACGGAC	GAAACACCGGTACCTTTGTTGATGCTGGGTGGGGTTAGAGCTAGAAATAG	1
ATACCATCAC	GAAACACCGGTGCATTCGAAAGTCCGGTCGTAGTGTGGACGTGGGGTTAG	1
ATACGCACGC	GAAACACCGGTGCATTCGAAAGTCCGGTCGTAGTGTGGACGTGGGGTTAG	1
ATACGCGGCT	GAAACACCGGTACCTTTGTTGATGCTGGGTGGGGTTAGAGCTAAAAATAG	1
ATACGCTCGA	GAAACACCGGTGCATTCGAAAGTCCGGTCGTAGTGTGGACGTGGGGTTAG	1
ATACTAACGC	GAAACACCGGTGCATTCGAAAGTCCGGTCGTAGTGTGGACGTGGGGTTAG	1
ATACTCAGCA	GAAACACCGGTACCTTTGTTGATGCTGGGTGGAAGGAATTGGAGCTAGAA	1
ATACTCATGT	GAAACACCGGTACCTTTGTTGATGCTGGGTGGAAGGAATTTGTGGGGTTA	1
ATACTCGCAC	GAAACACCGGTACCTTTGTTGATGCTGGGTGGAAGGAAAAAGTGGCACCG	1
ATACTCGGGT	GAAACACCGGTACCTTTGTTGATGCTGGGTGGAAGGAATTTTTTGTGGAT	1
ATACTGACTC	GAAACACCGGTCCGTAGGAGACCCGTGTGGCATGTACCTGTGGGGTTAGA	1
ATACTGCCTA	GAAACACCGGTCCGTAGGAGACCCGTGTGGCATGTACCTGTGGGGTTAGA	1
ATACTGGATC	GAAACACCGGTCCGTAGGAGACCCGTGTGGCATGTACCTTTGTGGGGTTA	1
ATACTGGCTC	GAAACACCGGTCCGTAGGAGACCCGTGTGGCATGTACCTGTGGGGTTAGA	1
ATACTTCTTA	GAAACACCGGTAACTATATTCATGCGATATCGCCGTATCAGTGGGGTTAG	1
ATACTTGGTC	GAAACACCGGTACCTTTGTTGATGCTGGGTGGAAGGAAGGTGGGGTTAGA	1
ATAGAAAGCT	GAAACACCGGTCGGCGGCAATCGGGGAATGAGCCAAGTGGGGATAGATCG	1
ATAGAGGGCC	GAAACACCGGTACCTTTGTTGATGCTGGGTGGAAGGTGGGGTTAGAGCTA	1
ATAGATACGC	GAAACACCGGTTTACGTTGCATCTAGAAATAGCAAGATAACCTAAGGCTA	1
ATAGATTAGA	GAAACACCGGTAACTATATTCATGCGATATCGCCGTATCAGTGGGGTTAG	1
ATAGCACTGT	GAAACACCGGTTACATTGAGATCTCTTTTGTGGGGTTAGAGCCAGAAATA	1
ATAGCGTGAC	GAAACACCGGTTCCCGTCCAGTGGGGTTAGAGCTAGAAATAGCAAGTTAA	1
ATAGCTGCGC	GAAACACCGGTGCATTCGAAAGTCCGGTCGTAGTGTGGACGTGGGGTTAG	1
ATAGCTTATA	GAAACACCGGTAACTATATTCATGCGATATCGCCGTATCAAGTGGGGTTA	1
ATAGCTTATA	GAAACACCGGTAACTATATTCATGCGATATCGCCGTATCAGTGGGGTTAG	1
ATAGGTGTCT	GAAACACCGGTGACATTGGGTACAGGGGTGGGGTTAGAGCTAGAAATAGC	1
ATAGTCTGCC	GAAACACCGGTCCGTAGGAGACCCGTGTGGCATGTACCTGTGGGGTTAGA	1
ATATATCTTA	GAAACACCGGTACTCCGGAAGGCTAAATGGAGTTATAGCTAGTAATCGTA	1
ATATGCATAA	GAAACACCGGTTAAGCCGAGGAGTTAGAGCTAGAAATAGCAAGTTAACCT	1
ATATGCGGGT	GAAACACCGGTCGATTCATATCGAAACCTTCCCGTGACAGTGGGGTTAGA	1
ATCAAACCAC	GCTAGAAATAGCAAGTTAACCTAAGGCTAGTCCGTTATCAACTTGAAAAA	1
ATCAATAATA	GAAACACCGGTTAAGCCGAGGGTTAGAGCTAGAAATAGCAAGTTAACCTA	1
ATCACACTGC	GAAACACCGGTGTGGCTGAGAGTCCGGCAATGGTGTGGCTGTGGGGTTAG	1
ATCAGCTATG	GAAACACCGGTTACATTGAGGGTTAGAGCTAGAAATAGCAAGTTAACCTA	1
ATCATAGTCG	GAAACACCGGTGTACGTATGGACTGAACCAGGGTGTGCAAGTGGGGTTAG	1
ATCATCGCCC	GAAACACCGGTACCTTTGTTGATGCTGGGGGGAAGGATGCTTTTTTTCCA	1
ATCATCGTGG	GAAACACCGGTGTACGTATGGACTGAACCAGGGTGGGGTTAGAGCTAGAA	1
ATCCTGGATC	GAAACACCGGTCCGTAGGAGACCCGTGTGGCATGTACCTGTGGGGTTAGA	1
ATCGAATTCT	GAAACACCGGTCTCGAGTGAGGTGTTCAGGGTGGGGTTAGAGCTAGAAAT	1
ATCGAGAGAG	GAAACACCGGTTATATTTGTAAGTGTGTGGGGTTAGAGCTAGAAATAGCA	1
ATCGTTAGTT	GAAACACCGGTTTTCGTTGCATCGGAAGCAAGTTAACCTAAAACTAGTCC	1
ATCTAAAGTG	GAAACACCGGTTATATTTGTAAGTGTGGGGTTAGAGCTAGAAATAGCAAG	1
ATCTAGCGAT	CAAGTTAACCTAAGGCTAGTCCGTTATCAACTTGAAAAAGTGGCACCGAG	1
ATCTATAGAG	GAAACACCGGCTATATTTGTAAGTGTGTGGGGTTAGAGCTAGAAATAGCA	1
ATCTATCGCG	GAAACACCGGTTATATTTGTAAGTGTGTGGGGTTAGAGCTAGAAATAGCA	1
ATCTATCGTG	GAAACACCGGTTATATTTGTAAGTGTGTGGGGTTAGAGCTAGAAATAGCA	1
ATCTATTGAG	GAAACACCGGTTATATTTGTAAGTGTGTGGGGTTAGAGCTAGAAATAGCA	1
ATCTCTCGAG	GAAACACCGGTTATATTTGTAAGTGTGTGGGGTTAGAGCTAGAAATAGCA	1
ATCTTTACCG	GAAACACCGGTCGGGGCCACTCAGTGGTGGGGTTAGAGCTAGAAATAGCA	1
ATCTTTAGTG	GAAACACCGGTCGGGGCCACTCAGTGGTGGGGTTAGAGCTAGAAATAGCA	1
ATGAACGTAC	GAAACACCGGTTAAGCCGAGGAGTTAGAGCTAGAAATAGCAAGTTAACCT	1
ATGAGCTATG	GAAACACCGGTTACATTGAGGGTTAGAGCTAGAAATAGCAAGTTAACCTA	1
ATGAGGATTA	GAAACACCGGTTAAGCCGAGGAGTTAGAGCTAGAAATAGCAAGTTAACCT	1
ATGATAACCG	GAAACACCGGTTTACGTTGCATCGGTGTGGGGTTAGAGCTAGAAATAGCA	1
ATGCAGCGCT	GAAACACCGGTTTACGTTGCATCGGTGTGGGGTTAGAGCTAGAAATAGCA	1
ATGCCCATAA	GAAACACCGGTAAATTTGAGGCTCCGGCATGCAGGAGGCCGTGGGGTTAG	1
ATGCGCATGC	GAAACACCGGTTAAGCCGAGTGGGGTTAGAGCTAGAAATAGCAAGTTAAC	1
ATGCGGATAA	GAAACACCGGTTAAGCCGAGTGGGGTTAGAGCTAGAAATAGCAAGTTAAC	1
ATGCGTCGTT	GAAACACCGGTTTACGTTGCATCGGTGTGGGGTTAGAGCTAGAAATAGCA	1
ATGCGTGGCA	GAAACACCGGTTTACGTTGCATCGGGGTTAGAGCAAGAAATAGCAAGTTA	1
ATGCTCCTTT	GAAACACCGGTCTCGAGTGAGGCGGTCAGGGGTGGGGTTAGAGCTAGACA	1
ATGCTCGGGA	GAAACACCGGTATCTTTTTTGATGCTGGGTGGAAGGTGGGGTTAGGGCGA	1
ATGCTCTGCC	GAAACACCGGTGCATTCGAAAGTCCGGTCGTAGTGTGGCCGGGGGGTTAG	1
ATGCTGCTCC	GAAACACCGGTTTACGTTGCATCGGTGTGGGGTTAGAGCTAGAAATAGCA	1
ATGCTTAGCT	GAAACACCGGTTTACGTTGCATCGGTGTGGGGTTAGAGCTAGAAATAGCA	468
ATGCTTAGCT	GAAACACCGGTTTACGTTGCATCGGGGTTAGAGCTAGAAATAGCAAGTTA	64
ATGCTTAGCT	GAAACACCGGTTTACGTTGCATCGGTTGTGGGGTTAGAGCTAGAAATAGC	44
ATGCTTAGCT	GAAACACCGGTTTACGTTGTGGGGTTAGAGCTAGAAATAGCAAGTTAACC	20
ATGCTTAGCT	GAAACACCGGTTTACGTTGCATCGTACGTTTTACGTTGAAAAAGTGGCAC	11
ATGCTTAGCT	GAAACACCGGTTTACGTTGCATCGGTTTGTGGGGTTAGAGCTAGAAATAG	10
ATGCTTAGCT	GAAACACCGGTTTACGTTGCATCGGTTAGAGCTAGAAATAGCAAGTTAAC	9
ATGCTTAGCT	GAAACACCGGTTTACAGCAAGTTAACCTAAGGCTAGTCCGTTATCAACTT	8
ATGCTTAGCT	GAAACACCGGTTTACGTTGCATCGGGTTAGAGCTAGAAATAGCAAGTTAA	8
ATGCTTAGCT	GAAACACCGGTTTACGTTGCATGTGGGGTTAGAGCTAGAAATAGCAAGTT	8
ATGCTTAGCT	GAAACACCGGTTAGCAAGTTAACCTAAGGCTAGTCCGTTATCAACTTGAA	7
ATGCTTAGCT	GAAACACCGGTTTACGTTGCATCAGCTAGAAATAGCAAGTTAACCTAAGG	7
ATGCTTAGCT	GAAACACCGGTTTACACCGGTGGGGTTAGAGCTAGAAATAGCAAGTTAAC	5
ATGCTTAGCT	GAAACACCGGTTTACGTTGCATCGGTAGCAAGTTAACCTAAGGCTAGTCC	5
ATGCTTAGCT	GAAACACCGGTTTACGTTTTACGTTGCTAGAAATAGCAAGTTAACCTAAG	5
ATGCTTAGCT	GAAACACCGGTTTACGTTGGGGGTTAGAGCTAGAAATAGCAAGTTAACCT	4
ATGCTTAGCT	GAAACACCGGTTTACGTTGCATCTAGAAATAGCAAGTTAACCTAAGGCTA	3
ATGCTTAGCT	GAAACACCGGTTTACGCTAGAAATAGCAAGTTAACCTAAGGCTAGTCCGT	2
ATGCTTAGCT	GAAACACCGGTTTACGTGTTGGGTTAGAGCTAGAAATAGCAAGTTAACCT	2
ATGCTTAGCT	GAAACACCGGTTTGCGTTGCATCGGTTAGAGCTAGAAATAGCAAGTTAAC	2
ATGCTTAGCT	GAAATAGCAAGTTAACCTAAGGCTAGTCCGTTATCAACTTGAAAAAGTGG	2
ATGCTTAGCT	GGAACACCGGTTTACGTTGCATCGGGTTAGAGCTAGAAATAGCAAGTTAA	2
ATGCTTAGCT	CAAAACACCGGTTTACGTTGCATCGGGGTTAGAGCTAGAAATAGCAAGTT	1
ATGCTTAGCT	CTAAACACCGGTTTACGTTGCATCGGGGTTAGAGCTAGAAATAGCAAGTT	1
ATGCTTAGCT	GAAACACCGGTACCTTTGTTGATGCTGGGTGGAAGGAATTTGTGGGGTTA	1
ATGCTTAGCT	GAAACACCGGTCTCGAGTGAGGTGTTCAGGGTGGGGTTAGAGCTAGAAAT	1
ATGCTTAGCT	GAAACACCGGTGTGGCTGAGAGTCCGGCAATGGTGTGGCTGTGGGGTTAG	1
ATGCTTAGCT	GAAACACCGGTTAAGCCGTGGGGTGAGAGCTAGCTAGAACAAGTTAACCA	1
ATGCTTAGCT	GAAACACCGGTTACGTTGCATCGGTGTGGGGTTAGAGCTAGAAATAGCAA	1
ATGCTTAGCT	GAAACACCGGTTCGTAGGAGATCCGTGTGGCATGTACCTGTGGGGTTAGA	1
ATGCTTAGCT	GAAACACCGGTTTACACCGGTGGGGTTAGAGCTAGAAATAGCAAGTTAGC	1
ATGCTTAGCT	GAAACACCGGTTTACACCGGTGGGGTTAGAGCTAGGAATAGCAAGTTAAC	1
ATGCTTAGCT	GAAACACCGGTTTACGCTAGAAATGGCAAGTTAACCTAAGGCTAGTCCGT	1
ATGCTTAGCT	GAAACACCGGTTTACGCTAGAACTAGCAGGTTAACCTACGACTAATACGT	1
ATGCTTAGCT	GAAACACCGGTTTACGTGTCGGGTTAGAGCTAGAAATAGCAAGTTAACCT	1
ATGCTTAGCT	GAAACACCGGTTTACGTTGCACCTAGAAATAGCAAGTTAACCTAAGGCTA	1
ATGCTTAGCT	GAAACACCGGTTTACGTTGCATCGGAAAAAGTGGCACCCTTTTTTTTTCA	1
ATGCTTAGCT	GAAACACCGGTTTACGTTGCATCGGAAAAAGTGGCACCTTTTTTTTTCAA	1
ATGCTTAGCT	GAAACACCGGTTTACGTTGCATCGGAAAAAGTGGCACCTTTTTTTTTTTC	1
ATGCTTAGCT	GAAACACCGGTTTACGTTGCATCGGTGTGGGTTAGAGCTAGAAATAGCAA	1
ATGCTTAGCT	GAAACACCGGTTTACGTTGCATCGGTTATTGTTATTGTTATCGGTTAGAG	1
ATGCTTAGCT	GAAACACCGGTTTACGTTGCATCGGTTGGGGTTAGAGCTAGAAATAGCAA	1
ATGCTTAGCT	GAAACACCGGTTTACGTTGGGGGTTAGAGCTAGAAATAGCTAGTTAACCT	1
ATGCTTAGCT	GAAACACCGGTTTGTGGGGTTAGAGCTAGAAATAGCAAGTTAACCTAAGG	1
ATGCTTAGCT	GAAGCACCGGTTTGTGGGGTTAGAGCTAGAAATAGCAAGTTAACCTAAGG	1
ATGCTTAGCT	GGAACACCGGTTTACGTTGCATCGGGTTAGAGTGGGGTTAGAGCTAGAAA	1
ATGGAGCATA	GAAACACCGGTTAAGCCGAGTGGGGTTAGAGCTAGAAATAGCAAGTTAAC	1
ATGGAGCATA	GAAACACCGGTTAAGCCGAGGAGTTAGAGCTAGAAATAGCAAGTTAACCT	1
ATGGATATGT	GAAACACCGGTTACATTGAGGGTTAGAGCTAGAAATAGCAAGTTAACCTA	1
ATGGCCAGGA	GAAACACCGGTTGAGCCGAGGTGTTATATCTAGAAATAGCAAGTTAACCT	1
ATGTACAGCT	GAAACACCGGTTTACGTTGCATCGGTGTGGGGTTAGAGCTAGAAATAGCA	1
ATGTATAGTT	GAAACACCGGTTTACGTTGCATCGGTGTGGGGTTAGAGCTAGAAATAGCA	1
ATGTATCGCT	GAAACACCGGTTTACGTTGCATCGGTGTGGGGTTAGAGCTAGAAATAGCA	1
ATGTCTACCT	GAAACACCGGTTTACGTTGGGGGTTAGAGCTAGAAATAGCAAGTTAACCT	1
ATGTCTGTCT	GAAACACCGGTCCGTAGGAGACCCGTGTGGCATGTACCTGTGGGGTTAGA	1
ATGTGAAGCA	GAAACACCGGTTCCCGTCCAGTGGGGTTAGAGCTAGAAATAGCAAGTTAA	1
ATGTGTTGTA	GAAACACCGGTGACAGGTGGGGTTAGAGCTAGAAATAGCAAGTTAACCTA	1
ATGTTAAGAT	GAAACACCGGTTTACGTTGCATCGGTGTGGGGTTAGAGCTAGAAATAGCA	1
ATGTTTATCC	GAAACACCGGTTTACACCGGTGGGGTTAGAGCTAGAAATAGCAAGTTAAC	1
ATTAAACATA	GAGACACCGGTTAAGCCGAGGAGTTAGAGCTAGAAATAGCAAGTTAACCT	1
ATTAGAATAA	GAAACACCGGTTAAGCCGAGGAGTTAGAGCTAGAAATAGCAAGTTAACCT	1
ATTAGATATG	GAAACACCGGTTACATTGAGGGTTAGAGCTAGAAATAGCAAGTTAACCTA	1
ATTAGATATG	GAAACACCGGTTACATTGAGGGGTTAGAGCTAGAAATAGCAAGTTAACCT	1
ATTAGGTATG	GAAACACCGGTTACTTGGGGTTAGAGCTAGAAATAGCAAGTTAACCTAAG	1
ATTATAAGAA	GAAACACCGGTTTACGTTGCATCGGTTGTGGGGTTAGAGCTAGAAATAGC	1
ATTATAGAGG	GAAACACCGGTTATATTTGCAAGTGTTTTGTGGGGTTAGAGCTAGAAATA	1
ATTATCTATG	GAAACGAGGGTTAGAGCTAGAAATAGCAAGTTAACCTAAGGCTAGTCCGT	1
ATTATGCGTC	GAAACACCGGTCCGTAGGAGACCCGTGTGGCATGTACCTGTGGGGTTAGA	1
ATTATTCATA	GAAACACCGGTCCGTAGGAGACCCGTGTGGCATGTACCTGTGGGGTTAGA	1
ATTCAACATA	GAAACACCGGTTAAGCTAAGGTTAACCTAAGGCTAGTCCGTTATCAACTT	1
ATTCCCTACA	GAAACACCGGTAAATTTGAGGCTCCGGCATGCAGGAGGCCGTGGGGTTAG	1
ATTCGCTATG	GAAACACCGGTTACATTGAGGGGTTAGAGCTAGAAATAGCAAGTTAACCT	1
ATTCGGACGC	GAAACACCGGTCCGTATGGGACCCGTGTGGCATGTACCTGGTGGGCTAAA	1
ATTCTCTATG	GAAACACCGGTTTAGAGCTAGAAATAGCAAGTTAACCTAAGGCTAGTCCG	1
ATTCTGACTA	GAAACACCGGTCCGTAGGAGACCCGTGTGGCATGTACCTGTGGGGTTAGA	1
ATTCTGACTT	GAAACACCGGTCCGTAGGAGACCCGTGTGGCATGTACCTGTGGGGTTAGA	1
ATTCTGCATA	GAAACACCGGTCCGTAGGAGACCCGTGTGGCATGTACCTGTGGGGTTAGA	1
ATTCTTAACG	GAAACACCGGTTTACGTTGCATCTAGAAATAGCAAGTTAACCTAAGGCTA	1
ATTGAGAATA	GAAACACCGGTTAAGCCGAGGAGTTAGAGCTAGAAATAGCAAGTTAACCT	1
ATTGAGAATA	GAAACACCGGTTAGAGCTAGAAATAGCAAGTTAACCTAAGGCTAGTCCGT	1
ATTGAGCAGA	GAAACACCGGTTAAGCCGAGGTTAGAGCTAGAAATAGCAAGTTAACCTAA	1
ATTGAGCATC	GAAACACCGGTTAAGCCGAGTGGGGTTAGAGCTGGAAATAGCAAGTTAAC	1
ATTGAGTATA	GAAACACCGGTTAAGCCGAGGAGTTAGAGCTAGAAATAGCAAGTTAACCT	1
ATTGAGTATA	GAAACACCGGTTAAGCCGAGTGGGGTTAGAGCTAGAAATAGCAAGTTAAC	1
ATTGATCATC	GAAACACCGGTTAAGCCGAGGATGGGGTTAGAGCTAGAAATAGCAAGTTA	1
ATTGCATAGC	GAAACACCGGTTTACGTTGCATCGGTGTGGGGTTAGAGCTAGAAATAGCA	1
ATTGCGTATA	GAAACACCGGTTAAGCCGAGGAGTTAGAGCTAGAAATAGCAAGTTAACCT	1
ATTGCTTAGA	GAAACACCGGTTTACGTTGCATCGGTGTGGGGTTAGAGCTAGAGATAGCA	1
ATTGCTTATA	GAAACACCGGTAACTATATTCATGCGATATCGCCGTATCGTGGGGTTAGA	1
ATTTACATAT	GAAACACCGGTTACATTGAGATTGGGGTTAGAGCTAGAAATAGCAAGTTA	1
ATTTAGCATA	GAAACACCGGTTAAGCCGAGGAGTTAGAGCTAGAAATAGCAAGTTAACCT	1
ATTTAGCATA	GAAACACCGGTTAAGCCGGTGGGGTTAGAGCTAGAAATAGCAAGTTAACC	1
ATTTAGCCTA	GAAACACCGGTTAAGCCGAGGAGTTAGAGCTAGAAATAGCAAGTTAACCT	1
ATTTGAATGA	GAGACACCGGTCGGGGCCACTCAGTGGTGGGGTTAGAGCTAGAAATAGCA	1
ATTTTAACGA	GAAACACCGGTCGGGGCCACTCAGTGGTGGGGTTAGAGCTAGAAATAGCA	1
ATTTTACCGT	GAAACACCGGTCGGAGCCACTCAGTGGCGGGGGTAGAGATTAAAAAACAA	1
CAAAAAGACC	GAAACACCGGTTTGAACCGGTGGGGTTAGAGCTAGAAATAGCAAGTTAAC	1
CAAAACGAAA	GAAACACCGGTTTGAACTACCGGGGTTAGAGCTAGAAATAGCAAGTTAAC	1
CAAAACGGCA	GAAACACGGGTTAGAGCTAGAAATAGCAAGTTAACCTAAGGCTAGTCCGT	1
CAAAACTCTG	GAAACACCGGTGCATTCGAAAGTCCGGTCGTAGTGTGGACGTGGGGTTAG	1
CAAACATCGC	GAAACACCGGTGCATTCGAAAGTCCGGTCGTAGTGTGGACGTGGGGTTAG	1
CAAATCGAGG	GAAACACCGGTTATATTTGTAAGTGTGTGGGGTTAGAGCTAGAAATAGCA	1
CAACACCCTT	GAAACACCGGTCGGCGGCAACGTGGGGTTAGAGCTAGAAATAGCAAGTTA	1
CAACACCTTT	GAAACACCGGTCGGGGGGGTTAGAGCTAGAAATAGCATGTTAACATAAGG	1
CAACACGCCT	GAAACACGGGTTAGAGCTAGAAATAGCAAGTTAACCTAAGGCTAGTCCGT	1
CAACCTCGGC	GAAACACCGGTGCATTCGAAAGTCCGGTCGTAGTGTGGACGTGGGGTTAG	1
CAACGACTAC	GAAACACCGGTGTACGCATGGACTGAACCAGGGTGTGCAAGTGGGGTTAG	1
CAACGCCGTT	GAAACACCGGTCTCGAGTGAGGTGTTCAGGGTGGGGATAGAGCTAGAAAT	1
CAACGCGTCC	GAAACACCGGTACCTTTGTTGATGTTGATGTGGGGTTAGAGCTAGAAATA	1
CAACTCGCTC	GAAACACCGGTTTGAACTAGAAATAGCAAGTTAACCTAAGGCTAGTCCGT	1
CAACTGGCCT	GAAACACCGGTCCGTAGGAGACCCGTGTGGCATGTACCTGAGCGGGTAGT	1
CAACTTGAAC	GAAACACCGGTAAGTATATTCATGTGATATCGCCGTATCAAGTGGTGTTA	1
CAACTTTCGG	GAAACACCGGTCGATTCATATCGAAACCTTCCCGTGACAGTGGGGTTAGA	1
CAAGCAATAT	GAAACACCGGTGCCCTCACTCTCACCTGATTACTTAATCCGTGGGGTTAG	1
CAAGCATCGC	GAAACACCGGTCGGCGGCCGGTTAGAGCTAGAAATAGCAAGTTAAAATAA	1
CAATACGACC	GAGACACCGGTTTGGGGGTAGAGCTAGAAATAGCAAGTTAACCTAAGGCT	1
CAATACGGTT	GAAACACCGGTCGATTCATATCGAAACCTTCCCGTGACAGTGGGGTTAGA	1
CAATCTCTGG	GAAACACCGGTGAGGGTTAGAGCTAGAAATAGCTAATTAACCTAAGGCTA	1
CAATTCGTTT	GAAACACCGGTATCAAGGGAGGTGTTCAGGGTGGGGTTAGAGCTAGAAAT	1
CACAAAGAGC	GAAACACCGGTCGGGGCCACTCAGTGGTGGGGTTAGAGCTAGAAATAGCA	1
CACAAATGCA	GAAACACCGGTAGCAAGTGCGAGCAAGTTTGTGGGGTTAGAGCTAGAAAT	1
CACAACCACT	GAAACACCGGTTTGAACTAGAAATAGCAAGTTAACCTAAGGCTAGTCCGT	1
CACAACGCCC	GAAACACCGGTTTGAACTAGAAATAGCAAGTTAACCTAAGGCTAGTCCGT	281
CACAACGCCC	GAAACACGGGTTAGAGCTAGAAATAGCAAGTTAACCTAAGGCTAGTCCGT	90
CACAACGCCC	GCTAGAAATAGCAAGTTAACCTAAGGCTAGTCCGTTATCAACTTGAAAAA	41
CACAACGCCC	GAAACACCGGTTTGAACTACCTAGTTCAAACCGGTGGGGTTAGAGCTAGA	33
CACAACGCCC	GAAACACCGGTTTGAACTACCTAGTAGCAAGTTAACCTAAGGCTAGTCCG	22
CACAACGCCC	GAAACACCGGTTTGAACCGGTGGGGTTAGAGCTAGAAATAGCAAGTTAAC	16
CACAACGCCC	GAAACACCGAGTTAACCTAAGGCTAGTCCGTTATCAACTTGAAAAAGTGG	14
CACAACGCCC	GAAACCACGGGTTAGAGCTAGAAATAGCAAGTTAACCTAAGGCTAGTCCG	10
CACAACGCCC	CGTCCGTTATCAACTTGAAAAAGTGGCACCGAGTCGGTGTTTTTTTCCTG	9
CACAACGCCC	GAAACATAGCAAGTTAACCTAAGGCTAGTCCGTTATCAACTTGAAAAAGT	7
CACAACGCCC	GAAACACAGCAAGTTAACCTAAGGCTAGTCCGTTATCAACTTGAAAAAGT	6
CACAACGCCC	GAAACACCGGTTTGAAATAGCAAGTTAACCTAAGGCTAGTCCGTTATCAA	5
CACAACGCCC	GAAACACCGGTTTGAACTACCGGGGTTAGAGCTAGAAATAGCAAGTTAAC	5
CACAACGCCC	GAAACACCGGTTTGAACTACCTGGGGTTAGAGCTAGAAATAGCAAGTTAA	5
CACAACGCCC	GAAACACCGGTTTGAAAGCTAGAAATAGCAAGTTAACCTAAGGCTAGTCC	3
CACAACGCCC	GAAACACCGGTTTGAACTACCAAGTTAACCTAAGGCTAGTCCGTTATCAA	3
CACAACGCCC	GAAACACCGGTTTACCGGGGTTAGAGCTAGAAATAGCAAGTTAACCTAAG	2
CACAACGCCC	GAAACACCGGTTTGAAAGTGGGGTTAGAGCTAGAAATAGCAAGTTAACCT	2
CACAACGCCC	GAAACACCGGTTTGAACGTGGGGTTAGAGCTAGAAATAGCAAGTTAACCT	2
CACAACGCCC	GAAACACCGGTTTGAACTACCTAGGGGGTAGTTCAAACCGGGGTTAGAGC	2
CACAACGCCC	GAAACACCGGTTTGAACTACCTAGTTCAAACCGGGTGGGGTTAGAGCTAG	2
CACAACGCCC	GACACGGGTTAGAGCTAGAAATAGCAAGTTAACCTAAGGCTAGTCCGTTA	2
CACAACGCCC	CAAAACACAGCAAGTTAACCTAAGGCTAGTCCGTTATCAACTTGAAAAAG	1
CACAACGCCC	GAAACACCGGTAACTATATTCATGCGATATCGCCGTATCAGTGGGGTTAG	1
CACAACGCCC	GAAACACCGGTCTGCACCACTCAGTAGAGGTGGTAGAACCAGAAAAAGCA	1
CACAACGCCC	GAAACACCGGTGACATTGGGTACGGGGTGGGGTTAGAGCTAGAAATAGCA	1
CACAACGCCC	GAAACACCGGTTAGAACTACCTAGTTCAAACCGGGTGGGGTTAGAGCTAG	1
CACAACGCCC	GAAACACCGGTTGGCAGTACTCGTGTGTGGGGTTAGAGCTAGAAATAGCA	1
CACAACGCCC	GAAACACCGGTTTACCGGGGTTAGAGCTAGAAATAGCAAGTTAATCTAAG	1
CACAACGCCC	GAAACACCGGTTTGAAAGTGGGGTTAGAGCTAGAAAAAGCAAGTTAACCT	1
CACAACGCCC	GAAACACCGGTTTGAACTAAAGGGTTAGAGCTAGAAATAGCAAGTTAACC	1
CACAACGCCC	GAAACACCGGTTTGAACTACCTAGCAAGTTAACCTAAGGCTAGTCCGTTA	1
CACAACGCCC	GAAACACCGGTTTGAACTACCTAGGGTTAGAGCTAGAAATAGCAAGTTAA	1
CACAACGCCC	GAAACACCGGTTTGAACTACCTAGTTCAAACCCGGTGGGGTTAGAGCTAG	1
CACAACGCCC	GAAACACCGGTTTGAGCTACCTGGGGTTAGAGCTAGAAATAGCAAGTTAA	1
CACAACGCCC	GAAACACCGGTTTGGGGTTAGAGCTAGAAATAGCAAGTTAACCTAAGGCT	1
CACAACGCCC	GAAACACCGGTTTGGGGTTAGAGCTAGAAATAGCATGTTAACCTAAGGCT	1
CACAACGCCC	GAAACCCCGGTTTGAAGCAAAAGTAGCAGGTTATCCTGATACTAGTACCT	1
CACAACGCCC	GAAACGCCGGTTTGAACTACCAAGTTAACCTAAGGCTAGTCCGTTATCAA	1
CACAACGTGT	GAAACACCGGTTTGAACTAGAAATAGCAAGTTAACCTAAGGCTAGTCCGT	1
CACAACGTTA	GAAACACCGGTTTGAACTAGAAATAGCAAGTTAACCTAAGGCTAGTCCGT	1
CACACACATC	GAAACACCGGTAGCAAGTGCGAGCAAGTTTTTGTGGGGTTAGAGCTAGAA	1
CACACAGCAC	GAAACACCGGTTTGAACTAGAAATAGCAAGTTAACCTAAGGCTAGTCCGT	1
CACACCCCTC	GAAACACCGGTTTGAACTAGAAATAGCAAGTTAACCTAAGGCTAGTCCGT	1
CACAGAGATC	GAAACACCGGTTTGAAATAGCAAGTTAACCTAAGGCTAGAAATAGCAAGA	1
CACAGAGGAC	GAAACACCGGTGCCCTTACTCTCACCTGATTACTTAATCCGTGGGGTTAG	1
CACAGCAGTC	GAAACACCGGTGTACGTATGGACTGAACCAGGGTGTGCAAGTGGGGTTAG	1
CACATCACAC	GAAACACCGGTGCCCTTACTCACACCTGATTACTTAATCCGTGGGGTTAG	1
CACATCACAC	GAAACACCGGTTTGAACTAGAAATAGCAAGTTAACCTAAGGCTAGTCCGT	1
CACATGCTCT	GAAACACCGGTTTGAACTACCTAGCAAGTTAACCTAAGGCTAGTCCGTTA	1
CACCACGTAC	GAAACCACGGGTTAGAGCTAGAAATAGCAAGTTAACCTAAGGCTAGTCCG	1
CACCCCTCCC	GAAACACCGGTTAGAGCTAGAAATAGCAAGTTAACCTAAGGCTAGTCCGT	1
CACCGAATTC	GAAACACCGGTGTACGTATGGACTGAACCGGGGTGTGCAAGTGGGGTTTG	1
CACCGCACTT	GAAACACCGGTGTACGTATGGACTGAACCAGGGTGTGTAAGGGGGGTTAG	1
CACCTTTACC	GAAACACCGGTCGGGGCCACTCAGTGGTGGGGTTAGAGCCAGAAATAGCA	1
CACGAGGTCC	GAAACACCGGTTTGAACTACCTAGTAGCAAGTTAACCTAAAGCTAGAACG	1
CACGCCATTC	GAAACACCGGTGCCCTTACTCTCACCTGATTACTTGATCCGTGGGGTTAG	1
CACGCGATAA	GAAACACCGGTGCCCTTACTCTCACCTAATTACTTAATCCGTGGGGTTAG	1
CACGCTCTAA	GAAACACCGGTGCCCTTACTCTCACCTGATTACTTAATCCGTGGGGTTAG	1
CACTAAGCCA	GAAACACCGGTTTGAACTGGAAATAGCAAGTTATCGTAAGGCTAGTCCGA	1
CACTATGCTC	GAAACACGGGTTAGAGCTAGAAATAGCAAGTTAACCTAAGGCTAGTCCGT	1
CACTCCGCAC	GAAACACCGGTTTGAACCGGTGGGGTTAGAGCTAGAAATAGCAAGTTAAC	1
CACTGCGGAC	GAAACACCGGTGCCCTTACTCTCACCTGATTACTTAATCCGTGGGGGTAG	1
CACTTACCGA	GAAACACCGGTCGGGGCCACTCAGTGGTGGGGTTAGAGCTAGAAATAGCA	1
CACTTTCTGC	GAAACACCGGTGACATTAGAGCTAGAAATAGCAAGTTAACCTAAGGCTAG	1
CAGAAAGCTC	GAAACACCGGTTTGAACTACCTAGTTCAAACCGGTGGGGTTAGAGCTAGA	1
CAGAAGCCTC	GAAACACCGGTTCCCGTCCAGTGGGGTTAGAGCTAGAAATAGCAAGTTAA	1
CAGAATGTCC	GAAACACCGGTTTGAACTAGAAATAGCAAGGTAACATAAGGCTAGTCCGT	1
CAGAGCCTAG	GAAACACCGGTTAACCCGAGGAGTTAGAGCTGGAAGAAGCAAGTTAACCA	1
CAGAGGCGTC	GAAACACCGGTGTACGTATGGACTGAACCAGGGTGTGCAAGTGGGGTTAG	1
CAGAGTCCTC	GAAACACCGGTGTACGTATGGACTGAACCAGGGTGTGCAAGTGGGGTTAG	1
CAGATCGAGG	GAAACACCGGTTATATTTGTAAGTGTGTGGGGTTAGAGCTAGAAATAGCA	1
CAGATCGTCC	GAAACACGGGTTAGAGCTAGAAATAGCAAGTTAACCTAAGGCTAGTCCGT	1
CAGATGGCTC	GAAACACCGGTCCGTAGGAGACCCGTGTGGCATGTACGTGTGGGGTTAGA	1
CAGCGTCGGT	GAAACACCGGTGTACGTATGGACTGAACCAGGGTGTGCAAGTGGGGTTAG	1
CAGCGTGGGC	GAAACACCGGTGTACGTATGGACTGAACCAGGGTGTGCAAGTGGGGTTAG	1
CAGCTTAGAT	GAAACACCGGTTTACGTTGCATCGGTGTGGGGTTAGAGCTAGAAATAGCA	1
CAGCTTAGTC	GAAACACCGGTGTACGTATGGACTGAACCAGGGTGTGCAAGTGGGGTTAG	1
CAGGATGTTG	GAAACACCGGTGACATTGGGTACAGGGGTGGGGTTAGAGCTAGAAATAGC	1
CAGGCACCCT	GGAACACCGGTGTGGCTGAGAGTCCGGCAATGGTGTGGCTGTGGGGTTAG	1
CAGGCCCTCC	GAAACACCGGTGCCCTTACTCTCACCTGATTACTTAATCCGTGGGGTTAG	1
CAGGGTAGTA	GAAACACCGGTGTACGTATGGACTGAACCAGGGTGTGCAAGTGGGGTTAG	1
CAGGTAGGCT	GAAACACCGGTGACATTGGGCTAGAAATAGCAAGTTAACCTAAGGCTAAT	1
CAGTTAATGC	GAAACACCGGTCGGGGCCACTCAGTGGTGGGGTTAGAGCTAGAAATAGCA	1
CATAACGCGT	GAAACACCGGTTGAACCGGTGGGGTTAGAGCTAGAAATAGCAAGTTAACC	1
CATAGACGTA	GAAACACCGGTGTACGTATGGACTGAACCAGGGTGTGCAAGTGGGGTTAG	1
CATAGCGCGC	GAAACACGGGTTAGAGCTAGAAATAGTAAGTTAACCTAAGGCTAGTCCGT	1
CATAGCGGGA	GAAACACCGGTACCTTTGTTGATGCTGGGTGGAAGGAATTTGTGGGGTTA	1
CATAGGATAA	GAAACACCGGTCGGGGCCACTCAGTGGTGGGGTTAGAGCTAGAAATAGCA	1
CATAGGCGTT	GAAACACCGGTGTACGTATGGACTGAACCAGGGTGTGCAAGTGGGGTTAG	1
CATAGTAGAC	GAAACACCGGTGTACGTATGGACTGAACCAGGGTGTGCAAGTGGGGTTAG	1
CATAGTAGCC	GAAACACCGGTGTACGTATGGACTGAACCAGGGTGGGGTTAGAGCTAGAA	1
CATATCGCCT	GAAACACCGGTTTGAACTAGAAATAGCAAGTTAACCTAAGGCTAGTCCGT	1
CATCACCCCC	GAAACACCGGTTTGAACTAGAAATAGCAAGTTAACCTAAGGCTAGTCCGT	1
CATCGTCGTC	GAAACACCGGTGTACGTATGGACTGAACCAGGGTGTGCAAGTGGGGTTAG	454
CATCGTCGTC	GAAACACCGGTGTACGTATGGACTGAACCAGGGTGTGCAAAGTGGGGTTA	28
CATCGTCGTC	GAAACACCGGTGTACGTATGGACTGAACCAGGGTGGGGTTAGAGCTAGAA	12
CATCGTCGTC	GAAACACCGGTGGTGCTTTTTTTCCTGCAGGGACGACGATGGAATTCGGG	8
CATCGTCGTC	GAAACACCGGTGTACGTATGGACTGAACCAGGGTGTTATCAACTTGAAAA	8
CATCGTCGTC	GAAACGCCGGTGTACGTATGGACTGAACCAGGGTGTGCAAAAGTGGGGTT	5
CATCGTCGTC	GAAACACCGGTGTACGTATGGACTGAACCAGCAAGTTAACCTAAGGCTAG	4
CATCGTCGTC	GAAACACCGGTGTACGTATGGACTGAACCAGAAATAGCAAGTTAACCTAA	3
CATCGTCGTC	GAAACACCGGTGTACGTATGGACTGAACCAGGGTGTGCAACTTGCTTGGG	3
CATCGTCGTC	GAAACACCGGTGTACGTATGGGTTAGAGCTAGAAATAGCAAGTTAACCTA	3
CATCGTCGTC	GAACACCGGTGTACGTATGGACTGAACCAGGGTGTGCAAGTGGGGTTAGA	3
CATCGTCGTC	GAAACACCGGTGTACGTATGGACTGAACCAGGGTGTGCAGGGTGTGCAAA	2
CATCGTCGTC	GAAACACCGGTGTACGTATGGACTGAACCAGGGTGTGGGGTTAGAGCTAG	2
CATCGTCGTC	CAAAACACCGGTGTACGTATGGACTGAACCAGGGTGTGCAAGTGGGGTTA	1
CATCGTCGTC	CAAAACACCGGTGTACGTATGGACTGAACCAGGGTGTGGGTTAGAGCTAG	1
CATCGTCGTC	GAAACACAAGTTAACCTAAGGCTAGTCCGTTATCAACTTGAAAAAGTGGC	1
CATCGTCGTC	GAAACACCGGTACCTTTGTTGATGCTGGGTGGAAGGAATTAGTGGGGTTA	1
CATCGTCGTC	GAAACACCGGTCCGTAGAAGACCCGTATGGCGTGGTGCTGAGGGGGTTTA	1
CATCGTCGTC	GAAACACCGGTCCGTAGGAGACCCGTGTGGCATGTACCTGTGGGGTTAGA	1
CATCGTCGTC	GAAACACCGGTCGGGGCCACTACTGGGCGAGGGTAGGCCTAGAAGGATAG	1
CATCGTCGTC	GAAACACCGGTGCCCTTACTCTCACCTGATTACTTAATCCGTGGGGTTAG	1
CATCGTCGTC	GAAACACCGGTGTACGGAGCGACTGTACAAGTGTGTGTAAGAGGGGATAC	1
CATCGTCGTC	GAAACACCGGTGTACGTATGGACTGAACCAGGGTGTGCAGGGTGTGAAAA	1
CATCGTCGTC	GAAACACCGGTGTACGTATGGACTGAACCAGGGTGTGGGTTAGAGCTAGA	1
CATCGTCGTC	GAAACACCGGTGTACGTATGGGCTGAACCAGGGTGTGCAAAAGTAGGGTT	1
CATCGTCGTC	GAACACCGGTGTACGTATGGACTGAACCAGGGTGTGCGAGTGGGGTTAGA	1
CATCGTCGTC	GAACCACCGGTGTACGTATGGACTGAACCAGGGTGTGCAAAAGTGGGGTT	1
CATCTACCTC	GAAACACCGGTAGCAAGTGCGAGACGTGTTTGTGGGGTTAGAGCTAGAAA	1
CATCTTCTGC	GAAACACCGGTCGGGGCCACTCAGTGTTAGAGCTAGAAATAGCGAGTTAA	1
CATGCTCTCC	GAAACACCGGTGCCCTTACTCTCACCTGATTACTTAATCCGTGGGGTTAG	1
CATGTACAGC	GAAACACCGGTCGGGGCCACTCAGTGGTGGGGTTAGAGCTAGAAATAGCA	1
CATGTAGTCA	GAAACACCGGTAGCAAGTGGGGTTAGAGCTAGAAATAGCAAGTTAACCTA	1
CATTCAGAGC	GAAACACCGGTCGGGGCCACTCAGTGGTGGGGTTAGAGCTAGAAATAGCA	1
CATTGAATTC	GAAACACCGGTGTACGTATGGACTGAACCAGGGTGTGCAAGTGGGGTTAG	1
CATTTATGGC	GAAACACCGGTCGGGGCAAGTTAACCTAAGGCTAGTCCGTTACAACTTGA	1
CCAAACTCCC	GAAACACCGGTTAGAGCTAGAAATAGCAAGTTAACCTAAGGCTAGTCCGT	1
CCAACCGCCA	GAAACACCGGTTTGAACTAGAAATAGCAAGTTAACCTAAGGCTAGTCCGT	1
CCAATACGTT	GAAACACCGGTCTCGAGTGAGGTGTTCAGGGTGGGGTTAGAGCTAGAAAT	2
CCAATCATAC	GAAACACCGGTACCTTTGTTGATGATAGCAAGTTAACCTAAGGCTAGTCC	1
CCACCCCTTT	GAAACACCGGTATCGGGAGCGGTTAGAGGGGGGGGTAGAGCTAGAAATAG	1
CCATACAGCC	GAGACACCGGTCGGGGCCACTCAGTGGTGGGGTTAGAGCTAGAAATAGCA	1
CCATTAGTAT	GAAACACCGGTCGATTCATATCGAAACCTTCCCGTGACAGTGGGGTTAGA	1
CCATTAGTGC	GAAACACCGGTCGGGGCCACTCAGTGGTGGGGTTAGAGCTAGAAATAGCA	1
CCATTCCCTC	GAAACACCGGTCGGGGCCACTCAGTGGTGGGGTTATAGCTAGAAATAGCG	1
CCCAACCCAT	GAAACACCGGTTTCGTGGGATGGGTTCAGGTGGGGTTAGAGCTAGTAATA	1
CCCAGAGCCC	GAAACACGGGTTAGAGCTAGGAATAGCAAGTTAACCTAAGGCTAGTCCGT	1
CCCCTGGGGT	GAAACACCGGTCGATTCATATCACCACCTTCCCGTGACAGTGCGGTTAGT	1
CCCGACCTAC	GAAACACCGGTGCCCTTACTCTCACCTGATTACTTAATCCGTGGGGTTAG	1
CCGAAAGACC	GAAACACCGGTAATCAGAGGTGAACGTAAGGTGGGGTTAGAGCTAGAAAT	1
CCGAACCAGG	GAAACACCGGTCGGGGCCACTCAGGGGTGGGGTTAGAGCTAGAAATAGCA	1
CCGAACGCGT	GAAACACCGGTTTGACCTACCTAGTAGCAAGTTAACCTAAGGCTAGTCCG	1
CCGATCATAC	GAAACACCGGTTAAGCCGGTGGGGTTAGAGCTAGAAATAGCAAGTTAACC	1
CCGCACCTTC	GAAACACCGGTATCGCGTGAGGTGATCAGGGTGTAGTTAGAGATATAGAT	1
CCGCTAAGCG	GAAACACCGGTTTACGTTGCATCGGTGTGGGGTTAGAGCTAGAAATAGCA	1
CCTAGTAGTC	GAAACACCGGTTTACGTCTGGACTGAACCAGCCAGTTAACCTAAGGCTAG	1
CCTAGTCGTT	GAAACACCGGTGTACGTATGGACTGAACCAGGGTGTGCAAGTGGGGTTAG	1
CCTAGTGGTC	GAAACACCGGTGTACGTATGGACTGAACCAGGGAGTGCAAGTGGGGTTAG	1
CCTCTAGCTC	GAAACACCGGTTTGAACTAGAAATAGCAAGTTAACCTAAGGCTAGTCCGT	1
CCTCTGCATC	GAAACACCGGTCCGTAGGAGTCCCGTGTGGCATTTACCTGTGGGGTTAGA	1
CCTCTGCCCC	GAAACACCGGTCCGTAGGAGACCCGTGTGGCAGGTTCCTGTGGGGATAGA	1
CCTTCATCCA	GAAACACCGGTCGTGGCCACTCCGTGGTGGGGTTAGAGCTAGAAATAGCA	1
CCTTGAATGC	GAAACACCGGTCGGGGCCACTCAGTGGTGGGGTTAGAGCTAGAAATAGCA	1
CCTTTACCGC	GAAACACCGGTCGGGGCCACTCAGTGGTGGGGTTAGAGCTAGAAATAGCA	545
CCTTTACCGC	GCACCGGTCGGGGCCACTCAGTGGTGGGGTTAGAGCTAGAAATAGCAAGT	9
CCTTTACCGC	GAAACACCGGTCGGGGCCACTCAGTGGGGTTAGAGCTAGAAATAGCAAGT	8
CCTTTACCGC	GAAACACCGGTCGGGGCCACTCAGTGTGGGGTTAGAGCTAGAAATAGCAA	8
CCTTTACCGC	GAAACACCGGTCGGGGCCACTGGTGGGGTTAGAGCTAGAAATAGCAAGTT	7
CCTTTACCGC	GAAAAATAGCAAGTTAACCTAAGGCTAGTCCGTTACAACTTGAAAAAGTG	5
CCTTTACCGC	GAAACACCGGTCTGGTGGGGTTAGAGCTAGAAATAGCAAGTTAACCTAAG	5
CCTTTACCGC	GAAACACCGGTCGGGGCAAGTTAACCTAAGGCTAGTCCGTTACAACTTGA	4
CCTTTACCGC	GAAACACCGGTCGGGGCCACTCAGCTAGAAATAGCAAGTTAACCTAAGGC	4
CCTTTACCGC	GAAACACCGGTCGGGGCCACTCAGTGCCCTCGTGGGGTTAGAGCTAGAAA	4
CCTTTACCGC	GAAACACCGGTCGGGGCCACTCATGTGGGGTTAGAGCTAGAAATAGCAAG	4
CCTTTACCGC	CACCGGTCGGGGCCACTCAGTGGTGGGGTTAGAGCTAGAAATAGCAAGTT	3
CCTTTACCGC	GAAACACCGGTCGGGGCAAGTTAGCCTAAGGCTAGTCCGTTACAACTTGA	3
CCTTTACCGC	GAAACACCGGTCGGGGCCACTCAGGTTAGAGCTAGAAATAGCAAGTTAAC	3
CCTTTACCGC	GAAACACCGGTCGGGGCCAGTGGGGTTAGAGCTAGAAATAGCAAGTTAAC	3
CCTTTACCGC	CAAAACACCGGTCGGGGCCACTCAGTGGTGGGGTTAGAGCTAGAAATAGC	2
CCTTTACCGC	GAAACACCGGTACCTTTGTTGATGCTGGGTGGAAGGAATTTGTGGGGTTA	2
CCTTTACCGC	GAAACACCGGTCGGGCAAGTTAACCTAAGGCTAGTCCGTTACAACTTGAA	2
CCTTTACCGC	GAAACACCGGTCGGGGATTTGAGCTAGAAATAGCAAGTTAACCTAAGGCT	2
CCTTTACCGC	GAAACACCGGTCGGGGCCACTCAAGTGGGGTTAGAGCTAGAAATAGCAAG	2
CCTTTACCGC	GAAACACCGGTCGGGGCCACTCAGTATAGCAAGTTAACCTAAGGCTAGTC	2
CCTTTACCGC	GAAACACCGGTCGGGGCCACTCAGTGGGCTTAGAGCTAGAAATAGCAAGT	2
CCTTTACCGC	GAAACACCGGTCGGGGCCACTCAGTGGGTGGGGTTAGAGCTAGAAATAGC	2
CCTTTACCGC	GAAACACCGGTCGGGGCCACTCAGTGTTAGAGCTAGAAATAGCAAGTTAA	2
CCTTTACCGC	GAAACACCGGTCGGGGCGGGTTAGAGCTAGAAATAGCAAGTTAACCTAAG	2
CCTTTACCGC	GAAACACCGGTCGGGGGTTAGAGCTAGAAATAGCAAGTTAACCTAAGGCT	2
CCTTTACCGC	CACCGGTCGGGGCCACTCAGTGGTGGGGTTGGAGCTAGAAATAGCAAGTT	1
CCTTTACCGC	CACCGGTCTGGGCCACTCAGTGGTGGGGTTAGAGCTAGAAATAGCAAGTT	1
CCTTTACCGC	GAAAAATAGCAAGTTAACCTAAGGCTAGTCCGTTACAACTCGAAAAAGTG	1
CCTTTACCGC	GAAAATTAGCAAGTTAACCTAAGGCTAGTCCGTTACAACTTGAAAAAGTG	1
CCTTTACCGC	GAAACACCGGTAGCAAGTGCGAGACGTGTTGAATAGCAAGTTAACCTATG	1
CCTTTACCGC	GAAACACCGGTCGGGCAAGTTAACCTAAGGCCAGTCCGTTACAACTTGAA	1
CCTTTACCGC	GAAACACCGGTCGGGCAAGTTAACCTAAGGCTAGTCCGCTACAACTTGAA	1
CCTTTACCGC	GAAACACCGGTCGGGCCACTCAGTGGTGGGGTTAGAGCTAGAAATAGCAA	1
CCTTTACCGC	GAAACACCGGTCGGGGCAAGTTAACCTAAGGCTAGTCCGTTACAACTTGG	1
CCTTTACCGC	GAAACACCGGTCGGGGCACTCAGTGGTGGGGTTAGAGCTAGAAATAGCAA	1
CCTTTACCGC	GAAACACCGGTCGGGGCGGGTTAGAGCTAGGAATAGCAAGTTAACCTAAG	1
CCTTTACCGC	GAAACACCGGTCTAGCAAGTTAACCTAAGGCTAGTCCGTTACAACTTGAA	1
CCTTTACCGC	GAAACACCGGTGGGGGCCAGTCAGTGGCGGGGGTGGGGATGGAGATAGAA	1
CCTTTACCGC	GAAACACCGGTGGGGTTAGAGCTAGAAATAGCAAGTTAACCTAAGGCTAG	1
CCTTTACCGC	GAAACACGGGTTAGAGCTAGACATAGCAAGTTAACCTAAGGCTAGTCCGT	1
CCTTTACCGC	GAAACCACGGGCTAGGGCTAGAAATAGCAAGTTAACCTAAGGCTAGTCCG	1
CCTTTACCGC	GAAGCACCGGTCGGGGCCACGTGGGGTTAGAGCTAGAAATAGCAAGTTAA	1
CCTTTACCGC	GACGAAACACCGGTCGGGGCCACTCAGTGGTGGGGTTAGAGCTAGAAATA	1
CCTTTACCGC	GAGACACCGGTCGGGGCCAGTGGGGTTAGAGCTAGAAATAGCAAGTTAAC	1
CCTTTACCGC	GCAAGTTAACCTAAGGCTAGTCCGTTACAACTTGAAAAAGTGGCACCGAG	1
CCTTTCACGA	GAAACACCGGTCGGGGCCACTCAGTGGTGGGGTTAGAGCTAGAAATAGCA	1
CCTTTCCCCA	GAAACACCGGTCGGGGCCACTCGGTGGTGGGGTTAGAGCTAGAAATAGCA	1
CCTTTCGGTC	GAAACACCGGTCGATTCATATCGAAACCTTCCCGTGACAGTGGGGTTAGA	1
CGAAACGACC	GAAACACCGGTTTGAACTAGAAATAGCAAGTTAACCTAAGGCTAGTCCGT	1
CGAACCCGCC	GAAACACCGGTGTGGCTGAGAGTCCGGCAATGGTGTGGCTGTGGGGTTAG	1
CGAACCTTCC	GAAACACCGGTGTGGCTGAGAGTCCGGCAATGGTGTGGCTGTGGGGATAG	1
CGAATCAGCT	GAAACACCGGTCTCGAGTGAGGTGTTCAGGGTGGGGTTAGAGCTAGAAAT	1
CGAATCCTTT	GAAACACCGGTCTCGAGTGAGGTGTTCAGGGTGGGGTTAGAGCTAGAAAT	501
CGAATCCTTT	GAAACACCGGTCTCGAGTGAGGTGTTCAGGTGGGGTTAGAGCTAGAAATA	46
CGAATCCTTT	GAAACACCGGTCTCGAGTGAGGTGTTCAGGGGTGGGGTTAGAGCTAGAAA	14
CGAATCCTTT	GAAACACCGGTCTCGAGTGAGGTGTTCAGGGGGTGGGGTTAGAGCTAGAA	10
CGAATCCTTT	GAAACACCGGTCTCGAGTGATTGGGGTTAGAGCTAGAAATAGCAAGTTAA	7
CGAATCCTTT	GAAACACCGGTCTCGAGTGAGGTTAGAGCTAGAAATAGCAAGTTAACCTA	5
CGAATCCTTT	GAAACACCGGTCTCGAGTGAGGAGCTAGAAATAGCAAGTTAACCTAAGGC	4
CGAATCCTTT	GAAACACCGGTCTCGAGTGAGGGTTAGAGCTAGAAATAGCAAGTTAACCT	3
CGAATCCTTT	GAAACACCGGTCTCGAGTGAGGTGTGAGGTGTTCAGGTGGGGTTAGAGCT	2
CGAATCCTTT	GAAACACCGGTCTCGAGTGAGGTGTTCAGGTGTTCAGGTGGGGTTAGAGC	2
CGAATCCTTT	CTAAACACCGGTCTCGAGTGATTGGGGTTAGAGCTAGAAATAGCAAGTTA	1
CGAATCCTTT	GAAACACCGGTATCCAGGGAGGCGTTGAGGGGGTGGAGAGAGCTAGAGAT	1
CGAATCCTTT	GAAACACCGGTCTCGAGAGAGGTGTTACGGGGGGGGTTAGGGCTGGAAAT	1
CGAATCCTTT	GAAACACCGGTCTCGAGCGAGGTTAGAGGTGGGGTTAGAGCTAGAAATAG	1
CGAATCCTTT	GAAACACCGGTCTCGAGTAAGGTTAGAGGTGGGGTTAGAGCTAGAAATAG	1
CGAATCCTTT	GAAACACCGGTCTCGAGTGAGGAGGGGTTAGAGCTAGAAATAGCAAGTTA	1
CGAATCCTTT	GAAACACCGGTCTCGAGTGAGGTGTGAGGTGTTCAGGTGGGGTTGGAGCT	1
CGAATCCTTT	GAAACACCGGTCTCGAGTGAGGTGTTCATAGAGCTAGAAATAGCAAGTTA	1
CGAATCCTTT	GACGAAACACCGGTCTCGAGTGAGGTGTTCAGGGTGGGGTTAGAGCTAGA	1
CGAATCCTTT	GGAACACCGGTCGATTCATATCGAAACCTTCCCGTGACAGTGGGGGTAGA	1
CGAATGCCTC	GAAACACCGGTCTCGAGTGAGGTGTTCAGGTGGGGTTAGAGCTAGAAATA	1
CGACACTGCA	GAAACACCGGTGTGGCTGAGAGTCCGGCAATGGCGTGGCTGTGGGGTTAG	1
CGACCCTACC	GAAACACCGGTAAATTTGAGGCTCCGGCATGCAGGAGGCCGTGGGGTTAG	1
CGACGCATTT	GAAACACCGGTCTCGAGTGAGGTGTTCAGGGTGGGGTTAGAGCTAGAAAT	1
CGACGCTATT	GAAACACCGGTGCATTCGAAAGTCCGGTCGTAGTGTGGACGTGGGGTTAG	1
CGACTCTTGC	GAAACACCGGTGCATTCGAAAGTCCGGTCGTAGTGTGGACGTGGGGTTAG	1
CGACTGCCAC	GAAACACCGGTCCGTAGGAGACCCGTGTGGCATGTACCTTGTGGGGTTAG	1
CGACTTACAC	GAAACACCGGTAACTATATTCATGCGATATCGCCGTAGTTAGAGCTGGAA	1
CGACTTGCGT	GAAACACCGGAGCATTCGAAAGACCGGTCGTAGTGTGGACGAGGGGTTAG	1
CGACTTGTCC	GAAACACCGGTAACTATATTCATGCGATATCGCCGTATCAGTGGGGTTAG	1
CGAGCCATTT	GAAACACCGGTCTCGAATGAGGTGTTCAGGGTGGGGCTAGAGCTAGAAAT	1
CGAGCTGTCA	GAAACACCGGTGACATTGGGTAAAATAGCAAGTTAACCTAAGGCTAGTCC	1
CGAGTAGGTT	GAAACACCGGTGGCATTGGGTAGGGTTAGAGCTAGAAATAGCAAGTTAAC	1
CGATAGGTTT	GAAACACCGGTCGATTCATATCGAAACCTTCCCGTGACAGTGGGGTTAGA	1
CGATATTCGC	GAAACACCGGTGCATTCGAAAGTCCAGTCGTAGTGTGGACGTGGGGTTAG	1
CGATCCTGGT	GAAACACCGGTGCATTCGAAAGTCCGGTCGTAGTGTGGACGTGGGGTTAG	1
CGATTACCGA	GAAACACCGGTCGGGGCCACTCAGTGGTGGGGTTAGAGCTAGAAATAGCA	1
CGATTCACTC	GAAACACCGGTCTCGAGTGAGGTGTTCAGGGTGGGGTTAGAGCTAGAAAT	1
CGATTCTCTC	GAAACACCGGTGCATTCGAAAGTCCGGTCGTAGTGTGGACGTGGGGTTAG	1
CGCATAGCCC	GAAACACCGGTTTCATTTGGCATAGAGCTAGAAATAACAAGTTAACCTAA	1
CGCCAACTAC	GAAACACCGGTGCGGCTGAGAGTCCGGCAATGGTGTGGCTGTGGGGTTAG	1
CGCCACCGCA	GAAACACCGGTAAATTTGAGGCTCCGGCATGCAGGAGGCCGTGGGGTTAG	1
CGCCTGTCTC	GAAACACCGGTCCGTAGGAGACCCGTGTGGCATGTACCTGTGGGGTTAGA	1
CGCGAATCCT	GAAACGCCGGTCTCGAGTGAGGTGTTCAGGGTGGGGTTAGAGCTAGAAAT	1
CGCTTCATTC	GAAACACCGGTCTCGAGTGAGGGGTTCAGTAGGGGTTAAAGCTAGAAATA	1
CGGAACCCAT	GAAACACCGGTCTCGAGTGAGGTGTTCAGGGTGGGGTTAGAGCTAGAAAT	1
CGGACACTTC	GAAACACCGGTCTCGATTGAAGTGTTCCGGGTGGGGTTAGAGCTAGAAAT	1
CGGAGCATTA	GAAACACCGGTTTTAGTGGGGGTAGACATAGAAATAGTAAATTAACCTAT	1
CGGAGCCGTC	GAAACACCGGTCTCGAGTGAGGTGTTCAGGGTGGGGTTAGAGCTAGAAAT	1
CGGATCATTC	GAAACACCGGTCTCGAGTGAGGTGTTCAGGGTGGGGTTAGAGCTGGAAAT	1
CGGCAGTTTA	GAAACACCGGTCCGTAGGAGACCCGTGTGGCATGTACCTGTGGGGTTAGA	1
CGGCCTGGTC	GAAACACCGGTCCACGTATGGACTAAACCAGGGTGTGCCTAGGGGTATAG	1
CGGCGGCGTT	GAAACACCGGCGTACGTATGGACTGAACCAGGGTGTGCAAGTGGGGTTAG	1
CGGCGGTTGC	GAAACACCGGTGTATTCGATAGGCCGGTCGGAGTGGAGACGAGAGATTAG	1
CGGCGTCGTA	GAAACACCGGTGTACGTATGGACTGAACCAGGGTGTGCAAGTGGGGTTAG	1
CGGCTTCGCT	GGAACACCGGTTTACGTTGCATCGGGGTTAGAGCTAGAAATAGCAAGTTA	1
CGGGCTCTTA	GAAACACCGGTGACAGGTGGGGTTAGAGCTAGAGATAGCAAGTTAACATA	1
CGGGTAGGCT	GAAACACCGGTGGCATTGGGTACATGGTGGGGTTAGAGCTAGAAATAGCA	1
CGGGTTGTTC	GAAACACCGGTGACATTGGGTACAGGGGTGGGGTTAGAGCTAGAAATAGC	1
CGGTCGCCAG	GAAACACCGGTCCGCAGGAGACCCGTGTGGCATGTACCTGTGGGGTTAGA	1
CGGTTATCTC	GAAACACCGGTCGGGGCCACTGGGGGGGTTAGAGCTAGAAATAGCAAGTT	1
CGTAACGCTC	GAAACACCGGTTTGAACTACCTAGTAGCAAGTTAACCTAAGGCTAGTCCG	1
CGTAACGTAC	GAAGCACGGGTTAGAGCTAGAAATAGCAAGTTAACCTAAGGCTAGTCCGT	1
CGTACAGTCC	GAAACACCGGTGTGGCTGAGAGTCCGGCAATGGTGTGGCTGTGGGGTTAG	1
CGTAGTCGTT	GAAACACCGGTGTACGTATGGACTGAACCAGGGTGTGCAAGTGGGGTTAG	1
CGTATGCACC	GAAACACCGGTCCGTAGGAGACCCGTGTGGCATGTACCTGTGGGGTTAGA	1
CGTATTATTT	GAAACACCGGTCTCGAGTGAGGTGTTCAGGGTGGGGTTAGAGCTAGAAAT	1
CGTCGCCGCC	GAAACACCGGTGTACGTATGGACTGAACCAGGGTGTGCAAGTGGGGTTAG	1
CGTCGGACTC	GAAACACCGGTCCGTAGGAGACCCGTGTGGCATGTACCTGTGGGGTTAGA	1
CGTCTACATA	GAAACACCGGTCCGTAGGAGACCCGGGTGTCGTGTACCTGTGGGAATAGA	1
CGTCTTGCTC	GAAACACCGGTCCGTAGGAGACCCGTGTGGCATGTACCTGTGGGGTTAGA	1
CGTGCATGCT	GAAACACCGGTGGCATTAGGAACAGGGGTGGGGTTAGAGCTAGAAGTAGC	1
CGTGGTGACA	GAAACACCGGTGACATTGGGTACAGGGGTGGGGTTAGAGCTAGAAATAGC	1
CGTGTCGTAC	GAAACACCGGTGCATTTGAATACCCGGTCGGAGTTAGGACTAGAGATTGG	1
CGTGTTGTCT	GAAACACCGGTGACATTGGGTACAGGGTGGGGTTAGAGCTAGAAATAGCA	104
CGTGTTGTCT	GAAACACCGGTGACATTGGGTACAGGGGTGGGGTTAGAGCTAGAAATAGC	98
CGTGTTGTCT	GAAACACCGGTGACATTGGGTAAAATAGCAAGTTAACCTAAGGCTAGTCC	56
CGTGTTGTCT	GAAACACCGGTGACATTGGGTGGGGTTAGAGCTAGAAATAGCAAGTTAAC	41
CGTGTTGTCT	GAAACACCGGTGACATTGGGTTAGAGCTAGAAATAGCAAGTTAACCTAAG	32
CGTGTTGTCT	GAAACACCGGTGACATTGGGAGTGGGGTTAGAGCTAGAAATAGCAAGTTA	26
CGTGTTGTCT	GAAACACCGGTGACATTGGGGTTAGAGCTAGAAATAGCAAGTTAACCTAA	26
CGTGTTGTCT	GAAACACCGGTGACAGGTGGGGTTAGAGCTAGAAATAGCAAGTTAACCTA	25
CGTGTTGTCT	GAAACACCGGTGACATTGGGTAGGGTTAGAGCTAGAAATAGCAAGTTAAC	22
CGTGTTGTCT	GAAACACCGGTGACATTGGGTAGTGGGGTTAGAGCTAGAAATAGCAAGTT	20
CGTGTTGTCT	GAAACACCGGTGACATTGGGTACGGGGTTAGAGCTAGAAATAGCAAGTTA	17
CGTGTTGTCT	GAAACACCGAGTCCGTTATCAACTTGAAAAAGTGGCACCGAGTCGGTGCT	16
CGTGTTGTCT	GAAACACCGGTCGGCGGCAATCGTGGGTGGGGTTAGAGCTAGAAATAGCA	14
CGTGTTGTCT	GAAACACCGGTGACATTGGTGGGGTTAGAGCTAGAAATAGCAAGTTAACC	14
CGTGTTGTCT	GAAACACCGGTGACATTGGGTACTAGCTAGAAATAGCAAGTTAACCTAAG	12
CGTGTTGTCT	GGGTTAGAGCTAGAAATAGCAAGTTAACCTAAGGCTAGTCCGTTATCAAC	11
CGTGTTGTCT	GAAACACCGGTGACATGGGGTTAGAGCTAGAAATAGCAAGTTAACCTAAG	10
CGTGTTGTCT	GAAACACCGGTGACATTAGAGCTAGAAATAGCAAGTTAACCTAAGGCTAG	10
CGTGTTGTCT	GAAACACCGGTGACGTGGGGTTAGAGCTAGAAATAGCAAGTTAACCTAAG	10
CGTGTTGTCT	GAAACACCGGTGACATCGTGGGGTTAGAGCTAGAAATAGCAAGTTAACCT	9
CGTGTTGTCT	GAAACACCGGTGACATTGGGTACAGAGCTAGAAATAGCAAGTTAGCCTAA	9
CGTGTTGTCT	GAAACACCGGTGACATTGGGTTAACCTAAGGCTAGTCCGTTATCAACTTG	9
CGTGTTGTCT	GAAACACCGGTGAGCTAGAAATAGCAAGTTAACCTAAGGCTAGTCCGTTA	9
CGTGTTGTCT	GAAACACCGTTGGGGTTAGAGCTAGAAATAGCAAGTTAACCTAAGGCTAG	9
CGTGTTGTCT	GTTTGGGGTTAGAGCTAGAAATAGCAAGTTAACCTAAGGCTAGTCCGTTA	9
CGTGTTGTCT	GGTTAGAGCTAGAAATAGCAAGTTAACCTAAGGCTAGTCCGTTATCAACT	8
CGTGTTGTCT	GAAACACCGGTGACATTGGGTACTACAGGGTGGGGTTAGAGCTAGAAATA	7
CGTGTTGTCT	GAAACACCGGTGACGTTAGAGCTAGAAATAGCAAGTTAACCTAAGGCTAG	7
CGTGTTGTCT	GAAACACCGGTGACATTGGGTACAGGTTAGAGCTAGAAATAGCAAGTTAA	6
CGTGTTGTCT	GAAACACCGGTGACATTGGGTACAGTGGGTGACATTGGGTACAAGTGGGG	6
CGTGTTGTCT	GAAACACCGGTGACATTGGGTGGGGGTTAGAGCTAGAAATAGCAAGTTAA	6
CGTGTTGTCT	GAAACACCGGTGACATTGGTAGTGGGGTTAGAGCTAGAAATAGCAAGTTA	6
CGTGTTGTCT	GAAACACCGGTGACATTTGGGGTTAGAGCTAGAAATAGCAAGTTAACCTA	6
CGTGTTGTCT	GAAACACCGGTGACAGTGATGGGGTTAGAGCTAGAAATAGCAAGTTAACC	5
CGTGTTGTCT	GAAACACCGGTGACATGGTGGGGTTAGAGCTAGAAATAGCAAGTTAACCT	5
CGTGTTGTCT	GAAACACCGGTGACATTGGGTACAGGAGGGTGGGGTTAGAGCTAGAAATA	5
CGTGTTGTCT	GAAACACCGGTGACATTGGGTACTAGAGCTAGAAATAGCAAGTTAACCTA	5
CGTGTTGTCT	GAAACACCGGTGACATTGGGTGGTGGGGTTAGAGCTAGAAATAGCAAGTT	5
CGTGTTGTCT	GAAACACCGGTGACATTGGGTTGGGGGTTAGAGCTAGAAATAGCAAGTTA	5
CGTGTTGTCT	GAAACACCGGTGAGGGGGGTTAGAGCTAGAAATAGCAAGTTAACCTAAGG	5
CGTGTTGTCT	GAAACACCGGTGTTAGAGCTAGAAATAGCAAGTTAACCTAAGGCTAGTCC	5
CGTGTTGTCT	GAAACAGTGGGGTTAGAGCTAGAAATAGCAAGTTAACCTAAGGCTAGTCC	5
CGTGTTGTCT	GTTAGTCCGTTATCAACTTGAAAAAGTGGCACCGAGTCGGTGCTTTTTTT	5
CGTGTTGTCT	GAAACACCGGTGACAGTGGGGTTAGAGCTAGAAATAGCAAGTTAACCTAA	4
CGTGTTGTCT	GAAACACCGGTGACATTGGGTAACATTGCTAGAAATAGCAAGTTAACCTA	4
CGTGTTGTCT	GAAACACCGGTGACATTGGGTACAGACAGGTGGGGTTAGAGCTAGAAATA	4
CGTGTTGTCT	GAAACACCGGTGACATTGGGTAGCTAGAAATAGCAAGTTAACCTAAGGCT	4
CGTGTTGTCT	GAAACACCGGTGAGTGGGGTTAGAGCTAGAAATAGCAAGTTAACCTAAGG	4
CGTGTTGTCT	CAGAGCTAGAAATAGCAAGTTAACCTAAGGCTAGTCCGTTATCAACTTGA	3
CGTGTTGTCT	GAAACACCGGTGACATTGAAGTGGGGTTAGAGCTAGAAATAGCAAGTTAA	3
CGTGTTGTCT	GAAACACCGGTGACATTGGGCTAGAAATAGCAAGTTAACCTAAGGCTAGT	3
CGTGTTGTCT	GAAACACCGGTGACATTGGGTACACGTGGGGTTAGAGCTAGAAATAGCAA	3
CGTGTTGTCT	GAAACACCGGTGACATTGGGTACAGGTCCCCCTGTGGGGTTAGAGCTAGA	3
CGTGTTGTCT	GAAACACCGGTGACATTGGGTACATTTTGTGGGGTTAGAGCTAGAAATAG	3
CGTGTTGTCT	GAAACACCGGTGACATTGTGGGGTTAGAGCTAGAAATAGCAAGTTAACCT	3
CGTGTTGTCT	GTTAGAGCTAGAAATAGCAAGTTAACCTAAGGCTAGTCCGTTATCAACTT	3
CGTGTTGTCT	GAAACACCGGTGACATTGGAGTGGGGTTAGAGCTAGAAATAGCAAGTTAA	2
CGTGTTGTCT	GAAACACCGGTGACATTGGGTACAGGGGGTGGGGTTAGAGCTAGAAATAG	2
CGTGTTGTCT	GAAACACCGGTGACATTGGGTACAGTAGAGCTAGAAATAGCAAGTTAACC	2
CGTGTTGTCT	GAAACACCGGTGACATTGGGTACATTGGGTACAGGGTGGGGTTAGAGCTA	2
CGTGTTGTCT	GAAACACCGGTGACATTGGGTACGCTAGAAATAGCAAGTTAACCTAAGGC	2
CGTGTTGTCT	GAAACACCGGTGACATTGGGTATAGCAAGTTAACCTAAGGCTAGTCCGTT	2
CGTGTTGTCT	GAAACACCGGTTAGAGCTAGAAATAGCAAGTTAACCTAAGGCTAGTCCGT	2
CGTGTTGTCT	GAAACACGGTGGGGTTAGAGCTAGAAATAGCAAGTTAACCTAAGGCTAGT	2
CGTGTTGTCT	AGGGGCGGAACACCGGTGACAGTGGGGTTAGAGCTAGAAATAGCGAGTTA	1
CGTGTTGTCT	GAAACACCGATGACATTGGGTACACGTGGGGTTAGAGCTAGAAATAGCAA	1
CGTGTTGTCT	GAAACACCGGTCTCGAGTGAGGTGTTCAGGGTGGGGTTAGAGCTAGAAAT	1
CGTGTTGTCT	GAAACACCGGTGACATTGGGCACATTTTGTGGGGTTAGAGCTAGAAATAG	1
CGTGTTGTCT	GAAACACCGGTGACATTGGGTACAAGTGGGGTTAGAGCTAGAAATAGCAA	1
CGTGTTGTCT	GAAACACCGGTGACATTGGGTACACTGGGTACAGGGTGGGGTTAGAGCTA	1
CGTGTTGTCT	GAAACACCGGTGACATTGGGTACAGGAGCTAGAAATAGCAAGTTAACCTA	1
CGTGTTGTCT	GAAACACCGGTGACATTGGGTACAGGTCCCCCTGCGGGGTTAGAGCTAGA	1
CGTGTTGTCT	GAAACACCGGTGACATTGGGTACAGGTCCCCCTGTGGGGTTAGAGTTAGA	1
CGTGTTGTCT	GAAACACCGGTGACATTGGGTACGCTAGAAATAGCAAGTCAACCTAAGGC	1
CGTGTTGTCT	GAAACACCGGTGACATTGGGTACGCTAGAAATAGCATGTTAACCTAAGGC	1
CGTGTTGTCT	GAAACACCGGTGACATTGGGTATAGCAAGTTAACCTAAGGCCAGTCCGTT	1
CGTGTTGTCT	GAAACACCGGTGAGTGGGGTCAGAGCTAGAAATAGCAAGTTAACCTAAGG	1
CGTGTTGTCT	GAAACACCGGTGAGTGGGGTTAGAGCTAGAAATAGCAAGTTGACCTAAGG	1
CGTGTTGTCT	GAAACACCGGTGTCAAGTGACCTGTTCCTGGTGGGGTTAGAGCTAGAAAT	1
CGTGTTGTCT	GAAACACCGGTTACATTAGGTACAGGAGCTAGCAATAGCAAGTTAACCTA	1
CGTGTTGTCT	GAAACACCGGTTTGAACTAGAAATAGCAAGTTAACCTAAGGCTAGTCCGT	1
CGTGTTGTCT	GAAACACCGTTAACCTAAGGCTAGTCCGTCATCAACTTGAAAAAGTGGCA	1
CGTGTTGTCT	GAAACACCGTTAACCTAAGGCTAGTCCGTTATCAACTTGAAAAAGTGGCA	1
CGTGTTGTCT	GAAACACCGTTAACCTAAGGCTAGTCCGTTATCGACTTGAAAAAGTGGCA	1
CGTGTTGTCT	GAAACAGTGGGGTTAGAGCTAGAAATAGCAAGTTAACCTAAGGCTAGTCT	1
CGTGTTGTCT	GAAACAGTGGGGTTAGAGCTTGAAATAGCAAGTTAACCTAAGGCTAGTCC	1
CGTGTTGTCT	GAAACAGTGGGGTTCGAGCTAGAAATAGCAAGTTAACCTAAGGCTAGTCC	1
CGTGTTGTCT	GAACCACCGGTTATATTTGTAAGGGGGGTTAGAGCTAGAAATAGCAAGTT	1
CGTGTTGTCT	GAAGCACCGGTTAGAGCTAGAAATAGCAAGTTAACCTAAGGCTAGTCCGT	1
CGTGTTGTCT	GTTAGAGCTAGAAATAGCAAGTTAACCTAAGGCTAGTCCGTTACCAACTT	1
CGTGTTGTCT	GTTAGAGCTAGGAATAGCAAGTTAACCTAAGGCTAGTCCGTTATCAACTT	1
CGTGTTGTCT	GTTAGTCCGTTATCAACTTGAAAAAGTGGCACCGGGTCGGTGCTTTTTTT	1
CGTTAAGTTT	GAAACACCGGTCTCGAGTGAGGTGTTCAGGGTGGGGTTAGAGCTAGAAAT	1
CGTTCTGGGT	GAAACACCGGTGACATTTGGGGTTAGAGCTAGAAATAGCAAGTTAACCTA	1
CGTTCTGTCG	GAAACACCGGTGACATTGGGTACAGGGTGGGGTTAGAGCTAGAAATAGCA	1
CGTTTTGGTT	GAAACACCGGTGACATTGGGAGTGGGGTTAGAGCTAGAAATAGCAAGTTA	1
CTAAACCCTA	GAAACACCGGTTCCCGTCCAGTGGGGTTAGAGCTAGAAATAGCAAGTTAA	1
CTAAACGCCA	GAAACACCGGTTTGAACTAGAAATAGCAAGTTAACCTAAGGCTAGTCCGT	1
CTAAGAAGTT	GAAACACCGGTGTACGTATGGACTGAACCAGGGTGTGCAAGCTGGGTTAG	1
CTAATAGGGC	GAAACACCGGTACCTTTGTTGATGCTGGGTGGAAGGAATTTGTGGGGTTA	1
CTAATTATTT	GAAACACCGGTCTCGAGTGAGGTGTTCAGGTGGGGTTAGAGCTAGAAATA	1
CTACACGGGA	GAAACACCGGTACCTTTGTTGATGCTGGGTGGAAGGAATGGGTGGGGTTA	1
CTACGTCCGC	GAAACACCGGTGTACGTATGGACTGAACCAGGGTGTGCAAGTGGGGTTAG	1
CTACTAGGTG	GAAACACCGGTACCTTTGTTGATGCTGGGTGGGGTTAGAGCTAGAAATAG	1
CTACTCACTT	GAAACACCGGTGGCTGGGTGGATGCTGGTTGTAGGGATTGAGTTAGAGAT	1
CTACTCGGCC	GAAACACCGGTACCTTTGTTGATGCTGGGTGGGGTTAGAGCTAGAAATAG	82
CTACTCGGCC	GAAACACCGGTACCTTTGTTGATGCTGGGTGGAAGGAATTTGTGGGGTTA	38
CTACTCGGCC	GAAACACCGGTACCTTTGTTGATGCTGGGTGGAAGGAATGTGGGGTTAGA	27
CTACTCGGCC	GAAACACCGGTACCTTTGTTGATGCTGGGTGGAAGGTGGGGTTAGAGCTA	15
CTACTCGGCC	GAAACACCGGTACCTTTGTTGATGCTGGGTGGAAGGAATTTTGTGGGGTT	14
CTACTCGGCC	GAAACACCGGTACCTTTGTTGATGCTGGGTGGAAGGATGCTTTTTTTCCT	13
CTACTCGGCC	GAAACACCGGTACCTTAGAGCTAGAAATAGCAAGTTAACCTAAGGCTAGT	11
CTACTCGGCC	GAAACACCGGTACCTTTGTTGATGCTGGGTGGAAGGATTTTTGTGGGGTT	10
CTACTCGGCC	GAAACACCGGTACCTTTGTTGATGCTGGTGGGGTTAGAGCTAGAAATAGC	7
CTACTCGGCC	GAAACACCGGTACCTTTGTTGGTGGGGTTAGAGCTAGAAATAGCAAGTTA	7
CTACTCGGCC	GAAACACCGGTACCTTTGTTGATGCTGGGTGGAAGGAAGTGGGGTTAGAG	6
CTACTCGGCC	GAAACACCGGTACCTTTGTTGATGCTGGGTGGAAGGAATTGGAGCTAGAA	6
CTACTCGGCC	GAAACACCGGTACCTTTGTTGATGCTGGGTGCCACTTGAAAAAGTGGCAC	5
CTACTCGGCC	GAAACACCGGTACCTTTGTTGATGCTGGGTGGAAGGAATGGGGTGGGGTT	5
CTACTCGGCC	GAAACACCGGTACCTTTGTTGATGCTGGGTGGAAGGAGCTAGATGCTGGT	5
CTACTCGGCC	GAAACACCGGTACCTTTGTTGATGCTGGGGTGGGGTTAGAGCTAGAAATA	4
CTACTCGGCC	GAAACACCGGTACCTTTGTTGATGCTGGGTGGAAGGGTGGAAGGGTTAGA	4
CTACTCGGCC	GAAACACCGGTACCTTTGTTGATGCTGGGTGGAAGGTGTGGGGTTAGAGC	4
CTACTCGGCC	GAAACACCGGTACCTTTGTTGATGCTGGGTGGAAGTGTGGGGTTAGAGCT	4
CTACTCGGCC	GAAACACCGGTACCTTTGTTGATGCTAGAAATAGCAAGTTAACCTAAGGC	3
CTACTCGGCC	GAAACACCGGTACCTTTGTTGATGCTATAACCCCTTTTGTGGGGTTAGAG	3
CTACTCGGCC	GAAACACCGGTACCTTTGTTGATGCTGGGTGGAAAGAGCTAGAAATAGCA	3
CTACTCGGCC	GAAACACCGGTACCTTTGTTGATGCTGGGTGGAAGGATTAGAGCTAGAAA	3
CTACTCGGCC	GAAACACCGGTACCTTTGTTGATGCTGGGTGGAGCTAGAAATAGCAAGTT	3
CTACTCGGCC	GAAACACCGGTACCTTTGTCGATGCTGGGTGGAAGGAATTAGAGCTAGTG	2
CTACTCGGCC	GAAACACCGGTACCTTTGTTGATGCTGGGTAGCAAGTTAACCTAAGGCTA	2
CTACTCGGCC	GAAACACCGGTACCTTTGTTGATGCTGGGTAGTGGGGTTAGAGCTAGAAA	2
CTACTCGGCC	GAAACACCGGTACCTTTGTTGATGCTGGGTGGAAGGAAAAAGTGGCACCG	2
CTACTCGGCC	GAAACACCGGTACCTTTGTTGATGCTGGGTGGAAGGAAGGAAGGTGGGGT	2
CTACTCGGCC	GAAACACCGGTACCTTTGTTGATGCTGGGTGGAAGGAGCTAGAAATAGCA	2
CTACTCGGCC	GAAACACCGGTACCTTTGTTGATGCTGGGTGGAAGGAGCTAGATGCTGCT	2
CTACTCGGCC	GAAACACCGGTACCTTTGTTGATGCTGGGTGGAAGGATGCTGGGTGGGGT	2
CTACTCGGCC	GAAACACCGGTACCTTTGTTGATGCTGGGTGGACCGTTATCAACTTGAAA	2
CTACTCGGCC	GAAACACCGGTACCTTTGTTGATGCTGGGTGGGGGGTTAGAGCTAGAAAT	2
CTACTCGGCC	GAAACACCGGTACCTTTGTTGATGCTGGGTGGGGTGGGGTTAGAGCTAGA	2
CTACTCGGCC	GAAACACCGGTACCTTTGTTGATGCTGGTTGTGGGGTTAGAGCTAGAAAT	2
CTACTCGGCC	GAAACGCCGGTACCTTTGTTGATGCTGGGTGGAAGGAAAAAGTGGCACCG	2
CTACTCGGCC	CAAAACACCGGTACCTTTGTTGATGCTGGGTGGAAGGATGCTTTTTTTCC	1
CTACTCGGCC	GAAACACCGGTACCTTCGTTGATGCTGGGTGGAGCTAGAAATAGCAAGTT	1
CTACTCGGCC	GAAACACCGGTACCTTTATTGATGCTGGGTGCCACTTGAAAAAGTGGCAC	1
CTACTCGGCC	GAAACACCGGTACCTTTGAAATAGCAAGTTAACCTAAGGCTAGTCCGTTA	1
CTACTCGGCC	GAAACACCGGTACCTTTGTTGACGCTGGGTGGAAGGAATTAGAGCTAGAA	1
CTACTCGGCC	GAAACACCGGTACCTTTGTTGACGCTGGGTGGAAGGAGCTAGATGCTGGT	1
CTACTCGGCC	GAAACACCGGTACCTTTGTTGATGATAGCAAGTTAACCTAAGGCTAGTCC	1
CTACTCGGCC	GAAACACCGGTACCTTTGTTGATGCTAGAAATAGCAAGTTAGCCTAAGGC	1
CTACTCGGCC	GAAACACCGGTACCTTTGTTGATGCTGGGTAGTGGGGTTAGAGCTAGAGA	1
CTACTCGGCC	GAAACACCGGTACCTTTGTTGATGCTGGGTAGTGGGGTTAGGGCTAGAAA	1
CTACTCGGCC	GAAACACCGGTACCTTTGTTGATGCTGGGTGGAAGGAATGGGGTTAGAGC	1
CTACTCGGCC	GAAACACCGGTACCTTTGTTGATGCTGGGTGGAAGGAATTGTGGGGTTAG	1
CTACTCGGCC	GAAACACCGGTACCTTTGTTGATGCTGGGTGGAAGGGCTAGAAATAGCAA	1
CTACTCGGCC	GAAACACCGGTACCTTTGTTGATGCTGGGTGGACGAAACACCGGTACCTT	1
CTACTCGGCC	GAAACACCGGTACCTTTGTTGATGCTGGTCGTGGGGTTAGAGCTAGAAAT	1
CTACTCGGCC	GAAACACCGGTACCTTTGTTGATGCTGGTGTGGGGTTAGAGCTAGAAATA	1
CTACTCGGCC	GAAACACCGGTACCTTTGTTGATGGTTAGAGCTAGAAATAGCAAGTTAAC	1
CTACTCGGCC	GAAACACCGGTCGGGGCCACTCAGTGGTGGGGTTAGAGCTAGAAATAGCA	1
CTACTCGGCC	GAAACACCGGTTTGAACTACCTAGGGGGTGGTTCAAACCGGGGTTAGAGC	1
CTACTCGGCC	GAAACACGGGTTTACGTTGCATCGGTGTGGGGTTAGAGCTAGAAATAGCA	1
CTACTCGGCC	GAAGCACCGGTACCTTTGTTGATGCTGGGTGGACTGTTATCAACTTGAAA	1
CTACTCGGCC	GAGACACCGGTACCTTTGTTGATGCTGGGTGGAAGCGTGGGGTTAGAGCT	1
CTACTCGGCC	GGAACACCGGTACCTTTGTTGATGCTGGGTGGAAGTGTGGGGTTAGAGCT	1
CTACTGGTAC	GAAACACCGGTACCTTTGTTGATGCTGGGTGGGGTTAGAGCTAGAAATAG	1
CTAGACGCCC	GAAACACCGGTTACATTTAGGGTTATAGCTAGATATAGCAAGATATCCTA	1
CTAGCTAGGA	GAAACACCGGTTACATTGAGATCTCTTTTATGAGATCTCTGGGGTTAGAG	1
CTATCTCTCT	GAAACACCGGTGTGGCTGAGAGTCCGGCAATGGTGTGGCTGTGGGGTTAG	1
CTATGGAGGT	GAAACACCGGTTACATTGAGGGGTAGAGCTAGAAATAGCAAGTTAACCTG	1
CTATTCTGGT	GAAACACCGGTCGATTCATACCGAAACCTTCCCGTGACAAGTGGGGTTAG	1
CTATTGGGCA	GAAACACCGGTACCTTTGTTGATGCTGGGTGGAAGGATTTTTGTGGGGTT	1
CTCCCCCGAC	GAAACACCGGTGCCCTTACTCTTACCTGATTACTTAATCCGTGGGGTTAG	1
CTCCCCGACC	GAAACACCGGTGCAAGTTAACCTAAGGCTAGTACGTTATCAACTTGAAAA	1
CTCCCCTGCA	GAAACACCGGTGTGGCTGAGAGTCCGGCAATGGTGTGGCTGTGGGGTTAG	5
CTCCCCTGCA	GAAACACTGGTGTGGCTGAGAGTCCGGCAATGGTGTGGCTGTGGGGTTAG	1
CTCCCCTTCA	GAAACACCGGTGTGGCTGAGAGTCCGGCAATGGTGTGGCTGTGGGGTTAG	1
CTCGCAAGAC	GAAACACCGGTGCCCTTACTCTCACCTGATTACTTAATCCGTGGGATTAG	1
CTCGTTTTCT	GAAACACCGGTGACATTGGTGGGGTCAGAGCTAGAAATAGCAAGTTAACC	1
CTGAACGGAC	GGAACACCGGTACCTTTGTTGATGCTGGGTGGGGTTAGAGCTAGAAATAG	1
CTGAGTGCTC	GAAACACCGGTTTGGGGTTAGAGCTAGAAATAGCAAGTTAACCTAAGGCT	1
CTGATCGCCC	GAAACACGGGTTAGAGCTAGAAATAGCAAGTTAACCTAAGGCTAGTCCGT	1
CTGATTCGCC	GAAACACCGGTCTGCGGCAATCGGGGGATGAGCCACGTGTGGATAGATCG	1
CTGATTCGTT	GAAACACCGGTTTACGTTGCATCGGGGTTAGAGCTAGAAATAGCAAGATA	1
CTGCAGACGC	GAAACACCGGTTCCCGTCCAGTGAGGTTAGAGCTAGAAATAGCAAGTTAA	1
CTGCCACAGA	GAAACACCGGTAGCAAGTGCGAGACGTGTTTGTGGGGTTAGAGCTAGAAA	1
CTGCGCAGTA	GAAACACCGGTTAACGCATGGACCTAACTTCGGTGTGCAAGTGCGGATAG	1
CTGCGTAGGT	GAAACACCGGTTTACGTTGCATCGGTGTGGGGTTAGAGCTTGAAATAGCA	1
CTGCGTCATC	GAAACACCGGTGTACGTCTGGACTGAACCAGGGTGTTATCAACTTGAAAA	1
CTGCGTCGCT	GAAACACCGGTTTACGTTGCATCGGTGTGGGGTTAGAGCTAGAAATAGCA	1
CTGGTCGTCC	GAAACACCGGTGTACGTATGGACTGAACCAGGGTGTGCAAAGTGGGGTTA	1
CTGGTGAGCT	GAAACACCGGTTTACGTTGCATCGGTGTGGGGTTAGAGCTAGAAATAGCA	1
CTGTCTAGGT	GAAACACCGGTTTACGTTGCATCGGTGTGGGGTTAGAGCTAGAAATAGCA	1
CTGTTAGCTC	GAAACACCGGTCGGGGCCACTCAGTGGTGGGGTTAGAGCTAGAAATAGCA	1
CTTAGCCTAC	GTTAACCTAAGGCTAGTCCGTTATCAACTTGAAAAAGTGGCACCGAGTCG	1
CTTATATCGT	GAAACACCGGTCTCGAGTGAGGTGCTCAGGGTGGGGTTATAGCTAGAAAT	1
CTTATCATAA	GAAACACCGGTTAAGCCGAGGGTTAGAGCTAGAAATAGCAAGTTAACCTA	1
CTTCTACGGA	GAAACACCGGTCGGGGCCACTCAGTGGTGGGGTTAGAGCTAGAAATAGCA	1
CTTTTGGCGC	GAAACACCGGTCTAATCCACTCCGTGGAGGATCTAGAGCTAGAAAGATCA	1
GAAAACACCC	GAAACACCGGTTTGAACTAGAAATAGCAAGTTAACCTAAGGCTAGTCCGT	1
GAAAACTAGG	GAAACACCGGTACCTTTGTTGATGCTGGGTGGAAGGTGGGGTTAGAGCTA	1
GAAAAGGACA	GAAACACCGGTAGCAAGTGCGGGGTTAGAGCTAGAAATAGCAAGTTAACC	1
GAAAATGGCC	GAAACACCGGTTTGAACTAGAAATAGCAAGTTAACCTAAGGCTAGTCCGT	1
GAAACGACCT	GAAACACCGGTGCCCTTACTCTCACCTGATTACGTAATCCGTGGGGTTAG	1
GAAACGGAAA	GAAACACCGGTGGGGTTAGAGCTAGAAATAGCAAGTTAACCTAAGGCTAG	1
GAAACGGAGA	GAAACACCGGTAGAGCCAGAAATAGCAAGTTAACCTAAGGCTAGTCCGTT	1
GAAACGTAGT	GAAACACCGGTGTACGTATGGACTGAACCAGGGTGTTATCAACTTGAAAA	1
GAAAGAGATG	GAAACACCGGTAGCAAGTGCGAGCAAGTTTGTGGGGTTAGAGCTAGAAAT	1
GAAAGCGCTA	GAAACACCGGTGCCCTTACTCTCACCTGATTACTTAATCCGTGGGGTTAG	1
GAAAGTGACA	GAAACACCGGTAGCAAGTGCGAGACGTGTTTGTGGGGTTAGAGCTAGAAA	1
GAAAGTGATA	GAAACACCGGTAGCAAGTGCGAGACGTGTTAAATAGCAAGTTAACCTAAG	1
GAAATAGCGG	GAAACACCGGTTATATTTGTAAGTGTGTGGGGTTAGAGCTAGAAATAGCA	1
GAAATCATAA	GAAACACCGATCGGCCGTGGGGGGTGAAGGAGGAAAAAAAAGCTAAACAA	1
GAAATTGACA	GAAACACCGGTAGCAAGTGCGGGGTTAGAGCTAGAAATAGCAAGTTAACC	1
GAACAACGCC	GAAACACCGGTTTGAACTACTTAGTTCAAACCGGTGGGGTTAGAGCTAGA	1
GAACACCTCC	GAAACACCGGTGTGGCTGAGAGTCCGGCAATGGTGTGGCTGTGGGGTTAG	1
GAACCAGACC	GAAACACCGGTAGCAAGTGCGAGACGTGTTGGTGGGGTTAGAGCTAGAAA	1
GAACCCATAC	GAAACACCGGTGTGGCTGAGAGTCCGGCAATGGTGTGGCTGTGGGGCTAG	1
GAACCCCCCA	GAAACACCGGTGTGGCTGAGAGTCCGGCAATGGTGTGGCTGTGGGGTTAG	1
GAACCTGATT	GAAACACCTGGGGTTAGAGCTAGAAATAGCAAGTTAACCTAAGGCTAGTC	1
GAACGCACTA	GAAACACTGGTGCCCTTACTCTCACCTGATTACTTAATCCGTGGGGTTAG	1
GAACGCACTA	GAAACACCGGTGCCCTTACTCTCACCTGATTACTTAATCCGTGGGGTTAG	1
GAACGCCGAA	GAAACACCGGTGCCCTTACTCTCACCTGATTACTTAATCCGTGGGGTTAG	1
GAACGCCGTC	GAAACACCGGTGCCCTTACTCTCACCTGATTACTTAATCCGTGGGGTTAG	1
GAACGCGCTA	GAAACACCGGTGCCCTTACTCTCACCTGATTACTTAATCCGTGGGGTTAG	1
GAACGGCGCT	GAAACACCGGTGCCCTTACTCTCACCTGATTACTTAATCCGTGGGGTTAG	1
GAACGGCGTC	GAAACACCGGTGTACGTATGGACTGAACCAGGGTGTGCAAGTGGGGTTAG	1
GAACTCAACA	GAAACACCGGTAAATATATTGCTGCGATATCCACGAATCAGTGGGGTTGG	1
GAAGAAACGA	GAAACACCGGTCGGCGGCAATTAGAGCTAGAAATAGCAAGTTAAACTAAG	1
GAAGAACTGT	GAAACACCGGTCGGCGGCCGGTTAGAGCTAGAAATAGCAAGTTAACCTAA	1
GAAGACAGAC	GAAACACCGGTAGCAAGTGCGAGACGTGTTTGTGGGGATAGAGCTAGAAA	1
GAAGACATGA	GAAACACCGGTCGGCGGCAAGGGGGGGTTAGAGCTAGAAATAGCAAGTTA	1
GAAGACCCGC	GAAACACCGGTCGGCGGCAATCGTGGGTGGGGTTAGAGCTAGAAATAGCA	152
GAAGACCCGC	GAAACACCGGTCGGCGGCAATCGTGGTTAGAGCTAGAAATAGCAAGTTAA	35
GAAGACCCGC	GAAACACCGGTCGGCGGCAATCGTGGGGTGGGGTTAGAGCTAGAAATAGC	21
GAAGACCCGC	GAAACACCGGTCGGCGGTGGGGTTAGAGCTAGAAATAGCAAGTTAACCTA	20
GAAGACCCGC	GAAACACCGGTCGGCGGCAATCGTGGTATGAGCCACGTGGGGTTAGATCG	17
GAAGACCCGC	GAAACACCGGTCGGCGGCAATCTGGGGTTAGAGCTAGAAATAGCAAGTTA	16
GAAGACCCGC	GAAACACCGGTCGGCGGCAATGGGGTTAGAGCTAGAAATAGCAAGTTAAC	15
GAAGACCCGC	GAAACACCGGTCGGTGGGGTTAGAGCTAGAAATAGCAAGTTAACCTAAGG	14
GAAGACCCGC	GAAACACCGGTCGGCGGCGGTGGGGTTAGAGCTAGAAATAGCAAGTTAAC	10
GAAGACCCGC	GACCGGTGTTTCGTGGGGTTAGAGCTAGAAATAGCAAGTTAACCTAAGGC	10
GAAGACCCGC	GAAACACCGGTCGGCGGCAACGTGGGGTTAGAGCTAGAAATAGCAAGTTA	8
GAAGACCCGC	GAAACACCGGTGGGGTTAGAGCTAGAAATAGCAAGTTAACCTAAGGCTAG	8
GAAGACCCGC	GAAACACCTAAGGCTAGTCCGTTATCAACTTGAAAAAGTGGCACCGAGTC	8
GAAGACCCGC	GAAACACCGGTCGGCGGCCGGTTAGAGCTAGAAATAGCAAGTTAACCTAA	7
GAAGACCCGC	GAAACAAGCGTGGGGTTAGAGCTAGAAATAGCAAGTTAACCTAAGGCTAG	5
GAAGACCCGC	GAAACACCGGTCGGCGGCAATCGAAATAGCAAGTTAACCTAAGGCTAGTC	5
GAAGACCCGC	GAAACACCGGTCGGCGGCAATCGAATAGCAAGTTAACCTAAGGCTAGTCC	5
GAAGACCCGC	GAAACACCGCAAGTTAACCTAAGGCTAGTCCGTTATCAACTTGAAAAAGT	4
GAAGACCCGC	GAAACACCGGTCGGCGGCAAGTTAACCTAAGGCTAGTCCGTTATCAACTT	4
GAAGACCCGC	GAAACACCGGTCGGCGGCAATCGTTTTGTGGGGTTAGAGCTAGAAATAGC	4
GAAGACCCGC	GAAACACCGGTCGGCGGCTAGAAATAGCAAGTTAACCTAAGGCTAGTCCG	4
GAAGACCCGC	GAAACATAGAGCTAGAAATAGCAAGTTAACCTAAGGCTAGTCCGTTATCA	4
GAAGACCCGC	GAAAGTGGGGTTAGAGCTAGAAATAGCAAGTTAACCTAAGGCTAGTCCGT	4
GAAGACCCGC	GTGGTTAGAGCTAGAAATAGCAAGTTAACCTAAGGCTAGTCCGTTATCAA	4
GAAGACCCGC	GAAACACAAGTTAACCTAAGGCTAGTCCGTTATCAACTTGAAAAAGTGGC	3
GAAGACCCGC	GAAACACCGGTCGGCGGCAAGAGCTAGAAATAGCAAGTTAACCTAAGGCT	3
GAAGACCCGC	GAAACACCGGTCGGCGGCAATCGAGCTAGAAATAGCAAGTTAACCTAAGG	3
GAAGACCCGC	GAAACACCGGTCGGCGGCAATCGTAGAAATAGCAAGTTAACCTAAGGCTA	3
GAAGACCCGC	GAAACACCGGTCGGCGGCAATCGTGCTTTTACTAGAAATAGCAAGTTAAC	3
GAAGACCCGC	GAAACACCGGTCGGCGGCAATCGTGTGTGGGTCCGTTATCAACTTGAAAA	3
GAAGACCCGC	GAAACACCGGTCGGCGGCAATCGTTAGAGCTAGAAATAGCAAGTTAACCT	3
GAAGACCCGC	GAAACACCGGTCGGCGGCAATTAGAGCTAGAAATAGCAAGTTAACCTAAG	3
GAAGACCCGC	GAAACACCGGTCGGCGGCGTGGGGTTAGAGCTAGAAATAGCAAGTTAACC	3
GAAGACCCGC	GAAACACCGGTCGGCGGGGGGTTAGAGCTAGAAATAGCAAGTTAACCTAA	3
GAAGACCCGC	GAAACACCGGTCGGCGTGCTATTTCTAGAAATAGCAAGTTAACCTAAGGC	3
GAAGACCCGC	GTCCGTTATCAACTTGAAAAAGTGGCACCGAGTCGGTGCTTTTTTTCCTG	3
GAAGACCCGC	TTAGCAAGTTAACCTAAGGCTAGTCCGTTATCAACTTGAAAAAGTGGCAC	3
GAAGACCCGC	GAAACACCGGTCAGCGGCAACTAATTAATTAGAGCTAGAAATAGCAAGTT	2
GAAGACCCGC	GAAACACCGGTCGGAGCTAGAAATAGCAAGTTAACCTAAGGCTAGTCCGT	2
GAAGACCCGC	GAAACACCGGTCGGCGGCAATCGTGAGGGTGGGGTTAGAGCTAGAAATAG	2
GAAGACCCGC	GAAACACCGGTCGGCGGCAATCGTGGAGCCCCGTGGGGTTAGAGCTAGAA	2
GAAGACCCGC	GAAACACCGGTCGGCGGCAATCGTTAATCGGTTAATCGTGGGGTTAGAGC	2
GAAGACCCGC	GAAACACCGGTCGGCGGCAATCGTTAGAAATAGCAAGTTAACCTAAGGCT	2
GAAGACCCGC	GAAACACCGGTCGGCGGGTTAGAGCTAGAAATAGCAAGTTAACCTAAGGC	2
GAAGACCCGC	GAAACACCGGTCGGGGTTAGAGCTAGAAATAGCAAGTTAACCTAAGGCTA	2
GAAGACCCGC	GGGTTAGAGCTAGAAATAGCAAGTTAACCTAAGGCTAGTCCGTTATCAAC	2
GAAGACCCGC	CAAAACACCGGTCGGCGGCAATCGTGGGTGGGGTTAGAGCTAGAAATAGC	1
GAAGACCCGC	CTAAACACCGGTCGGCGGCAATCGGGGTTAGAGCTAGAAATAGCAAGTTA	1
GAAGACCCGC	CTAAACACCGGTCGGCGGCAATCGTGGGGTGGGGTTAGAGCTAGAAATAG	1
GAAGACCCGC	GAAACACAAGTTAACCTAAGGCTAGTCCGTTATCAACTTGAGAAAGTGGC	1
GAAGACCCGC	GAAACACCGCAAGTTAACCTAAGGCTAGTCCGTTATCAACTCGAAAAAGT	1
GAAGACCCGC	GAAACACCGGTACCTTTGTTGATGCTGGGTGGAAGGAATTTTGTGGGGTT	1
GAAGACCCGC	GAAACACCGGTCCGCTTACTCCGACCTGATTACTTAATCCGTAGAGATAG	1
GAAGACCCGC	GAAACACCGGTCGGAGGCAATCGTGTGTGGGTCCGTTATTAACTTGAGCA	1
GAAGACCCGC	GAAACACCGGTCGGCGGCAAGAAATAGCAAGTTAACCTAAGGCTAGTCCG	1
GAAGACCCGC	GAAACACCGGTCGGCGGCAAGAGCTAGAAATAGCGAGTTAACCTAAGGCT	1
GAAGACCCGC	GAAACACCGGTCGGCGGCAAGCTAGAAATAGCAAGTTAACCTAAGGCTAG	1
GAAGACCCGC	GAAACACCGGTCGGCGGCAATCGTGAGGGTGGGGTTAGGGCTAGAAATAG	1
GAAGACCCGC	GAAACACCGGTCGGCGGCAATCGTGGGTTAAAAAGTGGGGTTAGAGCTAG	1
GAAGACCCGC	GAAACACCGGTCGGCGGCAATCGTGGTCGTGGGTGGGGTTAGAGCTAGAA	1
GAAGACCCGC	GAAACACCGGTCGGCGGCAGGAAATAGCAAGTTAACCTAAGGCTAGTCCG	1
GAAGACCCGC	GAAACACCGGTCGGGGGCCATGGTGGTTGGGGTTAGAGCTAAAAAGTTAA	1
GAAGACCCGC	GAAACACCGGTCTCGAGTGAGGTGTTCAGGTGGGGTTAGAGCTAGAAATA	1
GAAGACCCGC	GAAACACCGGTGTGGCTGAGAGTCCGGCAATGGTGTGGCTGTGGGGTTAG	1
GAAGACCCGC	GAAACACCGGTTTGCACTACCTAGTAGCAAGTTAACCTAAGGCTAGTCCG	1
GAAGACCCGC	GAAACACTAGTTAACCTAAGGCTAGTCCGTTATCAACTTGAAAAAGTGGC	1
GAAGACCCGC	GAAACGCCGGTCGGCGGCAAGCTAGAAATAGCAAGTTAACCTAAGGCTAG	1
GAAGACCCGC	GAAAGTGGGGTTAGAGCTAGAAATAGCAAGCTAACCTAAGGCTAGTCCGT	1
GAAGACCCGC	GAAAGTGGGGTTAGAGCTAGAAATAGCAAGTTAACCTAAGGCCAGTCCGT	1
GAAGACCCGC	GAACACCGGTCGGCGGCGTTAGAGCTAGAAATAGCAAGTTAACCTAAGGC	1
GAAGACCCGC	GGAACACCGCAAGTTAACCTAAGGCTAGTCCGTTATCAACTTGAAAAAGT	1
GAAGACCCGC	GTGGTTAGAGCTGGAAATAGCAAGTTAACCTAAGGCTAGTCCGTTATCAA	1
GAAGACCCGC	TCTAGCAAGTTAACCTAAGGCTAGTCCGTTATCAACTTGAAAAAGTGGCA	1
GAAGATGCCT	GAAACACCGGTCGGCGGCAAGTTAACCTAAGGCTAGTCCGTTATCAACTT	1
GAAGATTAGC	GAAACACCGGTCGGCGGCAATCGTAGAAATAGCAAGTTAACCTAAGGCTA	1
GAAGCCACGT	GAAACACCGGTCGGCGGCAATCGTGGGGTGGGGTTAGAGCTAGAAATAGC	1
GAAGGACAGC	GAAACACCGGTCAGCGGCAATCGTGGTTAGAGCTAGAAATAGCAAGTTAA	1
GAAGGATCGC	GAAACACCGGTCGGCGGCAATCGTGGGTGGGGTTAGAGCTAGAAATAGCA	1
GAAGGCACTT	GAAACACCGGTCGGCGGCAATCGTGGGTGGGGTTAGAGCTAGAAATAGCA	1
GAAGTATCGC	GAAACACCGGTCGGCGGCGGTGGGGTTAGAGCTAGAAATAGCAAGTTAAC	1
GAAGTATGCC	GAAACACCGGTCCGTAGGAGACCCGTGTGGCATGTACCTGTGGGGTTAGA	1
GAAGTTATAA	GAAACACCGGTAACTATATTCATGCGATATCGCCGTATCAGTGGGGTTAG	1
GAATAACCGA	GAAACACCGGTCGGTGGGGTTAGAGCTAGAAATAGCAAGTTAACCTAAGG	1
GAATACGGGC	GAAACACCGGTCGGCGGCAATCGTGGGTGGGGTTAGAGCTAGAAATAGCA	1
GAATACTAAG	GAAACACCGGTACCTTTGTTGATGCTGGGTGGAAGGTGGGGTTAGAGCTA	1
GAATAGTCGT	GAAACACCGGTGTACGTATGGACTGAACCAGGGTGCGCAAGTGGGGTTAG	1
GAATCGACGT	GAAACACCGGTGTACGTATGGACTGAACCAGGGTGTGCAAGTGGGGTTAG	1
GAATCGTAGT	GAAACACCGGTGTACGTATGGACTGAACCAGGGTGTGCAAGTGGGGTTAG	1
GAATCGTCGT	GAAACACCGGTGTACGTATGGACTGAACCAGGGTGTGCAAGTGGGGTTAG	1
GAATCTGCCT	GAAACACCGGTCCGTAGGAGACCCGTGTGGCATGTACCTGTGGGGTTAGA	1
GAATGGCTGT	GAAACACCGGTTTGCGTTGCATCGGTGTGGGGTTAGAGCTAGAAATAGCA	1
GAATTCCTGC	GAAACACCGGTCGGGGGCCGGTTAGAGTTAGAAATAGCAAGTTAACATAA	1
GAATTCTTTT	GAAACACCGGTCGATTCATATCGAAACCTTCCCGTGACAGTGGGGTTAGA	1
GACAACCGCC	GAAACACCGGTGTGGCTGAGAGTCCGGCAATGGTGTGGCTGTGGGGGTAG	1
GACAACGAGC	GAAACACCGGTAATCAGAGGTGAACGTAAGGTGGGGTTAGAGCTAGAAAC	1
GACAACGATA	GAAACACCGGTAGCAAGTGCGAGCAAGTGTGGGGTTAGAGCTAGAAATAG	1
GACAATGTGT	GAAACACCGGTTTCAACTAGCTAGTAGCAAGTTAACCTATGGCTATTCCG	1
GACACAAAAC	GAAACACCGGTAGCAAGTGCGAGACGTGTTTGTGGGGTTAGAGCTAGAAA	1
GACACAGACA	GAAACACCGGTAGCAAGTGCGAGACGTGTTTGTGGGGTTAGAGCTAGAAA	131
GACACAGACA	GAAACACCGGTAGCAAGTGCGAGACGTGTTAAATAGCAAGTTAACCTAAG	94
GACACAGACA	GAAACACCGGTAGCAAGTGCGGGGTTAGAGCTAGAAATAGCAAGTTAACC	58
GACACAGACA	GAAACACCGGTAGCAAGTGGGGTTAGAGCTAGAAATAGCAAGTTAACCTA	35
GACACAGACA	GAAACACCGGTGGGGTTAGAGCTAGAAATAGCAAGTTAACCTAAGGCTAG	17
GACACAGACA	GAAACACCGGTAGCAAGTGCGAGCAAGTTTGTGGGGTTAGAGCTAGAAAT	9
GACACAGACA	GAAACTAGAAATAGCAAGTTAACCTAAGGCTAGTCCGTTATCAACTTGAA	9
GACACAGACA	GAAACACCGGTAGCAAGTGCGAGCAAGTTGTGGGGTTAGAGCTAGAAATA	7
GACACAGACA	GAAACACCGGTAGCAAGTGCTAGAAATAGCAAGTTAACCTAAGGCTAGTC	7
GACACAGACA	GAAACACCGGTAGCAAGTGCGAGCAAGTGTGGGGTTAGAGCTAGAAATAG	5
GACACAGACA	GAAACACCGGTGCAAGTTAACCTAAGGCTAGTCCGTTATCAACTTGAAAA	5
GACACAGACA	GAAACACCGGTAGAGCTAGAAATAGCAAGTTAACCTAAGGCTAGTCCGTT	3
GACACAGACA	GAAACACCGGTAGCAAGTGCGAGACGTGTTTTTGTGGGGTTAGAGCTAGA	3
GACACAGACA	GAAACACCGGTAGCAAGTGCGAGACGTTTGTGGGGTTAGAGCTAGAAATA	3
GACACAGACA	GAAACACCGGTAGCAAGTGCGTGGGGTTAGAGCTAGAAATAGCAAGTTAA	3
GACACAGACA	GAAACACCTGGGGTTAGAGCTAGAAATAGCAAGTTAACCTAAGGCTAGTC	3
GACACAGACA	GAAACACCGGTAGCAAGTGCGAGACGGGGTGAGAGTGGGGTTAGAGCTAG	2
GACACAGACA	GAAACACCGGTAGCAAGTGCGAGACGTGTGTGGGGTTAGAGCTAGAAATA	2
GACACAGACA	GAAACACCGGTAGCAAGTGCGAGACGTGTTAGAGCTAGAAATAGCAAGTT	2
GACACAGACA	GAAACACCGGTAGCAAGTGCGAGACGTTAGAGCTAGAAATAGCAAGTTAA	2
GACACAGACA	GAAACACCGGTAGCAAGTGCGAGACGTTGTGGGGTTAGAGCTAGAAATAG	2
GACACAGACA	GAAACACCGGTAGCAAGTGCGAGCAAGTTAACCTAAGGCTAGTCCGTTAT	2
GACACAGACA	GAAACACCGGTCCGTAGGAGACCCGTGTGGCATGTACCTGTGGGGTTAGA	2
GACACAGACA	GAAACACCGGTGCCCTTACTCTCACCTGATTACTTAATCCGTGGGGTTAG	2
GACACAGACA	GAAATACCGGTGCCCTTACTCTCACCTGATTACTTAATCCGTGGGGTTAG	2
GACACAGACA	CAAAACACCGGTAGCAAGTGCGAGATACTACAAAAGTGGGGTTAGAGCTA	1
GACACAGACA	GAAACACCGCAAAGTGGGGTTAGAGCTAGAAATAGCAAGTTAACCTAAGG	1
GACACAGACA	GAAACACCGGTAAATTTGAGGCTCCGGCATGCAGGAGGCCGTGGGGTTAG	1
GACACAGACA	GAAACACCGGTAACTATATTCATGCGATATCGCCGTATGGGGTTAGAGCT	1
GACACAGACA	GAAACACCGGTAACTTGAAATAACTAGAAATAGCAAGTTAACCTAAGGCT	1
GACACAGACA	GAAACACCGGTAGAGCTAGAAATAGCAAGTTAACCTAAGGCTAGTCCGCT	1
GACACAGACA	GAAACACCGGTAGAGCTAGAAATAGCAGGTTAACCTAAGGCTAGTCCGTT	1
GACACAGACA	GAAACACCGGTAGCAAGTGCGAGACGTGTTAGAGCTAGGAATAGCAAGTT	1
GACACAGACA	GAAACACCGGTAGCAAGTGCGAGACGTGTTTCGTCTCGCACTTGCTACGT	1
GACACAGACA	GAAACACCGGTAGCAAGTGCGAGACGTGTTTGTGGGTTAGAGCTAGAAAT	1
GACACAGACA	GAAACACCGGTAGCAAGTGCGAGACTAGAAATAGCAAGTTAACCTAAGGC	1
GACACAGACA	GAAACACCGGTAGCAAGTGCGAGATACTACAAAAGTGGGGTTAGAGCCAG	1
GACACAGACA	GAAACACCGGTAGCAAGTGCGAGATACTACAAAAGTGGGGTTAGAGCTAG	1
GACACAGACA	GAAACACCGGTAGCAAGTGCGAGCAAGTTGTGGGGTAGAGCTAGAAATAG	1
GACACAGACA	GAAACACCGGTAGCAAGTGCGAGCAAGTTTTTGTGGGGTTAGAGCTAGAA	1
GACACAGACA	GAAACACCGGTAGCAAGTGCGAGGGGTTATAGCTAGAAATAGCAACTAAA	1
GACACAGACA	GAAACACCGGTAGCAAGTGCGTGGGGTTAGAGCTAGAAATAGCAGGTTAA	1
GACACAGACA	GAAACACCGGTGCAAGTTAACCTAAGGCTAATCCGTTATCAACTTGAAAA	1
GACACAGACA	GAAACACCGGTGTGGCTGAGAGTCCGGCAATGGTGTGGCTGTGGGGTTAG	1
GACACAGACA	GAAACACCGGTTTGAACTAGAACTCGCAAGTTAACCTAAGGCTAGTCCGT	1
GACACAGACA	GAAACACCGTAGCAAGTGCGAGACGTGTTAAATAGCAAGTTAACCTAAGG	1
GACACAGACA	GAAACCACGGGTTAGAGCTAGAAATAGCAAGTTAACCTAAGGCTAGTCCG	1
GACACAGACA	GAGACACCGGTAGCAGGTGCGAGACGTTTGTGGGGTTAGAGCTAGAAATA	1
GACACCAACC	GAAACACCGGTGTGGCTGAGAGTCCGGCAATGGTGTGGCTGTGGGGTTAG	1
GACACCACAC	GAAACACCGGTGTGGCTGAGAGTCCGGCAATGGTGTGGCTGTGGGGTTAG	1
GACACCATAC	GAAACACCGGTGTGGCTGAGAGTCCGGCAATGGTGTGGCTGTGGGGTTAG	1
GACAGCCGGC	GAAACACCGGTCGGCGGCAATCGTGGGTGGGGTTAGAGCTAGAAATAGCA	1
GACAGCGACT	GAAACACCGGTTCCCGTACCGTGAAGATACAGCATGCGATATCAGGTTAA	1
GACAGCTAAT	GAAACACCGGTAAATTTGAGGCTATGGCATGCAGGAGGACGTGGGGTTAG	1
GACAGTGCCA	GAAACACCGGTGGGGTTAGAGCTAGAAATAGCAAGTTAACCTAAGGCTAG	1
GACATCGTCG	GAAACACCGGTGTACGTATGGACTGAACCAGGGTGTTATCAACTTGAAAA	1
GACATGGAGC	GAAACACCGGTAGCAAGTGGGGTTAGAGCTAGAAATAGCAGGTTAACCTA	1
GACATTAATC	GAAACACCGGTCGGGCAAGTTAACCTAAGGCTAGTCCGTTACAACTTGAA	1
GACCAAAATT	GAAACACCGGTAGCAAGTGCGGGGTTAGAGCTATAAATAGCGAGTTAACC	1
GACCCCATCC	GAAACACCGGTGTGGCTGAGGGTCCGGCAATGGTGTGGCTGTGGGGTTAG	1
GACCCCCGCG	GAAACACCGGTGTGGCTGAGAGTCCGGCAATGGTGTGGCTGTGGGGTTAG	1
GACCCCTCCT	GAAACACCGGTAAATTTGAGGCTCCCGCATGCAGGAGTCCGTCGGGTTAT	1
GACCCCTGCG	GAAACACCGGTAAATTTGAGGCTCCGGCATGCAGGGGGCCGTGGGGTTAG	1
GACCGATAGA	GAAACACCGGTAAATTTGAGGCTCCGGCATGCAGGAGGCCGTGGGGTTAG	1
GACCGGCTTA	GAAACACCGGTGCCCTTACTCTCACCTGATTACTTAATCCGTGGGGTTAG	1
GACCGTGACC	GAAACACCGGTACCTTTGTTGATGCTGGGTGGAAGGATTTTTGTGGGTTT	1
GACCTTTAAC	GAAACACCGGTCGGGGCCACTCAGTGGTGGGGTTAGAGCTAGAAATAGCA	1
GACCTTTACC	GCAAGTTAACCTAAGGCTAGTCCGTTACAACTTGAAAAAGTGGCACCGAG	1
GACGAACTTC	GAAACACCGGTCGGCGGCAATCGTGGGGTGGGGTTAGAGCTAGAAATAGC	1
GACGAAGCGC	GAAACACCGGTCGGCGGCAATCGTGCTTTTACTAGAAATAGCAAGTTAAC	1
GACGAATCCT	GAAACACCGGTCTCGAGTGAGGTGTTCAGGGTGGGGTTAGAGCTAGAAGT	1
GACGACAAGC	GAAACACCGGTCGGCGGCAATCGTGGGTGGGGTTAGAGCTAGAAATAGCA	1
GACGACCCCA	GAAACACCGGTCGGCGGCAATCGTGGTTAGAGCTAGAAATAGCAAGTTAA	1
GACGACGGCA	GAAACACCGGTACATGTATTGTTGCTGGGTGGGTATAGAGCTAGATATAG	1
GACGATCCAC	GAAACACCGGTCGGCGGCAATGTGGGGTTAGAGCTAGAAATAGCAAGTTA	1
GACGCACCAC	GAAACACCGGTCGGCGGGGGGTTAGAGCTAGAAATAGCAAGTTAACCTAA	1
GACGCACGGA	GAAACACCGGTCGGCGGCAATCGTGGGTGGGGTTAGAGCTAGAAATAGCA	1
GACGCACTAT	GAAACACCGGTGCCCTTACTCTCACCTGATTACTTAATCCGTGGGGTTAG	1
GACGCCCTCT	GAAACACCGGTGTGGCTGAGAGTCCGGCAATGGTTTGTCTGTGGGGTTAG	1
GACGCCGACC	GAAACACCGGTAAATTTGAGGCTCCGGCATGCAGGAGGCCGTGGGGTTAG	1
GACGCTGTGT	GAAACACCGGTTGCATTGGGTAGGGTTAGTGTTAGTACTACAGGGTTCTG	1
GACGGGGACA	GAAACACCGGTAGCAAGTGCGAGACGTGTTAAATAGCAAGTTAACCTAAG	1
GACGGGGTGC	GAAACACCGGTGACATTGGGAGTGGGGTTAGAGCTAGAAATAGCAAGTTA	1
GACGTACGGT	GAAACACCGGTCGATTCATATCGAAACCTTCCCGTGACAGTGGGGTTAGA	1
GACGTACTCT	GAAACACCGGTTACATTGAGATTAGAGCTAGAAAAGGCTAGTCCGTTATC	1
GACGTCCGTC	GAAACACCGGTCGGCGGAGGGGTTAGAGCTAGAAATAGCAAGATAAGCTA	1
GACGTGTTGT	GAAACACCGGTGACATTGGGTACAGGGGTGGGGTTAGAGCTAGAAATAGC	1
GACTCAACGC	GCTAGAAATAGCAAGTTAACCTAAGGCTAGTCCGTTATCAACTTGAAAAA	1
GACTCAGCAA	GAAACACCGGTAGCAAGTGGGGTTAGAGCTAGTTATAGCAAGTTAACCTA	1
GACTTAGAGA	GAAACACCGGTAGCAAGTGCGAGACGTGTTAAATAGCAAGTTAACCTAAG	1
GACTTCATCC	GAAACACCGGTGTGGCTGAGAGTCCGGCAATGGTGTGGCTGTGGGGTTAG	1
GACTTTACGG	GAAACACCGGTGGGGTTAGAGCTAGAAATAGCAAGTTAACCTAAGGCTAG	1
GACTTTAGCG	GAAACACCGGTCGGGGCCACTCAGTGGTGGGGTTAGAGCTAGAAATAGCA	1
GAGAAACCAC	GAAACACCGGTTCCCGTCCAGTGGGGTTAGAGCTAGAAATAGCAAGTTAA	1
GAGAAGAACC	GAAACACCGGTCGGCGGCAATCGTGGTTAGAGCTAGAAACAGCAAGTTAA	1
GAGAATAATT	GAAACACCGGTCTCGAGTGAGGTGTTCAGGGTGGGGTTAGAGCTAGAAAT	1
GAGACCCACG	GAAACACCGGTGCATTCGAAAGTCCGGTCGTAGTGTGGCCGTGGGGTTAG	1
GAGACCGACT	GAAACACCGGTATCAAATGCGAGGCGTGGTGGGGGGGTTGGAGCTAAAAG	1
GAGACCGTTC	GAAACACCGGTGTGGCTGAGAGTCCGGCAATGGTGTGGCTGTGGGGTTAG	1
GAGAGCGTAA	GAAACACCGGTAGCAAGTGCGAGACGTGTTTGTGGGGTTAGAGCTAGAAA	1
GAGAGTCATT	GAAACACCGGTCTCGAGTGAGGTTAGAGCTAGAAATAGCAAGTTAACCTA	1
GAGATCCCCC	GAAACACCGGTTCAAGTCCAGTGGGGGTAGAGCTAGAAATAGCAAGTTAA	1
GAGATTTGTC	GAAACACCGGTGACAGTGATGGGGTTAGAGCTAGAAATAGCAAGTTAACC	1
GAGCTCATAA	GAAAGAGCTAGAAATAGCAAGTTAACCTACGACTAGGCCGTTATCAACTT	1
GAGCTTAGAT	GAAACACCGGTTTACGTTGCATCGGGGTTAGAGCTAGAAATAGCAAGTTA	1
GAGCTTTATC	GAAACACCGGTCGGGGCCACTCAGTGGTGGGGTTAGAGCTAGAAATAGCA	1
GAGGAATCTC	GAAACACCGGTTCCCGTCCAGTGGGGTTAGAGCTAGAAATAGCAAGTTAA	1
GAGGACCTAC	GAAACACCGGTGCCCTTACTCTCACCTGACTACTTAATCCGTGGGGTTAG	1
GAGGAGAATC	GAAACACCGGTTCCCGTCCAGTGGGGTTAGAGCTAGAAATAGCAAGTTAA	1
GAGGAGCAGA	GAAACACCGGTCGGCGGCAATCGTGGGTGGGGTCAGAGCTAGAAATAGCA	1
GAGGATCCTT	GAAACACCGGTTCCCGTCCAGTGGGGTTAGAGCTAGAAATAGCAAGTTAA	1
GAGGATTCGT	GAAACACCGGTCGGCGGCAATCGTGGGTGGGGTTAGAGCTAGAAATAGCA	1
GAGGCCCCGT	GAAACACCGGTGTGGCTGAGAGTCCGGCAATGGTGTGGCTGTGGGGTTAG	1
GAGGCCCCTA	GAAACACCGGTAAATTTGAGGCTCCGGCATGCAGGAGGCCGTGGGGTTAG	1
GAGGCGCGTC	GAAACACCGGTTCCCGTCCCGTGGGGTTAGGGCGAGAAATAGCAAGTTAA	1
GAGGCTATAC	GAAACACCGGTTCCCGTCCAGTGGGGTTAGAGCTAGAAATAGCAAGTTAA	1
GAGGCTCGTG	GAAACACCGGTTCCCGTCGAGTGGGGTTAGAGCTAGAAATAGCAATTTAA	1
GAGGGAGGGG	GAAACACCGGTGCATTCGAAAGTCCGGTCGTAGTGTGGACGTGGGGTTAG	1
GAGGGGCATC	GAAACACCGGTTCCCGTCCAGTGGGGTTAGAGCTAGAAATAGCAAGTTAA	1
GAGGTAGTCT	GAAACACCGGTGACATTGGGTAAAATAGCAAGTTAACCTAAGGCTAGTCC	1
GAGGTTAAGC	GAAACACCGGTCGGCGGTGGGGTTAGAGCTAGAAATAGCAAGATAACCTA	1
GAGTATGCCT	GAAACACCGGTCCGTAGGAGACCCGTGTGGCATGTACCTCTGTGGGGTTA	1
GAGTATGCCT	GAAACACCGGTCCGTAGGAGACCCGTGTGGCATGTACCTGTGGGGTTAGA	1
GAGTTGCGTC	GAAACACCGGTTCCCGTCCAGTGGGGTTATAGCTAGAAATAGCAAGTTAA	1
GATAATCCTT	GAAACACCGGTCTCGAGTGAGGTGTTCAGGGGTGGGGTTAGAGCTAGAAA	1
GATACCGCCA	GAAACACCGGTGAAAAATGTGCTAGAAATAGCATGGTAATAGAAGTCGAG	1
GATACTCGGC	GAAACACCGGTACCTTTGTTGATGCTGGGTGGAAGGAATTTTGTGGGGTT	1
GATACTCTCG	GAAACACCGGTGCATTCGAAAGTCCGGTCGTAGTGTGGACGTGGGGTTAG	1
GATAGTTGTC	GAAACACCGGTGTACGTATGGACTGAACTAGGGTGTGCAAGTGGGGTTAG	1
GATATCCCCT	GAAACACCGGTCTCGAGTGAGGCGTTCAGGGTGTGGATAGAGCAAGAAAT	1
GATATCGTGG	GAAACACCGGTGTACGTATGGACTGAACCAGGGTGTGCAAGTGGGGTTAG	1
GATCAGCCGC	GAAACACCGGTCGGTGGGGGTAGAGCTAGAAATAGCACGTTAACCTAAGG	1
GATCATGAAC	GAAACACCGGTAGCAAGTGCGAGACGTGTTTGTGGGGTTAGAGCTAGAAA	1
GATCGCCCTA	GAAACACCGGTCCGTAGGAGACCCGTGCGGCATGTACCTGTGGGGTTAGA	1
GATCGTAGAC	GAAACACCGGTGTACGTATGGACTGAACCAGGGTGTGCAAAGTGGGGTTA	1
GATCTATCGA	GAAACACCGGTTATATTTGTAAGTGTTGTGGGGTTAGAGCTAGAAATAGC	1
GATGAACTGC	GAAACACCGGTCGGCGGCAATCGTGGGTGGGGTTAGAGCTAGAAATAGCA	1
GATGATTAGC	GAAACACCGGTTTACGTTGCATCGGTGTGGGGTTAGAGCTAGAAATAGCG	1
GATGCATAGC	GAAACACCGGTTTACGTTGCATCGGTGTGGGGTTAGAGCTAGAAATAGCA	1
GATGGCCTGC	GAAACACCGGTCGCCGGCCGGTTAGAGCTAGAAATAGCAAGTTAACCTAA	1
GATGTTCGTA	GAAACACCGGTGTACGTATGGACTGAACCAGGGTGTGCAAGTGGGGTTAG	1
GATTAAGACA	GGAACACCGGTAGCAAGTGCGAGACGTGTTTGTGGGGTTAGAGCTAGAAA	1
GATTGACCCT	GAAACACCGGTTAAGCCGAGTGGGGTTAGAGCTAGAAATAGCAAGTTAAC	1
GCAAACACGC	GAGACACCGGTCGGCGGCAATCGTGGGTGGGGTTAGAGCTAGAAATAGCA	1
GCAAACGATC	GAAACACCGGTAATCAGAGGTGAACGTAAGGTGGGGTTAGAGCTAGAAAT	1
GCAACCCTAC	GAAACACCGGTGTGGCTGAGAGTCCGGCAATGGTGTGGCTGTGGGGTTAG	1
GCAATAGACA	GAAACACCGGTAGTAAGTGGGGTTAGAGCTAGAAATAGCAAGTTAACCTA	1
GCAATAGCGG	GAAACACCGGTTATATTTGTAAGTGTGTGGGGTTAGAGCTAGAAATAGCA	1
GCAATCGACA	GAAACACCGGTTATATTTGTAAGTGTGGGGTTAGAGCTAGAAATAGCAAG	1
GCACAACGAC	GAAACACCGGTTTGAACTAGAAATAGCAAGTTAACCTAAGGCTAGTCCGT	1
GCACAACGCT	GAAACACCGGTTTGAACTAGAAATAGCAAGTTAACCTAAGGCTAGTCCGT	1
GCACAAGCCG	GAAACACCGGTTTGAACTAGAAATAGCAAGTTAACCTAAGGCTAGTCCGT	1
GCACAATGGA	GAAACACCGGTTTGAACTAGAAATAGCAAGTTAACCTAAGGCTAGTCCGT	1
GCACAGCGCA	GAAACACCGGTTTGAACTAGAAATAGCAAGTTAACCTAAGGCTAGTCCGT	1
GCACCCTGGA	GAAACACCGGTAAATTTGAGGCTCCGTCATGCAGGAGTCCGTGTGGTTAG	1
GCACGATCGA	GAAACACCGGTGCCCTTACTCTCACCTGATTACTTAATCCGTGGGGTTAG	1
GCACTTCGTC	GAACACCGGTGTACGTATGGACTGAACCAGGGTGTGCAAGTGGGGTTAGA	1
GCAGAACAGC	GAAACACCGGTCGGCGGCGAGGGGGGGTGGGGTTAGAGCTAGAAATAGCA	1
GCAGACCGGT	GAAACACCGGTCGGCGGCAATCGTGGGTGGGGTTAGAGCTAGAAATAGCA	1
GCAGATCATC	GAAACACCGGTCGGCGGCAATCGTGGGTGGGGTTAGAGCTAGAAATAGCA	1
GCAGCACTGT	GAAACACCGGTTACATTGAGGGTTAGAGCTAGAAATAGCAAGTTAACCTA	1
GCAGCCCAGC	GAAACACCGGTCGGCGGCAATCGTGGTTAGAGCTAGAAATAGCAAGTTAA	1
GCAGCGCCGC	GAAACACCGGTTCCCGTCCAGTGGGGTTAGAGCTAGAAATAGCAAGTTAA	1
GCAGTCACGC	GAAACACCGGTCGGCGGCAATCGTGGGTGGGGTTAGAGCTAGAAATAGCA	1
GCAGTCTCGC	GAAACACCGGTTTGCAGCTCTCGCGGGTGGGGTTAGAGCTAGAAATAGCA	1
GCATACCCGA	GAAACACCGGTCGGCGGCAATCGTGGGGTGGGGTTAGAGCTAGAAATAGC	1
GCATACCTGC	GAAACACCGGTCGGCGGCAATCGTGGGTGGGGTTAGAGCTAGAAATAGCA	1
GCATCGGCGT	GAAACACCGGTGTACGTATGGACTGAACCAGGGTGTGCAAGTGGGGTTAG	1
GCATCTGCCT	GAAACACCGGTCCGTAGGAGACCCGTGTGGCATGTACCTGTGGGGTTAGA	1
GCATGACTTT	GAAACACCGGTCTCGAGTGAGGTGTTCAGGGTGGGGTTAGAGCTAGAAAT	1
GCATTCCCGC	GAAACACCGGTCGGGGCCACTCAGTGGTGGGGTTAGAGCTAGAAATAGCA	1
GCATTTAATG	GAAACACCGGTCGGGGCCACTCAGTGGTGGGGTTAGAGCTAGAAATAGCA	1
GCCAACCCGC	GAAACACCGGTCGGCGGCAATGGGGTTAGAGCTAGAAATAGCAAGTTACC	1
GCCAACGAGC	GAAACACCGGTAATCAGAGGTGAACGTAAGGTGGGGTTAGAGCTAGAAAT	3
GCCAACGAGC	GAAACACCGGTAATCAGAGATGAACGTAAGGTGGGGTTAGAGCTAGAAAT	1
GCCAACGAGC	GAAACACCGGTAACTATATTCATGCGATATCGCCGTATCAGTGGGGTTAG	1
GCCAACGCGC	GAAACACCGGTAATCAGAGGTGAACGTAAGGTGGGGTTAGAGCTAGAAAT	1
GCCACCCGCA	GAAACACCGGTGTGGCTGAGAGTCCGGCAATGGTGTGGCTGTGGGGTTAG	1
GCCAGCGCCC	GAAACACCGGTTTGAACTAGAAATAGCAAGTTAACCTAAGGCTAGTCCGT	1
GCCCCAGCGC	GAAACACCGGTAGCGAGTGCGAGACGTGTTAAATAGCAAGTTAACCTAAG	1
GCCCCATACC	GAAACACCGGTAGCAAGTGCGAGACGTGTTTGTGGGGTTAGAGCTAGAAA	1
GCCGTAATTT	GAAACACCGGTCTCGAGTGAGGTGTTCAGGGTGGGGCTAGAGCTAGAAAT	1
GCCGTATGTC	GAAACACCGGTAGCAAGTGCGAGATACTACAAAAGTGGGGTTAGAGCTAG	1
GCCTTTACTG	GAAACACCGGTCGGGGCCACTCAGTGGTGGGGTTAGAGCTAGAAATAGCA	1
GCGAAGACTT	GAAACACCGGTCTCGAGTGAGGTGTTCAGGGTGGGGTTAGAGCTAGAAAT	1
GCGAATACTT	GAAACACCGGTCTCGAGTGAGGTGTTCAGGGTGGGGTTAGAGCTAGAAAT	1
GCGAATCCAT	GAAACACCGGTCTCGAGTGAGGTGTCCAGGGTGGGGTTAGAGCTAGAAAT	1
GCGAATCGTT	GAAACACCGGTCTCGAGTGAGGTGTTCAGGGTGGGGTTAGAGCTAGAAAT	2
GCGAATGCTT	GAAACACCGGTCTCGAGTGAGGTGTTCAGGGTGGGGTTAGAGCTAGAAAT	1
GCGACTCCTT	GAAACACCGGTCTCGAGTGAGGTGTTCAGGGTGGGGTTAGAGCTAGAAAT	1
GCGATCAAGG	GAAACACCGGTTATATTTGTAAGTGGGTTAGAGCTAGAAATAGCAAGTTA	1
GCGATTACTT	GAAACACCGGTCTCGAGTGAGGTGTTCAGGGTGGGGTTAGAGCTAGAAAT	1
GCGCTTAGCC	GAAACACCGGTTTACGTTGCATCGGTGTGTGGTTAGAGCTAGAAATAGCA	1
GCGTAGCCCC	GAAACACCGGTTCCCGTCCAGTGGGGTTAGAGCTAGAAATAGCAAGTTAA	1
GCGTAGCCTA	GAAACACCGGTTCCCGTCCAGTGGGGTTAGAGCTAGAAATAGCAATTTAA	1
GCGTGTGGTC	GAAACACCGGTGACATTGGTGGGGTTAGGGCTAGAAATAGCAAGTTAACC	1
GCGTGTTGTA	GAAACACCGGTGACATTTGGGGTTAGAGCTAGAAATAGCAAGTTAACCTA	1
GCGTTTGGAT	GAAACACCGGTTGATTCATATCGGAACCTTCCCTTGACATTGGGATTGGA	1
GCTACAGGCA	GAAACACCGGTAGCAAGTGCGGGGTTAGAGCTAGAAATAGCAAGTTAACC	1
GCTACTTGGT	GAAACACCGGTACCTTTGTTGATGCTGGGTGGGGTTAGAGCTAGAAACAG	1
GCTAGATATG	GAAACACCGGTTACATTGAGGGTTAGAGCTAGAAATAGCAAGTTAACCTA	1
GCTATACTTC	GAAACACCGGTGTCAATGTAGGTGTTCCAGGTGGGGTTAGAGCTAGAAAT	1
GCTATTAGGC	GAAACACCGGTACCTTTGTTGATGATAGCAAGTTAACCTAAGGCTAGTCC	1
GCTCCTCGGC	GAAACACCGGTACCTTTGTTGATGCTGGGTGGGGTTAGAGCTAGAAATAG	1
GCTGCTTAGC	GAAACACCGGTTTACGTTGCATCGGTTGTGGGGTTAGAGCTAGAAATAGC	1
GCTTCGTCGT	GAAACACCGGTGTACGTATGGACTGAACCAGGGTGCGCAAGTGGGGTTAG	1
GCTTTGACGC	GAAACACCGGTCGGGGCCACTCAGTGGTGGGGTTAGAGCTAGAAATAGCA	1
GCTTTTCAGC	GAAACACCGGTCGGGGCCACTCAGTGGTGGGGTTAGAGCTAGAAATAGCA	1
GGAAACCTCT	GAAACACCGGTGTGGCTGAGGGTCCGGCAATGGTGTGGCTGTGGGGTTAG	1
GGAAACGTTT	GAAACACCGGTCTCGAGTGAGGTGTTCAGGGTGGGGTTAGAGCTAGAAAT	1
GGAAACTACC	GAAACACCGGTAAATTTGAGGCTCCGGCATGCAGGAGGCCGTGGGGTTAG	1
GGAAACTTCT	GAAACACCGGTAAATTTGAGGCTCCGGCATGCAGGAGGCCGTGGGGTTAG	1
GGAACAAGCC	GAAACACCGGTGTGGCTGAGAGTCCGGCAATGGTGTGGCTGTGGGGTTAG	1
GGAACATACA	GAAACACCGGTAGCAAGTGCGGGGTTAGAGCTAGAAATAGCAAGTTAACC	1
GGAACCAGCC	GAAACACCGGAGTGGCTGAGAGTCCGGCAATGGTGTGGCTGTGGGGTTAG	1
GGAACCAGTA	GAAACACCGGTGTGGCTGAGAGTCCGGCAATGGTGTGGCTGTGGGGTTAG	1
GGAACCCTAA	GAAACACCGGTGTGGCTGAGAGTCCGGCAATGGTGTGGCTGTGGGGTTAG	1
GGAAGAATTT	GAAACACCGGTCTCGAGTGAGGTGTTCAGGGTGGGGTTAGAGCTAGAAAT	1
GGAAGATGCG	GAAACACCGGTCGGCGGCAATCGGGGTTAGAGCTAGAAATAGCAAGTTAA	1
GGAAGCATAC	GAAACACCGGTGTGGCTGAGAGTCCGGCAATGGTGTGGCTGTGGGGTTAG	1
GGAAGCATCA	GAAACACCGGTGTGGCTGAGAGTCCGGCAATGGTGTGGCTGTGGGGTTAG	1
GGAAGTGTAT	GAAACACCGGTCTCGAGTGAGGTGTTCAGGGGGGGTTAGAGCTAGAAATA	1
GGAATCTATT	GAAACACCGGTCTCGAGTGAGGTGTTCAGGGTGGGGTTAGAGCTAGAAAT	1
GGACAAAGAC	GAAACACCGGTAGCAAGTGCGAGACGTGTTTGTGGGGTTAGAGCTAGAAA	1
GGACACAGCC	GAAACACCGGTAGCAAGTGCGAGACGTGTTAAATAGCAAGTTAACCTAAG	1
GGACACATGC	GAAACACCGGTAGCAAGCGGGGTTAGAGCTAGAAATAGCAAGTTAACCTA	1
GGACACCGAA	GAAACACCGGTAGCAAGTGCGAGACGTGTTAAATAGCAAGTTAACCTAAG	1
GGACACTTCA	GAAACACCGGTAAATTTGAGGCTCCGGCATGCAGGAGGCCGAAATAGCAA	1
GGACTCTGCC	GAAACACCGGTGCATTCGAAAGTCCGGTCTTAGTGTGGACGTGGGGATAG	1
GGAGACCGCC	GAAACACCGGTAGAGCTAGAAATAGCAAGTTAACCTATGGCTAGTCCGTT	1
GGAGAGCAGC	GAAACACCGGTCGGCGGCAATCGTGGAAATAGCAAGTTAACCTAAGGCTA	1
GGAGGAGCCT	GAAACACCGGTTCCCGTCCAGTGGGGTTAGAGCTAGAAATAGCAAGTTAA	1
GGAGTCTTTT	GAAACACCGGTCTCGAGTGAGGTGTTCAGGGTGGGGTTAGAGCTAGAAAT	1
GGATTCCTCC	GAAACACCGGTGTGGCTGAGAGTCCGGCAATGGTGTGGCTGTGGGTTAGA	1
GGCAAAGTAC	GAAACACCGGTGTGGCTGAGAGTCCGGCAATGGTGGGGCTGTAGGGATAG	1
GGCAACAACC	GAAACACCGGTGTGGCTGAGAGTCCGGCAATGGTGTGGCTGTGGGGTTAG	1
GGCAACATAC	GAAACACCGGTGTGGCTGAGAGTCCGGCAATGGTGTGGCTGTGGGGTTAG	1
GGCAACCATA	GAAACACCGGTTTGGCTGCGAGTCCGGCGATGGTGTGGCTGAGGGGTTAG	1
GGCAAGATCA	GAAACATCGGTGTGGCTGAGAGTCCGGCAATGGTGTGGCTGTGGGGTTAG	1
GGCAATTATC	GAAACACCGGTAAATTTGAGGCTCCGGCATGCAGGAGGCCGTGGGGTTAG	1
GGCACAGGCC	GAAACACCGGTAGCACGTGCGACAGGAGTTGGGGGGGTTAGATCTAGAAA	1
GGCACAGTAC	GAAACACCGGTAGCAAGTGCGAGACGTGTTAAATAGCAAGTTAACCTAAG	1
GGCACCCTCC	GAAACACCGGTGTGGCTGAGAGTCCGGCAATGGTGTGGCTGTGGGGTTAG	351
GGCACCCTCC	GAAACACCGGTAAATTTGAGGCTCCGGCATGCAGGAGGCCGTGGGGTTAG	5
GGCACCCTCC	CAAAACACCGGTGTGGCTGAGAGTCCGGCAATGGTGTGGCTGTGGGGTTA	2
GGCACCCTCC	ATGAGGGTTAGAGCTAGAAATAGCAAGTTAACCTAAGGCTAGTCCGTTAT	1
GGCACCCTCC	GAAACACCGGTCGATTCATATCGAAACCTTCCCGTGACAGTGGGGTTAGA	1
GGCACCCTCC	GAAACACCGGTGCCCTTACTCTCACCTGATTACTTAATCCGTGGGGTTAG	1
GGCACCCTCC	GAAACACCGGTTCCCGTCCAGTGGGGTTAGAGCTAGAAATAGCAAGTTAA	1
GGCACCCTCC	GAAAGGCCGTGGCTGAGAGTCCGGCAATGGTGTGGCTGTGGGGTTAGAGC	1
GGCACCCTCC	GGAACTCCGATGTTGCTCAAAGTCCGGCCCTGTTTCGACTTGGGGGATAG	1
GGCACGATCT	GAAACACCGGTGTGGCTGAGAGTCCGGCAATGGTGTGGCTGTGGGGTTAG	1
GGCACTTACC	GAAACACCGGTAAATTTGAGGCTCCGGCATGCAGGAGGCCGTGGGGTTAG	1
GGCAGATACA	GAAACACCGGTAAATTTGAGGCTCCGGCATGCGGGAGGCCGTGGGGTTAG	1
GGCCAACACT	GCAACACCGGTAAATTTGAGGCTCCGGCATGCAGGAGGCCGTGGGGTTAG	1
GGCCAATAAC	GAAACACCGGTAAATTTGAGGCTCCGGCATGCAGGAGGCCGTGGGGTTAG	1
GGCCCCTACA	GAAACACCGGTAAATTTGAGGCTCCGGCATGCAGGAGGCCGTGGGGTTAG	220
GGCCCCTACA	GAAACACCGGTAAATTTGAGGCTCCGGCATGCAGGAGGCGTGGGGTTAGA	9
GGCCCCTACA	GAAACACCGGTAAATTTGAGGCTCCGGCATGCAGGAGGCCCGTGGGGTTA	3
GGCCCCTACA	CCGGTAAATTTGAGGCTCCGGCATGCAGGAGGCCCGTGGGGTTAGAGCTA	1
GGCCCCTACA	GAAACACCGGTAAATTTGAGGCTCCGGCGTGCAGGAGGCCCGTGGGGTTA	1
GGCCCCTACA	GAAACACCGGTAAATTTGAGGTTCCGGCATGCAGGAGGCCCGTGGGGTTA	1
GGCCCCTACA	GAAACACCGGTAATTTGAGGCTCCGGCATGCAGGAGGCCGTGGGGTTAGA	1
GGCCCCTACA	GAAACACCGGTGTGGCTGAGAGTCCGGCAATGGTGTGGCTGTGGGGTTAG	1
GGCCCTCTCT	GAAACGCCGGTGTGGCTGAGAGTCCGGCGATGGTGTGGCTGTGGGGTTAG	1
GGCGAAGACC	GAAACACCGGTCCCAACAGAACCGTTAGAGCTAGAAATAGCACGATAACT	1
GGCGATCCGC	GAAACACCTAAGGCTAGTCCGTTATCAACTTGAAAAAGTGGCACCGAGTC	1
GGCTAGCACA	GAAACACCGGTAAATTTGAGGCTCCGGCATGCAGGAGGCCGTGGGGTTAG	1
GGCTGATAGC	GAAACACCGGTAAATTTGAGGCTCCGGCATGCAGGAGGCCGTGGGGTTAG	1
GGCTTACTCC	GAAACATCGGTGTGGCTGAGAGTCCGGCAATGGTGTGGCTGTGGGGTTAG	1
GGGAACGCTC	GAAACACCGGTGTGGCTGAGAGTCCGGCAATGGTGTGGCTGTGGGGTTAG	1
GGGACAAACA	GAAACACCGGTAAATTTGAGGCTCCGGCATGCAGGAGGCCGTGGGGTTAG	1
GGGACCTAAA	GAAACACCGGTAAATTTGAGGCTCCGGCATGCAGGAGGCCGTGGGGTTAG	1
GGGACGTGCC	GAAACACCGGTGTGGCTGAGAGTCCGGCAATGGTGTGGCTGTGGGGTTAG	1
GGGAGCGCAA	GAAACACGGGTTAGAGCTAGAAATAGCAAGTTAACCTACGGCTAGTCCGT	1
GGGCAGCATC	GAAACACCGGTTCCCGTCCAGTGGGGTTAGAGCTAGAAATAGCAAGTTAA	1
GGGCGGCTCC	GAAACACCGGTGTGGCTGAGAGTCCGGCAATGGTGTGGCTGTGGGGTTAG	1
GGGGTGACAC	GAAACACCGGTTCCCGTCCAGTGGGGTTAGAGCTAGAAATAGCAAGTTAA	1
GGGGTGCATA	GAAACACCGGTTCCCGTCCAGTGGGGTTAGAGCTAGAAATAGCAAGTTAA	1
GGGGTGCCGC	GAAACACCGGTACCCGTCCAGTGGGGTTAGAGCTAGAAATAGCAAGTTAA	1
GGGTAATCTC	GAAACACCGGTTCCCGTCCAGTGGGGTTAGAGCTAGAAATAGCAAGTTAA	1
GGTAACCTTC	GAAACACCGGTGTGGCTGAGAGTCCGGCAATGGTGTGGCTGTGGGGTTAG	1
GGTACATACA	GAAACACCGGTAAATTTGAGGCTCCGGCATGCAGGAGGCCGTGGGGTTAG	1
GGTATCCCTT	GAAACACCGGTCTCGAGTGACGCGTTCAGGGTGTGGTTATAGCTAGAAAT	1
GGTATGCCTA	GAAACACCGGTCCGTAGGAGACCCGTGTGGCATGTACCTGTGGGGTTAGA	1
GGTCCGACCC	GAAACACCGGTCCGTAGGAGACCCGTGTGGCATGTACCTGGGGGGTTAGA	1
GGTCGTTATA	GAAACACCGGTAAATTTGAGGCTCCGGCATGCAGGAGGCCGTGGGGTTAG	1
GGTCTATACA	GAAACACCGGTAAATTTGAGGCTCCGGCATGCAGGAGGCCGTGGGGTTAG	1
GGTGAGCATC	GAAACACCGGTTCCCGTCCAGTGGGGTTAGAGCTAGAAATAGCAAGTTAA	1
GGTGATGACT	GAAACACCGGTGACATTGGGTTAGAGCTAGAAATAGCAAGTTAACCTAAG	1
GGTGGAGCTT	GAAACACCGGTTCCCGTCCAGTGGGGTTAGAGCTAGAAATAGCAAGTTAA	1
GGTTAACCGC	GAAACACCGGTCGGGGCCACTCAGTGGTGGGGTTAGAGCTAGAAATAGCA	1
GTAAGAACAA	GAAACACCGGTTAAGCCGAGGTTAGAGCTAGAAATAGCAAGTTAACCTAA	1
GTAATCATCC	GAAACACCGGTGTGGCTGAGAGTCCGGCAATGGTGTGGCTGTGGGGTTAG	1
GTACACCGCC	GAAACACCGGTGTGGCTGAGAGTCCGGCAATGGTGTGGCTGTGGGGTTAG	1
GTAGAACCGA	GAAACACCGGTCGGCGGCAATGGGGTTAGAGCTAGAAATAGCAAGTTAAC	1
GTAGACACGT	GAAACACCGGTCGGCGGCAATCGTGGGGGGGGTTAGAGCTAGAAATAGCA	1
GTAGCACTGA	GAAACACCGGTTACATTGAGGGTTAGAGCTAGAAATAGCAAGTTAACCTA	1
GTAGCCTTGT	GAAACACCGGTTACATTGAGGGTTAGAGCTAGAAATAGCAAGTTAACCTA	1
GTAGCTTTCA	GAAACACCGGTAAATTTGAGGCCCCGGCATGCAGGAGGCTCGTGGGGTTA	1
GTAGGTAGGT	GAAACACTGGTTACATTGAGGGTTAGAGCTAGAAATAGCAAGTTAACCTA	1
GTAGTCTGCC	GAAACACCGGTCCGTAGGAGACCCGTGTGGCATGTACCTGTGGGGTTAGA	1
GTAGTGCTAC	GAAACACCGGTAACTATATTCATGCGATATCGCCGGATCTGTGGGGTTAG	1
GTATAGTTAT	GAAACACCGGTGTACGTATGGACTGAACCAGGGTGTGCAAGTGGGGTTAG	1
GTATCTCGAG	GAAACACCGGTTATATTTGTAAGTGTGTGGGGTTAGAGCTAGAAATAGCA	1
GTATGTCTAG	GAAACACCGGTTTACGTTGCATCGGGGTTAGAGCTAGAAATAGCAAGTTA	1
GTATTCCTCG	GAAACACCGGTGCATTCGAAAGTCCTTTCGTAGTGGGGACGTGGGGTTAG	1
GTCAACCTTT	GAAACACCGGTGTGGCTGAGAGTCCGGCAATGGTGTGGCTGTGGGGGTAG	1
GTCACCTCCA	GAAACACCGGTATATTTGAGACTCCGGCATTGGGGTGGCCGTGGGGTTAG	1
GTCCCAGGAA	GAAACACCGGTAGCAAGTGCGAGACGTGTTAAATAGCAAGTTAACCTAAG	1
GTCCTCAGCT	GAAACACCGGTTTACGTTGTGGGGTTAGAGCTAGAAATAGCAAGTTAACC	1
GTCCTTTACC	GAAACACCGGTACCTTTGTTGATGCTGGGTGGAAGGAATTTGTGGGGTTA	1
GTCGAGCTAC	GAAACACCGGTGCCCTTACTCTCACCTGATTACTTAATCCGTGGGGTTAG	1
GTCGCGCCCC	GAAACACCGGTTCCCGTACAGTGGGGTTAGAGCTAGATATAGCAAGTTAA	1
GTCTATCGTG	GAAACACCGGTTATATTTGTAAGTGTGTGGGGTTGGAGCTAGAAATAGCA	1
GTCTATGGAG	GAAACACCGGTTATATTTGTAAGTGTTGTGGGGTTAGAGCTAGAAATAGC	1
GTGAAACGTT	GAAACACCGGTTCCCGTCCAGTGGGGTTAGAGCTAGAAATAGCAAGTTAA	1
GTGAACTCTC	GAAACACCGGTTCCCGTCCAGTGGGGTTAGAGCTAGAAATAGCAAGTTAA	1
GTGAAGATGC	GAAACACCGGTTCCCGTCCAGTGGGGTTAGAGCTAGAAATATCAAGTTAA	1
GTGAAGGATA	GAAACACCGGTTCCCGTCCAGTGGGGTTAGAGCTAGAAATAGCAAGTTAA	1
GTGACCAGAA	GAAACACCGGTTAAGCCGAGTGGGGTTAGAGCTAGAAATAGCAAGTTAAC	1
GTGACCCCTC	GAAACACCGGTTTGGCTGAGGTACCGGTAATGGTGTGGCTGGGGGGTTAA	1
GTGAGACTAA	GAAGCACCGGTTAAGCCGAGGAGTTAGAGCTAGAGATAGCAAGTTAACCT	1
GTGAGATTCC	GAAACACCGGTCGGCGCCACTCAGTGGCGGGGTTAGAGCTAGCAATAGCA	1
GTGAGTAGAA	GAAATACCGGTTAAGCCGAGGATGGGATTAGAGCTAGCAATAGCAGGTTA	1
GTGAGTATAT	GAAACACCGGTTAAGCCGGTGGGGTTAGAGCTAGAAATAGCAAGTTAACC	1
GTGAGTCCTA	GAAACACCGGTTCCCGTCCAGTGGGGTTAGAGCTAGAAATAGCAAGTTAA	1
GTGATAAGGC	GAAACACCGGTTTACGTTGCATCGGTGTGGGTGTAGATCTAGCAATAGCA	1
GTGATACAGA	GAAACACCGGTAGCAAGTGGGGTTAGAGCTAGAAATAGCAAGTTAACCTA	1
GTGATCGCGG	GAAACACCGGTTATATTTGTAAGCGTTGTGGGGTTAGAGCTAGAAATAGC	1
GTGATTGACT	GAAACACCGGTTTACGTTGCATCGGTGTGGGGTTAGAGCTAGAACTAGCA	1
GTGCAATATC	GAAACACCGGTTCCCGTCCAGTGGGGTTAGAGCTAGAAATAGCAAGTTAA	1
GTGCACCCTA	GAAACACCGGTTCCCGTCCAGTGGGGTTAGAGCTAGAAATAGCAAGTTAA	1
GTGCAGAACC	GAAACACCGGTTCCCGTCCAGTGGGGTTAGAGCTAGAAATAGCAAGTTAA	1
GTGCATAGCC	GAAACACCGGTTTACGTTGCATCGGATGTGGGGGTAGAGCTAGAAATAGC	1
GTGCATAGGG	GAAACACCGGTTTACGTTGCATCGGTGTGGGGTTAGAGCTAGAAATAGCA	1
GTGCATCGCT	GAAACACCGGTTTACGTTGCATCGGAAAAAGTGGCACCTTTTTTTTTTCA	1
GTGCCGCTTT	GAAACACCGGTCTCGAGTGAGGTGTTCAGGGTGGGGTTAGAGCTAGAAAT	1
GTGCGCATCA	GAAACACCGGTTAAGCCGAGGAGTTAGGGCTAGAAATAGCAAGTTAACCT	1
GTGCGCATCC	GAAACACCGGTTAAGCCGAGTGGGGTTAGAGCGAGGATTAGCAAGTTAAC	1
GTGCGGCCTA	GAAACACCGGTTCCCGTCCAGTGGGGTTATAGCTAGAAATAGCAAGTTAA	1
GTGCTCATCC	GAAACACCGGTTTACGTTGCATCGGTGCGGGGGTAGAGCTAGAAATAGCA	1
GTGCTCATCC	GAAACACCGGTTTGGCTGAGAGTACGGCACTGGAGTGGCTGTGGGGTTAG	1
GTGCTCTCCC	GAAACACCGGTAAATTTGAGGCTCCGGCATGCAGGAGGCCGTGGGGTTAG	1
GTGCTGGGTC	GAAACACCGGTTCCCGTCCAGGGGGGTTAGGGCTGGAAATAGCAAGTTAA	1
GTGGAGAATT	GAAACACCGGTTCCCGTCCAGTGGGGTTAGAGCTAGAAATAGCAAGTTAA	1
GTGGAGCCTC	GAAACACCGGTTCCCGTCCAGTGGGGTTAGAGCTAGAAATAGCAAGTTAA	477
GTGGAGCCTC	GAAACACCGGTTCGCAAGTTAACCTAAGGCTAGTCCGTTATCAACTTGAA	4
GTGGAGCCTC	GAAACACCGGTTCCCGGGGTTAGAGCTAGAAATAGCAAGTTAACCTAAGG	3
GTGGAGCCTC	GAAATAGCAAGTTAACCTAAGGCTAGTCCGTTATCAACTTGAAAAAGTGG	3
GTGGAGCCTC	AGGGGACGAAACACCGGTTCCCGTCCAGTGGGGTTAGAGCTAGAAATAGC	1
GTGGAGCCTC	CAAAACACCGGTTCCCGTCCAGTGGGGTTAGAGCTAGAAATAGCAAGTTA	1
GTGGAGCCTC	CCAAACACCGGTTCCCGTACAGTGGGGTTAGAGCTAGAAATAGCAAGTTA	1
GTGGAGCCTC	GAAACACCGGTGTGGCTGAGAGTCCGGCAATGGTGTGGCTGTGGGGTTAG	1
GTGGAGCCTC	GAAACACCGGTTAAGCCGAGGGGTTAGAGCTAGAAATAGCAAGTTAACCT	1
GTGGAGCCTC	GAAACACCGGTTCCCGTAGTGGGGTTAGAGCTAGAAATAGCAAGTTAACC	1
GTGGAGCCTC	GAAACACCGGTTCCCTTACTCTCACCTTATTACTTGATACGTGAGGTTAA	1
GTGGAGCCTC	GAACACCGGTTCCCGTCCAGTGGGGTTAGAGCTAGAAATAGCAAGTTAAC	1
GTGGATACAA	GAAACACCGGTTCCCGTCCAGTGGGGTTAGAGCTAGAAATAGCAAGTTAA	1
GTGGATGATT	GAAACACCGGTTCCCGTCCAGTGGGGTTAGAGCTAGAAATAGCAAGTTAA	1
GTGGCACCCT	GAAACACCGGTGTGGCTGAGAGTCCGGCAATGGTGTGGCTGTGGGGTTAG	1
GTGGCGATTC	GAAACACCGGTTCCCGTCCAGTGGGGTTAGAGCTAGAAATAGCAAGTTAA	1
GTGGCGCTTA	GAAACACCGGTTCCCGTCCAGTGGGGTTAGAGCTAGAAATAGCAAGTTAA	1
GTGGCGCTTT	GAAACACCGGTTACATTGAGGGTTAGAGCTAGATATAGCAAGCTAACCAA	1
GTGGGGACGC	GAAACACCGGTTCCCGTCCAGTGGGGTTAGAGCTAGAAATAGCAAGTTAA	1
GTGGGGAGCC	GAAACACCGGTTCCCGTCCAGTGGGGTTAGAGCTAGAAATAGCAAGTCAA	1
GTGGTGCATA	GAAACACCGGTTAAGCCGAGGTTAGAGCTAGAAATAGCAAGTTAACCTAA	1
GTGGTGCTTT	GAAACACCGGTTCCCGTCCAGTGGGGTTAGAGCTAGAAATAGCAAGTTAA	1
GTGGTTCCTT	GAAACACCGGTTCCCGTCCAGTGGGGTTAGAGCTAGAAATAGCAAGCTAA	1
GTGTAGCTGC	GAAACACCGGTTCCCGTCCAGCGGGGTTAGAGCTAGACATAGCAAGTTAA	1
GTGTAGGCGC	GAAACACCGGTTCCCGCTATTGGGGTTAGAGCTAGAAATAGCAAGTTATC	1
GTGTAGTCGC	GAAACACCGGTTCCCGTCCAGTGGGGTTAGAGTTAGAAATAGCAAGTTAA	1
GTGTATACTC	GAAACACCGGTTCCCGTCCAGTGGGGTTAGAGCTAGAAATAGCAAGTTAA	1
GTGTCTATGT	GAAACACCGGTTACATTCTGAGGGTTAGAGCTAGAAATAGCAAGTTAACC	1
GTGTGGAGCG	GAAACACCGGTTCCCGTCCAGTGGGGTTAGAGCTAGAAATAGCAAGTTAA	2
GTTAGCGATG	GAAACACCGGTTACATTGAGGGTTAGAGCTAGAAATAGCAAGTTAACCTA	1
GTTATCTATG	GAAACACCGGTTACATTGAGGGTTAGAGCTAGAAATAGCAAGTTAACCTA	1
GTTCGCTATG	GAAACACCGGTTACATTGAGGGTTAGAGCTAGAAATAGCAAGTTAACCTA	1
GTTCTGCTGT	GAAACACCGGTTTACGTTGCATCGGTGTGGGGTTAGAGCTAGGAATAGCA	1
GTTGCGTAGG	GAAACACCGGTTTGTGGGGGTAGAGCTAGAAATAGCAAGTTAACCTAAGG	1
TAAAAACGCC	GAAACACCGGTTTGAACTAGAAATAGCAAGTTAACCTAAGGCTAGTCCGT	1
TAAAACGTCC	GAAACACCGGTAAATTTGAGGCTCCGGCATGCAGGAGGCCGTGGGGTTAG	1
TAAAAGTTGG	GAAACACCGGTCTCGAGTGAGGTGTTCAGGGTGGGGTTAGAGCTAGAAAT	1
TAAAATGTAC	GAAACACCGGTAACTATATTCATGCGATATCGCCGTATCAGTGGGGTTAG	1
TAAACAGCTA	GAAACACCGGTAGCAAGTGCGAGACGTGTTAAATAGCAAGTTAACCTAAG	1
TAAACCCTCG	GAAACACCGGTGCATTCGAAAGTCCGGTCGTAGTGTGGACGTGGGGTTAG	1
TAAAGCATTA	GAAACACCGGTCTCGAGGGAGGGGTTCAGGGGGGGGATAGAGCTAGAAAT	1
TAAATCTACA	GAAACACCGGTAAATTTGAGGCTCCGGCATGCAGGAGGCCGTGGGGTTAG	1
TAAATTAGAA	GAAACACCGGTAACTATATTCATGCGATATCGCCGTATCAGTGGGGTTAG	1
TAACAATGCC	GAAACACCGGTTTGAACTAGAAATAGCAAGTTAACCTAAGGCTAGTCCGT	1
TAACATCCAA	GAAGCACCGGTAACTATATTCATGCGATATCGCCGTATCAGTGGGGTTAG	1
TAACATCTAA	GAAACACCGGTAACTATATTCATGCGATATCGCCGTATCAGTGGGGTTAG	1
TAACGACATA	GAAACACCGGTGCCCTTACTCTCACCTGATTACTTAATCCGTGGGGTTAG	1
TAACGACCAC	GAAACACCGGTGCCCTTACTCTCACCTGATTACTTAATCCGTGGGGTTAG	1
TAACGACCTA	GAAACACCGGTGCCCTTACTCTCACCTGATTACTTAATCCGTGGGGTTAG	1
TAACGCACTA	GAAACACCGGTGCCCTTACTCTCACCTGATTACTTAATCCGTGGGGTTAG	1
TAACGCCATA	GAAACACCGGTGCCCTTACTCTCACCTGATTACTTAATCCGTGGGGTTAG	1
TAACGTAGTC	GAAACACCGGTGTACGTATGGACTGAACCAGGGTGTGCAAGTGGGGTTAG	1
TAACGTATTA	GAAACACCGGTAACTATATTCATGCGATATCGCCGTATCAGTGGGGTTAG	1
TAACTGCTAA	GAAACACCGGTAACTATATTCATGCGATATCGCCGTATCAGTGGGGTTAG	1
TAACTTATAC	GAAACACCGGTAACTATATTCATGCGATATCGCCGTATCAGTGGGGTTAG	203
TAACTTATAC	GAAACACCGGTAACTATATTCATGCGATATCGCCGTATCAAGTGGGGTTA	16
TAACTTATAC	GGTGGCACCGAGTCGGTGCTTTTTTTCCTGCAGGGTATAAGTTAGAATTC	9
TAACTTATAC	GAAACACCGGTAACTATATTCATGCGATATCGCCGTATCGTGGGGTTAGA	8
TAACTTATAC	GAAACACCGGTAACTATATTCATGCGATATCGCTAGAAATAGCAAGTTAA	5
TAACTTATAC	GAAACACCGGTAACTATATTCATGCGATATGTGGGGTTAGAGCTAGAAAT	5
TAACTTATAC	GAAACACCGGTAACTATATTCATGCGATATCGCCTAGAGCTAGAAATAGC	4
TAACTTATAC	GAAACACCGGTAACTATATTCATGCGATATCGCGAGCTAGAAATAGCAAG	4
TAACTTATAC	GAAACACCGGTAACTATATTCATGCGATATCGCCGAGAGCTAGAAATAGC	3
TAACTTATAC	GAAACACCGGTAACTATATTCATGCGATATCGCCGTAGTTAGAGCTGGAA	2
TAACTTATAC	GAAACACCGGTAACTATATTCATGCGATATCGCGGCTAGTCCGTTATCAA	2
TAACTTATAC	CTAAACACCGGTAACTATATTCATGCGATATCGCCGTATCAGTGGGGTTA	1
TAACTTATAC	GAAACACCGGTAAATATATTCATGCGATATCGCCGTAGTTAGAGCTGGAA	1
TAACTTATAC	GAAACACCGGTAAATTTGAGGCTCCGGCATGCAGGAGGCCGTGGGGTTAG	1
TAACTTATAC	GAAACACCGGTAACTATATTCAAGCGATAGCGCGGTTGTTAGAGCTAGAA	1
TAACTTATAC	GAAACACCGGTAACTATATTCATGCGATATCGCCGTATCAACCTAAGGCT	1
TAACTTATAC	GAAACACCGGTAACTATATTCATGCGATATCGCCGTGGGGTTAGAGCTAG	1
TAACTTATAC	GAAACACCGGTAACTATATTCATGCGATATGGGGGGATAGATCTAGAAAT	1
TAACTTATAC	GAAACACCGGTAGCAAGTGCGAGACGTGTTAAATAGCAAGTTAACCTAAG	1
TAACTTATAC	GAAACACCGGTGACAGGTGGGGTTAGAGCTAGAAATAGCAAGTTAACCTA	1
TAACTTATAC	GAAACACCGGTGCCCTTACTCTCACCTGATTACTTAATCCGTGGGGTTAG	1
TAACTTATAC	GAAACACCGGTTACTTTGACGGCAGAGAGCTGGAAGTGGTGAGTTAACCT	1
TAACTTATAC	GAAACACCGGTTTTAGTGTTGTTAGAGCTAGAAATAGCAAGTTAACCTAA	1
TAACTTATAC	GAAACACGGGTTAGAGCTAGAAATAGCAAGTTAACCTAAGGCTAGTCCGT	1
TAACTTATAC	GAAACATAGCAAGTTAGCCTAAGGCTAGTCCGTTATCAACTTGAAAAAAG	1
TAACTTATAC	GAAACTATATTCATGCGTTATCAACTTGAAAAAGTGGCACCGAGTCGGTG	1
TAACTTATAC	GAGACACCGGTAACTATATTTATATAGCAAGTTAACCTAGGGCTAGTCCG	1
TAAGAGTCGC	GAAACACCGGTCGGCGGCAATCGTGGGTGGGGTTAGAGCTAGAAATAGCA	1
TAAGGACCTA	GAAACACCGGTGCCCTTACTCTCACCTGATTACTTAATCCGTGGGGTTAG	1
TAATCGGTCA	GAAACACCGGTTTGAACTACCGTGGCTTACTCTACTAATTGCAGGGTTAC	1
TAATGCCCTA	GAAACACCGGTGCCCTTACTCTCACCTGATTACTTAATCCGTGGGGTTAG	1
TAATGTGCCT	GAAACACCGGTCCGTAGGAGACCCGTGTGGCATGTACCTGTGGGGTTAGA	1
TAATTTATGT	GAAACACCGGTTACATTTGAGGGTTAGGGCTAGAAATAGCAAGTTAACCT	1
TACAAATGCC	GAAACACCGGTAAATTTGAGGCTCCGGCATGCAGGAGGCCGTGGGGTTAG	1
TACAACGCAG	GCTAGAAATAGCAAGTTAACCTAAGGCTAGTCCGTTATCAACTTGAAAAA	1
TACACCATAC	GAAACACCGGTGCCCTTACTCTCACCTGATTACTTAATCCGTGGGGTTAG	1
TACACCTGCA	GAAACACCGGTAAATTTGAGGCTCCGGCATGCAGGAGGCCGTGGGGTTAG	140
TACACCTGCA	GAAACACCGGTAAATTTGAGGCTCCGGCATGCAGGAGGCGTGGGGTTAGA	9
TACACCTGCA	GAAACACCGGTAAATTTGAGGCTCCGGCATGCAGGAGGCCCGTGGGGTTA	5
TACACCTGCA	CCGGTAAATTTGAGGCTCCGGCATGCAGGAGGCCCGTGGGGTTAGAGCTA	1
TACACCTGCA	CCGGTAAATTTGAGGCTCCGGCGTGCAGGAGGCCCGTGGGGTTAGAGCTA	1
TACACCTGCA	GAAACACCGGTAAATTCGAGGCTCCGGCATGCAGGAGGCGAGCTAGAAAT	1
TACACCTGCA	GAAACACCGGTCGGCGGCAATCGTGGGTGGGGTTAGAGCTAGAAATAGCA	1
TACACCTGCA	GAAACACCGGTGTGGCTGAGAGTCCGGCAATGATGTGGCTGTGGGGTTAG	1
TACACCTGCA	GAAACACCGGTGTGGCTGAGAGTCCGGCAATGGTGTGGCTGTGGGGTTAG	1
TACACCTGCA	GAAGCACCGGTGCATTCGAAAGTCCGGTCGTAGTGTGGACGTGGGGTTAG	1
TACAGATGGA	GAAACACCGGTAAATTTGAGGCTCCGGCATGCAGGAGGCCGTGGGGTTAG	1
TACCCATGCT	GAAACACCGGTAAATTTGAGGCTCCGGCATGCAGGAGGCCGTGGGGTTAG	1
TACCTATGTC	GAAACACCGGTAAGTTTGAGGCTCCGGCATGCAGGAGGCCGTGGGGTTAG	1
TACTCGTACA	GAAACACCGGTAGCAAGTGCGAGACGTGTTTGTGGGGTTAGAGCTAGAAG	1
TACTCTTCGT	GAAACACCGGTGTACGTATGGACTGAACCAGGGTGTGCAAGTGGGGTTAG	1
TACTGCGTAT	GAAACACCGGTTAAGCCGAGGAGTTAGAGCTAGAAATAGCAAGTTAACCT	1
TACTTAATGT	GAAACACCGGTTAGGGGGTAGGGTTAGAGCTAGAAGTAGCAATTTGACCT	1
TACTTTACCG	GAAACACCGGTCGGGGCCACTCAGTGGTGGGGTTAGAGCTAGAAATAGCA	2
TACTTTACGT	GAAACACCGGTCGATTCATATCGAAACCTTCCCGTGACAGTGGGGTTAGA	1
TAGAATCCTT	GAAACACCGGTCTCGAGTGAGGTGTTCAGGGTGGGGTTAGAGCTAGAAAT	2
TAGAATCGTT	GAAACACCGGTCTCGAGTGAGGTGTTCAGGGTGGGGTTAGAGCTAGAAAT	1
TAGACACACG	GAAACACCGGTGCATTCGAAAGTCCGGTCGTAGTGTGGACGTGGGGTTAG	1
TAGACACTCG	GAAACACCGATGCATTCGAAAGTCCGGTCGTAGTGTGGACGTGGGGTTAG	1
TAGACTGCGT	GAAACACCGGTCCGTAGGAGACCCGTGTGGCATGTACCTGTGGGGTTAGA	1
TAGAGAGTAA	GAAACACCGGTTAAGCCGAGGAGTTAGAGCTAGAAATAGCAAGTTAACCT	1
TAGAGGAGGG	GAAACACCGGTAACTATATTCATGCGATATCGCCGTATCAGTGGGGTTAG	1
TAGATCGCGG	GAAACACCGGTTATATTTGTAAGAGTGTGGGGTTAGAGCTAGAAATAGCA	1
TAGATTAAAC	GAAACACCGGTAACTATATTCCTGCGATCTCTCCGTCTCATTGTGGTTAG	1
TAGCCGAGCT	GAAACACCGGTTTACGTTGCATCGGAGTGGGGTTAGAGCTAGAAATAGCA	1
TAGCGTCGTA	GAAACACCGGTGTACGTATGGACTGAACCAGGGTGTGCAAGTGGGGTTAG	1
TAGCTTACAA	GAAACACCGGTAACTATATTCATGCGATATCGCCGTATCAAGTGGGGTTA	1
TAGTATGCCC	GAAACACCGGTCCGTAGGAGACCCGTGTGGCATGTACCTGTGGGGTTAGA	1
TAGTCTAAGA	GAAACACCGGTAACTATAATCATGCGATGTCGCCGTATCAGTGGGGTTAG	1
TAGTCTGCAT	GAAACACCGGTCCGTAGGAGACCCGTGTGGCATGTACCTGTGGGGTTAGA	1
TAGTGTTGTC	GAAACACCGGTGACATTGGGTATAGCAAGTTAACCTAAGGCTAGTCCGTT	1
TATACCAGCC	GAAACACCGGTAAATTTGAGGCTCCGGCATGCAGGAGGCCGTGGGGTTAG	1
TATACGTCTC	GAAACACCGGTCCGTAGGAGACCCGTGTGGCATGTACCTGTGGGGTTAGA	1
TATAGCATAC	GAAACACCGGTCAACGGCAATCGTGGTTGGGGTTAGAGCAAGAAATAGCA	1
TATATGGAAG	GAAACACCGGTTATATTTGTGGGTTAGAGCTAGAAATAGCAAGTTAACCT	1
TATATGGAGA	GAAACACCGGTTATATTAGGAAGTGAATGAGGTTAGTGATAGAAATAGAG	1
TATCGTGGGA	GAAACACCGGTTATATTTGTAAGTGTGTGGGGTTAGAGCTAGAGATAGCA	1
TATCTTCATC	GAAACACCGGTGTACGTATGGACTGAACCAGGGTGTGCAAGTGGGGTTAG	1
TATGACAGAC	GAAACACCGGTGGGGTTAGAGCTAGAAATAGCAAGTTAACCTAAGGCTAG	1
TATGATGAGC	GAAACACCGGTTTACGTTGCATCGGTGTGGGGTTAGAGCTAGAAATAGCA	1
TATGCGTAGC	GAAACACCGGTTTACGTTGCATCGGTGTGGGGTTAGAGCTAGAAATAGCA	1
TATGCTTCGC	GAAACACCGGTTTACGTTGTGGGGTTAGAGCTAGAAATAGCAAGTTAACC	1
TATGCTTTGG	GAAACACCGGTTTACGTTGCATCGGTGTGGGGTTAGAGCTAGAAATAGCA	1
TATTATAAAC	GAAACACCGGTCGGGGCCACTCAGTGGTGGGGTTAGAGCTAGAAATAGCA	1
TATTCTGACT	GAAACACCGGTCCGTAGGAGACCCGTGTGGCATGTACCTGTGGGGTTAGA	1
TATTTAGTGG	GAAACACCGGTTATATTTGTAAGTGTGTGGGGTTAGAGCTAGAAATAGCA	1
TCAATCATAA	GTTAACCTAAGGCTAGTCCGTTATCAACTTGAAAAAGTGGCACCGAGTCG	1
TCAATCGGGC	GAAACACCGGTTATATTTGTTAGTATGTGGGGTTAGAGCTAGAAATAGCA	1
TCACAACGCA	GAAACACCGGTTTGAACTAGAAATAGCAAGTTAACCTAAGGCTAGTCCGT	1
TCACACCGCC	GAAACACCGGTTTGAACTAGAAATAGCAAGTTAACCTAAGGCTAGTCCGT	1
TCACAGCGTC	GAAACACGGGTTAGAGCTAGAAATAGCAAGTTAACCTAAGGCTAGTACGT	1
TCACGCCCTA	GAAACACCGGTGCCCTTACTCTCACCTGATTACTTAGTCCGTGGGGTTAG	1
TCAGATCTGG	GAAACACCGGTTACATTGAGGGTTAGAGCTAGAAATAGCAAGTTAACCTA	1
TCAGCTCAGT	GAAACACCGGTCGGGGCCACTCAGTGGTGGGGTTAGAGCTAGAAATAGCA	1
TCAGTTATAA	GAAACACCGGTAACTATATTCATGCGATATCGCCGTATCAGTGGGGTTAG	1
TCAGTTTGTT	GAAACACCGGTGACATTGGGTTAGAGCTAGAAATAGCAAGTTAACCTAAG	1
TCATTACGGC	CACCGGTCGGGGCCACTCAGTGGTGGGGTTAGAGCTAGAAATAGCAAGTT	1
TCATTGACGC	GAAACACCGGTCGGGGCCACTCAGTGGTGGGGTTAGAGCTAGAAATAGCA	1
TCATTGTCGT	GAAACACCGGTGTACGTATGGACTGAACCAGGGTGTGCAAGTGGGGTTAG	1
TCATTTAACG	GAAACACCGGTCGGGGCCACTCAGTGGTGGGGTTAGAGCTAGAAATAGCA	1
TCATTTACCG	GAAACACCGGTCGGGGCCACTCAGTGGTGGGGTTAGAGCTAGAAATAGCA	1
TCCACCGCCC	GCTAGAAATAGCAAGTTAACCTAAGGCTAGTCCGTTATCAACTTGAAAAA	1
TCCCCAGGCC	GAAACACCGGTAAATTTGAGGCTCCGGCATGCAGGAGGCCGTGGGGTTAG	1
TCCCCCTCGC	GAAACACCGGTGCATTCGAAAGTCCGGTCGTAGTGTGGACGTGGGGTTAG	1
TCCCTATGCG	GAAACACCGGTTTGAACTACCTAGTTCAAACCGGTGGGGTTAGAGCTAGA	1
TCCGGCCTCT	GAAACACCGGTGCCCTTACTCTCACCTGATTACTTAATCCGTGGGGTTAG	1
TCCTATACAT	GAAACACCGGTCGGGGCCACTCAGTGGTGGGGTTAGGGCTAGAAATAGCA	1
TCCTTCACCG	GAAACACCGGTCGGGGCCACTCAGTGGTGGGGTTAGAGCTAGAAATAGCA	1
TCCTTTACAG	GAAACACCGGTCGGGGCCACTCAGTGGTGGGGTTAGAGCTAGAAATAGCA	1
TCCTTTACTG	GAAACACCGGTCGGGGCCACTCAGTGGTGGGGTTAGAGCTAGAAATAGCA	1
TCCTTTATAG	GAAACACCGGTCGGGGCCACTCAGTGGTGGGGTTAGAGCTAGAAATAGCA	1
TCGAATACTT	GAAACACCGGTCTCGAGTGAGGTGTTCAGGGTGGGGTTAGAGCTAGAAAT	1
TCGAATCCGT	GAAACACCGGTCTCGAGTGAGGTGTTCAGGGTGGGGTTAGAGCTAGAAAT	1
TCGAATGCTT	GAAACACCGGTCTCGAGTGAGGTGTTCAGGGTGGGGTTAGAGCTAGAAAT	1
TCGAATTCTT	GAAACACCGGTCTCGAGTGAGGTGTTCAGGGTGGGGTTAGAGCTAGAAAT	1
TCGACCCTCG	GAAACACCGGTGCATTCGAAAGTCCGGTCGTAGTGTGGACGTGGGGTTAG	1
TCGACTCGCT	GAAACACCGGTCTCGAGTGAGGTGTTCAGGGGGTGGGGTTAGAGCTAGAA	1
TCGAGAACAA	GAAACACCGGTTAAGCCGAGGAGTTAGAGCTAGAAATAGCAAGTTAACCT	1
TCGAGAGAGG	GAAACACCGGTTATATTTGTAAGTGGGGTTAGAGCTAGAAATAGCAAGTT	1
TCGCTCAAGG	GAAACACCGGTTATATTTGTAAGTGGGGTTAGAGCTAGAAATAGCAAGTT	1
TCGCTCTGCA	GAAACACCGGTGCATTCGAAAGTCCGGTCGTAGTGTGGACGTGGGGTTAG	1
TCGTCTATGT	GAAACACCGGTTACATTGAGTGGGGTTAGAGCTAGAAATAGCAAGTTAAC	1
TCGTCTGCCT	GAAACACCGGTCCGTAGGAGACCCGTGTGGCATGTACCTGTGGGGTTAGA	1
TCGTGACTGC	GAAACACCGGTCGGGGCCACTCAGTGGTGGGGTTAGAGCTAGAAATAGCA	1
TCGTGTAAAT	GAAACACCGGTCCGCAGGAGACCCGTGTGGCATGTACCTGGGGTTAGAGC	1
TCGTGTATTC	GAAACACCGGTCACGTTTCCTAGAATGTGGGGGTTGAGCTTGAAATAGGC	1
TCGTGTTGTA	GAAACACCGGTGACATTGGGTACAGGGGTGGGGTTAGAGCTAGAAATAGC	1
TCTAATAAGC	GAAACACCGGTTATATTTGTAAGTGTGTGGGGTTAGAGCTAGAAATAGCA	1
TCTAATCATT	GAAACACCGGTCTCGTGTGCGGGGTTGAGGGGGGAGATCTAGCTAGAACT	1
TCTAATCGGC	GAAACACCGGTACCTTTGTTGATGCTGGGTGGAAGGAATTTTGTGGGGTT	1
TCTAATCGTC	GAAACACCGGTACCTTTGTTGATGCTGGGTGGAAGGAATGTGGGGGTAGA	1
TCTACAGTCA	GAAACACCGGTAGCAAGTGCGAGACGTGTTTGTGGGGTTAGAGCTAGAAA	1
TCTACGCGGT	GAAACACCGGTACCTTTGTTGATGCTGGGTGGGGTTAGAGCTAGAAATAG	1
TCTAGTGTGG	GAAACACCGGTTATATTTGTAAGTGTGTGGGGTTAGAGCTAGAAATAGCA	1
TCTATAGGTG	GAAACACCGGTTATATTTGTAAGTGTGTGGGGTTAGAGCTAGAAATAGCA	1
TCTATCGAGG	GAAACACCGGTTATATTTGTAAGTGTGTGGGGTTAGAGCTAGAAATAGCA	514
TCTATCGAGG	GAAACACCGGTTATATTTGTAAGTGGGGTTAGAGCTAGAAATAGCAAGTT	63
TCTATCGAGG	GAAACACCGGTTATATTTGTAAGTGTTGTGGGGTTAGAGCTAGAAATAGC	57
TCTATCGAGG	GAAACACCGGTTATATTTGTGGGGTTAGAGCTAGAAATAGCAAGTTAACC	20
TCTATCGAGG	GAAACACCGGTTAGCAAGTTAACCTAAGGCTAGTCCGTTATCAACTTGAA	13
TCTATCGAGG	GAAACACCGGTTAACCTAAGGCTAGTCCGTTATCAACTTGAAAAAGTGGC	12
TCTATCGAGG	GAAACACCGGTTATGGGTTAGAGCTAGAAATAGCAAGTTAACCTAAGGCT	12
TCTATCGAGG	CAAGTTAACCTAAGGCTAGTCCGTTATCAACTTGAAAAAGTGGCACCGAG	10
TCTATCGAGG	GAAACACCGGTTATATTTGGGGTTAGAGCTAGAAATAGCAAGTTAACCTA	10
TCTATCGAGG	GAAACACCGGTTATATTTGTAAGTGTTTGTGGGGTTAGAGCTAGAAATAG	10
TCTATCGAGG	GAAACACCGGTTATATTTGTAAGTGAGCTAGAAATAGCAAGTTAACCTAA	9
TCTATCGAGG	GAAACACCGGTTATATTTGTAAGTGTGGGGTTAGAGCTAGAAATAGCAAG	9
TCTATCGAGG	GAAACACCGGTTATATTTGTGTGGGGTTAGAGCTAGAAATAGCAAGTTAA	9
TCTATCGAGG	GAAACACCGGTTATATTTGTGGGTTAGAGCTAGAAATAGCAAGTTAACCT	8
TCTATCGAGG	GAAACACCGGTTATATTTGTAAGTATTAGAGCTAGAAATAGCAAGTTAAC	7
TCTATCGAGG	GAAACACCGGTTATATTTGTAAGTGTTTTGTGGGGTTAGAGCTAGAAATA	7
TCTATCGAGG	GAAACACCGGTGGGGTTAGAGCTAGAAATAGCAAGTTAACCTAAGGCTAG	6
TCTATCGAGG	GAAATAGCAAGTTAACCTAAGGCTAGTCCGTTATCAACTTGAAAAAGTGG	6
TCTATCGAGG	GAAACACCGGTTAGCTAGAAATAGCAAGTTAACCTAAGGCTAGTCCGTTA	5
TCTATCGAGG	GAAACACCGGTTATATTTGTAAGCTAGAAATAGCAAGTTAACCTAAGGCT	5
TCTATCGAGG	ATAGCAAGTTAACCTAAGGCTAGTCCGTTATCAACTTGAAAAAGTGGCAC	4
TCTATCGAGG	GAAACACCGGTTAGAGCTAGAAATAGCAAGTTAACCTAAGGCTAGTCCGT	4
TCTATCGAGG	GAAACACCGGTTATATTTGTAAGGGGTTAGAGCTAGAAATAGCAAGTTAA	4
TCTATCGAGG	GAAACACCGGTTATATTTGTAAGTGGCCCCTTGTGGGGTTAGAGCTAGAA	4
TCTATCGAGG	GAAACACCGGTTATATTTGTAAGTTATATTTGGGTTAGAGCTAGAAATAG	4
TCTATCGAGG	GAAACACCGGTTATATTTGTAATGGGGTTAGAGCTAGAAATAGCAAGTTA	4
TCTATCGAGG	GAAACACCGGTTATATTTGTAGTGGGGTTAGAGCTAGAAATAGCAAGTTA	4
TCTATCGAGG	GAAACACCCAAGTTAACCTAAGGCTAGTCCGTTATCAACTTGAAAAAGTG	3
TCTATCGAGG	GAAACACCGGTTATATTTGTAAGTTAGAGCTAGAAATAGCAAGTTAACCT	3
TCTATCGAGG	GAAACACCGGTTATTGTGGGGTTAGAGCTAGAAATAGCAAGTTAACCTAA	3
TCTATCGAGG	GACACCGGTTATATTTGTAAGTGTGTGGGGTTAGAGCTAGAAATAGCAAG	3
TCTATCGAGG	GATAGCAAGTTAACCTAAGGCTAGTCCGTTATCAACTTGAAAAAGTGGCA	3
TCTATCGAGG	GAAACACCGGTTATATTTGTAAGTGGTTAGAGCTAGAAATAGCAAGTTAA	2
TCTATCGAGG	GAAACACCGGTTATATTTGTAGGGGTTAGAGCTAGAAATAGCAAGTTAAC	2
TCTATCGAGG	GAGACACCGGTTATATTTGTAAGTGTGGGGTTAGAGCTAGAAATAGCAAG	2
TCTATCGAGG	CAAAACACCGGTTATATTTGTAAGTGTGTGGGGTTAGAGCTAGAAATAGC	1
TCTATCGAGG	CAAAACACCGGTTATGGGTTAGAGCTAGAAATAGCAAGTTAACCTAAGGC	1
TCTATCGAGG	GAAAACACCGGTTATATTTGTAAGTGTGTGGGGTTAGAGCTAGAAATAGC	1
TCTATCGAGG	GAAACACCGGTCTCGAGTGAGGTGTTCAGGGTGGGGTTAGAGCTAGAAAT	1
TCTATCGAGG	GAAACACCGGTCTCGAGTGAGGTGTTCAGGTGGGGTTAGAGCTAGAAATA	1
TCTATCGAGG	GAAACACCGGTGTGGCTGAGAGTCCGGCAATGGTGTGGCTGTGGGGTTAG	1
TCTATCGAGG	GAAACACCGGTTAGAGCTAGAAATAGCAAGTTAACCTAAGGCTGGTCCGT	1
TCTATCGAGG	GAAACACCGGTTATATTTAGAGCTAGAAATAGCAAGTTAACCTAAGGCTA	1
TCTATCGAGG	GAAACACCGGTTATATTTGTAAGAGCTAGAAATAGCAAGTTAACCTAAGG	1
TCTATCGAGG	GAAACACCGGTTATATTTGTAAGTATTGTTGGGTTAAGGATGGTAATCGA	1
TCTATCGAGG	GAAACACCGGTTATATTTGTAAGTTAGAGCTAGAAATCTGTAAGTTATAT	1
TCTATCGAGG	GAAACACCGGTTATATTTGTAGTGGGGTTAGAGCTAGAGATAGCAAGTTA	1
TCTATCGAGG	GAAACACCGGTTATATTTGTTAGGGCTAGAAATAGCAAGTTAACCTAAGG	1
TCTATCGAGG	GAAACACCGGTTATTGTGGGGTTAGAGCTAGAAATAGCAGGTTAACCTAA	1
TCTATCGAGG	GAAACACCGGTTCCCCTGTGGGGTTAGAGCTAGAAATAGCAAGTTAACCT	1
TCTATCGAGG	GAAACACCGGTTCCCCTGTGGGGTTAGAGCTAGAAATAGCAAGTTAGCCT	1
TCTATCGAGG	GAAACACCGGTTCCCCTGTGGGGTTTGAGCTAGAAATAGCAAGTTAACCT	1
TCTATCGAGG	GAAACACCGGTTTACGTTGCATCGGTGTGGGGTTAGAGCTAGAAATAGCA	1
TCTATCGAGG	GAAACATCGGTTATATTTGTAATGGGGTTAGAGCTAGAAATAGCAAGTTA	1
TCTATCGAGG	GACGAAACACCGGTTATATTTGTAAGTGTGTGGGGTTAGAGCTAGAAATA	1
TCTATCGAGG	GATAGCAAGTTAACCTAAGGCTAGTCCGTTATCAACTTGAAAAGGTGGCA	1
TCTATTAGGG	GAAACACCGGTTATATTTGTAAGTGTGTGGGGTTAGAGCTAGAAATAGCA	1
TCTATTGAAC	GAAACACCGGTTATATTTGTAAGTGTTGTGGGGTTAGAGCTAGAAATAGC	1
TCTCTAGTGG	GAAACACCGGTTATATTTGTAAGTGTGTGGGGTTAGAGCTAGAAATAGCA	1
TCTCTCCCTC	GAAACACCGGTCCGTAGGAGACCCGTGTGGCATGTACCTGTGGGGTTAGA	1
TCTGCCGAGC	GAAACACCGATTCCCTTACTCTCACCTGATTACTTAATCCGTGGGGTTAG	1
TCTGCTTCGC	GAAACACCGGTTTACGTTGCATCGGTGTGGGGTTAGAGCTAGAAATAGCA	1
TCTGTAGAGC	GAAACACCGGTTATATTTGTAAGTGTGTGGGGTTAGAGCTAGAAATAGCA	1
TCTTACATAC	GAAACACCGGTAAGGAGCTTTTTTTCTACAGTGTGTGCACAGCTATTCAT	1
TCTTTAAAGC	GAAACACCGGTCGGGGCCACTCAGTGGTGGGGTTAGAGCTAGAAATAGCA	1
TCTTTAACGA	GACGAAAAATAGCAAGTTAACCTAAGGCTAGTCCGTTACAACTTGAAAAA	1
TGAACACTCC	GAAACACCGGTGTGGCTGAGAGTCCGGCAATGGTGTGGCTGTGGGGTTAG	1
TGAACGTCGT	GAAACACCGGTGTACGTATGGACTGAACCAGGGTGTGCAAGTGGGGTTAG	1
TGAAGACCAG	GAAACACCGGTCGGCGGCAATGGGGTTAGAGCTAGAAATAGCAAGTTAAC	1
TGAAGACGAG	GAAACACCGGTCGGCGGTGGGGTTAGAGCTAGAAATAGCAAGTTAACCTA	1
TGAAGACTCG	GAAACACCGGTCGGCGGTGGGGTTAGAGCTAGAAATAGCAAGTTAACCTA	1
TGAAGCCGTT	GAAACACCGGTCTCGAGTGAGGTGTTCAGGGTGGGGTTAGAGCTAGAAAT	1
TGAAGCGTTT	GAAACACCGGTCTCGAGGGAGGTGTTCAGGGGGGGAAGTTAGAGCTAGAA	1
TGAATCGATT	GAAACACCGGTCTCGAGTGAGGTGTTCAGGGTGGGGTTAGAGCTAGAAAT	1
TGACCCTAGA	GAAACACCGGTAAATTTGAGGCTCCGGCATGCAGGAGGCCGTGGGGTTAG	1
TGACTCAGAC	GAAACACCGGTAGCAAGTGCGAGCAAGTTAACCTAAGGCTAGTCCGTTAT	1
TGATCTGTCT	GAAACACCGGTAACCATCGCATCCGCCAAAGGGTAGATAGAGCTATAGAT	1
TGATTGCTGC	GAAACACCGGTCCGTAGGAGACCCGTGTGGCATGTACCTGTGGGGTTAGA	1
TGCAACCACC	GAAACACCGGTTTGAACTACCTAGCAAGTTAACCTAAGGCTAGTCCGTTA	1
TGCAACCTCA	GAAACACCGGTGTGGCTGAGAGTCCGGCAATGGTGTGGCTGTGGGGTTAG	1
TGCAACTAGG	GAAATAGCAAGTTAACCTAAGGCTAGTCCGTTATCAACTTGAAAAAGTGG	1
TGCATCGGGG	GAAACACCGGTACCTTTGTTGATGCTAGAAATAGCAAGTTAACCTAAGGC	1
TGCATGCTCC	GAAACACCGGTTTGGCTGAGAGTCCGGCAATGGTGTGGCTGTGGGGTTAG	1
TGCATTATAC	GAAACACCGGTAACTATATTCATGCGATATCGCCGTATCAGTGGGGTTAG	1
TGCGGAGCCT	GAAACACCGGTTCCCGGGGTTAGAGCTAGAAATAGCAAGTTAACCTAAGG	1
TGGAATCCTC	GAAACACCGGTGTGGCTGAGAGTCCGGCAATGGTGTGGCTGTGGGGTTAG	1
TGGCAACCTC	GAAACACCGGTGTGGCTGGGAGTCCGGCAATGGTGTGGCTGTGGGGTTAG	1
TGGCACACTC	GAAACACCGGTGTGGCTGAGAGTCCGGCAATGGTGTGGCTGTGGGGTTAG	1
TGGCACATAC	GAAACACCGGTAAATTTGAGGCTCCGGCATGCAGGAGGCCGTGGGGTTAG	1
TGGGTTGGCT	GAAACACCGGTGACATTGGGGTTAGAGCTAGAAATAGCAAGTTAACCTAA	1
TGGTACCATA	GAAACACCGGTGTGGCTGAGAGTCCGGCAATGGTGTGGCTGTGGGGTTAG	1
TGTACCCCCC	GAAACACCGGTGTGGCTGAGAGTCCGGCAATGGTGTGGCTGTGGGGTTAG	1
TGTAGTATAA	GAAACACCGGTTAAGTTGAGGAGTTTCGTTAGAGCTAGAAATAGCCAGTT	1
TGTATCCACC	GAAACACCGGTCGGGGCCACTCAGTGTGGTGGGGGTAGAGCTAGAAATAG	1
TGTCATCGAC	GAAACACCGGTAGCAAGTGCGAGCAAGTTTGTGGGGTTAGAGCTAGAAAT	1
TGTCCGCTTC	GAAACACCGGTCCGTAGGAGACCCGTGTGGCATGTACCTGTGGGGTTAGT	1
TGTCTAGATA	GAAACACCGGTTAATTTGACGCGCCGTCATGCAGGAGGCGGGGGGGTTAG	1
TGTCTGGCTA	GAAACACCGGTGCGAAGGAGCTCCGTGTGGCGTGAGCCCTTGGAGTTGCA	1
TGTGATGTAT	GAAACACCGGTGACATTGGGAGTGGGGTTAGAGCTAGAAATAGCAAGTTA	1
TGTGATTTGA	GAAACACCGGTAAATTTGAGGCTCCGGCATGCAGGAGGCCGTGGGGTTAG	1
TGTGGATCCT	GGAACACCGGTTCCCGTCCAGTGGGGTTAGAGCTGGAAATAGCAAGATAA	1
TTAAAATATC	GAAACACCGGTAACTATATTCATGCGATATCGCCGTATCAGTGGGGTTAG	1
TTAAGCACAC	GAAACACCGGTTCAGACGAGGGGGGGTTAGAGCTAGAAATAGCAAGTTAG	1
TTAAGGATCA	GAAACACCGGTTAAGCCGAGGAGTTAGAGCTAGAAATAGAAAGTTAACCT	1
TTAATCGAGC	GAAACACCGGTTATATTTGTAAGTGTGTGGGGTTAGAGCTAGAAATAGCA	1
TTAATCGGCA	GAAACACCGGTACCTTTGTTGATGCTGGGTGGAAGGAAGTGGGGTTAGAG	1
TTACATCTGT	GAAACACCGGTTACATTGGGGTTAGAGCTAGAAATAGCAAGTTAACCTAA	1
TTACCAGCAC	GAAACACCGGTTTGAACTAGAAATAGCAAGTTAACCTAAGGCTAGTCCGT	1
TTACTCGTAC	GAAACACCGATACCTTTGTTGATGCTGGGTGGGGTTAGAGCTAGAAATAG	1
TTAGAAATGC	GAAACACCGGTTACATTGAGGGTTAGAGCTAGAAATAGCAAGTTAACCTA	1
TTAGAACGCG	GAAACACCGGTTTGAACTAGAAATAGCAAGTTAACCTAAGGCTAGTCCGT	1
TTAGATAGCT	GAAACACCGGTTTACGTTGCATCGGTGTGGGGTTAGAGCTAGAAATAGCA	1
TTAGATCCGT	GAAACACCAGTCACGGTCACTCCGTGGGGGTAGTGCTGGTAATAGTAAGT	1
TTAGCCACGC	GAAACACCGGTTACATTGAGGGGTTAGAGCTAGAAATGGCAAGTTAACCT	1
TTAGCGATAC	GAAACACCGGTTACATTGAGGGGTTAGAGCTAGAAATAGCAAGTTAACCT	1
TTAGCTATGT	GAAACACCGGTTACATTGAGGGTTAGAGCTAGAAATAGCAAGTTAACCTA	415
TTAGCTATGT	GAAACACCGGTTACATTGAGGGGTTAGAGCTAGAAATAGCAAGTTAACCT	154
TTAGCTATGT	GAAACACCGGTTACATTGAGATTAGAGCTAGAAAAGGCTAGTCCGTTATC	51
TTAGCTATGT	GAAACACCGGTTACATTGAGATTGGGGTTAGAGCTAGAAATAGCAAGTTA	48
TTAGCTATGT	GAAACACCGGTTACATTGAGTGGGGTTAGAGCTAGAAATAGCAAGTTAAC	48
TTAGCTATGT	GAAACACCGGTTACATTGGGGTTAGAGCTAGAAATAGCAAGTTAACCTAA	19
TTAGCTATGT	GAAACACCGGTTGAGGGTTAGAGCTAGAAATAGCAAGTTAACCTAAGGCT	15
TTAGCTATGT	GAAACACCGGTTACATTGAGATCTCTTTTGTGGGGTTAGAGCTAGAAATA	12
TTAGCTATGT	GAAACACCGTGAGGGGTTAGAGCTAGAAATAGCAAGTTAACCTAAGGCTA	12
TTAGCTATGT	GAAACACAAGAGCTAGAAATAGCAAGTTAACCTAAGGCTAGTCCGTTATC	11
TTAGCTATGT	GAAACACCATTGGGGTTAGAGCTAGAAATAGCAAGTTAACCTAAGGCTAG	9
TTAGCTATGT	GAAACACCGGTTACAGGGGTTAGAGCTAGAAATAGCAAGTTAACCTAAGG	9
TTAGCTATGT	GAAACACCGGTTACTGGGGTTAGAGCTAGAAATAGCAAGTTAACCTAAGG	6
TTAGCTATGT	GAAACACCGGTGAGAGTTAGAGCTAGAAATAGCAAATTAACCTAAGGCTA	5
TTAGCTATGT	GAAACACCGGTGAGGGGTTAGAGCTAGAAATAGCAAGTTAACCTAAGGCT	5
TTAGCTATGT	GAAACACCGGTTACATGAGGGTTAGAGCTAGAAATAGCAAGTTAACCTAA	5
TTAGCTATGT	GAAACACCGGTTACATTGAGATCTCTTTTATGAGATCTCTGGGGTTAGAG	5
TTAGCTATGT	GAAACACCGGTTACTGAGGGTTAGAGCTAGAAATAGCAAGTTAACCTAAG	5
TTAGCTATGT	GAAACACCGGTTAGGGGTTAGAGCTAGAAATAGCAAGTTAACCTAAGGCT	5
TTAGCTATGT	GAAACACCGGTTTAGAGCTAGAAATAGCAAGTTAACCTAAGGCTAGTCCG	5
TTAGCTATGT	GAAACACCGGTTACTTGGGGTTAGAGCTAGAAATAGCAAGTTAACCTAAG	4
TTAGCTATGT	GAAACACCGGTTTAGAAATAGCAAGTTAACCTAAGGCTAGTCCGTTATCA	4
TTAGCTATGT	ATTGGGGTTAGAGCTAGAAATAGCAAGTTAACCTAAGGCTAGTCCGTTAT	3
TTAGCTATGT	GAAACACCGGTTACATTCTGAGGGTTAGAGCTAGAAATAGCAAGTTAACC	3
TTAGCTATGT	GAAACGAGGGTTAGAGCTAGAAATAGCAAGTTAACCTAAGGCTAGTCCGT	3
TTAGCTATGT	GAAACACCGGTTACTGGGGTTAGAGCCAGAAATAGCAAGTTAACCTAAGG	2
TTAGCTATGT	GATTGGGGTTAGAGCTAGAAATAGCAAGTTAACCTAAGGCTAGTCCGTTA	2
TTAGCTATGT	GGGTTAGAGCTAGAAATAGCAAGTTAACCTAAGGCTAGTCCGTTATCAAC	2
TTAGCTATGT	ATTGGGGTTAGAGCTAGAAATAGCGAGTTAACCTAAGGCTAGTCCGTTAT	1
TTAGCTATGT	CAAAACACCGGTTACATTGAGGGGTTAGAGCTAGAAATAGCAAGTTAACC	1
TTAGCTATGT	CAAAACACCGGTTACATTGAGGGTTAGAGCTAGAAATAGCAAGTTAACCT	1
TTAGCTATGT	GAAACACCGGCGTGGCTGAGAGTCCGGCAATGGTGTGGCTGTGGGGTTAG	1
TTAGCTATGT	GAAACACCGGTAAATTTGAGGCTCCGGCATGCAGGAGGCCGTGGGGTTAG	1
TTAGCTATGT	GAAACACCGGTCGGGGCCACTCAGTGGTGGGGTTAGAGCTAGAAATAGCA	1
TTAGCTATGT	GAAACACCGGTGAGGGTTAGAGCTAGAAATAGCAAATTAACCTAAGTCTA	1
TTAGCTATGT	GAAACACCGGTTACATTGAGGTGTCAGAGCCAGTATTAGCTAGTTAACCT	1
TTAGCTATGT	GAAACACCGGTTACTGAGGGCTAGAGCTAGAAATAGCAAGTTAACCTAAG	1
TTAGCTATGT	GAAACACCGGTTACTGGGGTTAGTGCTAGTAATGACAAGATAACCTACGG	1
TTAGCTATGT	GAAACACCGGTTTACGTTGCATCGGTGTGGGGTTAGAGCTAGTTATAGCA	1
TTAGCTATGT	GAAACACCGGTTTAGAGCTAGAGATAGCAAGTTAACCTAAGGCTAGTCCG	1
TTAGCTATGT	GAAACACCGTTACATTGAGGGTTAGAGCTAGAAATAGCAAGTTAACCTAA	1
TTAGCTATGT	GAAACGAGGGTTAGAGCTAGAAATAGCAAGTTAACCTAAGGCTGGTCCGT	1
TTAGCTATGT	GAAGCACCGGTTACATTGAGATCTCTTTTATGAGATCTCTGGGGTTAGAG	1
TTAGCTATGT	GACGAAACACCGGTTACATGAGGGGTTAGAGCTAGAAATAGCAAGTTAAC	1
TTAGCTATGT	GACGAAACACCGGTTACATTGAGATTAGAGCTAGAAAAGGCTAGTCCGTT	1
TTAGCTATGT	GAGACACCGGTCCCTATGAGACCCTCGTGGCATTAAAGCTAGGAGTTGGA	1
TTATCCATAA	GAAACACCGGTTAAGCCGAAGAGTTAGAGCTAGAAATAGCAAGTTAACCT	1
TTATGTACGT	GAAACACCGGTTACATTGAGGGGTTAGAGTTAGAAATAACAAGTTGACAT	1
TTATTCCCTT	GAAACACCGGTCTCGAGTGAGGTGTTCAGGTGGGGTTAGAGCTAGAAATA	1
TTCAACGCAC	GAAACACCGGTTTGAATTAGAAATAGCAAGTTAACCTAAGGCTAGTCCGT	1
TTCACAAACC	GAAACACCGGTAGCAAGTGCGAGACGTGTTTGTGGGGTTAGAGCTAGAAA	1
TTCACTTATA	GAAACACCGGTAACTATATTCATGCGATATCGCCGTATCAGTGGGGTTAG	1
TTCCCGTACA	GAAACACCGGTAGATATGAGGGTGCCCCACTCAGCAAGCCGTGGGGTTAG	1
TTCGCCCTAT	GAAACACCGGTGCCCTTACTCTCACCTGATTACTTAATCCGTGGGGTTAG	1
TTCGTAAGTC	GAAACACCGGTGTGGAGAGGGGCGCGCGGGGTTGGGGCGAGAAGTGGTAA	1
TTCGTGATGT	GAAACACCGGTTACATTGAGGGTTAGAGCTAGAAATAGCAAGTTAACCTA	1
TTGAATAGCT	GAAACACCGGTTTACGTTGCATCGGTGTGGGGTTAGAGCTAGAAATAGCA	1
TTGACCTTGA	GAAACACCGGTTAACCCGATGAGTTAGAGCGAGAAATAGTAAATTAACCT	1
TTGACGAGAA	GAAACACCGGTTAAGCCGAGGAGTTAGAGCTAGAAATAGCAAGTTAACCT	1
TTGAGAAACA	GAAACACCGGTTAAGCCGAGGAGTTAGAGCTAGAAATAGCAAGTTAACCT	1
TTGAGCAACG	GAAACACCGGTTAAGCCGAGGTGGGGTTAGAGCTAGAAATAGCAAGTTAA	1
TTGAGCATAA	GAAACACCGGTTAAGCCGAGGAGTTAGAGCTAGAAATAGCAAGTTAACCT	475
TTGAGCATAA	GAAACACCGGTTAAGCCGAGTGGGGTTAGAGCTAGAAATAGCAAGTTAAC	239
TTGAGCATAA	GAAACACCGGTTAAGCCGAGGTTAGAGCTAGAAATAGCAAGTTAACCTAA	64
TTGAGCATAA	GAAACACCGGTTAAGCCGAGGGTTAGAGCTAGAAATAGCAAGTTAACCTA	37
TTGAGCATAA	GAAACACCGGTTAAGCCGAGGAGTTTCGTTAGAGCTAGAAATAGCAAGTT	32
TTGAGCATAA	GAAACACCGGTTAGAGCTAGAAATAGCAAGTTAACCTAAGGCTAGTCCGT	26
TTGAGCATAA	GAAACACCGGTTAAGCCGAGCTAGAAATAGCAAGTTAACCTAAGTTAACC	21
TTGAGCATAA	GAAACACCGGTTAAGCCGGTGGGGTTAGAGCTAGAAATAGCAAGTTAACC	20
TTGAGCATAA	GAAACACCGGTTCGGTGCTTTTTTCCTGCAGGTTATGCTCAAGAATTCGG	19
TTGAGCATAA	GAAACACCGGTTAAGCCGAGGTGGGGTTAGAGCTAGAAATAGCAAGTTAA	17
TTGAGCATAA	GAAACACCGGTTAAGCCGAGGATGGGGTTAGAGCTAGAAATAGCAAGTTA	15
TTGAGCATAA	GAAACACCGGTTAATCCTAAGGCTAGTCCGTTATCAACTTGAAAAAGTGG	10
TTGAGCATAA	GAAACACCGGTTAAGCCCGTGGGGTTAGAGCTAGAAATAGCAAGTTAACC	8
TTGAGCATAA	GAAACACCGGTTAAGCCGAGGAGGTTAGAGCTAGAAATAGCAAGTTAACC	8
TTGAGCATAA	GAAACACCGGTTAAGCCGAGGAGTGGGGTTAGAGCTAGAAATAGCAAGTT	8
TTGAGCATAA	GAAACACCGGTTAAGCCGAGGATTAGAGCTAGAAATAGCAAGTTAACCTA	8
TTGAGCATAA	GAAACACCGGTTAAAGCCGAGGTTAGAGCTAGAAATAGCAAGTTAACCTA	7
TTGAGCATAA	GAAACACCGGTTAAGCCGAGGGTGGGGTTAGAGCTAGAAATAGCAAGTTA	7
TTGAGCATAA	GAAACACCGGTTAAGCTAAGGTTAACCTAAGGCTAGTCCGTTATCAACTT	7
TTGAGCATAA	GAAAGAGCTAGAAATAGCAAGTTAACCTAAGGCTAGTCCGTTATCAACTT	5
TTGAGCATAA	GAAACACCGGTTAAGTTAGAGCTAGAAATAGCAAGTTAACCTAAGGCTAG	4
TTGAGCATAA	GAAACACCGGTTAAGAGCTAGAAATAGCAAGTTAACCTAAGGCTAGTCCG	3
TTGAGCATAA	GAAACACCGGTTTTAGTGGGGTTAGAGCTAGAAATAGCAAGTTAACCTAA	3
TTGAGCATAA	GACACCGGTTAAGCCGAGTGGGGTTAGAGCTAGAAATAGCAAGTTAACCT	3
TTGAGCATAA	GAAACACCGGTTAAGCTAAGGTTAACCTAAGGCTAGTCCGTTATCAACCT	2
TTGAGCATAA	GTTAACCTAAGGCTAGTCCGTTATCAACTTGAAAAAGTGGCACCGAGTCG	2
TTGAGCATAA	CAAAACACCGGTTAAGCCGAGGAGTTAGAGCTAGAAATAGCAAGTTAACC	1
TTGAGCATAA	GAAACACCGGCTAAGCCGAGGGGTTAACCGGTGTTGTCGGTGTTTCGAGG	1
TTGAGCATAA	GAAACACCGGTGTGGCTGAGAGTCCGGCAATGGTGTGGCTGTGGGGTTAG	1
TTGAGCATAA	GAAACACCGGTTAAATAGCAAGTTAACCTAAGGCTAGTCCGTTATCAACT	1
TTGAGCATAA	GAAACACCGGTTAAGCCGAGGGGTTAACCGGTGTTGTCGGTGTTTCGAGG	1
TTGAGCATAA	GAAACACCGGTTAAGCCGAGGTAGAGCTAGAAATAGCAAGTTAACCTAAG	1
TTGAGCATAA	GAAACACCGGTTTTAGTGGGGTTAGAACTAGAAATAGCAAGTTAACCTAA	1
TTGAGCATAA	GAAACACTGGTTAAGTTAGAGCTAGAAATAGCAAGTTAACCTAAGGCTAG	1
TTGAGCATAA	GAAGCACCGGTCCGTAGGAGACCCGTGTGGCATGTACCTGTGGGGTTAGA	1
TTGAGCATAA	GACACCGGTTAAGCCGAGTGGGGTTAGAGCTAGAAGTAGCAAGTTAACCT	1
TTGAGCATAA	GACGAAACACCGGTTAAGCCGAGTGGGGTTAGAGCTAGAAATAGCAAGTT	1
TTGAGCATAA	GGAACACCGGTTAAATAGCAAGTTAACCTAAGGCTAGTCCGTTATCAACT	1
TTGAGCATAA	TCGAGAGGACGAAACACCGGTTAAGCCGAGGAGTTAGAGCTAGAAATAGC	1
TTGAGCGCCA	GAAACACCGGTTTAAACTAGGAGGTAGAGCTAGAAATAGTAAGTTAAGCT	1
TTGAGTAGTC	GAAACACCGGTTAAGCCGAGGTTAGAGCTAGAAATAGCAAGTTAACCTAA	1
TTGAGTGTCA	GAAACACCGGTTAAGCTAAGGTTAACCTAAGGCTAGTCCGTTATCAACTT	1
TTGATCATTC	GAAACACCGGTTAAGCCGAGGAGTTAGAGCTAGAAATAGCAAGTTAACCT	1
TTGATCTTAT	GAAACACCGGTTAAGCCGAGTGGGGTTAGAGCTAGAAATAGCAAGTTAAC	1
TTGATGCCTA	GAAACACCGGTTAAGCCGAGGGGTTAGAGCTAGAAATAGCAAGTTAACCT	1
TTGCCTAGAT	GAAACACCGGTTTACGTTGCATCGGTGTGGGGTTAGAGCTAGAAATAGCA	1
TTGCCTGCAG	GAAACACCGGTCTCGAGTGAGGTGTTCAGGTGGGGTTAGAGCTAGAAATA	1
TTGCGGCTAA	GAAACACCGGTTAAGCCGAGGAGTTAGAGCTAGAAATAGCAAGTTAACCT	1
TTGCTAACAA	GAAACACCGGTTAAGCCGAGTGGGGTTAGAGCTAGAAATAGCAAGTTAAC	1
TTGCTGCCTA	GAAACACCGGTTCGTAGGAGACCCGGGTGTCGTGTACGTGTGGGGTTAGA	1
TTGCTGCGCT	GAAACACCGGTTTACAGCAAGTTAACCTAAGGCTAGTCCGTTATCAACTT	1
TTGGCAATGC	GAAACACCGGTTACATTGAGGGTTAGAGCTAGAAATAGCAAGTTAACCTA	1
TTGGCGACGT	GAAACACCGGTTACATTGAGGGTTAGAGCTAGAAGTAGCAAGTTAACCTA	1
TTGGCGAGGG	GAAACACCGGTTACATTGAGATTAGAGCTAGAAAAGGCTAGTCCGTTATC	1
TTGGGAGTAA	GAAACACCGGTTAAGCCGAGGAGTTTCGTTAGAGCTAGAAATAGCAAGTT	1
TTGTGTTGTC	GAAACACCGGTGACATTGGGTACTACAGGGTGGGGTTAGAGCTAGAAATA	1
TTTAGATATG	GAAACACCGGTTACATTGAGGGTTAGAGCTAGAAATAGCAAGTTAACCTA	1
TTTAGGTATG	GAAACACCGGTTACATTGAGATTAGAGCTAGAAAAGGCTAGTCCGTTATC	1
TTTCTCGATG	GAAACACCGGTTATATTTGTAAGTGTTTGTGGGGTTAGAGCTAGAAATAG	1
TTTGAGAAGA	GAAACACCGGTTAAGCCGAGGAGTTAGAGCTAGAAATAGCAAGTTAACCT	1
TTTGGAGCCT	GAAACACCGGTTCCCGTCCAGTGGGGTTAGAGCTAGAAATAGCAAGTTAA	1
TTTGGTTTGT	GAAACACCGGTTACATTGAGGGTTAGAGCTAGAAATAGCAAGTTAACCTA	1
