CCACCATCCG	GAAACACCGGTGGCAATAGGATGAGTGGAGTGGGGTTAGAGCTAGAAATA	7	bc
TTACCACGAA	GAAACACCGGTGTGGAACGGGGCCCCCAGGGTGGCCCCGAGCGGGGTTAG	7	bc
TTGAGTTGCA	GAAACACCGGTGTACGTATGGACTGAACTAGGGTGTGCAACTCAAGAATT	5	bc
GAGACACTCG	GAAACACCGGTGCATTCGAAAGTCCGGTCGTAGTGTGGACGTGGGGTTAG	2	bc
AAGTCGGCCT	GAAACACCGGTCCGTAGGAGACCCGTGTGGCATGTACCTGTGGGGTTAGA	2	bc
AAATCGTCGT	GAAACACCGGTGTACGTATGGACTGAACCAGGGTGTGCAAGTGGGGTTAG	2	bc
ACGAATCATT	GAAACACCGGTCTCGAGTGAGGTGTTCAGGGTGGGGTTAGAGCTAGAAAT	2	bc
ACGCATCCTT	GAAACACCGGTCTCGAGTGAGGTGTTCAGGGTGGGGTTAGAGCTAGAAAT	2	bc
TAGACTATCG	GAAACACCGGTGCATTCGAAAGTCCGGTCGTAGTGTGGACGTGGGGTTAG	2	bc
ACGCGTAACG	GAAACACCGGTTTACGTTGCATCGGGGGTAGAGCTAGAAATAGCAAGATA	1	bc
GAGATCATCG	GAAACACCGGTGCATTCGAAAGTCCGGTCGTAGTGTGGACGTGGGGTTAG	1	bc
AGCGGAGCCT	GAAACACCGGTTCCCGTCCAGTGGGGTTAGAGCTAGAAATAGCAAGTTAA	1	bc
ATGCTGAGTC	GAAACACCGGTTTACGTTGCATCGGGGTTAGAGCTAGAAATAGCAAGTTA	1	bc
GGGCCCGTAC	GAAACACCGGTAAATTTGAGGCTCCGGCATGCAGGAGGCCGTGGGGATAG	1	bc
TAAGCTTAGC	GAAACACCGGCTGGAAATAGCAAGTTAACCTAAGGCTAGTCCGTTATCAA	1	bc
TCGACTCCTT	GAAACACCGGTCTCGAGTGAGGTGTTCAGGGTGGGGTTAGAGCTAGAAAT	1	bc
TAACCTTTAA	GAAACACCGGTAACTATATTCATGCGATATCGCCGTATCAGTGGGGTTAG	1	bc
GGCAGCTCCA	GAAACACCGGTAAATTTGAGGCTCCGGCATGCAGGAGGCCGTGGGGTTAG	1	bc
AGTAGGCCTG	GAAACACCGGTCCGTAGGAGACCCGTGTGGCATGTACCTGTGGGGTTAGA	1	bc
TACCTTCTCC	GAAACACCGGTAACTATATTCATGCGATATCGCCGTATCAGTGGGGTTAG	1	bc
AGGAACCCTC	GAAACACCGGTGTGGCTGAGAGTCCGGCAATGGTGTGGCTGTGGGGTTAG	1	bc
ACGCGCAGAT	GAAAAACCGGTTTACGTTGCATCGGTGTGGGGTTAGAGCTAGAAATAGCA	1	bc
CCAACATCCG	GAAACACCGGTGGCAATAGGATGAGTGGAGTGGGGTTAGAGCTAGAAATA	1	bc
AAGACACTCG	GAAACACCGGTGCATTCGAAAGTCCGGTCGTAGTGTGGACGTGGGGTTAG	1	bc
AGAACAGAGT	GAAACACCGGTAGCAAGTGGGGTTAGAGCTAGAAATAGCAAGTTAACCTA	1	bc
AGCCGTTCGC	GAAACACCGGTGCATTCGAAAGTCCGGTCGTAGTGTGGACGTGGGGTTAG	1	bc
CGGTGCCTTT	GAAACACCGGTCTCGAGTGAGGGGTTCAGGGTGGGGTTAGAGCTAGAAAT	1	bc
AGACATCGGC	GAAACACCGGTGCATTGGAAATTCCGGTCGTAGTCGGCACGTGGGGTTAG	1	bc
AAACGCGCTA	GAAACACCGGTGCCCTTACTCTCACCTGATTACTTAATCCGTGGGGTTAG	1	bc
GAAATTCGGT	GAAACACCGGTCGATTCATATCGAAACCTTCCCGTGACAGTGGGGTTAGA	1	bc
ATGGCACCGC	GAAACACCGGTCGCTGCTTGTTACGGGCTGGGGTGGAGATAGCTATAGAT	1	bc
AGCCACAGAC	GAAACACCGGTAGCAAGTGCGAGTTAAGGCTAGTCCGTTATCAACTTGAA	1	bc
AAGATCCTCG	GAAACACCGGTGCATTCGAAAGTCCGGTCGGAGTGTGGACGTGGGGTTAG	1	bc
GCGAGCGAGA	GAAACACCGGTTATATCTGTAAGTGTGTGGGGTTAGAATTAGAAATAGCA	1	bc
AACATTCGGG	GAAACACCGGTCGATTCATATCGAAACCTTCCCGTGACAGTGGGGTTAGA	1	bc
AGAACATCGA	GAAACACCGGTGCATTCGAAAGTCCGGTCGTAGTGCGGGCGAGGGGATAG	1	bc
AGACACCGAC	GAAACACCGGTAGCAAGTGCGAGACGTTTTTGTGGGGTTAGAGCTAGAAA	1	bc
AGACAGCATC	GAAACACCGGTCCGTAGGAGACCCGTGTGGCATGTACCTGTGGGGTTAGA	1	bc
TGGAACCCTC	GAAACACCGGTGTGGCTGAGAGTCCGGCAATGGTGTGGCTGTGGGGTTAG	1	bc
CTACTGAGAC	GAAACACCGGTACCTTTGTTGATGCTGGGTGGAAGGTGGGGTTAGAGCTA	1	bc
TGAGCCATGC	GAAACACCGGTTACATTGAGGGTTAGAGCTAGAAATAGCAAGTTAACCTA	1	bc
TGAATGCTGG	GAAACACCGGTGCAGAGGGGGGAGTTGAGCGTGGGGTTAGAGCTAGAAAT	1	bc
GAGCGCTGGG	GAAACACCGGTGACACAAGTGTGGATGGATTGGCTGACGTGTGGGGTTAG	1	bc
CATCGCAGGC	GAAACACCGGTGTACGTATGGACTGAACCAGGGTGTGCAAGTGGGGTTAG	1	bc
TTGAGATGCA	GAAACACCGGTGTACGTATGGACTGAACTAGGGTGTGCAACTCAAGAATT	1	bc
AGCACCGTAC	GAAACACCGGTGTGGCTGAGAGTCCGGCAATGGTGTGGCTGTGGGGTTAG	1	bc
AACTACGTAC	GAAACACCGGTTCCCTTTCTTTCATCTGGTTACTTAATCTGTCGGGATAG	1	bc
AAAAACGGTT	GAAACACCGGTCGATTCATATCGAAACCTTCCCGTGACAGTGGGGTTAGA	1	bc
ACACTCGCGA	GAAACACCGGTGCATTCGTATCTACGCCTTCCGGGGACAGTGGGGGTAAG	1	bc
TGCAAACCCG	GAAACACCGGTCGGCGGCAATCGTGGGTGGGGTTAGAGCTAGAAATAGCA	1	bc
GGTCCACTCC	GAAACACCGGTGTGGCTGAGAGTCCGGCAATGGTGTGGCTGTGGGGTTAG	1	bc
ATACGCCGTA	GAAACACCGGTGCCCTTACTCTCACCTGATTACTTAATCCGTGGGGTTAG	1	bc
AATACTCGGC	GAAACACCGGTACCTTTGTTGATGCTGGGTGGAAGGAATGTGGGGCTAGA	1	bc
TCTATTCGGC	GAAACACCGGTACCTTTGTTGATGCTGGGTGGCAGGAACTTGATAAAGTG	1	bc
GTCTTTAACG	GAAACACCGGTCGGGGCCACTCAGTGGTGGGGTTAGAGCTAGAAATAGCA	1	bc
CCCAACTTCC	GAAACACCGGTTTGAACTAGAAATAGCAAGTTAACCTACGGCTAGTCCGT	1	bc
ACCTTTACCT	GAAACACCGGTCGGGGCCCCTCAGTGAGCTAGAAATAGCAAGTTAACCTA	1	bc
TGACGCCTGC	GAAACACCGGTGCATTCGAAAGTCCGGTCGTAGTGTGGACGTGGGGTTAG	1	bc
GAGGCGTCCC	GAAACACCGGTGTGGCTGAGAGTCCGGCAATGGTGTGGCTGGGGGGATAG	1	bc
GGCATGCCCC	GAAACACCGGTCCGTAGGAGACCCGTGTGGCATGTACCTGTGGGGTTAGA	1	bc
TATCCTATGC	GAAACACCGGTGAACGTATGGACTGAACCAGGGAGTGCAAGAGGTGTTAG	1	bc
ACGAGTTGCC	GAAACACCGGTGACATTGGGTACAGGGGTGGGGTTAGAGCTAGAAATAGC	1	bc
ACAAGTCGGC	GAAACACCGGTACCCGGTGGGGTTAGAGCTAGAAATAGCAAGTTAACCTA	1	bc
AGACAAAGAC	GAAACACCGGTAGCAAGTGCGAGACGTGTTAAATAGCAAGTTAACCTAAG	1	bc
AGGATTGGCT	GAAACACCGGTTTACGTTGCATCGGTGTGGGGTTAGAGCTAGAAATAGCA	1	bc
TACAGTGTCC	GAAACACCGGTTAGAACTACCTAGATCAAACGGAAGAGGATAGAGCTAGA	1	bc
AATACGCGGC	GAAACACCGGTACCTTTGTTGATGCTGGGTGGAAGGAATTTTGTGGGGTT	1	bc
GCATACACGC	GAAACACCGGTAGGTGGGGTTAGAGCTAGAAATAGCAAGGTAACCGAAGG	1	bc
TCTCGGCGTC	GAAACACCGGTGTACGTATGGACTGAACCAGGGTGTGCAAGTGGGGTTAG	1	bc
TCTTTTACGT	GAAACACCGGTCGGGGCCACTCAGTGGTGGGGTTAGAGCTAGAAATAGCA	1	bc
AGATCCGCGT	GAAACACCGGTGCATTCGAAAGACCGGTCGGAGTGTGGCCGTAGGTTTCA	1	bc
CCACCATCCG	GAAACACCGGTGGCAATAGGATGAGTGGAGTGGAGTTAGAGCTAGAAATA	1	bc
ATGGTGACTT	GAAACACCGGTTTACGTTGCATCGGTGTGGGGTTAGAGCTAGAAATAGCA	1	bc
GATTCAGATA	GAAACACCGGTAGCAAGTGCGAGACGTGTTAAATAGCAAGTTAACCTAAG	1	bc
AGACGACCCG	GAAACACCGGTCGGCGGCAATCGTTAATCGGTTAATCGTGGGGTTAGAGC	1	bc
CACCAAGATC	GAAACACCGGTTTGAACTACCGGGGTTAGAGCTAGAAGTAGCAAGTTAAC	1	bc
AGAATTCTAT	GAAACACCGGTCTCGAGTGGGGTGTTTAGGGTGGGGGTAGAGCTAGAAAT	1	bc
AAACGCACTA	GAAACACCGGTGCCCTTACTCTCACCTGATTACTTAATCCGTGGGGTTAG	1	bc
GTGGATCTTA	GAAACACCGGTTCCCGTCCAGTGGGGTTAGAGCTAGAAATAGCAAGTTAA	1	bc
AGCAACTCGC	GAAACACCGGTTCATTCGGATGTCCGGTCGTAGTGTGGACGTGGGGTTAG	1	bc
ACACAATGCC	GAAACACCGGTTTAAACTACCTAGCAAGTTAACCTAAGGCTAGTCCGTTA	1	bc
GTGGAGAGTA	GAAACACCGGTTCCCGTCCAGTGGGGTTAGAGCTAGAAATAGCAAGTTAA	1	bc
GGCCACTGCC	GAAACACCGGTAAATGTGATGCTCCGGCATGCAGGAGGCCGTGGGGTTAG	1	bc
AAGACCCTTG	GAAACACCGGTGCATTCGAAAGTCCGGTCGTAGTGTGGACGTGGGGTTAG	1	bc
ACGGCACTGC	GAAACACCGGTGCCCTTACTCTCACCTGATTACTTAATCCGTGGGGTTAG	1	bc
ACTACTCTGC	GAAACACCGGTACCTTTGTTGATGCTGGGTGGAAGGAATTTGTGGGGTTA	1	bc
AAGAATCCTT	GAAACACCGGTCTCGAGTGAGGTGTTCAGGGTGGGGTTAGAGCTAGAAAT	1	bc
AGTAATAGGA	GAAACACCGGTACCTTTGTTGATGCTGGGTGGAAGGATTTTGTGGGGTTA	1	bc
ACTTTACGTC	GAAACACCGGTCGGGGCCACTCAGTGGATGGGTTAGAGCTAGAAATAGCA	1	bc
GAATGCTTAG	GAAACACCGGTTTACGTTGCATCGGTGTGGGGTTAGAGCTAGAAATAGCA	1	bc
TGAAGTATAG	GAAACACCGGTAACTAGAGCTAGAAATAGCAAGTTAACCTAAGGCTAGTC	1	bc
ACATCGTAGT	GAAACACCGGTGTACGTATGGACTGAACCAGGGTGTGCAAGTGGGGTTAG	1	bc
AGGCATCCTC	GAAACACCGGTGTGGCTGAGAGTCCGGCAATGGTGTGGCTGTGGGGCTAG	1	bc
AACAAAGCAC	GCTAGAAATAGCAAGTTAACCTAAGGCTAGTCCGTTATCAACTTGAAAAA	1	bc
ACAAAAAGCC	GAAACACCGGTTTGAACTAGAAATAGCAAGTTAACCTAAGGCTAGTCCGT	1	bc
GATGGTAGTC	GAAACACCGGTTCCCGTACAGAGTGGTTAGAGGTGGGAATATCAAGTTAG	1	bc
ACTCCTCGGC	GAAACACCGGTACCTTTGTTGATGCTGGGTGGAAGGAATAGCAAGTTAAC	1	bc
GGCAGCTAAA	GAAACACCGGTAAATTTGAGGCGTGGGGTTAGAGCTAGAAATAGCAAGTT	1	bc
ACGTGGTGTC	GAAACACCGGTGACATTGGGGGTGGGGTTAGAGCTAGAAATAGCAAGTTA	1	bc
GAGACTGGCA	GAAACACCGGTAGCAAGGGGGGTTAGAGCTAGAAATAGCAAGTTAACCTA	1	bc
CCGTTTACGT	GAAACACCGGTTTACGTCACATCGGTGTGGGGTTAGAGCTAGAAATAGCA	1	bc
CTGCGTCCTC	GAAACACCGGTGTACGTATGGACCGAACCAGGGTGTGCAACCAAGTGGGG	1	bc
AGGCACGCGC	GAAACACCGGTGCATTCGAAAGTCCGGTCGTAGTGTGGACGTGGGGTTAG	1	bc
CGACCAACGC	GAAACACCGGTGCATTCGAAAGTCCGGTCGTAGTGTGGACGTGGGGATAG	1	bc
GCTAACACCA	GAAACACCGGTTAAGCCGAAGTGGGGGTAGAGCTAGAAATAGTAATTTAA	1	bc
CAGCGTAGTA	GAAACACCGGTGTACGCATGGACTCAACCAGGGTATGCATGTGAGGATAA	1	bc
GAACGGCCTA	GAAACACCGGTGCCCTTACTCTCACCTGATTACTTAATCCGTGGGGTTAG	1	bc
GGACCCAGAC	GAAACACCGGTAGCAGGTTAGAGCTAGAAATAGCAAGTTAACCTAAGGCT	1	bc
CTATATGGGC	GAAACACCGGTACCTTCCATATTAGTGGGGGGATCGATGTGTGGGGTTGG	1	bc
CAAGGTAGGT	GAAACACCGGTTACATTGAGGGTTAGAGCTAGAAATAGCAAGTTAACCTA	1	bc
GCCTTCGGCT	GAAACGCCGGTAGCAAGTGCGAGACGTGTTTGTGGGGCTAGAGCTAGAAA	1	bc
CCGTTAAAGC	GAAACACCGGTCGGGGCCACTCAGTGGTGGGGTTAGAGCTAGAAATAGCA	1	bc
CGTTTAGTGC	GAAACACCGGTCGGGGCCACTCAGTGGTGGGGTTAGAGCTAGAAATAGCA	1	bc
TAAATTGTTC	GAAACACCGGTAACTATATTCATGCGATATCGCCGTATCAGTGGGGTTAG	1	bc
TCCACAGAGC	GAAACACCGGTAGCAAGTGCGAGACGTTTGAGGGGTTAAAGCTAGAAATA	1	bc
GCGGAGCTTA	GAAACACCGGTTCCCGTCCAGTGGGGTTAGAGCTAGAAATAGCAAGTTAA	1	bc
CTAATCGACA	GAAACACCGGTACCTTTGTTGATGCTGGGTGGAAGGAATTGAGAGCTAGA	1	bc
ATGGAGCTAC	GAAACACCGGTTCCCTTAACCTAAGGCTAGTCCGTTGTCAACTTGGATAA	1	bc
CAAACAGTTT	GAAACACCGGTCGCGAGTGAGGTGGTCAGATGGGGTTAGATCGCGAAATA	1	bc
ACTGAGTATC	GAAACACCGGTTAAGCCGAGGAGTTAGAGCTCAAAAGAGCATGTTAATAT	1	bc
AGGCCGCTAC	GAAACACCGGTAAATTTGAGGCTCCGGCATGCAGGAGGCCGTGGGGTTAG	1	bc
GGAGTCCCGA	GACACACCGGTCGGCGTGGGGTTAGAGCTAGAAATAGCAAGTTAACCTAA	1	bc
GTCCCCTCCC	GAAACACCGGTAAATTTGAGGCTCCGGCATGCAGGAGGCCGTGGGGTTAG	1	bc
GGTCACGATA	GAAACACCGGTAAATTTGAGGCTCCGGCATGCAGGAGGCCGTGGGGTTAG	1	bc
AGATTCTGGC	GAAACACCGGTGCATTCGAAAGTCCGGTCGTAGTGTGGACGTGGGGTTAG	1	bc
GACGTCCAAC	GAAACACCGGTGCACTTACTCTCAACTGATTACTTAATCCGTGGGGTTAG	1	bc
AGTCTCTCGA	GAAACACCGGTTATATTTGTAAGTGTGTGGGGTTAGAGCTAGAAATAGCA	1	bc
GTGACAGAGA	GAAACACCGGTAGAGCTAGAAATAGCAAGTTAACATAGGGCTAATCCGTT	1	bc
GGCGCTAATA	GAAACACCGGTAAATTTGAGGCTCCGGCATGCAGGAGGCCGTGGGGTTAG	1	bc
GCGTATCGTT	GAAACACCGGTCTCGAGTGAGGTGTTCAGGGTGGGGTTAGAGCTAGAAAT	1	bc
AGGAACCCTC	GAAACACCGGTGTGGCTGAGAGTCCGGCAATGGTGTGACTGTGGGGTTAG	1	bc
TCACAACGCT	GAAACACCGGTTTGAACTACCTAGTTCAAACCGGTGGGGTTAGAGCTAGA	1	bc
AGGTGTTGTC	GAAACACCGGTGACATTGGGTACAGGGTGGGGTTAGAGCTAGAAATAGCA	1	bc
GGCAGACGCG	GAAACACCGGTCGGCGGCAATCGTGGGTGGGGTTAGAGCTAGAAATAGCA	1	bc
AGGTACCCTC	GAAACACCGGTGTGGCTGAGAGTCCGGCAATGGTGTGGCTGTGGGGTTAG	1	bc
GGGACCGTGC	GAAACACCGGTGTGGCTGAGAGTCCGGCAATGGTGTGGCTGTGGGGTTAG	1	bc
ACGAAAACCC	GAAACACCGGTTTACGTTGTTAGAGCTAGAAATAGCAAGTTAACCTAAGG	1	bc
ACTAATCGGC	GAAACACCGGTACCTTTGTTGATGCTGGGTGGAAGGTGGGGTTAGAGCTA	1	bc
GACATACTAC	GAAACACCGGTGTGGCTGAGAGTCCGGCAATGGTGTGGCTGTGGGGTTAG	1	bc
AGGAGCTGGC	GAAACACCGGTGCATTCGAAAGTCCGGTCGTAGTGTGGACGTGGGGTTAG	1	bc
TAGAGAATTA	GAAACACCGGTTAAGACGAGTGGGGCCAGAGCTGGAATAGGGAAGGTAAT	1	bc
GTGAGCTATG	GAAACACCGGTTACATTGAGGGGTTAGAGCTAGAAATAGCAAGTTAACCT	1	bc
AGATCCGCGT	GAAACACCGGTACATTCGAAACTCCTGTCGTAGTGTGGAGGGGGAGATAG	1	bc
AGAGTTGTCG	GAAACACCGGTGAAATTGGGTACATTTGGTACAGGGTGGGGTTAGAGCTA	1	bc
GGCTCTCTGA	GAAACACCGGTGTGGCTGAGAGTCCGGCAATGGTGTGGCTGTGGGGTTAG	1	bc
CTGTTAACCC	GAAACACCGGTTGGGGCTACTCAGGGGTGGGGTTAGATCTAGAAATAGCA	1	bc
AACGCTTAGC	GAAACACCGGTCGGCGGCAAAGTTAACCTAAGGCTAGTCCGTTATCAACT	1	bc
ACTCCTCGGC	GAAACACCGGCACCTTTGTTGATGCTGGGTGGAAGGAATTTGGTGGGGTT	1	bc
CTCTACTCGG	GAAACACCGGTACCTTTGTTGATGCTGGGTGGAAGGAGAGCTAGAAATAG	1	bc
GGGGCGCTTC	GAAACACCGGTTCCCGTCCAGGGGGGTTAGAGCTAGGAATAGCAAGTTAA	1	bc
GCTACACGCC	GAAACACCGGTGCGGCTGTGAGTCCGTCATTTGGGGGTCGAGCTAGTTAT	1	bc
CGACACACGC	GAAACACCGGTGCATTCGAAAATCCGGTCGTTGTGTGGTCATGGGGTTAG	1	bc
TCACGTCTAC	GAAACACCGGTAACTATATTCATGCGATATCGCCGTATCAGTGGGGTTAG	1	bc
ACATTTGGCC	GAAACACCGGTCGATTCATGTCGAAACCTTCCCGTGACAGTGGGGTTAGA	1	bc
AGGAACCCTC	GAAACACCGGTGTGGCTGAGAGGCCGGCAATGGTGTGGCTGTGGGGTTAG	1	bc
AAATGACATA	GAAACACCGGTGCCCTTACTCTCACCTGATTACTTAATCCGTGGGGTTAG	1	bc
GCGAATCATT	GAAACACCGGTCTCGAGTGAGGTGTTCAGGGTGGGGTTAGAACTAGAAAT	1	bc
ACTGCACTAC	GAAACACCGGTGCCCTTACTCTCACCTGATTACTTAATCCGTGGGGTTAG	1	bc
CATTTATCGA	GAAACACCGGTCGGGGCCACTCAGTGGTGGGGTTAGAGCTAGAAATAGCA	1	bc
AGAAGAACCG	GAAACACCGGTCGGCGGCAATCGTGGGTGGGGTTAGAGCTAGAAATAGCA	1	bc
AGACACGGAC	GAAACACCGGTAGCAAGTGCGAGACGTGTTTGTGGGGTTAGAGCTAGAAA	1	bc
ACATCGCCGT	GAAACACCGGTGTACGTATGGACGCAAGTTAACCTAAGGCTAGTCCGTTA	1	bc
ACCATCGGAT	GAAACACCGGTCGATTCATATCGAAACCTTCCCGTGACAGTGGGGTTAGA	1	bc
GGCCACATCC	GAAACACCGGTGTGGTTGAGAGTCCGGCAATGGTGTGGCTGTGGGGTTAG	1	bc
ACACTCGGGG	GAAACACCGGTCGAATCATATCGAAACAGAGCTAGAAATAGCAAGTTAAC	1	bc
CCTTGAGCGA	GAAACACCGGTCGGGGCCACTTGGGGTTAGAGCTAGAAATAGCAAGTTAA	1	bc
TCGTGTTGGC	GAAACACCGGTGGGTGGGGTTAGAGCCGGAAATAGCAAGTTAACCTAAGG	1	bc
CGAGAGCCTC	GAAACACCGGTGCATTCGAAAGTCCGGTCGTAGTGTGGACGTGGGGTTAG	1	bc
GGCTTCATTC	GAAACACCGGTGTGGGTGTAGAGTAGGCATTGGAGGGTATCCGAAGGCAA	1	bc
CGACTAGGCT	GAAACACCGGTACCTTTGTTGATGCTGGGTGGGGTTAGAGCTAGAAATAG	1	bc
CTAATCCGTC	GAAACACCGGTCTCGAGTGAGGTGTTCAGGGGTGGGGTTAGAGCTTGAAA	1	bc
GTTACATGTG	GAAACACCGGTAACTATATTCATGCGATATCGCCGCATCAGTGGGGTTAG	1	bc
GAAACCGAGA	GAAACACCGGTAGCAAGGTAACCTAGGTCGAGTCCGTTATCAGCTTGTAG	1	bc
ACAGCTGGCT	GAAACACCGGTTGATTCATATCGTACCTTTCCCGTGAGGGTTTGGGGGAG	1	bc
ATGACACAGA	GAAACACCGGTAGCAAGTGCGAGAAAAAGTGGCACCGAGTCGGTGCTTTT	1	bc
TTCTTTTACG	GAAACACCGGTCGGGGGGGTTAGAGCTAGAAATAGCAAGTTAACCTAAGG	1	bc
CAGCCAGCCA	GAAACACCGGTAGCAAGTGCGTGACGTGTTTTTGTGGGGTTGGAGCTAGA	1	bc
TGGCACCCTG	GAAACACCGGTGTGGCTGAGAGTCCGGCAATGGTGTGGCTGTGGGGTTAG	1	bc
CGTATCGAGC	GAAACACCGGTTATATTTGTAAGTGTGTGGGGGTAGAGCTAGAAATAGCA	1	bc
AACATGCGGT	GAAACACCGGTCGATTCATATCGAAACCTTCCCGTGACAGTGGGGTTAGA	1	bc
CGCATGCCTC	GAAACACCGGTCCGTAGGAGACCCGTGTGGCATGTACCTGTGGGGTTAGA	1	bc
TTGGGTGTCT	GAAACACCGGTTACATAGGTGGGGTTAGAGCTAGAAATAGCAAGTTAACC	1	bc
AGAAACCTAC	GAAACACCGGCGTGGCTGAGAGTCCGGCAATGGTGTGGCTGGGGGGTTAG	1	bc
CTCCACTGCA	GAAACACCGGTGTGGCTGAGAGTCCAGCAATGGTGTGGCTGTGGGGTTAG	1	bc
GGGCAGCCTA	GAAACACCGGTTCCCGTCCAGTGGGGTTAGAGCTAGAAATAGCAAGATAA	1	bc
CAATGCCGTC	GAAACCCCGGTTGGCGTAAGGAGTGCACGATGGCGTGCAAGGTGGGGTAA	1	bc
AACGCCATCA	GACACACCGGTGCCCTTACTCTCACCTGATTACTTAATCCGTGGGGTTAG	1	bc
TTCTTTCTGC	GAAACACCGGTCGGGGCCACTCCGTGGTGGGGTTAGAGCTAGAAATAGCA	1	bc
TTACGGATAC	GAAACACCGGTTCAAAATGGGAAGAGGACCTTAGCGTTAGAGCTAGAAAT	1	bc
CCCATCGAGC	GAAACACCGGTTTTATTTGTTAGTGCGTGGGGTTAGAGCTAGAAATAGCA	1	bc
AATTTACAGC	GAAACACCGGTCGGGGCCACTCAGTGTGGTGGGGTTAGAGCTAGAAATAG	1	bc
AAGACCCCCA	GAAACACCGGTGCATTCGAAAGTCCGGTCGTAGTGTGGACGTGGGGTTAG	1	bc
CCAATCGCTC	GAAACACCGGTTTGAACTACCTAGCAAGTTAACCTAAGGCTAGTCCGTTA	1	bc
AGGCCGTGCC	GAAACACCGGTGCATTCGAACGTTCGGTCGTGGTAGGGCCAGAGGGATAG	1	bc
GTATATTCGG	GAAACACCGGTGTACTTATGGACTGAACCAGGGTGTGCGAGAGGGGTTAG	1	bc
GTCATAGTCG	GAAACACCGGTGTACGTATGGACTGAACCAGGGTGTGCAAGTGGGGTTAG	1	bc
GCAAACGAGT	GAAACACCGGTTATATTTGAAAGTGTGTGGGGTTAGAGCTAGAAATAGCA	1	bc
TCTACCGCGC	GAAACACCGGTTATATTTGTGGGTTAGAGCTAGAAATAGCAAGTTAACCT	1	bc
TGTGGGGCAT	GAAACACCGGTTCCCGTCCAGTGGGGTTAGAGCTAGAAATAGCAAGTTAA	1	bc
CCGTTCCTTT	GAAACACCGGTCTCGAGTGAGGTGTTCAGGTGGGGTTAGAGCTAGAAATA	1	bc
GACCTAGACC	GAAACACCGGTAGCAAGTGCGAGTGGGGTTAGAGCTAGAAATCGCAAGTT	1	bc
GAGAAGAGGC	GAAACACCGGTTCACGTCCTGTGGGGTTAGAGCTAGAAATAGCAAGTTAA	1	bc
ATCACTTATA	GAAACACCGGTAACTATATTCATGCGATATCGCCGTATCAGTGGGGTTAG	1	bc
ATGCATGGCC	GAAACACCGGTTTACGTTATAGCAAGTTAACCTAACGCTAGTCAGTTCTC	1	bc
CATAGAAACA	GAAACACCGGTAGCAAGTGGGGTTAGAGCTGGAAATAGCAAGTTAACCTA	1	bc
CACCTCGCTC	GAAACACGGGTTAGAGCTAGAAATAGCATGTTAACCTAAGACTAGGCCGT	1	bc
GATTAGCTAT	GAAACACCGGTTACATTGAGGGGTTAGAGCTAGAAATAGCAAGTTAACCT	1	bc
GGACACGCGC	GAAACACCGGTACTTACGGAAGTCCGGTCGTAGTGTGGACGTCGGGTTAG	1	bc
TAGAAACCTT	GAAACACCGGTGTGGCTGAGAGTCCGGCAATGGTGTGGCTGTGGGGTTAG	1	bc
ACAGAACGCC	GAAACACCGGTTTGAACTAGAAATAGCAAGTTAACCTAAGGCTAGTCCGT	1	bc
GAACCCAACC	GAAACACCGGTGCATTCAAAATTCCGGTCGTAGTGTGGACGTGGGGTTAG	1	bc
ACACAACGCA	GAAACACCGGTTTGAACTAGGAATAGCAAGTTAACCTAAGGCTAGTCCGT	1	bc
AGGCCCTTAC	GAAACACCGGTAAATTTGAGGCTCCGGCATGCAGGAGGCCGTGGGGTTAG	1	bc
AACACCGCCA	GAAACACCGGTTTGAACTAGAAATAGCAAGTTAACCTAAGGCTAGTCCGT	1	bc
AGAGTCGGAT	GAAACACCGGTCGATTCATATCGAAACCTTCCCGTGACAGTGGGGTTAGA	1	bc
AAGTTCAACT	GAAACACCGGTTTACGTTGCATCGTTGTGGGGTTAGAGCTAGAAATTGCA	1	bc
CACACCGTAC	GAAACACCGGTAGCAAGAGCGAGACGTTTGTACGGTTAGAGCTAGAATTA	1	bc
GATGCCTAGC	GAAACACCGGTTTACGTTGCATCGTAATCGTGGGGTTAGAGCTAGAAATA	1	bc
AGAGGCAGAC	GAAACACCGGTAGCAAGTGGGGTTAGAGCTAGAAATAGCAAGTTAACCTA	1	bc
AGGAACCGGC	GAAACACCGGTGTGGCTGGGAGTCCGGCAATGGTGTGGCTGGGGGGTTAG	1	bc
ACGGACCTAA	GAAACACCGGTGCCCTTACTCTCACCTGATTACTTAATCCGTGGAGTTAG	1	bc
GGAGACAACA	GAAACACCGGTAAATTTGAGGCTCAGGCATGCAGGAGGCGTGGGGTTAGA	1	bc
AGCGTTGTAT	GAAACACCGGTGACATTGGGTACAAGGGAGGGGTTATAGCTAGAAATAGC	1	bc
GACCCGGAAC	GAAACACCGGTAGCTGGGGGGGTAACAGCTGGAGATATCAAGTTAACATA	1	bc
CGCCCGCCGC	GAAACACCGGTGCATTCGAAAGTCCGGTCGTAGTGTGGCTGTGGGGTTAG	1	bc
TACCACGGCC	GAAACACCGGTTTGAACTAGAAATAGCAAGTTAACCTAAGGCTAGTCCGT	1	bc
AGGATTCGCT	GAAACACCGGTTTACGTTGCATGTGGGGTTAGAGCTAGAAATAGCAAGCT	1	bc
GCGCACTTTC	GAAACACCGGTGTGGCTGAGAGTCCGGCAATGGTGGAGCTGGGGATTGCA	1	bc
TTATTCGGTC	GAAACACCGGTCGATTCATATCGAAACCTTCCCGTGACAGTGGGGTTAGA	1	bc
GTCGAGATGT	GAAACACCGGTTACCTTGAGGGGTGAGAGCTAGTAGTAGCAAGTTAATCT	1	bc
GCTATCGGGT	GAAACACCGGTTATGGTAGAAAGAGGGGTTAGAGCTAGAAATAGCAAGTT	1	bc
CGACGCGTCC	GAAACACCGGTACCTTTGTTGATGCTGGGGGTGTGGTTAGAGCTAGAAAT	1	bc
AGAACTTATA	GAAACACCGGTAACTATATTCATGCGATATCGCCGTATCAGTGGGGTTAG	1	bc
CGACTCACGC	GAAACACCGGTGCATTCGAAAGTCCGGTCGTAGTGTGGACGTGGGGTTAG	1	bc
ACATGCTTTC	GAGACACCGGTCGATTCATGGCGAAACCTCCCCGTGACAGAGGGTTTAGA	1	bc
ATAAGCGTAC	GAAACACCGGTTAAGCAGAGGCGTTAGAGCTAGAAATAGCAAGTTAACAT	1	bc
GCGCGTCGTC	GAAGCACCGGTGTACGTATGGACTGAACCAGGGCGTGGGGTTAGAGCTAG	1	bc
AAAATAGTTC	GAAACACCGGTGTACGTATAGACTGAACCAGGGTGTGCAAGTGGGGTTAG	1	bc
TAACAATGCC	GAAACACCGGTTTGAACTACCTAGTTCAAAGAGCTAGAAATAGCAAGTTA	1	bc
AGGCCCTGGA	GAAACACCGGTGCATTCGAAAACCCGGTGGGAGTGTGTACGTGGAGTTAG	1	bc
GGGGCGGGCT	GAAACACCGGTTCCCGTCCAGTGGGGTTAGAGCTAGAAATAGCAAGTTAA	1	bc
CAGCTTAGCC	GAAACACCGGTTTGAACTAGAAATAGCAAGTTAACCTAAGGCTAGTCCGT	1	bc
TAGTCTGACT	GAAACACCGGTCCGTAGGAGACCCGTGTGGCATGTACCTGTGGGGTTAGA	1	bc
TTAACCATTT	GAAACACCGGTTACATTGAGGGTTAGAGCTAGAAATAGCAAGTTAACCTA	1	bc
AGACGAACGC	GAAACACCGGTGCATTCGAAAGTGCGGTCGTAGTGTGGACGTGGGGTTAG	1	bc
AATACTCGGC	GAAACACCAGTACCTTTGTTGATGCTGGTGGAAGGAATTTGTGGGGTTAG	1	bc
GGGACACTAC	GAAACACCGGTAAATTTGAGGCTCCGGCATGCAGGAGGCCGTGGGGTTAG	1	bc
AGTGATGCCT	GAAACACCGGTTCCCGTCCAGTGGGGTTAGAGCTAGAAATAGCAAGATAA	1	bc
AGACGCACAC	GAAACACCGGTTCATTCGAAAGTCCGAGCGTAGAGTGGACGTGGGGTTAG	1	bc
CTGCTTCGTC	GAAACACCGGTTTACGTTGCATCGGTGTGGGGTTAGAGCTAGAAATAGCA	1	bc
CACTCTGTCT	GAAACACCGGTGACATTGGGTACAGGGCGGGGTTAGAGCTAGAAATAGCA	1	bc
AAAGCTCTGC	GAAACACCGGTGCCCTTACTCTCACCTGATTACTTAATCCGTGGGGTTAG	1	bc
GATTAGCTAT	GAAACACCGGTTACATTGAGATTGGGGTTAGAGCTAGAAATAGCAAGTTA	1	bc
ATAGAGCGTA	GAAACACCGGTTAAGCCGATGTGCTTTTTTCCTGCAGGTTACGCTCAAGA	1	bc
TAACTTGACC	GAAACACCGGTAACTATATTCATGCGATATTGCCGTATCAGTGGGGTTAG	1	bc
AGATTCTCGG	GAAACACCGGTGCATTCGAAAGCCCTGTCGTAGAGTGGACGTGGGGTTAG	1	bc
CCACTCGACA	GAAACACCGGTACCTTTGTTGATGCTGGGTGGGAGGAATTTGTGGGGTTA	1	bc
AGTGGTGTAT	GAAACACCGGTGACATTGGTGGGGTTAGAGCTAGAAATAGCAAGTTAACC	1	bc
AGGACCCTAC	GAAACACCGGTAAATTTGAGGCTCCGGCATGCAGGAGGCCGTGGGGTTAG	1	bc
AGTGGCGCCT	GAAACACCGGTTCCCGTCCAGTGGGGTTAGAGCTAGAAATAGCAAGTTAA	1	bc
ATATATCGGG	GAAACACCGGTTATATTTGTAAGTGTGTGGGGTTAGAGCTAGAAATAGCA	1	bc
TTCAACGCTC	GAAACACCGGTTTGAACTACCTAGTTTTAACTGTTGGGGCTAGAGCTAGA	1	bc
GACACCCTTT	GAAACACCGGTGTGGCTGAGCGGCCGGCAATGGTATGGCTGTGGGTATCA	1	bc
GATGGCACTA	GAAACACCGGTGCCCTTACTCTCACCTGATTACTTAACCCGTGGGGTTAG	1	bc
CGTATCCCTC	GAAACACCGGTCCGTAGGAGACCCGTGTGGCCTGTACCTGTGGGGTTAGA	1	bc
CAGCGTTGAC	GAAACACCGGTGTACGTATGGACTGAACCAGGGTGTGCAAGGGGGGTTAG	1	bc
CAAAAAGACC	GAAACACCGGTTTGAACTAGAAATAGCAAGTTAACCTAAGGCTAGTCCGT	1	bc
AGTGGAGCCG	GAAACACCGGTTCCCGTCCAGTGGGGTTAGAGCTAGAAATAGCAAGTTAA	1	bc
CACATCGTCG	GAAACACCGGTGTACGTATGGACTGAACCAGGGTGTGCAAGTGGGGTTAG	1	bc
GCCATACCCC	GAAACACCGGTGTGGCTGAGTGTCCGGCAATGGTGTGGCTGTGGGGATAG	1	bc
CGGGTTTTAC	GAAACACCGGTGACATAGAAATAGCAAGTTAACCTAAGGCTAGTCCGTTA	1	bc
GCCCTCCACA	GAAACACCGGTAAATTTGTGTCTCCGGCATGCAGGAGGCCGTGGCGATAG	1	bc
AACAACGCGA	GAAACACGGGTTAGAGCTAGAAATAGCAAGTTAACCTAAGGCTAGTCCGT	1	bc
GACGAGCTAC	GAAACACCGGTGCCCTTACTCTCACCTGATTACTTAATCCGTGGGGTTAG	1	bc
CATCGGAGTT	GAAACACCGGTGAAAGAATGGACTGAACCAGGGTGGGCAAGTGAAGATAG	1	bc
AATGACTAAA	GAAACACCGGTGCCCTTACTATCACCTGATTACTTAATCCGTGGGGTTAG	1	bc
AACATACGGT	GAAACACCGGTCGATTCATATCGAAACCTTCCCGTGACAAGTGGGGTTAG	1	bc
AAAACTTATA	GAAACACCGGTAACTATATTCATGCGATATCGCCGTATCAGTGGGGTTAG	1	bc
GTCAGCGACC	GAAACACCGGTGTGGCTGAGAGTCCGGCAATGGTGTGGCTGTGGGGTTCG	1	bc
AGACGCGTGC	GAAACACCGGTGACTTCGAAAGTAGGGTTGGAAAGTGCACGTGAGGCTAG	1	bc
ATGCGAAGGT	GAAACACCGGTTTACGTTGCATCGTTGTGGGGTTAGAGCTAGAAATAGCA	1	bc
GGACTCCGCC	GAAACACCGGTATGTCTGTGGGTGCGGGAAGGGAGTGGTTGTGGGGGTTG	1	bc
AAGAATCCTT	GAAACACCGGTCTCGAGTGAGGTGTTTAGGGTGGGGTTAGAGCTAGAAAT	1	bc
TAACGCCGTA	GAAACACCGGTGCCCTTACTCTCACCTGATTACTTAATCCGTGGGGTTAG	1	bc
GTGGCACATA	GAAACACCGGTTCCCGTCCAGTGGGGTTAGAGCTAGAAATAGGAAGTTAA	1	bc
ACGAGTTGTC	GAAACACCGGTGACATTGGGTAGTGGGGTTAGAGCTAGAAATAGCAAGTT	1	bc
ACGAGTCCTT	GAAACACCGGTCTCGAGTGAGGTGTTCAGGGTGGGGTTAGAGCTAGAAAT	1	bc
CTACCGGGCA	GAAACACCGGTACCTTTGTTGATGCTGGGTGGAAGGAATTTTGTGGGGTT	1	bc
AAAGGCCCTA	GAAACACCGGTGCCCTTACTCTCACCTGATTACTTAATCCGTGGGGTTAG	1	bc
ATCCTTCGCC	GAAACACCGGTTTACGTTGCATCGGTGTGGGGTTAGAGCTAGAAATAGCA	1	bc
TCTAGCGGTG	GAAACACCGGTGTGGGGATAGAGCTAAAAATAGCAAGTTAACCTAAGGCT	1	bc
ACGACAAATT	GAAACACCGGTCTCGAGTGAGGTGTTCAGGTGGGGTTAGAGCTAGAAATA	1	bc
GTCCAAGATA	GAAACACCGGTAGCAAGTGCGAGCGGTGTTTGTGGGGTAGAGCTTGGAAT	1	bc
ATGATTCGCA	GAAACACCGGTTTACGTTGCATCGGTGTGGGGTTAGAGCTAGAAATAGCA	1	bc
GACATACTCA	GAAACACCGGTAGCAAGTGCGAGACGTGTTTGTGGGGTTAGAGCTAGAAA	1	bc
TATCGTGGTT	GAAACACCGGTGTACGTATGGACTGAACCAGGGTGTGCAAGTGGGGTTAG	1	bc
TGTGTCGTGG	GAAACACCGGTTATATTTGTAAGTGTGTGAGGTTAGAGCAAGAAATAGCA	1	bc
GTCAACATCC	GAAACACCGGTGTGGCTGAGAGTCCGGCAATGGTGTGGCTGGGGGGATAG	1	bc
GTGATTCTCC	GAAACACCGGTTTACGTTGCATCGGTGTGGGGTTAGAGCTAGAAATAGAA	1	bc
AGTCACCATC	GAAACACCGGTGTGGCAGAGAGTCCGGCAATGGTGTGGCTGTGGGGTTAG	1	bc
CGCCTGACTC	GAAACACCGGTCCGTAGGAGGGGGTTAGAGCTAGAAATAGCAAGATCACC	1	bc
TCGCAACGCC	GAAACACCGGTTTGAACTAGAAATAGCAAGTTAACCTAAGGCTAGTCCGT	1	bc
TGAGCTCTTT	GAAACACCGGTTACATTGAGGGCGTAGAGCTAGAAATAGCAAGTTAAGCT	1	bc
AGGATGCATC	GAAACACCGGTCCGTAGGAGACCCGTGTGGCATGTACCTTGTGGGGTTAG	1	bc
AGTGGAGGCT	GAAACACCGGTTCCCGTCCAGTGGGGTTAGAGCTAGAAATAGCAAGTTAA	1	bc
GGTTACCTCC	GAAACACCGGTGTGGCTGAGAGTCCGGCAATGGTGTGGCTGTTGGGTTAG	1	bc
ACTGCCCTTC	GAAACACCGGTGCCCTTACTCTCACCTGATTACTTAACCCGTGGGGTTAG	1	bc
AATCGCGGTT	GAAACACCGGTCGATTCATATCGAAACCTTCCCGTGACAGTGGGGTTAGA	1	bc
TATCTTATCA	GAAACACCGGTAACTATATTCATGCGATATCGCCGTATCAGTAAGGTTAG	1	bc
TATGGAGCCT	GAAACACCGGTTCCCGTCCAGTGGGGTTAGAGCTAGAAATAGCAAGTTAA	1	bc
GGAGTTGTCC	GAAACACCGGTGACATTGGGGCTAGAGCTAGAAATAGCAAGTTAACCTAA	1	bc
AGTAAACCTC	GAAACACCGGTCCGTAGGAGACCCGTGTGGCATGTACCTGTGGGGTTAGA	1	bc
CGTGTGGCGT	GAAACACCGGTGACATTGGGTACAGGGTGGGGTTAGAGCTAGAAATAGCA	1	bc
GAGCAGCCTA	GAAACACCGGTGCCCTTACTCTCACCTGATTACTTAATCCGTGGGGTTAG	1	bc
GGACTCCATT	GAAACACCGGTCTCGAGAGAGGCGTTCAGGGAGGATGTAGATCTAGATAT	1	bc
GGAATCCTCG	GAAACACCGGTGTGGCTGAGAGTCCGGCAATGGTGTGGCTGTGGGGCTAG	1	bc
AAACGCCGTA	GAAACACCGGTGCCCTTACTCTCACCTGATTACTTAATCCGTGGGGTTAG	1	bc
CTGTGACGCG	GAAACACCGGTACCTTAGAGCTAGAAATAGCAAGTTAACCTAAGGCTAGT	1	bc
CGAGCGTTGC	GAAACACCGGTGCCTTCGAAAGTCCGGTCGTAGTGTGGACGTGGGGTTAG	1	bc
ACAAGCTCGT	GAAACACCGGTGCATTCGAAAGTCCGGTCGTAGTGTGGACGTGGGGTTAG	1	bc
GGAACACTTC	GAAACACCGGTGTGGCTGAGAGTCCGGCAATGGTGTGGCTGTGGGGTTAG	1	bc
ACACAACCGC	GAAACACCGGTCGGGGCCACTCAGTGGTGGGGTTAGAGCTAGAAATAGCA	1	bc
ATGCTCTCGC	GAAACACCGGTGCATTCGAAAGTCCGGTCGTAGTGTGGACGTGGGGTTAG	1	bc
ACGTGTTGGC	GAAACACCGGTGACATTGGGTACAGGGTGGGGTTAGAGCTAGAAATAGCA	1	bc
AGTAGGTATG	GAAACACCGGTTACATTGAGGGGTTAGAGGTAGAAATAGCAAGTTAACCT	1	bc
CTAGTGAGTT	GAAACACCGGTTACATTGAGGGTTAGAGCTAGAAATAGCAAGTTAACCTA	1	bc
AATGCGTAGC	GAAACACCGGTTTACGTTGCATCGGTGTGGGGTTAGAGCTAGAAATAGCA	1	bc
TACTTTACCG	GAAACACCGGTCGGGGCCACTCAGTGGTGGGGTTAGAGCTAGAAATAGCA	1	bc
AATGCTTCGC	GAAACACCGGTTTACGTTGCATCGGTTAGAGCTAGAAATAGCAAGTTAAC	1	bc
GACCGAGACT	GAAACACCGGTAGCAAGTGCGAGACGTGTGTGGGGTTAGAGCTAGAAATA	1	bc
AACTTTACCG	GAAACACCGGTCGGGGCCACTCAGTGGTGGGGTTAGAGCTAGAAATAGCA	1	bc
ATACCCAGAC	GAAACACCGGTACCTTTGTTGATGCTGGGTGGAAGGTGGGGTTAGTGCTA	1	bc
ACTCCTCGGC	GAAACACCGGTACCTTTGTTGATGCTGGGTGGGGTTAGAGCTAGAAATAG	1	bc
GCGGATCCTT	GAAACACCGGTCTCGAGTGAGGTGTTCAGGGTGGGGTTAGAGCTAGAAAT	1	bc
GGTGGAGACT	GAAACACCGGTTCCCGCCCAGTGGGGTTAGAGCTAGAAATAGCAAGTTAA	1	bc
TGGACCCACG	GAAACACCGGTGCATTCGAAAGTCCGGTCGTAGTGTGGACGTGGGGTTAG	1	bc
AGCTTTCCCG	GAAACACCGGTCGGGGCCACTCAGACCTAGAAATAGCAAGTTAACCTAAG	1	bc
GCCAAAGCCA	GAAACACCGGTAGCAAGTGCGAGACGTTTTTGGGGTTAGAGCTAGAAGTA	1	bc
AAACGTCCTA	GAAACACCGGTGCCCTTACTCTCACCTGATTACTTAATCCGTGGGGTTAG	1	bc
CCTTGTCGGC	GAAACACCGGTGTACGTATGGACTGAACCAGGGTGTGCAAGTGGGGTTAG	1	bc
ATAGCCCTGC	GAAACACCGGTGCCCTTACTCTCACCTGATTACTTAATCCGTGGGGTTAG	1	bc
AATAGCGGCT	GAAACACCGGTTTGAACTACCTAGTTCAAACCGGTGGGGTTAGAGCTAGT	1	bc
ATGCTAGGGC	GAAACACCGGTTTACGTTGCATCGGTTGTGGGGTTAGGGCTAGAATTAGC	1	bc
GGACACAGAT	GAAACACCGGTAGCAAGTTAGAGCTAGAAATAGCAAGTTAACCTAAGGCT	1	bc
AAGACCATCG	GAAACACCGGTGCATTCGAAAGTCCGGTCGTAGTGTGGACGTGGGGTTAG	1	bc
GGAAGTATAC	GAAACACCGGTAACTATATTCATGCGATATCGCCGTATCAGTGGGGTTAG	1	bc
CTACTCATAC	GAAACACCGGTAACTTTGTTGATGCTGTGTGGCCGGATTATGTGGGGTTA	1	bc
AATGAGCATA	GAAACACCGGGTAAGCTAGAAATAGCAAGTTAACCTAAGGCTAGTCCGTT	1	bc
GCAGGTATGT	GAAACACCGGTTACATTGAGGTTTAGAGCTAGTAGTAGCAAGTTAACCTA	1	bc
CATTTGCCTC	GAAACACCGGTCCGCAACTTGAAAAAGTGGCACCGAGTCGGTGCTTTTTT	1	bc
AGGCCACTAC	GAAACACCGGTAAATTTGAGGCTCCGGCATGCAGGAGGCCGTGGGGTTAG	1	bc
GGCATGGAGA	GAAACACCGGTAGCAAGTGCGGGGTTAGAGCTAGAAATAGCAAGTTAACC	1	bc
GACTTTACCG	GAAACACCGGTCGGGGCCACTCAGTGGTGGGGTTAGAGCTAGAAATAGCA	1	bc
TACGCACTCC	GAAACACCGGTGCCCTTACTCTCACCTGATTACCTAATCCGTGGGGTTAG	1	bc
TATGGCGCGG	GAAACACCGGTTATATTTGTAAGTGTGTGGGGTTAGAGCTAGAAATAGCA	1	bc
GTGGAGACAA	GAAACACCGGTTCCCGTCCAGTGGGGTTAGAGCTAGAGATAGCAAGTTAA	1	bc
AGAGGAGCCT	GAAACACCGGTTCCCGTCCAGTGGGGTTAGAGCTAGAAATAGCAAGTTAA	1	bc
TAATTAGGTT	GAAACACCGGTCGATTCATATCGAAACCTTCCCGTGACAGTGGGGTTAGA	1	bc
ACACTAGGTC	GAAACACCGGTCGATTCATATCGAAACCTTCCCGTGACAGTGGGGTTAGA	1	bc
ACGTGCTGGC	GAAACACCGGTGACATTGGGTACAGGGTGGGGTTAGAGCTAGAAATAGCA	1	bc
GAAAGCCCTA	GAAACACCGGTGCCCTTACTCTCACCTGATTACTTAATCCGTGGGGTTAG	1	bc
TCGCAGCCTC	GAAACACCGGTCCGTAGGAGACACGTGCGGCATGTACCTGTGGGGTTAGA	1	bc
ACATAGTCGT	GGAACACCGGTGTACGTATGGACTGAACCAGGGTGTGCAAGTGGGGTTAG	1	bc
GGCAGCCTTA	GAAACACCGGTGTGGCTGAGAGTCCGGCAATGGTGTGGCTGTGGGGTTAG	1	bc
TAACGTAGTC	GAAACACCGGTGAACGTATGGACTGAACCAGGGCGTGCAAAGTGGGGTTA	1	bc
CCTGAAGCGC	GAAACACCGGTCGGGGCCACTCAGTGGAGGGTTTAGAGCTAGAAATAGCA	1	bc
GTGCTTAACC	GAAACACCGGTTTACGTTGCATCGGTTGTGGGGTTAGAGCTAGAAATAGC	1	bc
CTTCCCTGCA	GAAACACCGGTGTGGCTGAGAGTCCGGCAATGGTGTGGCTGTGGGGTTAG	1	bc
AGCACTGTCC	GAAACACCGGTGTGGCTGAGAGTCCGGCAATGGTGTGGCTGTGGGGTTAG	1	bc
TAGTCTGGCT	GAAACACCGGTCCGTAGGAGACCCGTGTGGCATGTACCTGTGGGGTTAGA	1	bc
AGCAGCCGCA	GAAACACCGGTGTGTAGGAGAGCCCGGCAATGGGGAGCCTGGGGGGTTGA	1	bc
ACATCGTAGT	GAAACACCGGTGTACGTATGGACTGAACCAGGGCGTGGGGTTAGAGCTAG	1	bc
AATCATGCTC	GAAACACCGGTCCGTAGGAGACCCGTGTGGTGTGGGGTTAGAGCTAGAAA	1	bc
TAAAATACCC	GAAACACCGGTTTGAACTAGAAATAGCAAGTTAACCTAAGGCTAGTCCGT	1	bc
ACAAAACGCC	GAAACACCGGTTTGAACTACCTAGTTCAAACCGGTGGGGTTAGAGCTAGA	1	bc
AAAATTCTAC	GAAACACCGGTAACTATATTCATGCGATATCGCCGTATCAGTGGGGTTAG	1	bc
ACTACTCGGA	GAAACACCGGTACCTTTGTTGATGCTAGGTGGAAGGTGGGGTTAGAGCCA	1	bc
TCTAACGCGC	GAAACACCGGTTATATTTGTAAGTGGGTGGGGTTAGAGCTAGAAATAGCA	1	bc
ATAGAGATGA	GAAACACCGGTTACATTGAGGGGTTAGAGCTAGAAATAGCAAGTTAACCT	1	bc
CGAGTGGGGT	GAAACACCGGTGACATTGGGTAGAGCTAGAAATAGCAAGTTAACCTAAGG	1	bc
AACAAAGGCA	GAAACACCGGTAGCAAGTGCGAGACGTGTTTGTGGGGTTAGAGCTAGAAA	1	bc
AATAGTCTGC	GAAACACCGGTGTACGTATGGCATGAACCAGGGTGTGCAAGTGGGGTTAG	1	bc
GGCGCTCTGT	GAAACACCGGTTACGTTGAGATTGGGGTTATAGCGAGAAATAGCGAGTTG	1	bc
AACTCTGCAG	GAAACACCGGTTTTAACTACCGGGGTTAGAGCTAGAAATAGCAAGTTAAC	1	bc
GGTGAGCATA	GAAACACCGGTTAAGCCGATGTGCTTTTTTCCTGCAGGTTATGCTCAAGA	1	bc
TTGGATCGTG	GAAACACCGGTTACATTTAGTTTTGAAGCTGGTTAGAGCTAGTTATAGTA	1	bc
ATAATAGGCC	GAAACACCGGTACCTTTGTTGATGCTGGGTGGAAGGTTGGTTGGAAGGTT	1	bc
ACTACTCTGC	GAAACACCGGTACCTTTGTTGATGCTGGGTGGGGTTAGAGCTAGAAATAG	1	bc
GAGGCATCTC	GAAACACCGGTTCTTGTCGAGAGGTGTTGGGGGGAGTTATAGCTAGTAAT	1	bc
ATGTGTCTAA	GAAACACCGGTTAAGCCGATGTGCTTTTTTCCTGCAGGGTATGGTCATGA	1	bc
GAAGGCATGA	GAAACACCGGTCGATGCGGTTATAGCTATAATTATCACGTTAACATAAGG	1	bc
AGGCACCGTC	GAAAAACCGGTGTGGCTGAGAGTCCGGCAATGGTGTGGCTGTGGGGTTAG	1	bc
GTGGCAAATC	GAAACACCGGTTCCCGTCCAGTGGGGTTAGAGCTAGAAATAGCAAGTTAA	1	bc
ACACACCGCC	GAAACACCGGTTTGCAAGAGGAATAGACATTTGACCTAAGACTAATAAGT	1	bc
GGGACTCTCT	GAAACACCGGTGGGGGTGAGAGTCCGGTAATTGGGTGGCTGTGGGGTTAG	1	bc
AGTAACTCGC	GAAACACCGGTGCATTCGAAAGGCCGGTCGTAGTGTGGACGTGGGGATAG	1	bc
AGTAGCTATG	GAAACACCGGTTACATTGAGGGGTTAGAGCTAGAAATAGCAAGTTAACCT	1	bc
CAAAAAGCCA	GAAACACCGGTTTGAGCTAGAAATAGCAAGTTAGCCTAAGGCTAGTCCGT	1	bc
GCTACTTGGC	GAAACACCGGTACCTTTGTTGATGCTGGGTGGAAGCTAGAAATAGCAAGT	1	bc
GACGCCATTC	GAAACACCGGTGCCATTAATCTCACCTGATTACTTAATCCGTGGGGATAG	1	bc
CCCCTCCCTC	GAAACACCGGTGTGGCTGAGAGTCCGGCAATGGTGTGGCTGTGTGGTTAT	1	bc
AATAGGCGTC	GAAACACCGGTGTACGTATGGACTGAACCAGGGTGTGCAAGTGGGGTTAG	1	bc
GCGGGTTGTC	GAAACACCGGTGACATTGGGTACAGGCACCTAGTCGGTGCTTTTTTTCCT	1	bc
CGTGGTGGCC	GAAACACCGGTGACATTGGGTACAGGGTGGGGTTAGAGCTAGAAATAGCA	1	bc
CATAGTAGTA	GAAACACCGGTGTACGTATGGACTGAACCAGGGTGTGCAAGTGGGGTTAG	1	bc
GCGGAGGGTC	GAAACACCGGTCCCCTTCCATTGGGGCTAGAGCTAGAAATAGCAAGTTAA	1	bc
CATAATCATC	GAAACACCGGTTCACGTATGGTATGAGCCGGGGTAGAGCTAGAAAGAGCA	1	bc
GTGGCGCTAC	GAAACACCGGTGCCCTTACTCTCACCTGATTACTTAATCCGTGGGTATCG	1	bc
GCCAAAGCCA	GAAACACCGGTAGCAAGTGCGAGACAGCTAGAAATAGCAAGTTAACCTAA	1	bc
GAACGCCATA	GAAACACCGGTGCCCTTACTCTCACCTGATTACTTAATCCGTGGGGTTAG	1	bc
TTCGTCCTTT	GAAGCATTCGGGCCCATTGGTATGGCAGATCGGAAGAGCACACGTCTGAA	1	bc
AGACTAGCGC	GAAACACCGGTGCATTCGAAAGTCCGGTCGTAGTGTGGACGTGGGGTTAG	1	bc
CTCCCCTGCA	GAAACACCGGTGTGGCTGAGAGTCCGGCAATGGTGTGGCTGTGGGGTTAG	1	bc
AGAAGAACCG	GAAACACTGGTCGGCGGCAATCGTGGGTGGGGTTAGAGCTAGAAATAGCA	1	bc
CGAGCTATAT	GAAACACCGGTTACATTGAGGGGTTAGAGCTAGAAATAGCAAGTTAACCT	1	bc
ATATTCGGCG	GAAACACCGGTCGATTCATATCGAAACCTTCCCGTGACAGTGGGGTTAGA	1	bc
ACTATGGCTG	GAAACACCGGTTCTATTTGTAAGTGTTGTGGGGTTAGAGCTAGAAATAGA	1	bc
GCAGCGTCGT	GAAACACCGGTGTACGTATGGACTGAACCAGGGTGTGCAAGTGGGGTTGG	1	bc
AGCACCTAGC	GAAACACCGGTGCATTCGAAAGTCCGGTCGTAGTGTGGACGTGGGGTTAG	1	bc
ACTACTAGGC	GAAACACCGGTACCTTTTTTGTTTGTTTCTAACCTGGGGTTAGAGCTAGA	1	bc
AGAAACTAGC	GAAACACCGGTGCATTCGAAAGTCCGGTCGTAGTGTGGACGTGGGGTTAG	1	bc
CGGGCCCATA	GAAACACCGGTAAATTTGAGGCTCCGGCATGCAGGAGGCCGTGGGGTTAG	1	bc
CGACTGCGTC	GAAACACCGGTCCGTAGGAGACCCGTGTGGCATGTACCTGTGGGGGTAGA	1	bc
GCCTCGTCGC	GAAACACCGGTGTACGTATGGACTGAACCAGGGTGTGCAGGTGGGGTTAG	1	bc
TTAAGCGGCC	GAAACACCGGTACCTTTGTTGATGCTGGGTGGAAGGAATTTTGTGGGGTT	1	bc
ATTAGCTCTG	GAAACACCGGTTACAATTGGGGTTAGAGCTAGAAATAGCAGGTTAACCTA	1	bc
TGTATCGTTT	GAAACACCGGTCTCGAGTGAGGGGTTCAGGGGGGAGAGATAGCTAGAGAT	1	bc
TTAGCCTCGT	GAAACACCGGTGCATTCGAAAGTCCGGTCGTAGTGTGGACGTGGGGATAG	1	bc
TACACATGAC	GAAACACCGGTAAATTTGAGGCTCCGGCATGCAGGAGGCCGTGGGGTTAG	1	bc
AAGGCCATAA	GAAACACCGGTGCCCTTACTCTCACCTGATTACTTAATCCGTGGGGTTAG	1	bc
AAACAACGCC	GAAACACCGGTTTGAACTACCTAGTTCAAACCGGTGGGGTTAGAGCTAGA	1	bc
GATCGCCGCC	GAAACACCGGTGTACGTATGGACTGAACCAGGGTGTGCAAGTGGGGTTAG	1	bc
CAGTGGAGCC	GAAACACCGGTTCCCGTCCAGTGGGGTTAGAGCTAGAAATAGCAAGTTAA	1	bc
GCCCAACGCC	GAAACACCGGTTTGAACTAGAAATAGCAAGTTAACCTAAGGCTAGTCCGT	1	bc
AAAAGCGCTC	GAAACACCGGTGCCCTTACTCTCACCTGATTACTTAATCCGTGGGGTTAG	1	bc
CATTGAGCAT	GAAACACCGGTTAAGCCGAGGAGTTAGAGCTAGAAATAGCAAGTTAACCT	1	bc
GGCAGACTGA	GAAACACCGGTGTGGCTGAGAGTCCGGCAATGGTGTGGCTGTGGGGTTAG	1	bc
ATGTATGCCT	GAAACACCGGTCCGTAGGAGACCCGTGTGGCATGTACCTGTGGGGTTAGA	1	bc
ACTAGCTATG	GAAACGCCGGTTACACTGAGTGGGGTGATAGCTAGAACTAGCTAGTTTAC	1	bc
CGTGCTGACA	GAAACACCGGTGACACTGGGGTTCGGGCTAGGAATTGTCTGTTATGAGGG	1	bc
GTAGCTATTA	GAAACACCGGTTACATTGAGGGTTAGAGCTAGAAATAGCAAGTTAACCTA	1	bc
AGGCACCATC	GAAACACCGGTGTGGCTGAGAGTCCGGCAATGGTGTGGCTGTGGGGTTAG	1	bc
AACACTCGGT	GAAACACCGGTCGATTCATATCGAAACCTTCCCGTGACAGTGGGGTTAGA	1	bc
AAGACTGTCT	GAAACACCGGTGCGTAGGAAACCCGTGTCGCATGTACCTCTGTGGGGTTA	1	bc
GCCTTTAGAG	GAAACACCGGTCGGGGCCACTCAGTGGTGGGGTTAGAGCTAGAAATAGCA	1	bc
AAGAGCCTCG	GAAACACCGGTGCATTCGAAAGTCCGGTCGTAGTGTGGACGTGGGGTTAG	1	bc
TTACCACGAA	GAAAAACCGGTGTGGAACGGGGCCCCCAGGGTGGCCCCGAGCGGGGTTAG	1	bc
GAAGCCTTGC	GAAACACCGGTCGGCGGCAATCGTGGGTGGGGTTAGAGCTAGAAACAGCA	1	bc
CACCTTAGCT	GAAACACCGGTTTACGTTGCATCGGTGTGGGGTTAGAGCTAGAAATAGCA	1	bc
CTCCGCGTCC	GAAACACCGGTACCTTTGTTAGAGCTAGAAATAGCAAGTTAACCTAAGGC	1	bc
CTGGTGCTTT	GAAACACCGGTCTCGAGCGAGGTGTTCAGGGTGGGGTTATAGCTAGAAAT	1	bc
CCAAACGACC	GAAACACCGGTTTGAACTAGAAATAGCAAGTTAACCTAAGGCTAGTCCGT	1	bc
ATGAACAGCT	GAAACACCGGTTTACGTTACACCGGTGTGGGGTTAGAGCTAGAAATAGCA	1	bc
CACGCCGCTC	GAAAAAACGGAGTTAACCTAAGGCTAGTCCGTTATCAACTTGAAATAGCG	1	bc
CCACTCCTTC	GAAACACCGGTCTCGAGTGAGGTGTTCAGGGTGTGGTTAGAGCTAGAAAT	1	bc
CTCACATGCA	GAAACACCGGTGTGGCTGAGAGTCCGGCAATGGTGTGGCTGTGGGGTTAG	1	bc
ACCGACCTAA	GAAACACCGGTGCCCTTACTCTCACCTGATTACTTAATCCGTGGGGTTAG	1	bc
GAAATTCGGT	GAAACACCGGTCGATTCATATCGAAACCTTCCCGTGACAGTGGGGTTAAA	1	bc
AGTATTGTCC	GAAACACCGGTGACATTGGGTACAGAGCTAGAAATAGCAAGTTAACCTAA	1	bc
CGGCCCTGCA	GAAACACCGGTGTGGCTGAGAGTCCGGCAATGGTGTGGCTGTGGGGTTAA	1	bc
GATACAGATC	GAAACACCGGTAGCAAGGGCGAGAGGTGTTCTTGTGGGGTTAGAGCTAGA	1	bc
CCACCATACG	GAAACACCGGTGGCAATAGGATGAGTGGAGTGGGGTTAGAGCTAGAAATA	1	bc
GAAACAGCAA	GAAACACCGGTAGCAAGTGGGGTTAGAGCTAGAAATAGCAAGTTAACCTA	1	bc
ATTGAGCCTA	GAAACACCGGTTAAGCCGAGGTTAGAGCTAGAAATAGCAAGTTAACCTAA	1	bc
TCTTCACGGT	GAAACACCGGTCGGGGCCACTCAGTGGTGGGGTTAGAGCTAGAAATAGCA	1	bc
AAGACATTCG	GAAACACCGGTGCATTCGAAAGTCCGGTCGTAGTGTGGACGTGGGGTTAG	1	bc
CTTGGTGTCA	GAAACACCGGTGACATTGGGTACGTTAGAGCTAGAAATAGCAAGTTAACC	1	bc
TCGCCCTGCA	GAAACACCGGTGCATTCGAAAGTCCGGTCGTAGTGTGGACGTGGGGTTAG	1	bc
AGACAGACAA	GAAACACCGGTCCGTAGGAGACCCGTGTGGCATGTACCGGTGGGGTTAGA	1	bc
CATAACGAGG	GAAACACGGGTTATATTTGTAAGTGTGAGGGGATCGAAATACAAATAGCA	1	bc
AGACTGAGTC	GAAACACCGGTCCGTAGGAGACCCGTGTGGCATGTACCTGTGGGGTTAGA	1	bc
GCCACGGACT	GAAACACCGGTAGCAAGTGCGAGACGTGTTTGTGGGGTTAGAGCTAGTAA	1	bc
CGGGTTGGCC	GAAACACCGGTGACATTGGGTACAGGGTGGGGTTAGAGCTAGAAATAGCA	1	bc
ACTATTCGGG	GAAACACCGGTCATATTTGTATGTGTGTGGGGTTAGAGCTAGAAATATCA	1	bc
TCACGCCCCT	GAAACACCGGTGCCCTTACTCTCACCTGATTACTTAATCCGTGGGGTTAG	1	bc
TGCACTCTGC	GAAACACCGGTGTGGCTGAGAGTCCGGCAATGGTGTGGCTGTGGGGTTAG	1	bc
GTATCTCTGT	GAAACACCGGTTACATTGAGGGATAGAGCTAGAAATAGCCAGTTAACGTA	1	bc
CCGCTAAGCT	GAAACACCGGTTTACGTTAAGTTAACCTAAGGCTAGTCCGTTATCAACTT	1	bc
AGTATCCTTA	GAAACACCGGTCCAGAGTAGCACGGTGTGGTAAGACTAGTTCGTTATAAA	1	bc
AAAAGCCCTA	GAAACACCGGTGCCCTTACTCTCACCTGATTACTTAATCCGTGGGGTTAG	1	bc
GATATAGCGG	GAAACACCGGTTATATTTGTAAGTGGGGTTAGAGCTAGAAATAGCAAGTT	1	bc
TAAGCTCTGC	GAAACACCGGTTACATTGAGGGGTTAGAGCTAGAAATAGCAAGTTAACCT	1	bc
AAGGACATAC	GAAACACCGGTGCCCTTACTCTCACCTGATTACTTAATCCGTGGGGTTAG	1	bc
TACTCTACCG	GAAACACCGGTCGGGGAGACGGGGGTTAGAGCTAGGAATAGCAAGTTAAC	1	bc
ACCCTTTCAG	GAAACACCGGTCGGGGCCACCCAGTGGTGGGGTTAGAGCTAGAAATAGCA	1	bc
GATTTACAGC	GAAACACCGGTCGGGGTAGTCCGTTACAACTTGAAAAAGTGGCACCGAGT	1	bc
CTTCGTAGTA	GAAACACCGGTGTACGTATGGACTGAACCAGGGTGTGCAGTGGGGTTAGA	1	bc
AAACGCCGTA	GAAACACCGGTGCCCTTACTCTCACCTGATTACTTAATCCGTGGGGTCAG	1	bc
GTTTAGTGCG	GAAACATTCGGGCCCATTGGTATGGCAGATCGGAAGAGCACACGTCTGAA	1	bc
AAGACTAGTT	GAAACACCGGTTTACGTTGCATCGGTTGTGGGGTTAGAGCTAGAAGTAGC	1	bc
TTAAAAGTGT	GAAGCACCGGTTATATTTAGAAGTGCGTGGGGTTAGAGCTAGAAATAGCA	1	bc
ACACAACGCA	GAAACACCGGTTTGAACTAGAAATAGCAAGTTAACCTAAGGCTAGTCCGT	1	bc
GAAGCACCGA	GAAACACCGATAGCAAGTTAACCTAAGGCTAGTCCGTTATCAACTTGAAA	1	bc
ACACAAAGCC	GAAACACGGGTTAGAGCTAGAAATCGCAAGTTACCCTACGCCTAGTCCGT	1	bc
GAGACCATCG	GAAACACCGGTGCATTCGAAAGTCCGGTCGTAGTGTGGACGTGGGGTTAG	1	bc
AAAAACGATC	GAAACACCGGTTTGAACTACCTAGTTCAAACCGGTGGGGTTAGAGCTAGA	1	bc
TGCCAACTGC	GAAACACCGGTGTGGCTGAGAGTCCGTACATTGAGTGTCTGTGTGGTTAG	1	bc
ACTTCACCGA	GAAACACCGGTCGGGGCCACTCAGTGGTGGGGTTAGAGCTAGAAATAGCA	1	bc
CATAGTGGCC	GAAACACCGGTTTACGCTTGGACGGTATGAGGGTGGGCATAGAGGTAGAG	1	bc
TTTATTAAGT	GAAACACCGGTTACATTGAGGGTTAGAGCTAGAAATAGCAAGTTAACCTA	1	bc
AATTGAGCTG	GAAACACCGGTTAAGCCGAGTGGGGTTAGAGCTAGAAATAGCAAGTTAAC	1	bc
CGAACCGGCC	GAAACACCGGTACCCGGTGGGGTTAGAGCTAGAAATAGCAAGTTAACCTA	1	bc
CCTCTCTAGG	GAAACACCGGTTCTATTTGTCAGTGGGGTTACAGCTAGAAATAGCATGAT	1	bc
ACCTATCGCG	GAAACACCGGTTATATTTGTAAGTGTGTGGGGTTAGAGCTAGAAATAGCA	1	bc
AAAATCCGCC	GAAACACCGGTACCTTTGTTGATGCTGGGTGGAAGGAATAGCAAGTTAAC	1	bc
ACATCTTCGT	GAAACACCGGTGTACGTATGGACTGAACCAGGGTGGGCAAGTGGAGTTAT	1	bc
ACACTTATTT	GAAACACCGGTAACTATATTCATGCGATATCGCCGTATCAGTGGGGTTAG	1	bc
ATTGATCATA	GAAACACCGGTTAAGCCGAGTGGGGTTAGAGCTAGAAATAGCAAGTTAAC	1	bc
GGGGTGGTCT	GAAACACCGGTAGCAAGTGTGGGACGTGGTTGAGGGGTTAGAGCTAGAAA	1	bc
AAGTATGCGT	GAAACACCGGTCCGTAGGAGACCCGTGTGGCATGTACCTGTGGGGTTAGA	1	bc
GACAAGGCAC	CAAAACACCGGTTTGAACTACCTAGCAAGTTAACCTAAGGCTAGTCCGTT	1	bc
CGAGCTGACT	GAAACACCGGTGACATTGGGTAGAGCTAGAAATAGCAAGTTAACCTAAGG	1	bc
GGGAACCCTC	GAAACAACGGTGTGGCTGAGAGTCCGGCAATGGTGTGGCTGTGGGGTTAG	1	bc
TTCATTACAG	GAAACACCGGTCGGGGCCACTCAGTGGTGGGGTTAGAGCTAGAAATAGCC	1	bc
GGACCTAAGA	GAAACACCTGTAAATTTGAGGCTCCGGCATGCAGGAGGCCGTGGGGATAG	1	bc
CTGGAGCACC	GAAACACCGGTTCCCGTCCAGTGGGGTTAGAGCTAGAAATAGCAAGTTAA	1	bc
ACGTGTTGTA	GAAACACCGGTGACATTGGGTAGTGGGGTTAGAGCTAGAAATAGCAAGTT	1	bc
AGTGTAGCAT	GAAACACCGGTTAAGCCGAGGGTTAGAGCTAGAAATAGCAAGTTAACCTA	1	bc
AGGACACGCA	GAAACACCGGTAGCAAGTGATTCTAAGGCTAGTCAGTTATAATCTTGGCA	1	bc
GTGCCCTAAA	GAAACACCGGTAAACTTGAGGCTCCGGCATGCAGGAGGCCGTGGGGTTAG	1	bc
GGTATCCCTC	GAAACACCGGTCCGTATGAGGGTGCTACAGTTAGAAGTAGCAAGTTATAC	1	bc
CGTAAGTCTC	GAAACACCGGTCCGTAGGAGACCCGTGTGGCATGTACCTGTGGGGTTAGA	1	bc
GCATTCCCGC	GAAACACCGGTCGGCGCCACTCGGGGGTGGGGTTAGAGCTAGAAATAGCA	1	bc
CTAGTCAGAC	GAAACACCGGTACCTTTGTTGATGCTGGGTGGTAGGAGTTGGGGTTGGAG	1	bc
TCACTTGGAC	GAAACACCGGTAACTATATTCATGCGATATCGCCGTATCAGTGGGGTTAG	1	bc
AGGGGCCTAC	GAAACACCGGTGCCCTTACTCTCACCTGATTACTTAATCCGTGGGGTTAG	1	bc
CGGCTTAGTT	GAAACACCGGTTTACGTTGCATCGGTGTGGGGTTAGAGCTAGAAATAGCA	1	bc
AGAGGACCCG	GAAACACCGGTCGGTGGGGTTAGAGCTAGAAATAGCAAGTTAACCTAAGG	1	bc
AATGAGTAGC	GAAACACCGGTTTACGTTGCATCGGTTGTGGGGTTAGAGCTAGAAGTAGG	1	bc
CTAGCTCTGC	GTAACTTGAGGCTTAGCGCTAGAAATAGCAAGTTAACCTAAGGCTAGTCC	1	bc
GGCTACTACC	GAAACACCGGTAAATTTGGGGCTCCGGCATGCGGGAGGCCGTGGGGTTAG	1	bc
AAGATGACCC	GAAACACCGGTCCGTAGGAGACCCGTGTGGCATGTACCTCTGTGGGGTTA	1	bc
AAATCACTAC	GAAACACCGGTGCCCTTACTCTCACCTGATTACTTAATCCGTGGGGTTAG	1	bc
TCTATCCCGA	GAAACACCGGTTATATTTGTAAGTGTGTGGGGTTAGAGCTAGAAATAGCA	1	bc
AAGTCTGACT	GAGACACCGGTCCGTAGGAGACCCGTGTGGCATGTACCTGTGGGGTTAGA	1	bc
AGGGTTATCT	GAAACACCGGTGACATTGGTTAGAGCTAGAAATAGCAAGTTAACCTAAGG	1	bc
GGCTTTACCG	GAAACACCGTTAGAGCTAGAAATAGCAAGTTAACCTAAGGCTAGTCCGTT	1	bc
ACTGCTCGGC	GAAACACCGGTACCTTTGTTGATGCTGGTGTGGGGTTAGAGCTAGAAATA	1	bc
ATGAGCCTCT	GAAACACCGGTTAAGCCGAGGAGTTAGAGCTAGAAATAGCAAGTTAACCT	1	bc
CTGCTGGGCG	GAAACACCGGTACATTTGTTCGAGCTAGAAGTAGCAAGTTAACCTAAGGC	1	bc
GGCACGATCA	GAAACACCGGTGTGGCTGAGAGTCCGGCAATGGTGTGGCTGTGGGGTTAG	1	bc
AGACCTATGT	GAAACACCGGTTACATTGAGGGTTAGAGCGAGAAATAGCAAGTTAACATA	1	bc
GCGCATCCTT	GAAACACCGGTCTCGAGTGAGGGGGTTAGAGCTAGAAATAGCAAGTTAAC	1	bc
GAACACGACC	GAAACACCGGTTTGAACTAGAAATAGCAAGTTAACATAAGGCTAGTCCGT	1	bc
TCTTGACGGC	GAAACACCGGTCGGGGCCGAGCTAGAAATAGCAAGTTAACCTAAGGCTAG	1	bc
CTAATCGTGA	GAAACACCGGTACCTTTGTTGATGCTGGGTGGAAGGTGGGGTTAGAGCTA	1	bc
TTAATCGCGG	GAAACACCGGTTATATTTGTAAGTGTGTGGGGTTAGAGCTAGAAATAGCA	1	bc
ATTAGCTCTG	GAAACACCGGTTACATTGAGATTGGGGTTAGAGCTAGAAATAGCAAGTTA	1	bc
AGACTCTGTT	GAAACACCGGTCTCGAGTGAGGTGTTCATGTGGGGGTAGAGCTAGAAATA	1	bc
ATGAATATCC	GAAACACCGGTTTACGTTGCATCGGTGTGGGGTTAGAGCTAGAAATAGCA	1	bc
TTGGGAGTAT	GAAACACCGGTTAAGCCGAGGAGTTAGAGCTAGAAATAGCAAGTTAACCT	1	bc
TCATTAGGAT	GAAACACCGGTCGATTCATATCGAAACAGAGCTAGAAATAGCAAGTTAAC	1	bc
TAGCCTGCCT	GAAACACCGGTCCGTAGGAGACCCGTGTGGCTTGTACCTGTGGGGTTAGA	1	bc
ACACAACGAC	GAAACACCGGTTTGAACTAGAAATAGCAAGTTAACCTAAGGCTAGTCCGT	1	bc
GATTCTGAGT	GAAACACCGGTAGGCAAGACGAAATAGCAAGTTCACCTAAGGCTAGGCTG	1	bc
GGAAACTACT	GAAACACCGGTCGCGCTCAGGGGCTAAACAGAGCAGTTTAACCTAGAACT	1	bc
TGGCACACTC	GAAACACCGGTGTGGCTGAGAGTCCGGCAATGGTGTGGCTGTGGGGTTAG	1	bc
AGTTTTATGG	GAAACACCGGTCGGGGCCACTCAGTGGTGGGGTTAGAGCTAGAAATAGCA	1	bc
AAACACGCGC	GAAACACCGGTGCATTCGAAAGTCCGGTCGTAGTGTGGACGTGGGGTTAG	1	bc
ACTACCGCGC	GAAACACCGGTGCATTCGAAAGTCCGGTCGTAGTGTGGACGTGGGGTTAG	1	bc
GAGAGACACG	GAAACACCGGTAGCAAGAGCGAGAAGAAGTGGCACCGGGACGGGGCTTTT	1	bc
ACAACGTAGT	GAAACGCCGGTGCACGTATGGACTGAACCAGGGTGTGCAAGTGTGGTTAG	1	bc
GAGCACCAGC	GAAACACCGGTCGGCGGCAATCGTGGGTGGGGCTAGAGCTAGAAATAGCA	1	bc
TAGTACCCGC	GAAACACCGGTCGGCGGCAATCGTGGGTGGGGTTAGAGCTAGAAATAGCA	1	bc
TTGCGCATGT	GAAACACCGGTTACGCCGAGGGGTTAAAGCTAGAAATAGCAAGTTAACCT	1	bc
AGCCTGACTA	GAAACACCGGTCCGTATGAGACCCGTGTGGCATGTACCTGTGGGGTTACA	1	bc
ATTCCGACTC	GAAACACCGGTCAGTAGGAGACCCGTGTGGCATGAACCTGTGGGGTTAGA	1	bc
ATTTTAGCGC	GAAACACCGGTCGGGGCCACTCAGTGGTGGGGTTAGAGCTAGAAATAGCA	1	bc
AGGAGACCCG	GAAACACCGGTCGGCGTGGGGTTAGAGCTAGAAATAGCAAGTTAACCTAA	1	bc
GGGCGACACG	GAAACACCGGTAAATTTGAGGCCCCGGCATGCAGGAGGCCGTGGGGTTAG	1	bc
GGACAACGCA	GAAACACCGGTTTGAACTACCTAGTTCAAACCGGTGGGGTTAGAGCTAGA	1	bc
TCACAACTCC	GAAACACCGGTTTGAACTACCTAGTTCAAACCGGTGGGGTTAGAGCTAGA	1	bc
AGAAGACACG	GAAACACCGGTCGGTGGGTGGGGTTAGAGCTAGAAATAGCAAGTTAACCT	1	bc
AAGAGGATAA	GAAACACCGGTTAAGCCGAGGAGTTAGAGCTAGAAATAGCAAGTTAACCT	1	bc
GAATATATGC	GAAACACCGGTCGGCGGCAATCGGGGTTAGAGCTAGAAATAGCAAGTTAA	1	bc
GAGGATACGC	GAAACACCGGTTAACGTAACCTAATTCTAGCTCGTTATCACATTTTAACC	1	bc
GTAGTCGTCC	GAAACACCGGTACCTTTGTTAATGCTGGGTGGAAGGAATTTTGTGGGGTT	1	bc
