AAAAAAAGCC	GAAACACCGGTTTGAACTACCTAGTTCAAACCGGTGGGGTTAGAGCTAGA	1
AAAAAACGCC	GCTAGAAATAGCAAGTTAACCTAAGGCTAGTCCGTTATCAACTTGAAAAA	1
AAAAAAGCCC	GAAACACCGGTTTGAACTAGAAATAGCAAGTTAACCTAAGGCTAGTCCGT	1
AAAAACGACC	GAAACACCGGTTTGAACTAGAAATAGCAAGTTAACCTAAGGCTAGTCCGT	1
AAAAACGACC	GAAACACCGGTTTGAACTACCTAGAAAGGGTTAGAGCTAGAAATAGCAAG	1
AAAAACGCCA	GAAACACCGGTTTGAACTACCTAGTAGCAAGTTAACCTAAGGCTAGTCCG	1
AAAAACGCTA	GAAACACCGGTTTGAACTACCTAGTTCAAACCGGTGGGGTTAGAGCTAGA	1
AAAAACGCTC	GAAACACCGGTTTGAACTAGAAATAGCAAGTTAACCTAAGGCTAGTCCGT	1
AAAAACGGTC	GAAACACCGGTTTGAACTACCTAGAAATAGCAAGTTAACCTAGGGCTAGT	1
AAAAATAGGC	GAAACACCGGTACCTTTGTTGATGCTGGGTGCTTTTTTTCCTGCAGGGGC	1
AAAACCGCGC	GAAAGGCCGGTGCATTCGAAAGTCCGGACGTAGTGTGGACGTGGGGTTAG	1
AAAACGGCTC	GAAACACCGGTCCGTAGGAGACCCGTGTGGCATGTACCTGGGGGGGTAGA	1
AAAAGCCCTA	GAAACACCGGTGCCCTTACTCTCACCTGATTACTTAATCCGTGGGGTTAG	1
AAAAGCCCTA	GAAACACCGGTGCCCTTACTCTCGCCTGATTACTTAATCCGTGGGGTTAG	1
AAAATCCTTA	GAAACACCGGTCTCGAGTGAGGTGTTCAGGTGGGGTTAGAGCTAGAAATA	1
AAAATGAGGT	GAAACACCGGTCGATTCATATCGAAACCTTCCCGTGACAGTGGGGTTAGA	1
AAAATTATTC	GAAACACCGGTAACTATATTCATGCGATATCGCCGTATCAGTGGGGTTAG	1
AAACAACGAC	GGGTTAGAGCTAGAAATAGCAAGTTAACCTAAGGCTAGTCCGTTATCAAC	1
AAACAACGCC	GAAACACCGGTTTGAACTAGAAATAGCAAGTTAACCTAAGGCTAGTCCGT	3
AAACAACGCC	GAAACACGGGTTAGAGCTAGAAATAGCAAGTTAACCTAAGGCTAGTCCGT	1
AAACAACGCC	GAAACACCGGTTTGAACTACCTAGTTCAAACCGGTGGGGTTAGGGCTAGA	1
AAACAACGCC	GAAACACCGGTTTGAATCGGTGGGGTTAGAGCTAGAAATAGCAAGTTAAC	1
AAACAACGCC	GAAACACCGGTTTGAACTACCTAGTTCAAACCGGTGGGGTTAGAGCTAGA	1
AAACAATGCT	GAAACACCGGTTTGACCCGGTGGGGTTAGAGCTAGAAATAGCAAGTTAAT	1
AAACACAGGC	GAAACACCGGTAACTTTGTTGATGGTGGGGGGATGGGTTTGGGGTTAGAG	1
AAACACGCCC	GAAACACCGGTTTGAAAGGTGGGGTTAGAGCTAGAAATAGCAAGTTAACC	1
AAACAGCCGC	GAAACACCGGTCGGCGGCCGGTTAGAGCTAGAAATAGCAAGTTAACCTAA	1
AAACCCCGAG	GAAACACCGGTGCCCTTCCTCTCACCTGATTACTTAATCCGTGAGGATAG	1
AAACCTGCTC	GAAACACCGGTGCATTCGAAAGTCCGGTCGTAGTGTGGACGAGGGGTTAG	1
AAACGACCTA	GAAACACCGGTGCCCTTACTCTCACCTGATTACTTAATCCGTGGGGTTAG	1
AAACGACCTA	GAAACACCGGTGCCCTTGCTCTCACCTGATAACCTGGGGTTAGAGCTAGA	1
AAACGACCTG	GAAACACCGGTGCCCTTACTCTCACCTGATTACTTAATCCGTGGGGTTAG	1
AAACGACGTC	GAAACACCGGTGTACGTATAGACTGAACCAGGGTGTGCAAGTGGGGTTAG	1
AAACGAGGTC	GAAACACCGGTGTACGTATGGACTGAACCAGGGTGTGCAAGAGGGGTTAG	1
AAACGCACTA	GAAACACCGGTGACCTTACTCTCACCTGATTACTTAATCCGTGGGGTTAG	1
AAACGCACTA	GAAACACCGGTGCCCTTACTCTCACCTGATTACTTAATCCGTGGGGTTAG	1
AAACGCACTA	GAAACACCGGTGCCCTTACTCTCACCTGATTGCTTAATCCGTGGGGTTAG	1
AAACGCCATA	GAAACACCGGTGCCCTTACTCTCACCTGATTACTTAATCCGTGGGGTTAG	1
AAACGCCGTA	GAAACACCGGTGCCCTTACTCTCACCTGATTACTTAATCCGTGGGGTTAG	2
AAACGCGATA	GAAACACCGGTGCCCTTACTCTCACCTGATTACTTAATCCGTGGGGTTAG	1
AAACGCTCTA	GAAACACCGGTGCCCTTACTCTCACCTGATTACTTAATCCGTGGGGTTAG	1
AAACGGCCTA	GAAACACCGGTGCCCTTACTCTCACCTGATTACTTAATCCGTGGGGTTAG	1
AAACGGCGAT	GAAACACCGGTAACTATATTCATGCGATATCGCCGTATCAGTGGATACAG	1
AAACGGTCGC	GAAACACCGGTGCATTCGAAAGTCCGGTCGTAGTGTGGACGTGGGGTTAG	1
AAACGTCCTA	GAAACACCGGTGCCCTTACTCTCACCTGATTACTTAATCCGTGGGGTTAG	1
AAACGTCGTA	GAAACGCCGGTGTACGTATGGACTGAACCAGGGTGTGCAAAAGTGGGGTT	1
AAACTAAAAC	GAAACACCGGTAACTATATTCATGCGATATCGCCGTATCAGTGGGGTTAG	1
AAACTAGGAT	GAAACACCGGTACCTTTGTTGATGCTGGGTGGAAGGTGGGGTTAGAGCTA	1
AAACTCATGC	GAAACACCGGTAACTATATTCATGCGATATCGCCGTATCAGTGGGGTTAG	1
AAACTCGCGC	GAAACACCGGTGCATTCGAAGGTCCGGTCGTAGTGTGGACGTGGGGTTAG	1
AAACTGACAC	GAAACACCGGTACCTATATTCATGCGATATCGCCGAATCGGTGGGGTTAG	1
AAACTTAACT	GAAACACCGGTCGGGGCCACTCAGTGGTGGGGTTAGAGCTAGAAATAGCA	1
AAACTTAGAT	GAAACACCGGCAACTATATTCATGCGATATCGCGGTATCGGTGGGGTTAG	1
AAAGAACTAA	GAAACACCGGTGCCCTTACTCTCACCTGATTACTTAATCCGTGGGGTTAG	1
AAAGACATAC	GAAACACCGGTGCCCTTACTCTCACCTGATTACTTAATCCGTGGGGTTAG	1
AAAGACCCAA	GAAACACCGGTGCCCTTACTCTCACCTGATTACTTAATCCGTGGGGTTAG	1
AAAGAGGCCC	GAAACACCGGTTTGAACTACCTAGTTCAAACCGGTGGGGTTAGAGCTAGG	1
AAAGATCGGC	GAAACACCGGTAAACGGCAAACGAGGAACGAAATATAGCAAGTTAACCAG	1
AAAGCCATAA	GAAACACCGGTGCCCTTACTCTCACCTGATTACTTAATCCGTGGGGTTAG	1
AAAGCCGTCC	GAAACACCGGTGCCCTTACTCTCACCTGATTACTTAATCCGTGGGGTTAG	1
AAAGCGTCGT	GAAACACCGGTGTACGTATGGACTGAACCAGGGTGTGCAAGTGGGGTTAG	1
AAAGCTATAC	GAAACACCGGTGCCCTTACTCTCACCTGATTACTTAATCCGTGGGGTTAG	1
AAAGGCATAT	GAAACACCGGTGCCCTTACTCTCACCTGATTACTTAATCCGTGGGGTTAG	1
AAAGGCCATA	GAAACACCGGTCGGCGGCGAGCTAGAAATAGCAAGTTAACCTAAGGCTAG	1
AAAGGCCCTA	GAAACACCGGTGCCCTTACTCTCACCTGATTACTTAATCCGTGGGGTTAG	1
AAAGGCCTTT	GAAACACCGGTGCCCTTACTCTCACCTGATTACTTAATCCGTGGGGTTAG	1
AAAGTGTCGT	GAAACACCGGTGTACGTATGGACTGAACCAGGGTGTGCAAGTGGGGTTAG	1
AAAGTTATCC	GAAACACCGGTAACTATATTCATGCGAGATCGCCGTATCAGTGGGGTTAG	1
AAATCAGGTT	GAAACACCGGTCGATTCATATCGAAACCTTCCCGAGACAGTGGGGTTAGA	1
AAATCGGCCT	GAAACACCGGTCCGTAGGAGACCCGTGTGGCATGTACCTGTGGGGTTAGA	1
AAATCGTCGT	GAAACACCGGTGTACGTATGGACTGAACCAGGGTGTGCAAGTGGGGTTAG	3
AAATCTGCCT	GAAACACCGGTCCGTAGGAGACCCGTGTGGCATGTACCTCTGTGGGGTTA	1
AAATCTGGGT	GAAACACCGGTTACATTGAGGGTTAGAGCTAGAAATAGCAAGTTAACCTA	1
AAATGCCCTA	GAAACACCGGTGCCCTTACTCTCACCTGATTACTTAATCCGTGGGGTTAG	1
AAATGTGGTT	GAAACACCGGTCGATTCATATCGAAACCTTCCCGTGACAGTGGGGTTAGA	1
AAATTGTGGT	GAAACACCGGTCGATTCATATCGAAACCTTCCCGTGACAGTGGGGTTAGA	1
AACAACGCAA	GAAACACCGGTTTGAACTAGAAATAGCAAGTTAACCTAAGGCTAGTCCGT	1
AACAACGGCA	GAAACACCGGTTTGAACTAGAAATAGCAAGTTAACCTAAGGCTAGTCCGT	1
AACAACGGGC	GCTAGAAATAGCAAGTTAACCTAAGGCTAGTCCGTTATCAACTTGAAAAA	1
AACAACTCTC	GAAACACCGGTTTGAACTACCTAGGTCAAACCGGTGGTAGTAGAGCTAGA	1
AACAAGGCAC	GCTAGAAATAGCAAGTTAACCTAAGGCTAGTCCGTTATCAACTTGAAAAA	1
AACAATAGAG	GAAACACCGGTTATAGGGTTAGAGCTAGAAATAGCAAGTTAACCTAGGGC	1
AACAATCGGT	GAAACACCGGTCGATTCATATCGAAACCTTCCCGTGACAGTGGGGTTAGA	1
AACACAGGGG	GAAACACCGGTAGCACTTTGTGGGGTTAGAGCTAGAAATAGCAAGTTAAC	1
AACACCGCCA	GAAACACCGGTTTGAACTACCTAGCTCAAACCGGTGGGGTTAGAGCTAGA	1
AACACCGCGC	GAAACACCGGTTTGAACTAGAAATAGCAAGTTAACCTAAGGCTTGTCCGT	1
AACACGGCCC	GAAATAGCAAGTTAACCTAAGGCTAGTCCGTTATCAACTTGAAAAAGTGG	1
AACATCGCAC	GCTAGAAATAGCAAGTTAACCTAAGGCTAGTCCGTTATCAACTTGAAAAA	1
AACATCGGCC	GCTAGAAATAGCAAGTTAACCTAAGGCTAGTCCGTTATCAACTTGGAGAT	1
AACATCGTCG	GAAACACCGGTGTACGTATGGACTGAACCAGGGTGTGCAAGTGGGGTTAG	1
AACATGCGGT	GAAACACCGGTCGATTCATATCGAAACCTTCCCGTGACAGTGGGGTTAGA	1
AACATTAGGT	GAAACACCGGTCGATTCATATCGAAACCTTCCCGTGACAGTGGGGTTAGA	2
AACCAACGCC	GAAACACCGGTTTGAACTACCTAGTAGCAAGTTAACCTAAGGCTAGTCCG	1
AACCAAGTCC	GAAACACCGGTAGCAAGTGCGAGACGTGTTTATGGGGTTAGAGCTAGAAA	1
AACCATCGGT	GAAACACCGGTCGATTCATATCGAAACCTTCCCGTGACAGTGGGGTTAGA	1
AACCATGCCC	GAAACACCGGTTTGAACTAGAAATAGCAAGTTAACCTAAGGCTAGTCCGT	1
AACCGCACCA	GAAACACCGGTGCCCTTACTCTCACCTGATTACTTAATCCGTGGGGTTAG	1
AACCTCGCCC	GAAACACCGGTTTGAACAAGAAATAGCAGGTTAACCTAAGGCTAGTACGT	1
AACCTGGGTC	GAAACACCGGTAGCAAGTGCGAGACGTGTTTGTGGGGTTAGAGCTAGAAA	1
AACCTTACCG	GAAACACCGGTCGGGGCCAGCTAGAGATAGCAAGTTAACCTAAGGCTAGT	1
AACCTTCGGT	GAAACACCGGTCGATTCATATCGAAACCTTCCCGTGACAGTGGGGTTAGA	1
AACGAAGTAA	GAAACACCGGTGCCCTTACTCTCACCGGGTTACTTGATCCGTGGGGATAG	1
AACGAAGTAC	GAAACACCGGTGCCCTTACTCTCACCTGATTACTTAATCCGTGGGGTTAG	1
AACGAAGTCT	GAAACACCGGTTCCCGTCCAGGGGGGTTAGAGCGATGAATAGCAAGTTAA	1
AACGAATCAT	GAAACACCGGTCTCGAGTGAGGTGTTCAGGGTGGGGTTAGAGCTAGAAAT	1
AACGAATCCT	GAAACACCGGTCTCGAGTGAGGTGTTCAGGGTGGGGTTAGAGCTAGAAAT	1
AACGACGCAC	GAAACACCGGTGCCCTTACTCTCACCTGATTACTTAATCCGTGGGGTTAG	1
AACGACTTCC	GAAACACCGGTGCCCTTACTCTCACCTGATTACTTAATCCGTGGGGTTAG	1
AACGATCTAA	GAAACACCGGTGCCCTTACTCTCACCTGATTACTTAATCCGTGGGGTTAG	1
AACGCACTCG	GAAACACCGGTGCCCTTACTCTCACCTGATTACTTAATCCGTGGGGTTAG	1
AACGCAGCAC	GAAACACCGGTGCCCTTACTCTCACCTGATTACTTAATCCGTGGGGTTAG	1
AACGCCACAA	GCTCTCACCTGATTACTTAATCCGTGGGGTTAGAGCTAGAAATAGCAAGT	1
AACGCCCGGA	GAAACACCGGTGCCCTTACTCTCACCTGATTACTTAATCCGTGGGGTTAG	1
AACGCCCTAC	GAAACACCGGTGCCCTTACTCTCACCTGATTACTTAATCCGTGGGGTTAG	2228
AACGCCCTAC	GAAACACCGGTGCCCTTACTCTCACCTGATTACTTAATCCCGTGGGGTTA	51
AACGCCCTAC	GAAACACCGGTGCCCTTACTCTCACCTGATTACTTGGGGTTAGAGCTAGA	34
AACGCCCTAC	GAAACACCGGTGCCCTTACTCTCACCTGATAACCTGGGGTTAGAGCTAGA	21
AACGCCCTAC	GCTCTCACCTGATTACTTAATCCGTGGGGTTAGAGCTAGAAATAGCAAGT	16
AACGCCCTAC	GAAACACCGGTGCCCTTACTCTCACCTGAGCTAGAAATAGCAAGTTAACC	14
AACGCCCTAC	GAAACACCGGTGCCCTAACCTAAGGCTAGTCCGTTATCAACTTGAAAAAG	9
AACGCCCTAC	GAAACACCGGTGCCCTTACTCTCACCTGATTACTTAATCGTGGGGTTAGA	9
AACGCCCTAC	GAAACACCGGTGCCCTTACTCTAGAAATAGCAAGTTAACCTAAGGCTAGT	6
AACGCCCTAC	CAAAACACCGGTGCCCTTACTCTCACCTGATTACTTAATCCGTGGGGTTA	4
AACGCCCTAC	GAACACCGGTGCCCTTACTCTCACCTGATTACTTAATCCGTGGGGTTAGA	2
AACGCCCTAC	GAAACACCGGTAAATTTGAGGCCCCGGCATGCAGGAGGCCGTGGGGTTAG	1
AACGCCCTAC	GAAACACCGGTAAATTTGAGGCTCCGGCATGCAGGAGGCCGTGGGGTTAG	1
AACGCCCTAC	GAAACACCGGTCGGCGGCAATCGTGGGTGGGGTTAGAGCTAGAAATAGCA	1
AACGCCCTAC	GAAACACCGGTCGGGGGGACTAAGTGGTGGGGTTAGAGCTAGAAATAGCA	1
AACGCCCTAC	GAAACACCGGTGCATTCGAAAGTCCGGTCGTAGTGTGGACGTGGGGTTAG	1
AACGCCCTAC	GAAACACCGGTGCCCTACTCTCACCTGATTACTTAATCCGTGGGGTTAGA	1
AACGCCCTAC	GAAACACCGGTGCCCTTACTCTCACCTGATACTTAATCCGTGGGGTTAGA	1
AACGCCCTAC	GAAACACCGGTGCCCTTACTCTCACCTGATTACTTTGGGGTTAGAGCTAG	1
AACGCCCTAC	GAAACACCGGTGCCCTTACTCTCCCTGATTACTTAATCCGTGGGGTTAGA	1
AACGCCCTAC	GAAACACCGGTGCCCTTCTCTCACCTGATTACTTAATCCGTGGGGTTAGA	1
AACGCCCTAC	GAAACACCGGTGTGGCTGAGAGTCCGGCAATGGTGTGGCTGTGGGGTTAG	1
AACGCCCTAC	GAAACACCGGTGTGGCTGAGAGTTCGGCGATGGTGTGGCTAGGGGGATAG	1
AACGCCCTAC	GAAACACCGGTTACAATTGGGGTTAGAGCTAGAAATAGCAAGTTAACCTA	1
AACGCCCTAC	GAAACACCGGTTAGAAATAGCAAGTTAACCTAAGGCTAGTCCGTTATCAA	1
AACGCCCTAC	GAAACACCGGTTTACGTTGCATCGGTTTGTGGGGTTAGAGCTAGAAATAG	1
AACGCCCTAC	GAAACACCGGTTTACTTACTATCACCTGAGCTAGTAATAGCAAGTTTACC	1
AACGCCCTAC	GAAACACCGGTTTCCGTTCTCTCACCTGATTACTTAATCTGGCAGGTTAG	1
AACGCCCTAC	GAAACACCGGTTTGGCTGAGAGTCCGGCAATGGTGTGGCTGTGGGGATAG	1
AACGCCCTAC	GAAACCCGGTGCCCTTACTCTCACCTGATTACTTAATCCGTGGGGTTAGA	1
AACGCCTAAA	GAAACACCGGTACATTTAAGGCCACGTCATTCCTTAATCCGTGGGGTTAG	1
AACGCGTTAA	GAAACACCGGTGCCCTTACTCTCACCTGATTACTTAATCCGTGGGGTTAG	1
AACGCTCGCC	GAAACACCGGTGCCCTTACTCTCACCTGATTACTTAATCCGTGGGGTTAG	1
AACGGACTAA	GAAACACCGGTGCCCTTACTCTCACCTGATTACTTAATCCGTGGGGTTAG	1
AACGGCATAA	GAAACACCGGTGCCCTTACTCTCACTTGATTACTTAATCCGTGGGGTTAG	1
AACGGTCAAC	GAAACACCGGTGCCCTTACTCTCACCTGATTACTTAATCCGTGGGGTTAG	1
AACGTAACCG	GAAACACCGGTCGGGGCCACTCAGTGGTGGGGGTAGAGCTAGAAATAGCA	1
AACGTACTAA	GAAACACCGGTGCCCTTACTCTCACCTGATTACTTAATCCGTGGGGTTAG	1
AACGTAGTAC	GAAACACCGGTGCCCTTACTCTCACCTGATTACTTAATCCGTGGGGTTAG	1
AACGTATGAC	GAAACACCGGTGCCCTTACTCTCACCTGATTACTTAATCCGTGGGGTTAG	1
AACGTCCATC	GAAACACCGGTTCCCTTACTCTCACCTGATTACTTAATTCGGGGGGTTAG	1
AACGTTGGGT	GAAACACCGGTCGATTCATATCGAAACCTTCCCGTGACAGTGGGGTTAGA	1
AACTACCAAT	GAAACACCGGTGCCCTTACTCTCACCTGGTTTCTTAATCCATGTAGTTAG	1
AACTCTCGGC	GAAACACCGGTGCCCTTACTCTCACCTGATTACTTAATCCGTGGGGTTAG	1
AACTTCGCAC	GAAACACCGGTTTGAACTAGAAATAGCAAGTTAACCTAAGGCTAGTCCGT	1
AACTTCGCCC	GAAACACCGGTTTGAACTACCTAGTTCAAACCGGTGGGGTTAGAGCTGGA	1
AACTTCTGTT	GAAACACCGGTCGTTTCGTATCATCACCGTCCTAGAGCTGGGAGTAGCGA	1
AACTTTACCG	GAAACACCGGTCGGGGCCACTCAGTGGTGGGGTTAGAGCTAGAAATAGCA	1
AAGAAAGCCC	GAAACACCGGTTTGCACTACCTAGTTCAAACCGGTGGGGTTAGAGCTACA	1
AAGAAATTAT	GAAACACCGGTAACTATGTTCATGCGATATCGCCGTATCAGTGGGGTTAG	1
AAGAACACCC	GAAACACCGGTTTGAACTACCTAGTAGCAAGTTAACCTAAGGCTAGTCCG	1
AAGAACCGCC	GAAACACCGGTTTGAAGTAGAAATAGCAAGTTATACTAAGGCTAGTCCGA	1
AAGAACCTCG	GAAACACCGGTGCATTCGAAAGTCCGGTCGTAGTGTGGACGTGGGGTTAG	2
AAGAACGCTC	GAAACACCGGTTTGAACTAGAAATAGCAAGTTAACCTAAGGCTAGTCCGT	1
AAGAAGGCCC	GAAGCACCGGTCGGCGGCAATCGTGGGTGGGGTTAGAGCTAGAAATAGCA	1
AAGAATACTT	GAAACACCGGTCTCGAGTGAGGTGTTCAGGGTGGGGTTAGAGCTAGAAAT	1
AAGAATCCTT	GAAACACCGGTCTCGAGTGAGGTGTTCAGGGTGGGGTTAGAGCTAGAAAT	3
AAGAATCCTT	GAAACACCGGTCTCGAGTGAGGTGTTCAGGGGTGGGGTTAGAGCTAGAAA	1
AAGAATGCTT	GAAACACCGGTCTCGAGTGAGGTATTCAGGGTGGGGTTAGAGCTAGAAAT	1
AAGAATGGCT	GAAACACCGGTTTACATTACATCGGGGTTAGGGCTAGGCATAAAAAGTTA	1
AAGACACAGA	GAAACACCGGTAGCAAGTGCGAGACGTGTTTGTGGGGTTAGAGCTAGAAA	1
AAGACACGCG	GAAACACCGGTGCATTCGAAAGTCCGGTCGTAGTGTGGACGTGGGGTTAG	1
AAGACACTCG	GAAACACCGGTGCATTCGAAAGTCCGGTCGTAGTGTGGACGTGGGGTTAG	2
AAGACACTCG	GAAACACCGGTGCATTCGAAAGTCCGGTCGTGGTGTGGACGTGGGGTTAG	1
AAGACAGCCA	GAAACACCGGTAGCAAGGGCGAGACGTGTTTGTGGGGTTAGAGCTAGAAA	1
AAGACATTCG	GAAACACCGGTGCATTCGAAAGTCCGGTCGTAGTGTGGACGTGGGGTTAG	1
AAGACCAGCG	GAAACACCGGTGCATTCGAAAGTCCGGTCGTAGTGTGGACGTGGGGTTAG	1
AAGACCATAG	GAAACACCGGTGCATTCGAAAGTCCGGTCGTAGTGTGGACGTGGGGTTAG	1
AAGACCATCG	GAAACACCGGTGCATTCGAAAGTCCGGTCGTAGTGTGGACGTGGGGTTAG	1
AAGACCCACG	GAAACACCGGTGCATTCGAAAGTCCGGTCGTAGTGTGGACGTGGGGTTAG	1
AAGACCCTAG	GAAACACCGGTGCATTCGAAAGTCCGGTCGTAGTGTGGACGTGGGGTTAG	1
AAGACCCTAG	GAAACACCGGTGCATTCGAAAGTCCGGTCGCAGTGTGGACGTGGGGTTAG	1
AAGACCCTGG	GAAACACCGGTGCATTCGAAAGTCCGGTCGTAGTGTGGACGTGGGGTTAG	1
AAGACCTCCC	GAAACACCGGTTTGAACTACCTAGTTCAAACACCGGTTTGAACTACCTAG	1
AAGACGATAC	GAAACACCGGTGCCCTTACTCTCACCTGATTACTTAATCCGTGGGGTTAG	1
AAGACGCTCG	GAAACACCGGTGCATTCGAAAGTCCGGTCGTAGTGTGGACGTGGGGTTAG	1
AAGACGGCCC	GAAACACCGGTTTGACCTAACTCTGTCAGGGGGGAGAGCTAGAAACTGGA	1
AAGACTCTCG	GAAACACCGGTGCATTCGAAAGTCCGGTCGTAGTGTGGGCGTGGGGTTAG	1
AAGACTGCAT	GAAACACCGGTCCGTAGGAGACCCGTGTGGCATGTACCTGTGGGGTTAGA	1
AAGAGCATAT	GAAACACCGGTTAAGCAGAGGGGTTAGAGCTAGAAATAGCAAGTTAACCT	1
AAGAGCCTCG	GAAACACCGGTGCATTCGAAAGTCCGGTCGTAGTGTGGACGTGGGGTTAG	1
AAGAGTCCCT	GAAACACCGGTCTCGAGTGAGGTGTTCAGGGTGGGGTTAGAGCTAGAAAT	1
AAGAGTCGAC	GAAACACCGGTGTACGTATGGACTGAACCAGGGTGTGCAAGTGGGGTTAG	1
AAGATAGCCC	GAGACACCGGTTTGAACTACCTAGTTCAAACCGGTGGGGTTAGAGCTAGA	1
AAGATCCTAG	GAAACACCGGTGCATTCGAAAGTCCGGTCGTAGTGTGGACGTGGGGTTAG	1
AAGATCCTCG	GAAACTCCGGTGCATTCGAAAGTCCGGTCGTAGTGTGGACGTGGGGTTAG	1
AAGATTAGCA	GAAACACCGGTTTACGTTGTATCGGCTGTGGGGTTAGACCTAGAAATAGC	1
AAGCAACGGC	GAAACACCGGTTTGAACTAAGTGGGGTTAGAGCTAGAAATAGCAAGTTAA	1
AAGCATACCT	GAAACACCGGTTTGAACTACCTAGTTCAAACCGGTGGGGTTAGAGCTAGA	1
AAGCATACCT	GAAACACCGGTTTACGTTGCATCGGTGTGGAGTTAGAGCTAGAAATAGCA	1
AAGCCTAGAC	GAAACACCGGTAACTATATTCATGCGATATCGCCGTATCAGGGGAGATAA	1
AAGCCTGCCT	GAAACACCGGTCCGTAGGAGACCCGTGTGGCATGTACCTGTGAGGTTAGA	1
AAGCGTAGAT	GAAACACCGGTTTACGTTGCATCGGTGTGGGGTTAGAGCTAGAAATAGCA	1
AAGCGTCGCT	GAAACACCGGTTTACGTCGCATAGGAGTGGGGTTAGAGCTAGGAATAGCA	1
AAGCGTCGGC	GAAACACCGGTGTACGTATGGACTGAACCAGGGTGTGCAAGTGGGGTTAG	1
AAGCGTCGTA	GAAACACCGGTGTACGTATGGACTGAACCAGGGTGTGCAAGTGGGGTTAG	1
AAGCGTGGTC	GAAACACCGGTGTACGTATGGACTGAACCAGGGTGTGCAAAAGTGGGGTT	1
AAGCTTATCC	GAAACACCGGTTTACGTTGCATCGGTGTGGGGTTAGAGCTAGAAATAGCA	1
AAGCTTTTCT	GAAACACCGGTTTACGTTGCATCGGGGTTAGAGCTAGTAATAGCAAGTTA	1
AAGGAACTAT	GAAACACCGGTGCCCTTGCTTTCACCTGATTACTTAATCCGTGGGGTTAG	1
AAGGACATAC	GAAACACCGGTGCCCTTACTCTCACCTGATTACTTAATCCGTGGGGTTAG	1
AAGGACCTCC	GAAACACCGGTGCCCTTACTCTCACCTGATTACTTAATCCGTGGGGTTAG	1
AAGGACGTAC	GAAACACCGGTGCCCTTACTCTCACCTGATTACTTAATCCGTGGGGTTAG	1
AAGGCATTAA	GAAACACCGGTGCCCTTACTCTCACCTGATTACTTAATCCGTGGGGTTAG	1
AAGGCGGTAC	GAAACACCGGTGCCCTTACTCTCACCTGATTACTTAATCCGTGGGGTTAG	1
AAGGCTCGCG	GAAACACCGGTGCATTCGAAAGTCCGGTCGTAGAGTGGACGTGGGGTTAG	1
AAGGCTGCCT	GAAACACCGGTCCGTAGGAGACCCGTGTGGCATGTACCTGTGGGGTTAGA	1
AAGGTCTTAA	GAAACACCGGTGCCCTTACTCTCACCTGATTACTTAATCCGTGGGGTTAG	1
AAGGTTGTCT	GAAACACCGGTGGTTAGAGCTAGAAATAGCAAGTTAACCTAAGGCTAGTC	1
AAGTATGCCG	GAAACACCGGTCCGTAGGAGACCCGTGTGGCATGTACCTGTGGGGTTAGA	1
AAGTATGCCT	GAAACACCGGTCCGTAGGAGACCCGTGTGGCATGTACCTGTGGGGTTAGA	1
AAGTCACTAC	GAAACACCGGTGCCGTTACTCCGGCGTGGGGATAGAGTCAGAAGTAGTAA	1
AAGTCCCTCC	GAAACACCGGTACCCTGACTCTCACCTGATTACTTAATCCGTGGGGATAG	1
AAGTCGCTAA	GAAACACCGGTCCCATTGCTCTCACCTGATTACTTAATCCGTGGAGATAG	1
AAGTCTCTAC	GAAACACCGGTGCCCTTACTCTCACCTGATTACTTAATCCGTGGGGTTAG	1
AAGTCTGACT	GTAACACCGGTCCGTAGGAGACCCGTGTGGCATGTACCCTGTGGGGTTAG	1
AAGTCTGCAT	GAAACACCGGTCCGTAGGAGACCCGTGTGGCATGTACCTGTGGGGTTAGA	1
AAGTCTGCAT	GAAACACCGGTCCGTAGGAGACCCGTGTGGCATATGTGGGGTTAGAGCTA	1
AAGTCTGGCT	GAAACACCGGTGACATTGGGTACAGGGGTGGGGTTAGAGCTAGAAATAGC	1
AAGTGAGCCT	GAAACACCGGTCCGTAGGAGACCCGTGTGGCATGTACCTGTGGGGTTAGA	1
AAGTGATGCC	GAAACACCGGTTCCCGTCCAGTGGGGTTAGAGCTAGAAATAGCAAGTTAA	1
AAGTGGAGCC	GAAACACCGGTTCCCGTCCAGTGGGGTTAGAGCTAGAAATAGCAAGTTAA	1
AAGTGTCGTC	GAAACACCGGTGTACGTATGGACTGAACCAGGGTGTGCAAGTGGGGTTAG	1
AAGTGTTGTC	GAAACACCGGTGACATTGGGTACAGGGTTAGAGCTAGAAATAGCAAGTTA	1
AAGTTACCGC	GAAACACCGGTCGGAGCCACTCAGTGGTGGGGTTAGAGCTAGAAATAGCA	1
AATAATCGGC	GAAACACCGGTACCTTTGTTGATGCTGGGTGGGGTTAGAGCTAGAAATAG	1
AATACTCGGA	GAAACACCGGTACCTTTGTTGATGCTGGTGGGGTTAGAGCTAGAAATAGC	1
AATACTCGGC	GAAACACCGGTACCTTTGTTGATGCTGGGTGGAAGGAAATAGCAAGTTAA	1
AATACTCGGC	GAAACACCGGTACCTTTGTTGATGCTGGGTGGGGTTAGAGCTAGGAATAG	1
AATACTCGGT	GAAACACCGGTACCTTTGTTGATGCTGGGTGGAAGGAATGGTGGGGTTAG	1
AATAGACGTC	GAAACACCGGTGTACGTATGGACTGAACCAGGGGTGGGGTTAGAGCTAGA	1
AATAGGCGTC	GAAACACCGGTGTACGTATGGACTGAACCAGGGTGTGCAAGTGGGGTTAG	1
AATAGTAGTC	GAAACGCCGGTGTACGTATGGACTGAACCAGGGTGTGCAAGTGGGGTTAG	1
AATAGTCTTC	GAAACACCGGTGCACGTATGGACTGAACCAGGGTGTGCAAGTGGGGTTAG	1
AATAGTGTTC	GAAACACCGGTGTACGTATGGACTGAGCCAGGGAGTGCAAGTGGGGTTAG	1
AATATGCGGA	GAAACACCGGTACCTTTGTTGATGCTGGGTGGAAGGTACCGGTGGGGTTA	1
AATATGCGTC	GAAACACCGGTCCGTAGGAGACCCGTGTGGCATGTACCTGTGGGGTTAGA	1
AATATGGGTT	GAAACACCGGTCGATTCATATCGAAACCTTCCCGTGACAGTGGGGTTAGA	1
AATCACTGTA	GAAACACCGGTGCCCTTACTCTCACCTGATTACTTAATCCGTGGGGATAG	1
AATCGCAGTC	GAAACACCGGTGTACGTATGGACTGAACCAGGGTGTGCAAGTGGGGTTAG	1
AATCGTGGTA	GAAACACCGGTGTACGTATGGACTGAACCAGGGGGTGCAAAAAGTGGGGT	1
AATCTGATAC	GAAACACCGGTAACTATATTCATGCGATATCGCCGTATCAGTGGGGTTAG	1
AATGAATAGA	GAAACACCGGTTTACGTTGGAAATAGCAAGTTAACCTAAGGCTAGTCCGT	1
AATGAGCATA	GAAACACCGGTTAAGCCGAGGAGTTAGAGCTATAAATAGCAAGTTAACCT	1
AATGAGCATA	GAAACACCGGTTAAGCCGAGGAGTTTCGTTAGAGCTAGAAATAGCAAGTT	1
AATGATCAGC	GAAACACCGGTTTACGCTGCATCGGTGTGGGGTTAGTGCTAGAAATAGCA	1
AATGCACCGC	GAAACACCGGTATACAAAGATACGAGTACAAATAGGTTAGTGCTATAAAT	1
AATGCATAGC	GAAACACCGGTTTCCGTTGCATCGGGGTTAGAGCTAGAAATAGCAAGTTA	1
AATGCCTAGC	GAAACACCGGTTTACGTTGCATCGGTGTGGGGTTAGAGCTAGAAACAGCA	1
AATGCGTAGC	GAAACACCGGTTTACGTTGCATCGGTGTGGGGTTAGAGCTAGAAATAGCA	1
AATGCTTAGA	GAAACACCGGTTTACGTTGCATCGGTGTGGGGTTAGAGCTAGAAATAGCA	1
AATGGTCGGT	GAAACACCGGTTACATTGAGGGTTAGAGCTAGAAATAGCAAGTTAACCTA	1
AATGGTTAGC	GAAACACCGGTTTACGTTGCATCGGTGTGGGGTTAGAGCTAGAAATAGCA	1
AATGGTTAGT	GAAACACCGGTTTACGTTGCATCGGGGTGGGGTTAGAGCTAGAAATAGCA	1
AATGTTGGCT	GAAACACCGGTGGGGTTAGAGCTAGAAATAGCAAGTTAACCTAAGGCTAG	1
AATGTTTAGC	GAAACACCGGTTTACGTTGCATCGGTTTGTGGGGTTAGAGCTAGAAATAG	1
AATGTTTAGT	GAAACACCGGTTTACGTTGCATCGGTTGTGGGGTTAGAGCTAGAAATAGC	1
AATTATCGTC	GAAACACCGGTCCGGAGGATACCCGGGTGGCATGTAACTGGGGGGGTAAG	1
AATTCTTAGC	GAAACACCGGTTTACGTTGCATCGGTGTGGGGTTAGAGCTAGAAATAGCA	1
AATTGACCGC	GAAACACCGGTCGGGGCCACTCAGTGGTGGGGTTAGAACTAGAAATAGCA	1
AATTGGCGAT	GAAACACCGGTTACATTGAGGGTTAGAGCTAGAAATAGCAAGTTAACCTA	1
AATTTATCGC	GAAACACCGGTCGGGGCCACTCAGTGGTGGGGTTAGAGCTAGAAATAGCA	1
AATTTCCCGT	GAAACACCAGTCGGAGCCACTCAGTGGTGGGGTTAGAGCTAGAAATAGCA	1
AATTTCGGAT	GAAACACCGGTCGATTCATATCGAAACCTTCCCGTGACAGTGGGGTTAGA	1
AATTTGCGTC	GAAACACCGGTCCGTAGGAGAACCGTGTGGCATGTACTGGGGTTAGAGCT	1
ACAAAAATCC	GAAACACCGGTTTGAACTACCTAGTTCAAACCGGTGGGGTTAGAGCTAGA	1
ACAAAAGGCC	GAAACACCGGTTTAGAGCTAGAAATAGCAAGTTAACCTAAGGCTAGTCCG	1
ACAAACCCTC	GAAACACCGGTCGGCGGCAATCGAGGGTGGGGTTAGAGCTAGGAATAGCA	1
ACAAATCCTT	GAAACACCGGTCTCGAGTGAGGTGTTCAGGATGTGGGGATAGAGCTAGGA	1
ACAACGTCGT	GAAACACCGGTGTACGTATGGACTGAACCAGGGTGTGCAAGTGGGGTTAG	2
ACAACGTCGT	GAAACACCGGTGTACGTACGGACTGAACCAGGGTGTGCAAGTGGGGTTAG	1
ACAAGCTCGC	GAAACACCGGTGCATTCGAAAGTCCGGTCGTAGTGTGGACGTGGGGTTAG	1
ACACAAAGCC	GAAACACCGGTTTGAACTACCTAGTTCAAGCCGGTGGGGTTAGAGCTAGA	1
ACACAAAGCC	GAAACACCGGTTTGAACTACCTAGTTCAAACCGGTGGGGTTAGAGCTAGA	1
ACACAACGAC	GCTAGAAATAGCAAGTTAACCTAAGGCTAGTCCGTTATCAACTTGAAAAA	1
ACACAACGCA	GAAACACCGGTTTGAACTAGAAATAGCAAGTTAACCTAAGGCTAGTCCGT	1
ACACAACGTT	GAAACACCGGTTTGAACTACCTAGTTCAAACCGGTGGGGTTAGAGCTAGA	1
ACACAATGCC	GCTAGAAATAGCAAGTTAACCTAAGGCTAGTCCGTTATCAACTTGAAAAA	1
ACACAATGCC	GAAACACCGGTTTGAACTAGAAATAGCAAGTTAACCTAAGGCTAGTCCGT	1
ACACACCGCC	GAAACACCGGTTTGAACTACCTAGTAGCAAGTTAACCTAAGGCTAGTCCG	1
ACACCACGCC	GCTAGAAATAGCAAGTTAACCTAAGGCTAGTCCGTTATCAACTTGAAAAA	1
ACACCACGCC	GAAACACGGGTTAGAGCTAGAAATAGCAAGTTAACCTAAGGCCAGTCCGT	1
ACACCCCGCG	GAAACACGGGTTAGAGCTAGAAATAGCAAGTTAACCTAAGGCTAGTCCGT	1
ACACCTTTGT	GAAACACCGGTTTCAGTGTGGGGTTAGAGCTAGAAATAGCAAGTTAACCT	1
ACACGACGCG	GAAACACCGGTTTGAACTACCTAGAAATAGCAAGTTAACCTAAGGCTAGT	1
ACACGCCGTC	GAAACACCGATGTACGCATATACTGAACTAGGGGGTGCAGGGGGGGTTGA	1
ACACGTCTAC	GAAACACCGGTAACTATATTCATGCGATATCGCCGTATCAGTGGGGTTAG	1
ACACTACGCC	GAAACACCGGTTTGAACTACCTAGTTCAAACCGGTGGGGTTAGAGCTAGA	1
ACACTCCCGC	GAAACACCGGTGCATTCGAAAGTCCGGTCGTAGTGTGGACGTGGGGTTAG	1
ACACTCGACG	GAAACACCGGTACCTTTGTTGATGCTGGGGGGATGGAGTTTGAGGGGTTA	1
ACACTCTAGC	GAAACACCGGTGCATTCGAAAGTCCGGTCGTAGTGTGGACGTGGGGTTAG	1
ACAGAACGCA	GAAACACCGGTTTGAACTAGAAATAGCAAGTTAACCTAAGGCTAGTCCGT	1
ACAGAACGCG	GAGACACCGGTTTGAACAGAGCTAGAAATAGCAAGTTAACCTAAGGCTAG	1
ACAGAACGGC	GAAACACCGGTCGGCGGCGGTGGGGTTAGAGCTAGAAATAGCAAGTTAAC	1
ACAGACCTGC	GAAACACCGGTCGGCGGCAATCGTGGGGTGGGGTTAGAGCTAGAAATAGC	1
ACAGACGGTC	GAAACACCGGTCGATTCATATCGAAACCTTCCCGTGACAGAGGGGTTAGA	1
ACAGCAATGT	GAAACATTGGGGTTAGAACTAGAAATAGCAAGTTAACCTAAGGCTAGTCC	1
ACAGCCATAC	GAAACACCGGTGCCCTTACTCTCACCTGATTACTTAATCCGTGGGGTTAG	1
ACAGTACTAC	GAAACACCGGTGCCCTTACTCTCACCTCATTACTTAATCCGTGGGGATAG	1
ACATAACGCT	GAAACACCGGTTTGAACTAGAAATAGCAAGTTAACCTAAGGCTAGTCCGT	1
ACATAGTCGT	GAAACACCGGTGTACGTATGGTCTGAACCGGGGTATGCAAGTGGGGATCG	1
ACATAGTCGT	GAAACACCGGTGTACGTATGGACTGAACCAGGGTGTGCAAGTGGGGTTAG	1
ACATCACTAA	GAAACACCGGTGCCCTTACTCTCACCTGATTACTTAATCCCGTGGGGTTA	1
ACATCAGCCT	GAAACACCGGTCGATTCATATCGAAACCTTCCCGTGACAGTGGGGTTAGA	1
ACATCCGCGC	GAAACACCGGTGCATTCGAAAGTCCGGTCGTAGTGTGGACGTGGGGTTAG	1
ACATCGCAGT	GAAACACCGGTGTACGTATGGACTGAACCAGGGCGAGCTAGTGTGGTTAG	1
ACATCGGCGT	GAAACACAAGTTAACCTAAGGCTAGTCCGTTATCAACTTGAAAAAGTGGC	1
ACATCGTAGA	GAAACACCGGTGTACGTATGGACTGAACCAGGGTGTGCAAGTGGGGTTAG	1
ACATCGTAGT	GAAACACCGGTGTACGTATGGACTGAACCAGGGTGTGCAAGTGGGGTTAG	1
ACATCGTAGT	GAAACACCGGTGTACGTATGGACTGAACCAGGGTGTGCAATAGTGGGGTT	1
ACATCGTCGG	GAAACACCGGTGTACGCATGGACTGAACCAGGGTGTGCAAGTGGGGTTAG	1
ACATCGTCGG	GAAACACCGGTGTACGTATGGACTGAACCAGGGTGTGCAAGTGGGGTTAG	1
ACATCGTGGT	GAAACACCGGTGTACGTATGGACTGAACCAGGGTGTGCAAGTGGGGCTAG	1
ACATTCAGAA	GAAACACCGGTCGATTCATATCGAAACCTTCCCGTGACAGTGGGGTTAGA	1
ACATTCGGTT	GAAACACCGGTCGATTCATATCGAAACCTTCCCGTGACAGTGGGGTTAGA	1667
ACATTCGGTT	GAAACACCGGTCGATTCATATCGAAACCTTCCCGTGACAAGTGGGGTTAG	108
ACATTCGGTT	GAAACACCGGTCGATTCATATCGAAACCTTCCCGTGGGGTTAGAGCTAGA	27
ACATTCGGTT	GACTAGTCCGTTATCAACTTGAAAAAGTGGCACCGAGTCGGTGCTTTTTT	19
ACATTCGGTT	GAAACACCGGTCGCAAGTTAACCTAAGGCTAGTCCGTTATCAACTTGAAA	18
ACATTCGGTT	GAAACAGGCTAGTCCGTTATCAACTTGAAAAAGTGGCACCGAGTCGGTGC	13
ACATTCGGTT	ATTAACCTAAGGCTAGTCCGTTATCAACTTGAAAAAGTGGCACCGAGTCG	9
ACATTCGGTT	GAAACACCGGTCGATTCATATCGAAACCTTCCCGTGAGTGGGGTTAGAGC	7
ACATTCGGTT	GAAACACCGGTCGATTCATATCGAAACCTTCCCGGTTAGAGCTAGAAATA	6
ACATTCGGTT	GAAACACCGGTCGATTCATATCGAAACCTTCCCGTGACATGAGGTTAGAT	6
ACATTCGGTT	GAAACACCGGTCGATTCATATCGAAACCTTCCCCGTGGGGTTAGAGCTAG	5
ACATTCGGTT	GAAACACCGGTCGATTCATATCGACCGTGGGGTTAGAGCTAGAAATAGCA	5
ACATTCGGTT	GTTATCAACTTGAAAAAGTGGCACCGAGTCGGTGCTTTTTTTCCTGCAGG	5
ACATTCGGTT	CAAAACACCGGTCGATTCATATCGAAACCTTCCCGTGACAGTGGGGTTAG	4
ACATTCGGTT	GAAACACCGGTCGATTCATATCGAAACCTTCCCGTTAGAGCTAGAAATAG	4
ACATTCGGTT	GAAACACCGGTCGATTCATATCGAAACCTTCCCGTGACAAAAGTGGGGTT	3
ACATTCGGTT	GAAACACCGGTCGATTCATATCGAAACCTTCCCGTGTGGGGTTAGAGCTA	3
ACATTCGGTT	GAAACACCGGTCGATTCATATCGAAACCTTCCCGGTGGGGTTAGAGCTAG	2
ACATTCGGTT	GAAACACCGGTCGATTCGTATCGAAACCTTCCCGTGAAGGGTTAGAGCTA	2
ACATTCGGTT	AGGGGAGAAACAACCGTCCGTTTATATCCAAAACCTTCCCGGACCGGGGG	1
ACATTCGGTT	CAAAACACCGGTCGATTCATATCGACCGTGGGGTTAGAGCTAGAAATAGC	1
ACATTCGGTT	CAAAACACCGGTCGTTTCATATCGAAACCTTCCCGTGACAGTGGGGTTAG	1
ACATTCGGTT	CCAAACACCGGTCGATTCATATCGAAACCTTCCCGTGACAGTGGGGTTAG	1
ACATTCGGTT	GAAACACCAGTCGATTCATATCGAAACCTTCCCGTGACAAAAGTGGGGTT	1
ACATTCGGTT	GAAACACCGGTAAATTTGAGGCTCCGGCATGCAGGAGGCCGTGGGGTTAG	1
ACATTCGGTT	GAAACACCGGTCGACTCATATCTGAACCGTCCCTAGAGGGGTGGGGTTAG	1
ACATTCGGTT	GAAACACCGGTCGATTCATATCGAAACCTTCCCGCTAGAGCTAGAAATAG	1
ACATTCGGTT	GAAACACCGGTCGATTCATATCGAAACCTTCCCGTGAAGGGTTAGAGCTA	1
ACATTCGGTT	GAAACACCGGTCGATTCATATCGAAACCTTCCCGTTAGAGCTAGGAATAG	1
ACATTCGGTT	GAAACACCGGTCGATTCATATCGAACCTTCCCGTGACAGTGGGGTTAGAG	1
ACATTCGGTT	GAAACACCGGTCGATTCATATCGACCGTGGGGTTAGAGCTAGAAATAGCG	1
ACATTCGGTT	GAAACACCGGTCGGCGGCAATCGTGGGGTGGGGTTAGAGCTAGAAATAGC	1
ACATTCGGTT	GAAACACCGGTCTCGAGTGAGGTGTTCAGGGTGGGGATAGAGCTAGAAAT	1
ACATTCGGTT	GAAACACCGGTCTCGAGTGAGGTGTTCAGGGTGGGGTTAGAGCTAGAAAT	1
ACATTCGGTT	GAAACACCGGTTAAGCCGAGTGGGGTTAGAGCTAGAAATAGCAAGTTAAC	1
ACATTCGGTT	GAAACACCGGTTTACGCTTCATCGGAGTTGGGTTAGAGCTAGAAATAGCA	1
ACATTCGGTT	GAAACACCGGTTTACGTTGCATCGGTTAGTGGGGTTAGAGCTAGAAATAG	1
ACATTCGGTT	GAAACACCGGTTTCCTTGCGTAGATAGCTAGGCTTGACCTTGTAGTCTCA	1
ACATTCGGTT	GAAACCCGGTCGATTCATATCGAAACCTTCCCGTGACAGTGGGGTTAGAG	1
ACATTCGGTT	GAACACCGGTCGATTCATATCGAAACCTTCCCGTGACAGTGGGGTTAGAG	1
ACATTCGGTT	GAAGCACCGGTTTACGTTGCATCGGTGTGGGGTTAGAGCTAGAAATAGCA	1
ACATTCGGTT	GACGAAACACCGGTCGATTCATATCGAAACCTTCCCGTGACAGTGGGGTT	1
ACATTCGGTT	GGAACACCGGTGCATTCGAAAGTCCGGTCGTAGTGTGGACGTGGGGTTAG	1
ACATTTACAA	GAAACACCGGTCGGGGCCACTCAGTGGTGGGGTTAGAGCTAGAAATAGCA	1
ACATTTACAG	GAAACACCGGTCGGGGCCACTCAGTGGTGGGGTTAGAGCCAGAAATAGCA	1
ACATTTACCG	GAGCTAGAAATAGCAAGTTAACCTAAGGCTAGTCCGTTACAACTTGAAAA	1
ACATTTCCCG	GAAACACCGGTCGGGGCCACTCAGTGGTGGGGTTAGAGCTAGAAATAGAA	1
ACCAAAGCCC	GAAACACCGGTTTGAACTAGAAATAGCAAGTTAACCTAAGGCTAGTCCGT	1
ACCACAGACT	GAAACACCGGTAGCAAGTGCGAGACGTTTTTGTGGGGTTAGAGCTAGAAA	1
ACCACCCGCC	GAAACACCGGTGTGGCTGAGAGTCCGGCAATGGTGTGGCTGTGGGGTTAG	1
ACCATAGAGG	GAAACACCGGTTTTCTTTGTACGGGTTGTGGGGTTAGAGCTAGAAATAGC	1
ACCATAGGTT	GAAACACCGGTCGATTCATATCGAAACCTTCCCGTGACAGTGGGGTTAGA	1
ACCCAACGCT	GAAACACCGGTTTGAACTAGAAATAGCAAGTTAACCTAAGGCTAGTCCGT	1
ACCCCAGAAA	GAAACACCGGTAGCAAGTGCGAGACGTGTTAAATAGCAAGTTAACCTAAG	1
ACCCGACCGC	GAAACACCGGTGCATTCGAAAGTCCGGTCGTAGTGTGGACGTGGGGTTAG	1
ACCCTTACCG	GAAACACCGGTCGGGGCCACTCAGTGGTGGGGTTAGAGCTAGAAATAGCA	1
ACCCTTTGGC	GAAACACCGGTGCATTCGAAACACCGGTCGTAGTGTGGCCGTGGGGTTCT	1
ACCGACATAC	GAAACACCGGTGCCCTTACTCTCACCTGATTACTTAATCCGTGGGGTTAG	1
ACCGAGCTAC	GAAACACCGGTGCCCTTACTCTCACCTGATTACTTAATCCGTGGGGTTAG	1
ACCGCCAAAC	GAAACACCGGTGCCCTTACTCTCACCTGATTACTTAATCCGTGGGGTTAG	1
ACCGCTCTAA	GAAACACCGGTGCCCTTACTCTCACCTGATTACTTAATCCGTGGGGTTAG	1
ACCGTCATTT	GAAACACCGGTGCCCTTATGCACACCTGTTTACGTGATACAGCGAGGTAG	1
ACCGTTACCG	GAAACACCGGTCGGGGCCACTCAGTGGTGGGGTTAGAGCTAGAAATAGCA	1
ACCGTTATCG	GAAACACCGGTCGGGGCCACTCAGTGGTGGGGTTAGAGCTAGAAATAGCA	1
ACCTACGCCC	GAAACACCGGTTTAGAGCTAGAGATAGCTAGTTAACCTAAGGCTAGTCCG	1
ACCTATACTG	GAAACACCGGTCGGGGATACTCGGTTGTGGGGTTAGAGCTAGAAATAGCA	1
ACCTATGGTC	GAAACACCGGTCGATTCATGTCGAAACCTTCCCGTGACAAGTGGGGTTAG	1
ACCTATGGTT	GACTAGTCCGTTATCAACTTGAAAAAGTGGCACCGAGTCGGTGCTTTTTT	1
ACCTCATCGT	GGAACACCGGTGTACGTATGGACTGAACCAGGGTGTGCAAGTGGGGTTAG	1
ACCTGTTGTC	GAAACACCGGTGACATTGGGTACAGGGTGGGGTTAGAGCTAGAAATAGCA	1
ACCTTAACGC	GAAACACCGGTCGGGGCCACGGGTTAGAGCTAGAAATAGCAAGTTAACCT	1
ACCTTAGATT	GAAACACCGGTCGATTCATATCGAAACCTTCCCGTGGGGTTAGAGCTAGA	1
ACCTTCGGAC	GAAACACCGGTCGCTTCATATCGAAACCTTCCCGTGACAGGGGGGTTAGA	1
ACCTTGACCG	GAAACACCGGTCGGGGCCACTCAGTGGTGGGGTTAGAGCTAGAAATAGCA	4
ACCTTGTCCG	GAAACACCGGTCTGGGCCACAAATAGCAAGTTAACCTAAGGCTAGTCCGT	1
ACCTTTAACG	GAAACACCGGTCGGGGCCACTCAGTGGTGGGGTTAGAGCTAGAAATAGCA	1
ACCTTTACAG	GAAACACCGGTCGGGGCCACTCAGTGGTGGGGTTAGAGCTAGAAATAGCA	3
ACCTTTACTG	GAAACACCGGTCGGGGCCACTCAGTGGTGGGGTTAGAGCTAGAAATAGCA	1
ACCTTTAGCG	GAAACACCGGTCGGGGCCACTCAGTGGTGGGGTTAGAGCTAGAAATAGCA	2
ACCTTTATCG	GAAACACCGGTCGGGGCCACTCAGTGGTGGGGTTAGAGCTAGAAATAGCA	1
ACCTTTATCG	GAAACACCGGTCGGGGCCTGGGGTTAGAGCTAGAAATAGCAAGTTAACCT	1
ACCTTTCCTG	GAAACACCGGTCGGGGCCACTCAGTGGTGGGGTTAGAGCTAGAAATAGCA	1
ACCTTTGCCG	GAAACACCGGTCGGGGCCACTCAGTGGTGGGGTTAGAGCTAGAAATAGCA	1
ACGAACCCCT	GAAACACCGGTCTCGAGTGAGGTATTCAGGGTGGGGTTAGAGCTAGAAAT	1
ACGAAGACAT	GAAACACCGGTCTCGAGTGAGGTGTTCAGGGTGGGGTTAGAGCTAGAAAT	1
ACGAAGCATT	GAAACACCGGTCTCGAGTGAGGTGTTCAGGGTGGGGTTAGAGCTAGAAAT	1
ACGAAGCCTT	GAAACACCGGTCTCGAGTGAGGTGTTCAGGGTGGGGTTAGAGCTAGAAAT	1
ACGAATACTT	GAAACACCGGTCTCGAGTGAGGTGTTCAGGGTGGGGTTAGAGCTAGAAAT	3
ACGAATACTT	GAAACACCGGTCTCGAGTGAGGTGTTCAGGGGTGGGGTTAGAGCTAGAAA	1
ACGAATAGTT	GAAACACCGGTCTCGAGTGAGGTGTTCAGGGTGGGGTTAGAGCTAGAAAT	1
ACGAATCATT	GAAACACCGGTCTCGAGTGAGGTGTTCAGGGTGGGGTCAGAGCTAGAAAT	1
ACGAATCATT	GAAACACCGGTCTCGAGTGAGGTGTTCAGGGTGGGGTTAGAGCTAGAAAT	1
ACGAATCGAG	GAAACACCGGTTTCGAGCGAGATGTTCAGGGTGGGGCTAGAGCTAGACCT	1
ACGAATCGTT	GAAACACCGGTCTCGAGTGAGGTGTTCAGGGTGGGGTTAGAGCTAGAAAT	2
ACGAATTCTT	GAAACACCGGTCTCGAGTGAGGTGTTCAGGGTGGGGTTAGAGCTAGAAAT	1
ACGACCATCG	GAAACACCGGTGCATTCGAAAGTCCGGTCGTAGTGTGGACGTGGGGTTAG	1
ACGACTACTT	GAAACACCGGTCTCGAGTGAGGTGTTCAGGGTGGGGTTAGAGCTAGAAAT	1
ACGACTCCTT	GAAACACCGGTCTCGAGTGAGGTGTTCAGGGTGGGGTTAGAGCTAGAAAT	1
ACGAGCGGGG	GAAACACCGGTTATCTTTGTAAGTGTGTGGGGTTAGAGCTAGAAATAGCA	1
ACGAGTAGAA	GAAACACCGGTTAAGCCGAGGAGTTTCGTTAGAGCTAGAAATAGCAAGTT	1
ACGAGTCCTT	GAAACGCCGGTCTCGAGTGAGGTGTTCAGGGTGGGGTTAGAGCTAGAAAT	1
ACGAGTCCTT	GAAACACCGGTCTCGAGTGAGGTGTTCAGGGTGGGGTTAGAGCTAGAAAT	1
ACGAGTTGTC	GAAACACCGGTGACATTGGGGGTTAGAGCTAGAAATAGCAAGTTAACCTA	1
ACGAGTTGTC	GAAACACCGGTGACATTGGGTACAGGGGTGGGGTCAGAGCTAGAAATAGC	1
ACGATAGAGG	GAAACACCGGTTATATTTGTAAGTGGGGTTAGAGCTAGAAATAGCAAGTT	1
ACGATGAGTC	GAAACACCGGTTTACGTTGCATCGGTTGTGGGGTTAGAGCTAGAAATAGC	1
ACGATTAGAC	GAAACACCGGTTTACGTTGCTTCGGTTGTGGGGTTAGAGTTAGAATTAGC	1
ACGATTCCTT	GAAACACCGGTCTCGTGTGAGGTGTTCAGGGTGGGGTTAGAGCTAGAAAT	1
ACGCATAGAC	GCAACACCGGTTTACGTTGCATCGGTGTGGGGTTAGAGCTAGAAATAGCA	1
ACGCATCCTT	GAAACACCGGTCTTGAAAAAGTGGCACCGAGTCGGTGCTTTTTTTCCTGC	1
ACGCGTTGTC	GCCTCCACGGCCACTAGTCTAAGGCGAGTCCGTTATCAACTTGAAAAAGT	1
ACGCTGTCTC	GAAACACCGGTCCGTAGGAGACCCGTGTGGCATGTACCTGTGGGGTTAGA	1
ACGCTTACAT	GAAACACCGGTTTACGTTGCATCGGTTGTGGGGTTAGAGCTAGAAATAGC	1
ACGCTTGACT	GAAACACCGGTTTACGTTGCATCGGTGTGGGGTTAGAGCTAGAAATAGCA	1
ACGCTTGGGC	GAAACACCGGTTTACGCTGCATCGGTGTGGGGTTAGAGCTAGAAATAGCA	1
ACGGATCCTT	GAAACACCGGTCTCGAGTGAGGTGTTCAGGGTGGGGTTAGAGCTAGAAAT	1
ACGGCCCGCC	GAAACACCGGTGCCCGTACTCTCACCTGATTACTTAATCCGTGGGGTTAG	1
ACGGGACTAA	GAAACACCGGTGCCCTTACTCTCACCTGATTACTTAATCCGTGGGGTTAG	1
ACGGGTGCTT	GAAACACCGGTCTCGAGTGAGGTGTTCAGGGGTGGGGTTAGAGCTAGAAA	1
ACGGGTTGTA	GAAACACCGGTGACATTGGGGAAAATAGCAAGTTAACCTAAGGCTAGTCC	1
ACGGGTTGTC	GAAACACCGGTGACAGGTGGGGTTAGAGCTAGAAATAGCAAGTTAACCTA	1
ACGGGTTGTC	GAAACACCGGTGACATTGGGTACAGGGGTGGGGTTAGAGCTAGAAATAGC	1
ACGTAGCGTG	GAAACACTGGTGTGGCTGAGAGTCCGGCAATGGTGTGGCTGTGGGGTTAG	1
ACGTGAACTC	GAAACACCGGTCGGGGCCACTCAGTGGTGGGGTTAGAGCTAGAAATAGCA	1
ACGTGATGTC	GAAACACCGGTGACATGTGGGGTTAGAGCTAGAAATAGCAAGTTAACCTA	1
ACGTGGTGTC	GAAACACCGGTGACATTGGGTTAGAGCTAGAAATAGCAAGTTAACCTAAG	1
ACGTGTGGTC	GAAACACCGGTTCCATTGATTACCAGGGCGGAGTTAGAACGAGGAATAAC	1
ACGTGTTGAA	GAAACACCGGTGACATTGGGTACAGGGTGGGGTTAGAGCTAGAAATAGCA	1
ACGTGTTGAC	GAAACACCAATGTCACCGGTGGGGTTAGAGCTAGAAATAGCAAGTTAACC	1
ACGTGTTGCA	GAAACACCGGTGACATGGTGGGGTTAGAGCTAGAAATAGCAAGTTAACCT	1
ACGTGTTGCC	GAAACACCGGTGACATTGGGTACGGGGTTAGAGCTAGAAATAGCAAGTTA	1
ACGTGTTGGC	GAAACAAGGCTAGTCCGTTATCAACTTGAAAAAGTGGCACCGAGTCGGTG	1
ACGTGTTGTA	GAAACATCGGTGAGTGGGGTTAGAGCTAGAAATAGCAAGTTAACCTAAGG	1
ACGTGTTGTA	GAAACACCGGTGACATTGGGTACAGGGTGGGGTTAGAGCTAGAAATAGCA	1
ACGTGTTGTA	GAAACACCGGTGACATTGGGTACGGGGTTAGAGCTAGAAATAGCAAGTTA	1
ACGTTACCGT	GAAACACCGGTCGGGGCCACTCAGTGGTGGGGTTAGAGCTAGAAATAGCA	1
ACGTTGCGTT	GAAACACCGGTTCCCGTCCAGTGGGGTTAGAGCTAGAAATAGCAAGTTAA	1
ACTAACTTTT	GAAACACCGGTTATATTTGTAAGTGTTGTGGGGTTAGAGCTAGAAATAGC	1
ACTAATCGGC	GAAACACCGGTACCTTTGTTGATGCTGGGTGGAAGGATGCTGGGTGGGGT	1
ACTAATCGGC	GAAACACCGGTACCTTTGTTGATGCTGGGTGGATGGTGGGGTTAGAGCTA	1
ACTACACGGC	GAAACACCGGTACCTTTGTTGATGCTGGGTGGAAATAGCAAGTTAACCTA	1
ACTACACGGC	GAAACACCGGTACCTTTGTTGATGCTGGGTGGAAGGATGCTGGGTGGGGT	1
ACTACACGGC	GAAACACCGGTACCTTTGTTGATGCTGGGTGGAAGGTGGGGTTAGAGCTA	1
ACTACCCGGC	GAAACACCGGTACCTTTGTTGATGCTGGGTGGAAGGAATGGTGGGGTTAG	1
ACTACCGATG	GAAACACCGGTTATATTTGTAAGTGTGTGGGGTTAGAGCTAGAAATAGCA	1
ACTACGCGGA	GAAACACCGGTACCTTTGTTGATGCTGGGTGGAAGGAATTTTGTGGGGTT	1
ACTACGCGGC	GAAACACCGGTACCTTTGTTGATGCTGGGTGGGGTTAGAGCTAGAAATAG	1
ACTACTAGGA	GAAACACCGGTAGCTTTGTTGATGCTGGGGTCTGTTTTTCGTTCGGGGGA	1
ACTACTCAGC	GAAACACCGGTACCTTTGTTGATGCTGGGTGGAAGGTGGGGTTAGAGCTA	1
ACTACTCGGT	GAAACACCGGTACCTTTGTTGATGCTGGGTGGAAGGAATTTTGTGGGGTT	1
ACTACTCTGC	GAAACACCGGTACCTTTGTTGATGCTGGGTGGAAGGAAAAAGTGGCACCG	1
ACTATAACGC	GAAACACCGGTCGGGGCCACCCAGTGGTGGGGTTAGAGCTAGAAATAGCA	1
ACTATAGTGG	GAAACACCGGTTATATTTGTAAGTGTGTGGGGTTAGAGCTAGAAATAGCA	2
ACTATCCCGC	GAAACACCGGTTAGATTTGTTAGTGGGGTTAGAGCTAGAAATAGCAAGTT	1
ACTATCGGGT	GAAACACCGGTCGATTCATATCGAAACCTTCCCGTGACAGTGGGGTTAGA	1
ACTATCTACA	GAAACACCGGTAAATTTGAGGCTCAGGCATGCAGGAGGCCGTGGGGTTAG	1
ACTCCCTGTT	GACGGAACCCCGGGTAAATTTTAGGCAGCGATGGGCGGGTTAGAGCGGGA	1
ACTCGACGTC	GAGACACCGGTGTACGTATGGACTGAACCAGTGTGTGCAAGTGGGGTTAG	1
ACTCGACGTT	GAAACACCGGTGTACGTATGGACTGAACCAGGGTGTGCAAGTGGGGATAG	1
ACTCGTAGTC	GAAACACCGGTGTACGTATTGACTGAACCAGGGTGTGCAAGTGGGGTTAG	1
ACTCGTAGTC	GAAACACCGGTGTACGTATGGACTGAACCAGGGTGTGCAAGTGGGGTTAG	1
ACTCTGACGC	GAAACACCGGTCGGGGCGGGGGTAGAGCGTGAAATAACAAGTTAAACTAA	1
ACTCTGTGTT	GAAACACCGGTTTACGTTGCATCGGTGTGGGGTTAGAGCTAGAAATAGCA	1
ACTCTTACGC	GAAACACCGGTCGAGGCCGCTCCGTGGTGGGGTTAGAGCTAGAAATAGCA	1
ACTCTTCGCC	GAAACACCGGTTTACGTTGCATCGGGTTGTGGGGTTAGAGCTAGGAATAG	1
ACTGACCTTC	GAAACACCGGTGCCCTTACTCTCACCTGATAACCTGGGGTTAGAGCTAGA	1
ACTGCACTTC	GAAACACCGGTGCCCTTACTCTCACCTGATTACTTAATCCGTGGGGTTAG	1
ACTGCTAGGC	GAAACACCGGTACCTTTGTTGATGCTGGGTGGAAGGATGCTGGGTGGGGT	1
ACTGGTTAGC	GAAACACCGGTTTACGTTGTATCGGGGTGGGGTTAGGGTTTAAAAAGGCA	1
ACTGTCGGCC	GAAACACCGGTACCTTTGTTGATGCTGGGTGGAAGGAATTTGTGGGGTTA	1
ACTTAACAGG	GGAACACCGGTCGGGGCCACTCAGTGGTTTGGTTAGAGCTTGAAATAGAA	1
ACTTCCCTAC	GAAACACCGGTGCCCTTACTCTCACCTGATTACTTAATCCGTGGGGTTAG	1
ACTTGAACGC	GAAACACCGGTCGGGGCCACTCAGTGGTGGGGTTAGAGTTAGAAATAGCA	1
ACTTTACATC	GAAACACCGGTCGGGGCCACTCAGTGGTGGGGTTAGAGCTAGAAATAGCA	1
ACTTTACCTA	GAAACACCGGTCGGGGCCACTCAGTGGTGGGGTTAGAGCTAGAAATAGCA	1
ACTTTTCCTC	GAAACACCGGTCGGGGCCACTCAGTGGTGGGGTTAGAGCTAGAAATAGCA	1
AGAAAACCCG	GAAACACCGGTCGGCGGCGGTGGGGTTAGAGCTAGAAATAGCAAGTTAAC	1
AGAAACAGAC	GAAACACCGGTAGCAAGTGCGAGACGTGTTTGTGGGGTTAGAGCTAGAAA	1
AGAAACCGTT	GAAACACCGGTCTCGAGTGAGGTGTTCAGGGCGGGGTTAGAGCTAGAAAT	1
AGAAACGCGC	GAAACACCGGTGCATTCGACAGAGCGGTAGTAGTGTGGACGAGAGGTTAG	1
AGAACATTGT	GAAACACCGGTGCATTCGAAAGTCCGGTCGTAGTGTGGACGTGGGGTTAG	1
AGAACCATTT	GAAACACCGGTCTCGAGTGAGGTGTTCAGGGTGGGGTTAGAGCTAGTAAT	1
AGAACCCTGT	GAAACACCGGTCTCGAGTGAGGTGTTCAGGGGGGGTTAGAGCTAGAAATA	1
AGAACCTACA	GAAACACCGGTAAATTTGAGGCCCCGGCATGCAGGAGGCCGTGGGGTTAG	1
AGAACTGCGC	GTAACACCGGTGCATTCGAAAGTCCGGTCGTAGTGTGGACGTGGGGTTAG	1
AGAAGAACCG	GAAACACCGGTCGGCGGCAATCGTGGGTGGGGTTAGAGCTAGAAATAGCA	1
AGAAGAACCG	GAAACACCGGTCGGCGGCAATCGTGGGTTGGGGTTAGAGCTAGAAATAGC	1
AGAAGAATCG	GAAACACCGGTCGGCGGCAATCGTGGTAGAGCTAGAAATAGCAAGTTAAC	1
AGAAGACACG	GAAACACCGGTCGGCGGCAATCGTGGGTGGGGTTAGAGCTAGAAATAGCA	1
AGAAGACACG	GAAACACCGGTCGGCGGCAATAGAAATAGCAAGTTAACCTAAGGCTAGTC	1
AGAAGACGCG	GAAACACCGGTCGGCGGCGGTGGGGTTAGAGCTAGAAATAGCAAGTTAAC	1
AGAAGACTTT	GAAACACCGGTCTCGAGTGAGGTGTTCAGGGTGGGGTTAGAGCTAGAAAT	1
AGAAGATCGC	GAAACACCGGTGCATTCGAAAGCCCGGTCGTAGTGTGGACGTGGGGTTAG	1
AGAAGCCCAA	GAAACACCGGTCTCGAGTGAGGTGTTCAGGTGGGGTTAGAGCTAGAAATA	1
AGAAGCCCCG	GAAACACCGGTCGGCGGCAATCGTGGGTGGGGTTAGAGCTAGAAATAGCA	1
AGAAGCCGTT	GAAACACCGGTCTCGAGTGGGGTGTTCAGGGTGGGGTTAGAGCTAGAAAT	1
AGAAGCCTTC	GAAACACCGGTCTCGAGTGAGGTGTTCAGGGTGGGGTTAGAGCTAGAAAT	1
AGAAGCTAGA	GAAACACCGGTGCATTCGAAAGTCCGGTCGTAGTGTGGACGTGGGGTTAG	1
AGAAGCTGGC	GAAACACCGGTGCATTCGAAAGTCCGGTCGTAGTGTGGACGTGGGGTTAG	1
AGAAGGACCG	GAAACACCGGTCGGCGGCAATCTGGGGTTAGAGCTAGAAATAGCAAGTTA	1
AGAAGGCCTC	GAAACACCGGTCCGTAGGAGACCCGTGTGGCATGTACCTGTGGGGTTAGA	1
AGAAGGCGCG	GAAACACCGGTCGGCGGCAATCGTGGGGTGGGGTTAGAGCTAGAAATAGC	1
AGAAGGCTTT	GAAACACCGGTCTCGAGTGAGGGGGGTTAGAGCTAGAAATAGCAAGTTAA	1
AGAAGTCATA	GAAACACCGGTGCCCTTACTCTCACCTGATTACTTAATCCGTGGGGCTAG	1
AGAATACGCT	GAAACACCGGTATCGAGTGAGGTGTTCAGGGTGGGGTTAGAGCTAGAAAT	1
AGAATCATTA	GAAACACCGGTCTCGAGTGAGGTGTTCAGGGTGGGGTTAGAGCTAGAAAT	1
AGAATCGCTT	GAAACACCGGTCACGAGTGAGGTGTTCAGGGTGGGGTTAGAGCTAGAAAT	1
AGAATCTCGT	GAAACACCGGTGCATTCGAAAGTCCGGTCGTAGTGTGGACGTGGGGTTAG	1
AGAATCTCTT	GAAACACCGGTGCATTCGAAAGTCCGGTCGTAGTGTGGACGTGGGGTTAG	1
AGAATGCCTT	GAAACACCGGTCCGTAGGAGACCCGTGTGGCATGTACCTGTGGGGTTAGA	1
AGAATTATAT	GAAACACCGGTAACTATATTCATGCGATATCGCCGTATCAGTGGGGTTAG	1
AGACAAAGAC	GAAACACCGGTAGCAAGTGCGAGACGTGTTAAATAGCAAGTTAACCTAAG	1
AGACACAGAT	GAAACACCGGTAGCAAGTGCGAGACGTGTTTGTGGGGTTAGAGCTAGAAA	1
AGACACAGGC	GAAACACCGGTAGCAAGTGCGAGACGTGTTTGTGGGGTTAGAGCTAGAAA	1
AGACACCATT	GAAACACCGGTCTCGAGTGAGGTGTTCAGGGTGGGGTTAGAGCTAGAAAT	1
AGACACCCTC	GAAACACCGGTGTGGCTGAGAGTCCGGCAATGGTGTGGCTGTGGGGTTAG	1
AGACACCGAC	GAAACACCGGTAGCAAGTGCGAGACGTGTTAAATAGCAAGTTAACCTAAG	1
AGACACGAGC	GAAACACCGGTGCATTCGAAAGTCCGGTCGTAGTGTGGACGTGGGGTTAG	1
AGACAGAGAA	GAAACACCGGTAGCAAGTGCGAGCTAGAAATAGCAAGTTAACCTAAGGCT	1
AGACAGAGAC	GAAACACCGGTAGCAAGTGCGGGGTTAGAGCTAGAAATAGCAAGTTAACC	1
AGACAGAGCC	GAAGCACCGGTAGCAAGTGCGAGACGTGTTTGTGGGGTTAGAGCTAGAAA	1
AGACATAGAC	GAAACACCGGTAGCAAGTGCGGGGTTAGAGCTAGAAATAGCAAGTTAACC	1
AGACCCAGAC	GAAACACCGGTAGCAAGTGCGAGACGTGTTTGTGGGGTTAGAGCTAGAAA	1
AGACCCAGAC	GAAACACCGGTAGCAAGTGCGAGCAAGTTAGAGCTAGAAATAGCAAGTTA	1
AGACCCTCGC	GAAACACCGGTGCATTCGAAAGTCCGGTCGTAGTGTGGACGTGGGGTTAG	2455
AGACCCTCGC	CAAAACACCGGTGCATTCGAAAGTCCGGTCGTAGTGTGGACGTGGGGTTA	2
AGACCCTCGC	CAAAACACCGGTGCATTCGAAAGTCCGGTCGTAGTGTGGACGTGGGTTAG	1
AGACCCTCGC	CTAAACACCGGTGCATTTGAAAGTCCGGTCGTAGTGTGGACGTGGGGTTA	1
AGACCCTCGC	GAAACACCGCTGCATTCGAAAGTCTCGTCGTAGTGGCGTCGTGTGGTTAG	1
AGACCCTCGC	GAAACACCGGGCATTCGAAAGTCCGGTCGTAGTGTGGACGTGGGGTTAGA	1
AGACCCTCGC	GAAACACCGGTAAATTTGAGGCTCCGGCATGCAGGAGGCCGAGGGGTTAG	1
AGACCCTCGC	GAAACACCGGTCCGTAGGAGACCCGGGTGGCATGTTGATCTGGGGTTCGG	1
AGACCCTCGC	GAAACACCGGTCCGTAGGAGACCCGTGTGGCATGTACCTGTGGGGTTAGA	1
AGACCCTCGC	GAAACACCGGTCGATTCATATCGAAACCTTCCCGTGACAGTGGGGTTAGA	1
AGACCCTCGC	GAAACACCGGTCGGCGGCAAATGGGGTTAGAGCTAGAAATAGCAAGTTTA	1
AGACCCTCGC	GAAACACCGGTGCATTCGAAAGTCCGGTCGTAGTGTGACGTGGGGTTAGA	1
AGACCCTCGC	GAAACACCGGTGCCCTTACTCTCACCTGATTACTTAATCCGTGGGGTTAG	1
AGACCCTCGC	GAAACACCGGTGCCTTCGAAAGCCTGGTCGTAGTGTGGCCGTGGAGATCG	1
AGACCCTCGC	GAAACACCGGTGCCTTCGACCATCCGCTCGTAGGGTGGACATCGGGATAG	1
AGACCCTCGC	GAAACACCGGTGTACGTATGGACTGAACCAGGGTGTGCAAGTGGGGTTAG	1
AGACCCTCGC	GAAACACCGGTGTGGTTGAGAGTCCGGCAATGGTGTGGCTGTGGGGTTAG	1
AGACCCTCGC	GAAACACCGGTTAAGCCGAGTGGGGTTAGAGCTAGAAATAGCAAGTTAAC	1
AGACCCTCGC	GAAACACCGGTTACATTGAGGGTTAGAGCTAGAAATAGCAAGTTAACCTA	1
AGACCCTCGC	GAAACACCGGTTCCCGTCCAGTGGGGTTAGAGCTAGAAATAGCAAGTTAA	1
AGACCCTCGC	GAAACACCGGTTTGAACTACCTAGTTCAAACCGGTGGGGTTAGAGCTAGA	1
AGACCCTCGC	GAAACACCGGTTTGAACTAGAAATAGCAAGTTAACCTAAGGCTAGTCCGT	1
AGACCCTCGC	GAAACACCGTTGTGGCTGAGAGTCCGGCAATGGTGTGGCTGTGGGGTTAG	1
AGACCCTCGC	GAAACACGGGTTAGAGCTAGAAATAGCAAGTTTACCTAAGGCTAGTCCGT	1
AGACCCTCGC	GAAACGCCGGTGCACGCATGGACTGAACCAGGGTGTGCAAGTGGGGTTAG	1
AGACCTGCGA	GAAACACCGGTGCATTCGAAAGTCCGGTCGTAGTGTGGACGTGGGGTTAG	1
AGACGATAGC	GAAACACCGGTGCATTCGAAAGTCCGGTCGTAGTGTGGACGTGGGGTTAG	1
AGACGATGGC	GAAACACCGGTGCATTCGAAAGTCCGGTCGTGGTATGGCTGTAAGTATCG	1
AGACGTCTTC	GAAACACCGGTGCATTCGAAAGTCCGGTCGTAGTGTGGACGTGGGGCTAG	1
AGACTCACCC	GAAACACCGGTTTATGCGGAAGTCAGAGCGAAAAGTGGCCAGTTAACTAG	1
AGACTCATTT	GAAACACCGGTCTCGAGTGAGGTGTTCAGGGTGGGGTTAGAGCTAGACAT	1
AGACTCCGCC	GAAACACCGGTGTGGCTGAGAGTCCGGCAGTGGTGTGGCTGTGGGGTTAG	1
AGACTCCGTT	GAAACACCGGTCTCGAGTGAGGTGTTCAGGGTGGGGTTAGAGCTAGAAAT	1
AGACTCGGCA	GAAACACCGGTACCTTTGTTGATGCTGGGTGGAAGGAATGGGGTTAGAGC	1
AGACTCTGGT	GAAACACCGGTGCATTCGAAAGTCCGGTCGTAGTGTGGACGGGGGGTTAG	1
AGACTGCTTT	GAAACACCGGTCTCGAGTGAGGTGTTCAGGCGGGGTTAGAGCTAGAAATA	1
AGACTTATAA	GAAACACCGGTAACTATATTCATGCGATATCGCCGTATCAGTGGGGTTAG	1
AGAGACATCA	GAAACACCGGTAGCAAGTGCGAGACGTGTTAAATAGCAAGTTAACCTAAG	1
AGAGACCTTT	GAAACACCGGTCTCGAGTGAGGTGTTCAGGGTGGGGTTAGAGCTAGAAAT	1
AGAGACGCGC	GAAACACCGGTGGGGTTAGAGCTAGAAATAGCAAGTTAACCTAAGGCTAG	1
AGAGAGCCTC	GAAACACCGGTCGGCGGCAATAGAGATAGCAATTTAACCTAAGGCTAGTC	1
AGAGCAACGA	GAAACACCGGTTATATTGAGGGGGTAGAGCTAGAAATAGCAAGTTAACCT	1
AGAGCAGCGC	GAAACACCGGTGCATTCGAAAGTCCGGTCGTAGTGTGGACGTGGGGTTAG	1
AGAGCGCCGT	GAAACACCGGTGTACGAATGGAGTGTAGAAGGGCGTGCAAGTGGGGTTAG	1
AGAGCTACGT	GAAACACCGGTTACATTGAGTGGGGTTAGAGCTAGAAATAGCAAGTTAAC	1
AGAGGACCCT	GAAACACCGGTCGGCGGCAATCGGGGGTGGGGTTAGAGCTAGAAATAGCA	1
AGAGGAGCCT	GAAACACCGGTTCCCGTCCAGTGGGGTTAGAGCTAGAAATAGCAAGTTAA	3
AGAGGAGCGC	GAAACACCGGTGCATTCGAAAGTCCGGTCGTAGTGTGGACGTGGGGTTAG	1
AGAGGCGTAT	GAAACACCGGTTAAGCCGAGTGGGGTTAGAGCTAGAATTAGCAAGTTAAC	1
AGAGTCAGGC	GAAACACCGGTCCGTAGGAGACCCGTGTGGCATGTACCTGTGGGGTTAGA	1
AGAGTCGTTA	GAAACACCGGTCGATTCATATCGAAACCTTCCCGTGACAGTGGGGTTAGA	1
AGAGTCTGCC	GAAACACCGGTCCGTAGGAGACCCGTGTGGCATGTACCTGTGGGGTTAGA	1
AGAGTGCTTC	GAAACACCGGTCTCGAGTGGAGCTAGAAATAGCAAGTTAACCTAAGGCTA	1
AGAGTTGTCC	GAAACACCGGTGACATTGGGTACGCTAGAAATAGCAAGTTAACCTAAGGC	1
AGAGTTGTGT	GAAACACCGGTGACATTGGGTACAGGGTTAGAGCTAGAAATAGCAAGTTA	1
AGATACAGAT	GAAACACCGGTAGCAAGTGCGGGGTTAGAGCTAGAAATAGCAAGTTAACC	1
AGATACGGAT	GAAACACCGGTCGTTTCATTTCGAAACCTGCCCTAGAGCGGGGGTATAGA	1
AGATACGGGA	GAAACACCGGTGCATTCGAAAGTCCGGTCGTAGTGTGGACGAGAGGGTAG	1
AGATCAGTGT	GAAACACCGGTGCATTTAAAAACTCGGTCGGGTTAGAGCTGGGGATAGCG	1
AGATCCGTGC	GAAACACCGGTGCATTCGAAAGTCCGGTCGTAGTGTGGACGTGGGGTTAG	1
AGATCCTGTA	GAAACACCGGTAAATTTGTGTCTCCGGCTTGCAGGAGGCCGTGGGGTAAG	1
AGATCGTAGT	GAAACACCGGTGTACGTATGGACTGAACCAGGGTGTGCAAGTGGGGTTAG	1
AGATCGTTCC	GAAACACCGGTGCATTCGAAAGTCCGGTCGTGGTGTGGACATGGGGATAG	1
AGATGACCAG	GAACCACCGGTCGGCGGCAATCGTGGGTGGGGTTAGAGCTAGAAATAGCA	1
AGATGACCCG	GAAACACCGGTCGGCGGCAATATAGCAAGTTAACCTAAGGCTAGTCCGTT	1
AGATGATTAG	GAAACACCGGTTTACGTTGCATCGGTGTGGGGTTAGAGCTAGAAATAGCA	1
AGATGTGTAT	GAAACACCGGTAGCTATATTCATGCGATATCGCCGTATCAGTGGGGATAG	1
AGATTACCGC	GAAACACCGGTCGGGGCCACTCAGGGGTTAGAGCTAGAAATAGCAAGTTA	1
AGATTCCCGC	GAAACACCGGTCGGGGCCACTCAGTGGTGGGGTTGGAGCTAGAAATAGCA	1
AGATTGGCTT	GAAACACCCGGTGCTTTTTTGCCTGCAGGGAGGCAGACTGAACTCGAGCC	1
AGATTTGTCT	GAAACACCGGTGACATTGGGTACGAGCTAGAAATAGCAAGTTAACCTAAG	1
AGCAACAGAC	GAAACACCGGTAGCAAGTGGGGTTAGAGCTAGAAATAGCAAGTTAACCTA	1
AGCAACTAAA	GAAACACCGGTAAATTTGAGGCTCCGGCATGCAGGAGGCCGTGGGGTTAG	1
AGCAAGCCTC	GAAACACCGGTCCGTAGGAGACCTGTGTGGCATGCATCTGTGGGGTTAGA	1
AGCACCGTAA	GAAACACCGGCGTGGCTGAGAGTCCGGCAATGGTGTGGCTGTGGGGTTAG	1
AGCAGACCCG	GAAACACCGGTCGGCGGGGTTAGAACTAGAAATTGCAAGTTAACCTAAGG	1
AGCAGCCTTT	GAAACACCGGTCTCGAGCGAGGTGTTCGGGGTGGGGTTAGAGCTAGAAAT	1
AGCAGGACAT	GAAACACCGGTCCGTAGGAGACCCGTGTGGCATGTACCTTGTGGGGTTAG	1
AGCATCCATT	GAAACACCGGTCTCGAGTGAGGTGTTCAGGGTGGGGTTAGAGCTAGAAAT	1
AGCATCCCTC	GAAACACCGGTCCGTAGTAGACCCGTGTGGCATGTACCTCCTGTGGGGCT	1
AGCATGCATA	GAAACACCGGTCCGTGGGAGACCCGTGTGGCATGTACCTGTGGGGTTAGA	1
AGCCAACCCG	GAAACACCGGTCGTCTGCACTACAGAAATAGCATGTTAATAGAAGGAGCA	1
AGCCACGCCC	GAAACACCGGTTTGAACTAGAAATAGCAAGTTAACCTAAGGCTAGTCCGT	1
AGCCCATACC	GAAACACCGGTAAATTTGAGGCTCCGGCATGCAGGAGGCCGTGGGGTTAG	1
AGCCCCCCTC	GAAACACCGGTGTGGCTGAGAGTCCGGCAATGGTGTGGCTGTGGGGTTAG	1
AGCCTCCCTG	GAAACACCGGTTCCCGTCCAGTGGGGTTAGAGCTAGAAATAGCAAGATAA	1
AGCCTGACGC	GAAACACCGGTCCGTAGGAGACCCGTGTGGCATGTACCTGTGGGGTTAGA	1
AGCCTGATTC	GAAACACCGGTCCGTTGGAGGCGCGGGGGGTATGTACCTAGGGGGGTAAA	1
AGCCTTAGCC	GAAACACCGGTTTACGTTGCATCGGGGTTAGAGCTAGAAATAGCAAGTTA	1
AGCGACCTCC	GAAACACCGGTGTGGCTGAGAGTCCGGCAATGGTGTGGCTGTGGGGTTAG	1
AGCGAGCATA	GAAACACCGGTTAAGCCGAGTGGGGTTAGAGCTAGAAATAGCAAGTTAAC	1
AGCGGAGACT	GAAACACCGGTTCCCGTCCAGTGGGGTTAGAGCTAGAAATAGCAAGTTAA	1
AGCGGAGCCT	GAAACACCGGTTCCCGTCCAGTGGGGTTAGAGCTAGAAATAGCAAGTTAA	1
AGCGGATACG	GAAACACCGGTTCCCGTCCAGTGGGGTTAGAGCTAGAAATAGCAAGTTAA	1
AGCGTGCTAC	GAAACACCGGTTCCCTTACTCTCACCTGATTACTTAATCCGTGGGGTTAG	1
AGCTACTCGG	GAAACACCGGTACCTTTGTTGATGCTGGGTGATTGTGGGGTTAGAGCTAG	1
AGCTATCGAG	GAAACACCGGTTATATTTGTAAAGTGGGGTTAGAGCTAGAAATAGCAAGT	1
AGCTTCCGCT	GAAACACCGGTCGGTTCATATGGACAGCTTCGGGTTGCCGTGGGGGTAGA	1
AGCTTCTATA	GAAACACCGGTAGATTTGAGGCTCCGGCATGCAGGAGGCCGTGGGGTTAG	1
AGCTTTACCG	GAAACACCGGTCGGGGCCACTCAGTGGTGGGGTTAGAGCTAGAAATAGCA	1
AGGAAACCTC	GAAACACCGGTGTGGCTGAGAGTCCGGCAATGGTGTGGCTGTGGGGTTAG	2
AGGAACCATC	GAAACACCGGTGTGGCTGAGAGTCCGGCAATGGTGTGGCTGTGGGGTTAG	1
AGGAATCCTT	GAAACACCGGTCTCGAGTGAGGTGTTCAGGTGGGGTTAGAGCTAGAAATA	1
AGGACCCTAC	GAAACACCGGTAAATTTGAGGCTCCGGCATGCAGGAGGCCGTGGGGTTAG	1
AGGACCGCGC	GAAACACCGGTGCATTCGACAGTCCGGTCGTAGTGTGGACGTGGGGTTAG	1
AGGACTTCCT	GAAACACCGGTAAATTTGACGCCCTGTCGTGCGGGGGTCGGGGTAGATAT	1
AGGAGACGAA	GAAACACCGGTTAAGCCGGAGGGGTTAGAGCTAGAAATAGCAAGTTAACC	1
AGGAGCAGAC	GAAACACCGGTTAAGCCGAGAAGTTAGAGCTAGAAATAGCAAGTTAACCT	1
AGGAGGCCCG	GAAACACCGGTCGGCGGCAATCGTGGGTGGGGTTAGAGCTAGAAATAGCA	1
AGGAGGCCTC	GAAACACCGGTCCGTCGGAGACCCGTGTGGCATGTACCTGTGGGGTTAGA	1
AGGATACTCT	GAAACACCGGTATCGAGTGAGGCGTTCAGGGCGGGGTTAGAGCTAGAAAT	1
AGGATCATCT	GAAACACCGGTTTACGCTGCGTCGGTGTGGGGGTAGAGCGAGATATAGAA	1
AGGATCCGTT	GAAACACCGGTCTTGAAAAAGTGGCACCGAGTCGGTGCTTTTTTTCCTGC	1
AGGATCCTAC	GAAACACCGGTAAATTTGAGGCTCCGGCATGCAGGAGGCCGTGGGGTTAG	1
AGGATGCCTA	GAAACACCGGTCCGTAGGAGACCCGTGTGGCATGTACCTGTGGGGTTAGA	1
AGGCAACATC	GAAACACCGGTGTGGCTGAGAGTCCGGCAATGGTGTGGCTGTGGGGTTAG	1
AGGCAACCGC	GAAACGCCGGTGTGGCTGAGAGTCCGGCAATGGTGTGGCTGTGGGGTTAG	1
AGGCAACCTC	GAAACACCGGTGTGGCTGAGAGTCCGGCAATGGTGTGGCTGTGGGGTTAG	2
AGGCAAGCGC	GAAACACCGGTGCATTCGAAAGTCCGGTCGTAGTGTGGACGTGGGGTTAG	1
AGGCACACTA	GAAACACCGGTGTGGCTGAGAGTCCGGCAATGGTGTGGCTGTGGGGTTAG	1
AGGCACACTC	GAAACACCGGTGTGGCTGAGAGTCCGGCAATGGTGTGGCTGTGGGGTTAG	4
AGGCACCCTA	GAAACACCGGTGTGGCTGAGAGTCCGGCAATGGTGTGGCTGTGGGGTTAG	1
AGGCACCCTG	GAAACACCGGTGTGGCTGAGAGTCCGGCAATGGTGTGGCTGTGGGGTTAG	1
AGGCACCGTC	GAAACACCGGCGTGGCTGAGAGTCCGGCAATGGTGTGGCTGTGGGGTTAG	1
AGGCACTCGA	GAAACACCGGTGCATTCGAAAGTCCGGTCGTAGTGTGGACGTGGGGTTAG	1
AGGCACTCTC	GAAACACCGGTTTGGCTGAGAGTCCGGCAATGGTGTGGCTGTGGGGTTAG	1
AGGCATCTAC	GAAACACCGGTAAATTTGAGGCTCCGGCATGCAGGAGGCCGTGGGGTTAG	1
AGGCCACTAC	GAAACACCGGTAAATTTGAGGCTCCGGCATGCAGGAGGCCGTGGGGTTAG	2
AGGCCCACGA	GAAACACCGGTGCATTCGAAAGACCGGTCGTTGTATGGACGGGGGGATAG	1
AGGCCCATAC	GAAACACCGGTAAATTTGAGGCTCCGGCATGCAGGAGGCCGTGGGGTTAG	1
AGGCCCCGAC	GAAACACCGGTAAATTTGAGGCTCCGGCATGCAGGAGGCCGTGGGGTTAG	1
AGGCCCGGGC	GAAAAACCGGTGCATTCGAAAGTCCGGTCGTGGTGTGGACGTGGGGTTAG	1
AGGCCCTGGA	GAAACACCGGTGCATTCGAAAGTCCGGTCGTAGTGTGGACGTGGGGTTAG	1
AGGCCGCTAC	GAAACACCGGTAAATTTGAGGCTCCGGCATGCAGGAGGCCGTGGGGTTAG	1
AGGCGCCCGC	GAAACACCGGTGCATTCGAAAGTCCGGTCGTAGTGTGGACGTGGGGTTAG	1
AGGCGCTCGA	GAAACACCGGTGCATTCGAAAGTCCGGTCGTAGTGTGGACGTGGGGTTAG	1
AGGCGGAGCC	GAAACACCGGTTCCCGTCCAGTGGGGTTAGAGCTAGAAATAGCAAGTTAA	1
AGGCTCCTTT	GAAACACCGGTCTCGAGTGAGGTGTTCAGGGTGGGGTTAGAGCTAGAAAT	1
AGGGACCCTC	GAAACACCGGTGTGGCTGAGAGTCCGGCAATGGTGTGGCTGTGGGGTTAG	3
AGGGACCCTC	GAAACACCGGTGTGGCTGAGAGTCCGACAATGGTGTGGCTGTGGGGTTAG	1
AGGGACTCGC	GAAACACCGGTGCATTCGAAAGTCTGGTCGTAGTGTGGAAGTGGGGTTAG	1
AGGGCACACT	GAAACACCGGTGTGGCTGAGAGTCCGGCAAGGGTGTGGCTGTGGGGTTAG	1
AGGGCACTAC	GAAACACCGGTGCCCTTACTCTCACCTGATTACTTAATCCGTGGGGTTAG	1
AGGGCTGTCT	GAAACACCGGTGACATTGGGTACAGAAATAGCGAGTTAACCTAAGGCTAG	1
AGGGGAGGCT	GAAACACCGGTTCCCGTCCAGTGGGGTTAGAGCTAGAAATAGCAAGTTAA	1
AGGGTGTCTC	GACACACCGGTCCGTAGGAGACCCGTGTGGCATGTACCTTGTGGGGTTAG	1
AGGGTTAGCC	GAAACACCGGTTTACGTTGCATCGGTTGTGGGGTTAGAGCTAGAAATAGC	1
AGGGTTGTAT	GAAACACCGGTGACATTGGGTTAGAGCTAGAAATAGCAAGTTAACCTAAG	1
AGGTCATTAC	GAAACACCGGTAAATTTGAGGCTCCGGCATGCAGGAGGCCGTGGGGTTAG	1
AGGTCCATAA	GAAACACCGGTAAATTTGAGGCTCCGGCATGCAGGAGGCCGTGGGGTTAG	1
AGGTCTACCA	GAAACACCGGTTTACGTTGCATCGGGTTAGAGCTAGAAATAGAAAGTTAA	1
AGGTGATCGT	GAAACACCGGTGCATTCGAAAGTCCGGTCGGAGTGTGGACGGGGAGTTAG	1
AGGTTACTGG	GAAACACCGGTCTCGACTGAGGTGATCAGGGTGGTGCTAGAGCTAGAAAT	1
AGGTTCCTTT	GAAACACCGGTCTCGAGTGAGGTGTTCAGGGTGGGGTTAGAGCTAGAAAT	1
AGTAGACGTC	GAAACACCGGTATCCGTATGGACTGAACCAGGGTGTGCAGGTGGGGGTCC	1
AGTAGCCCTT	GAAACACCGGTCTCGAGTGAGGGGTTCAGGTTGTGGGGTTAGAGCTAGAA	1
AGTAGCTATG	GAAACACCGGTTACATTGAGTGGGGTTAGAGCTAGAAATAGCAAGTTAAC	1
AGTATAGATC	GAAACACCGGTCCGTAGGAGACCCGTGTGGCATGTACCTGTGGGGTTAGA	1
AGTATCCATT	GAAACACCGGTCTCGAGTGAGGTGTTCAGGGTCAGGGTGGGGTTAGAGCT	1
AGTATCGCGC	GAAACACCGGTTATATTTGTAAGCGTGTGGGGTTAGAGCTAGAAATAGCA	1
AGTCCCTCCT	GAAACACCAGTGCATTCGAAAGTCCGGTCGTAGTGTGGCCGTGGGGTTAG	1
AGTCCGCTGC	GAAACACCGGTCCGTAGGAGACCCGTGTGGCATGTACCTGTGGGGTTAGA	1
AGTCGCCCCT	GAAACACCGGTCCGTAGCCGACCCGGGTGGCATGTACCTGTGGGGTTAGA	1
AGTCGCTCGT	GAAACACCGGTGCATTCGAAAGTCCGGTCGTAGTGTGGACGTGGGGTTAG	1
AGTCGTTGTC	GAAACACCGGTGTACGTATGGACTGAACCAGGGTGTGCAAGTGGGGTTAG	1
AGTCTATCGA	GAAACACCGGTTATATTTGTAAGTGTGTGGGGTTAGAGCTAGAAATAGCA	1
AGTCTGAAGT	GAAACACCGGTCCGAAGGAGACCCGTGTGGCATGAACCTTAGGGGTAACA	1
AGTCTGCACA	GAAACACCGGTCCGTAGGAGACCCGTGTGGCATGTACCTGTGGGGTTAGA	1
AGTCTGCCTC	GAAACACCGGTCCGTAGGAGACCCGTGTGGCATGTACCTGTGGGGTTAGA	1895
AGTCTGCCTC	GAAACACCGGTCCGTAGGAGACCCGTGTGGCATGTACCTTGTGGGGTTAG	201
AGTCTGCCTC	GAAACACCGGTCCGTAGGAGACCCGTGTGGCATGTACCTCTGTGGGGTTA	102
AGTCTGCCTC	GAAACACTCGGTGCTTTTTTTCCTGCAGGGAGGCAGACTGAATTCGGGCC	35
AGTCTGCCTC	GAAACACCGGTCCGTAGGAGACCCGTGTGGCCATGGGGTTAGAGCTAGAA	19
AGTCTGCCTC	GAAACACCGGTCCGTAGGAGACCCGTGTGGCATATGTGGGGTTAGAGCTA	16
AGTCTGCCTC	GAAACACCGGTTTACGTTGCATCGGTGTGGGGTTAGAGCTAGAAATAGCA	15
AGTCTGCCTC	GAAACACCGGTCCGTAGGAGACCCGTGTGGCATGTACTGGGGTTAGAGCT	14
AGTCTGCCTC	GAAACACCGGTCCGTAGGAGACCCGTGTGGCATGTGTGGGGTTAGAGCTA	13
AGTCTGCCTC	GAAACACCGGTCCGTAGGAGACCCGTGTGGGGTTAGAGCTAGAAATAGCA	11
AGTCTGCCTC	GAAACACCGGTGTGGGGTTAGAGCTAGAAATAGCAAGTTAACCTAAGGCT	9
AGTCTGCCTC	GAAACACCGGTCCGTAGGAGACCCGTGTGCATCTGTGGGGTTAGAGCTAG	8
AGTCTGCCTC	GAAACACCGGTCCGTAGGAGACCCGTGTGGCATGTTGTGGGGTTAGAGCT	8
AGTCTGCCTC	GAAACACCGGTCCGTAGGAGACCCGTGTGGTGTGGGGTTAGAGCTAGAAA	8
AGTCTGCCTC	GAAACACCGGTTTACGTTGCATCGGGTTAGAGCTAGAAATAGCAAGTTAA	8
AGTCTGCCTC	GAAACACCGGTCCGTAGGAGACCCGTGTGGCATGTACGTGGGGTTAGAGC	7
AGTCTGCCTC	GAAACACCGGTCCGTAGGAGACCCCCGTGGGGTTAGAGCTAGAAATAGCA	6
AGTCTGCCTC	GAAACACCGGTCCGTAGGAGACCCGTGTGGCATGTACCTCCTGTGGGGTT	6
AGTCTGCCTC	GAAACACCGGTCCGTAGGAGACCCGTGTGGTCGTGTGGCATGTACCTGTG	5
AGTCTGCCTC	GAAACGCCGGTCCGTAGGAGACCCGTGTGGCATGTACCTGTGGGTTAGAG	4
AGTCTGCCTC	GAAACACCGGTCCGTAGGAGACCCGTGTGGCATGTACCCGTGTGGCATGT	3
AGTCTGCCTC	GAAACACCGGTGTGGCTGAGAGTCCGGCAATGGTGTGGCTGTGGGGTTAG	3
AGTCTGCCTC	CAAAACACCGGTCCGTAGGAGACCCGTGTGGCATGTACCTGTGGGGTTAG	2
AGTCTGCCTC	GAAACACCGGTCCGTAGGAGACCCGTGTGGCATGGGTTAGAGCTAGAAAT	2
AGTCTGCCTC	GAAACACCGGTCTCGAGTGAGGTGTTCAGGGTGGGGTTAGAGCTAGAAAT	2
AGTCTGCCTC	GAAACACCGGTTAAAGAGCTAGAAATAGCAAGTTAACCTAAGGCTAGTCC	2
AGTCTGCCTC	ACTGACGAAACACCGGTCCGTAGGAGACCCGTGTGGCATGTACCTGTGGG	1
AGTCTGCCTC	GAAAAACCGGTCCGTAGGAGACCCGTGTGGCATGTACCTCTTGTGGGGTT	1
AGTCTGCCTC	GAAACAAGGCTAGTCCGTTATCAACTTGAAAAAGTGGCACCGAGTCGGTG	1
AGTCTGCCTC	GAAACACCGGTAACATTGGGGCTAGAGCTAGAAATAGCAAGTTAACCTAA	1
AGTCTGCCTC	GAAACACCGGTCCGCAGGAGACCCCGGTGGCATGTACGTGTGGGGGTAGG	1
AGTCTGCCTC	GAAACACCGGTCCGGAGGAAACCCGTGAGGACCTGGTGTAAGAGCTAGAA	1
AGTCTGCCTC	GAAACACCGGTCCGTAATGTCCCCACGTGGGGTTAGAGCTAGAAAGAGCA	1
AGTCTGCCTC	GAAACACCGGTCCGTAGGAGACCCGTGTGGCAGTACCTGTGGGGTTAGAG	1
AGTCTGCCTC	GAAACACCGGTCCGTAGGAGACCCGTGTGGCATGTACCTCCCGTGGGGTT	1
AGTCTGCCTC	GAAACACCGGTCCGTAGGAGACCCGTGTGGCATTGAGCTGTGGGGGTTGG	1
AGTCTGCCTC	GAAACACCGGTCCGTAGGAGACCCGTGTGGCGGGTACGTTTGGGGGTTAA	1
AGTCTGCCTC	GAAACACCGGTCCGTAGGAGACCCGTGTGGTCGTGGCATGTACCTGTGGG	1
AGTCTGCCTC	GAAACACCGGTCCGTAGGAGACCGTGTGGCATGTACCTTGTGGGGTTAGA	1
AGTCTGCCTC	GAAACACCGGTCCGTAGGAGACGGGTTAGAGCTAGAAATAGCAAGTTAAC	1
AGTCTGCCTC	GAAACACCGGTCCGTAGGCGGCCCGTTAGACCTAGAACTAGCAAGTTAAC	1
AGTCTGCCTC	GAAACACCGGTCCGTAGGGCGCCCGTGTGGCTTGTACCCTGTGGGGTTCG	1
AGTCTGCCTC	GAAACACCGGTCCGTATGAGACCGGGGTGGCATGTAACTGTGGGGGTAAA	1
AGTCTGCCTC	GAAACACCGGTCCGTGAGAGACACGGGTGGCATGAACCTGCGGGGTTGGA	1
AGTCTGCCTC	GAAACACCGGTCCGTTCGAAAGCCGGGTCGCAGTGAGGACGGGGGGTTAG	1
AGTCTGCCTC	GAAACACCGGTCGGCAAGAGGCACTTGTGTGATGGGTTAGAGCTAGAAAT	1
AGTCTGCCTC	GAAACACCGGTGCATTCGAAAGTCCGGTCGCAGTGTGGACGTGGGGTTAG	1
AGTCTGCCTC	GAAACACCGGTGCATTCGAAAGTCCGGTCGTAGTGTGGACGGGGGGTTAG	1
AGTCTGCCTC	GAAACACCGGTGCCCTTACTCTCACCTGATTACTTAATCCGTGGGGTTAG	1
AGTCTGCCTC	GAAACACCGGTGTACGTATGGACTGAACCAGGGTGTGCAAGTGGGGTTAG	1
AGTCTGCCTC	GAAACACCGGTTAAGCCGAGGAGTGGGGTTAGAGCTAGAAATAGCAAGTT	1
AGTCTGCCTC	GAAACACCGGTTATATTTGTAAGTGTGTGGGGTTAGAGCTAGAAATAGCA	1
AGTCTGCCTC	GAAACACCGGTTCCCGTCCAGTGGGGTTAGAGCTAGAAATAGCAAGTTAA	1
AGTCTGCCTC	GAAACACCGGTTTACGTTGCATCGGTTAGTGGGGTTAGAGCTAGAAATAG	1
AGTCTGCCTC	GAAACACCGGTTTACGTTGCATCGGTTTGTGGGGTTAGAGCTAGAAATAG	1
AGTCTGTCCA	GAAACACCGGTCCGTAGGAGACCCGTGTGGCATATGTGGGGTTAGAGCTA	1
AGTCTTACTA	GAAACACCGGTCCGTAGGAGACCCGTGTGGCATGTACCTGTGGGGTTAGA	1
AGTGAGCATA	GAAACACCGGTTAAGCCGAGGAGTTAGAGCTAGAAATAGCAAGTTAACCT	1
AGTGATGTCC	GAAACACCGGTGACATTGGGTACAGGGGTGGGGTTAGAGCTAGAAATAGC	1
AGTGCAGCCT	GAAACACCGGTCCGTGTGAAGCCCGGGTAGCGTTAGACTGAGGAAGTAGA	1
AGTGCATGCT	GAAACACCGGTGACATTGGGTACAGGGTGGGGTTAGAGCTAGAAATAGCA	1
AGTGCCGTGT	GAAACACCGGTGCCAATTAGAGTTAGAGCTAGGAATAGCAGGGTAACCTA	1
AGTGCGCATA	GAAACACCGGTTAAGCCGAGGAGTTAGAGCTAGAAATAGCAAGTTAACCT	1
AGTGCGCCCC	GAAACACCGGTCCGCAGCAATCGCGTGTGGGGTTTGCGCTAGAAATAACA	1
AGTGCGCTTC	GAAACACCGGTTTACGTTGCATCGCCGGGTGGTTAAAGCTAGGAAGAGCA	1
AGTGCTGACT	CTAGTCCGTTATCAACTTGAAAGAGTGGCACCGAGTCGGTGCTTTTTTTA	1
AGTGGAGACT	GAAACACCGGTTCCCGTCCAGTGGGGTTAGAGCTAGAAATAGCAAGTTAA	1
AGTGGAGACT	GAAACACCGGTTCCCGTCCAGTGGGGGTAGAGCTAGAAATAGCAGGTTAA	1
AGTGGAGCAT	GAAACACCGGTTCCCGTCCAGTGGGGTTAGAGCTAGAAATAGCAAGTTAA	2
AGTGGAGGCT	GAAACACCGGTTCCCGTCCAGTGGGGTTAGAGCTAGAAATAGCAAGTTAA	1
AGTGGATGCT	GAAACACCGGTTCCCGTCCAGTGGGGTTAGAGCTAGAAATAGCAAGTTAA	1
AGTGGCGTCT	GAAACACCGGTCCCGTCCAGTGGGGTTAGAGCTAGAAAAAGCAAGTTAAA	1
AGTGGGCTGC	GAAACACCGGTCCGGAGGAGACCCGTGTGGCATGTACTAGTGGGGGTAAA	1
AGTGGTGCAT	GAAACACCGGTTCCCGTCCAGTGGGGTTAGAGCTAGAAATAGCAAGTTAA	1
AGTGTTCGCT	GCCTCCACGGCCACTAGTCTAAGGCTAGTCCGTTATCAACTTGAAAAAGG	1
AGTGTTGCCC	GAGACACCGGTGACATTGGGTACAGGGGTGGGGTTAGAGCTAGAAATAGC	1
AGTTGAGCCT	GAAACACCGGTTCCCGTCCAGTGGGGTTAGAGCTAGAAATAGCAAGTTAA	1
AGTTTCGTCT	GCAACACCGGTGACATTGGTGGGGTTAGAGCTAGAAATAGCAAGTTAACC	1
AGTTTGCATT	GAAACACCGGTCCGTAGGAGACCCGTGTGGCATGTACCTGTGGGGTTAGA	1
AGTTTGCTGC	GAAACACCGGTCCGTAGGAGACCCGTGCGGCATGGTCCTGTGGGGTTTGG	1
AGTTTGGGTA	GAAACACCGGTCGATTCATATCGAAACCGTCACGTAACAGTGGGGTTAGA	1
ATAAATTATA	GAAACACCGGTAACTATATTCATGCGATATCGCCGTATCAGTGGGGTTAG	3
ATAAATTCTA	GAAACACCGGTAACTATATTCATGCGATATCGCCGTATCAGTGGGGTTAG	1
ATAACATATA	GAAACACCGGTAACTATATTCATGCGATATCGCCGTATAGGGTTAGAGCT	1
ATAACCTAGC	GAAACACCGGTGCATTCGAAAGTCCGGTCGTAGTGTGGACGTGGGGTTAG	1
ATAACCTATA	GAAACACCGGTAACTATATTCATGCGATATCGCCGTATCAGTGGGGTTAG	1
ATAACTACAA	GAAACACCGGTTACATAGAGGGGTTAGAGCTAGAAATAGCAAGTTAACCT	1
ATAACTCATA	GAAACACCGGTAACTATATTCATGCGATATCGCCGTATCAGTGGGGTTAG	1
ATAACTGATA	GAAACACCGGTAACTATATTCATGCGATATCGCCGTATCAGTGGGGTTAG	1
ATAACTTAGA	GAAACACCGGTAACTATATTCATGCGATATCGCCGTATCAGTGGGGTTAG	2
ATAACTTATG	GAAACACCGGTTACTATGTTCATGCGATATCGTCGTATCTGTGGGGATAG	1
ATAACTTTTT	GAAACACCGGTAACTATATTCATGCGATATCGCCGTATCAGTGGGGTTAG	1
ATAAGCGAAC	GAAACACCGGTGCATTCGAAAGTCCGGTCGTAGTGTGGACGTGGGGTTAG	1
ATAAGCTATG	GAAACACCGGTACAGGGTTAGAGCTAGAAATAGCAAGTTAACCTAAGGCT	1
ATAAGTTATA	GAAACACCGGTAACTATATTCATGCGATATCGCCGTATCAAGTGGGGTTA	1
ATAATACTTT	GAAACACCGGTCTCGAGTGAGGTGTTCAGGGTGGGGTTAGAGCTAGAAAT	1
ATAATCATTT	GAAACACCGGTCTCGAGTGAGGTGTTCAGGGTGGGGTTAGAGCTAGAAAT	1
ATAATCCCTC	GAAACACCGGTCTCGAGTGAGGTGTTCAGGTGGGGTTAGAGCTAGAAATA	1
ATAATCCGGT	GAAACACCGGTCTCGAGTGAGGTGTTCAGGGTGTGGTTAGAGCTAGAAAT	1
ATAATCGGTC	GAAACACCGGTACCTTTGTTGATGCTGGGTGGAAGGTGGGGTTAGAGCTA	1
ATAATTCTCC	GAAACACCGGTTTACGTTGCATTGGTGTGGGGTTAGAGCTAGAAATAGCA	1
ATAATTTATA	GAAACACCGGTAACTATATTCATGCGATATCGCCGTATCAGTGGGGTTAG	1
ATACACACGC	GAAACACCGGTGCATTCGAAAGTCCGGTCGTAGTGTGGACGTGGGGTTAG	1
ATACACGGTC	GAAACACCGGTACCTTTGTTGATGCTGGGTGGGGTTAGAGCTAGAAATAG	1
ATACATTATT	GAAACACCGGTAAAGGCTAGTCCGTTATCAACTTGAAAAAGTGGCACCGA	1
ATACCAGACC	GAAACACCGGTACCTTGTGGGGTTAGAGCTAGAAATAGCAAGTTAACCTA	1
ATACCCAATC	GAAACACCGGTTCATGCAAAATGCGGGTCGGGGTAGGGCCAGGGGTAGCG	1
ATACCCTGTA	GAAACACCGGTGCATTCGAAAGTCCGGTCGTAGTGTGGACGTGGGGTTAG	1
ATACCTGGCC	GAAACACCGGTACCTTTGTTGATGCTGGGTGGAAGGAATTTGTGGGGTTA	1
ATACGAACTT	GAAAAACCGGTCGATTCATAACGAAACCTTCCCGTGACAGTGGGGTTAGA	1
ATACTAGGCT	GAAACACCGGTACCTTTGTTGATGCTGGGTGGAAGTAGAAATAGCAAGTT	1
ATACTCCCCC	GAAACACCGGTTTACGTTGCAGAAATAGCAAGTTAACCTAAGGCTAGTCC	1
ATACTGGGCA	GAAACACCGGTACCTTTGTTGATGCTGGGTGGAAGGAATTTTGTGGGGTT	1
ATACTGTGTA	GAAACACCGGTACCTTTGTTGATGCTGGGTGGAAGGAATGGGGTTAGAGC	1
ATACTTAGAC	GAAACACCGGTTTACGTTGCATCGGTGTGGGGTTAGAGCTAGAAATAGCA	1
ATAGAGCATA	GAAACACCGGTTAAGCCGAGTGGGGTTAGAGCTAGAAATAGCAAGTTAAC	1
ATAGCTACGC	GAAACACCGGTTACATTGAGTGGGGTTAGAGCTAGAAATAGCAAGTTAAC	1
ATAGCTCCTG	GAAACACCGGTTTACGTTGCATCGGGGTTAGAGCTAGAAATAGCAAGTTA	1
ATAGTGTTGT	GAAACACCGGTGACATTGGGTTAGAGCTAGAAATAGCAAGTTAACCTAAG	1
ATAGTTAGGT	GAAACACCGGTTACATTGGGGTTAGAGCTAGAAATAGCAAGTTAACCTAA	1
ATATCCGGGT	GAAACACCGGTCGATTCATATCGAAACCTTCCCGGTTAGAGCTAGAAATA	1
ATATCCTCGG	GAAACACCGGTTTACGTATGGACTGAACCAGGGTGTGCAAGTGGGGTTAG	1
ATATCGTCGT	GAAATACCGGTGTACGTATGGACTGAACCAGGGTGTGCAAGTGGGGTTAG	1
ATATCGTGGT	GAAACACCGGTGTACGTATGGACTGAACCAGGGTGTGCAACAAGTGGGGT	1
ATATCTATTT	GGGTTAGAGCTAGAAATAGCAAGTTAACCTAAGGCTAGTCCGTGATCAAC	1
ATATTCTCGC	GGAACACCGGTGCATTCGAAAGTCCGGGCGTAGAGCTGACATTGGGTTAG	1
ATCAATCGAG	GAAACACCGGTTATATTTGTAAGTGTGTGGGGTTAGAGCTAGAAATAGCA	1
ATCAGCAGCT	GAAACACCGGTTTACGTTGCATCGGTGTGGGGTTAGAGCTAGAAATAGCA	1
ATCAGCTATG	GAAACACCGGTTACATTGAGATTGGGGTTAGAGCTAGAAATAGCAAGTTA	1
ATCGAGCATA	GAAACACCGGTTAAGCCGAGGATGGGGTTAGAGCTAGAAGTAGCAAGTTA	1
ATCGCTCTTC	GAAACACCGGTTCCCTTACTCTCACCTGATTACTTAATCCGTGGGGTTAG	1
ATCGTATGAC	GAAACACCGGTCCGTAGGAGACCCGTGTGGCATGTACCTGTGGGGTTAGA	1
ATCGTTATGT	GAAACACCGGTTACATTGGGGTTAGAGCTAGAAATAGCAAGTTAACCTAA	1
ATCTAAGCGG	GAAACTGGGGTTAGAGCTAGAAATAGCAAGATAACCAAAGGCTAGGCCGT	1
ATCTACAGAG	GAAACACCGGTTATATTTGTAAGTGTGTGGGGTTAGAGCTAGAAATAGCA	1
ATCTATAGAG	GAAGCACCGGTTATATTTGTAAGTGTGTGGGGTTAGAGCTAGAAATAGCA	1
ATCTATAGAG	GAAACACCGGTTATATTTGTAAGTGTGTGGGGTTAGAGCTAGAAATAGCA	1
ATCTATCGCG	GAAACACCGGTTATATTTGTAAGTGTGTGGGGTTAGAGCTAGAAATAGCA	2
ATCTATCGCG	GAAACACCGGTTATATTTGTAAGTGGGGTTAGAGCTAGAAATAGCAAGTT	1
ATCTCACTAC	GAAACACCGGTGCCCTTACTCTCACCTGATTACTTAATCCGTGGGGTTAG	1
ATCTCTCGAG	GAAACACCGGTTATATTTGTAAGTGTTTTGTGGGGTTAGAGCTAGAAATA	1
ATCTCTCGAG	GAAACACCGGTTATATTTGTGATGGGGTTAGAGCTAGAAATAGCAAGTTA	1
ATCTCTCGAG	GAAACACCGGTTATATTTGTAAGTGTGTGGGGTTAGAGCTAGAAATAGCA	1
ATCTTAGGTC	GAAACACCGGTCGTGTCATATCGGTACGTTGTCATAGCTAGGAAGAGCGA	1
ATGAATAGAT	GAAACACCGGTTTACGGTGTTAGTGCGTGGGGTTAGAGCTAGAAATAGCA	1
ATGAATCCTT	GAAACACCGGTCTCGAGTGAGGTGTTCAGGGTGGGGTTAGAGCTAGAAAT	2
ATGACCATAT	GAAACACCGGTTAAGAGCTAGAAATAGCAAGTTAACCTAAGGCTAGTCCG	1
ATGACTTATA	GAAACACCGGTAACTATATTCATGCGATATCGCCGTATCAGTGGGGTTAG	1
ATGAGAAGTA	GAAACACCGGTTAAGCCGAGTGGGGTTAGAGCGAGAAATAGCAAGTTAAC	1
ATGAGATTAA	GAAACACCGGTTAAGCCGTGGAGTTAGATCTAGAAATAGCAAGTTAACCT	1
ATGAGCATTC	GAAACACCGGTTAAGCCGAGGAGTTAGAGCTAGAAATAGCAAGTTAACCT	1
ATGAGCTATG	GAAACACCGGTTACATTGAGTGGGGTTGGAGCTAGAAATAGCAAGTTAAC	1
ATGAGTAGTA	GAAAACCCGGTTTACGTTGCATCGGTGTGGGGTTAGAGCTAGAATTAGCA	1
ATGATAGGCC	GAAACACCGGTACCTTTGTTGATGCTGGGTGGAAGGAATTTTGGGGTTAG	1
ATGATATTAA	GAAACACCGGTTAAGCCGAGGATGGGGTTAGAGCTAGAAATAGCAAGTTA	1
ATGCACCCTC	GAAACACCGGTGTGGCTGAGAGTCCGGCAATGGTGTGGCTGTGGGGTTAG	1
ATGCAGACTT	GAAACACCGGTTCCCGTCCAGTGGGGGTAGAGCTAGAACTAGCAAGTTAA	1
ATGCCTATGT	GAAACACCGGTTTACGTTGCATCGGGGTGGGGTTAGAGCTAGATATAGCA	1
ATGCGTATAT	GAAACACCGGTTTACGTTGCATCGGTGTGGGGTTAGAGCTAGAAATAGCA	1
ATGCGTCTCT	GAAACACCGGTTAGAAATAGCAAGTTAACCTAAGGCTAGTCCGTTATCAA	1
ATGCTCGGCA	GAAACACCGGTACCTTTGTTGATGCTGGGTGGAAGGGATAGCAAGGAGGG	1
ATGCTGACTC	GAAACACCGGTCTGTAGTGGACCCGTGTGGCATTTACCCGAGGGGTTAGA	1
ATGCTGACTT	GAAACACCGGTCCGTAGGAGACCCGTGTGGCATGTACCTGTGGGGTTAGA	1
ATGCTGAGAA	GAAACACTGGTTTACGTTGCATCGGTGTGGGGTTAGAGCTAGAAATAGCA	1
ATGCTTAGCT	GAAACACCGGTTTACGTTGCATCGGTGTGGGGTTAGAGCTAGAAATAGCA	1744
ATGCTTAGCT	GAAACACCGGTTTACGTTGCATCGGTTGTGGGGTTAGAGCTAGAAATAGC	355
ATGCTTAGCT	GAAACACCGGTTTACGTTGCATCGGGGTTAGAGCTAGAAATAGCAAGTTA	302
ATGCTTAGCT	GAAACACCGGTTTACGTTGCATCGGGTTAGAGCTAGAAATAGCAAGTTAA	150
ATGCTTAGCT	GAAACACCGGTTTACGTTGCATCGGTTTGTGGGGTTAGAGCTAGAAATAG	107
ATGCTTAGCT	GAAACACCGGTTTACGTTGCATCGGTTAGAGCTAGAAATAGCAAGTTAAC	52
ATGCTTAGCT	GAAACACCGGTTAGAAATAGCAAGTTAACCTAAGGCTAGTCCGTTATCAA	43
ATGCTTAGCT	GAAACACCGGTTTACTAGAAACCTAAGGCTAGTCCGTTATCAACTTGAAA	28
ATGCTTAGCT	GAAGTTAACCTAAGGCTAGTCCGTTATCAACTTGAAAAAGTGGCACCGAG	24
ATGCTTAGCT	GAAACACCGGTTTACGTTGTTACGTTAGAGCTAGAAATAGCAAGTTAACC	19
ATGCTTAGCT	GAAACACCGGTTTACGTTGCATTTAGAGCTAGAAATAGCAAGTTAACCTA	18
ATGCTTAGCT	GGGTTAGAGCTAGAAATAGCAAGTTAACCTAAGGCTAGTCCGTTATCAAC	18
ATGCTTAGCT	GAAACACCGGTTTACGTTAGAGCTAGAAATAGCAAGTTAACCTAAGGCTA	16
ATGCTTAGCT	GAAACACCGGTTTGGTTAGAGCTAGAAATAGCAAGTTAACCTAAGGCTAG	16
ATGCTTAGCT	GAAACACCGGTTTACGTTGCAGAAATAGCAAGTTAACCTAAGGCTAGTCC	15
ATGCTTAGCT	GAAACACCGGTTTACGTTGCATCGGCTTTGTGGGGTTAGAGCTAGAAATA	13
ATGCTTAGCT	GAAACACCGGTTTACGTTGCATCGGTTGCATGGGGTTAGAGCTAGAAATA	13
ATGCTTAGCT	GAAACACCGGTTTACTGTGGGGTTAGAGCTAGAAATAGCAAGTTAACCTA	11
ATGCTTAGCT	GAAACACCGGTTTACGTTGCATCGGGGGTTAGAGCTAGAAATAGCAAGTT	10
ATGCTTAGCT	GAAACACCGGTTTACGTTGGGGTTAGAGCTAGAAATAGCAAGTTAACCTA	9
ATGCTTAGCT	GCTAGAAATAGCAAGTTAACCTAAGGCTAGTCCGTTATCAACTTGAAAAA	9
ATGCTTAGCT	GAAACACCGGTTTACGTTGCATCGGTAAGCTAGAAATAGCAAGTTAACCT	8
ATGCTTAGCT	CAAAACACCGGTTTACGTTGCATCGGTGTGGGGTTAGAGCTAGAAATAGC	7
ATGCTTAGCT	GAAACACCGGTTTACGTTGGAAATAGCAAGTTAACCTAAGGCTAGTCCGT	7
ATGCTTAGCT	GAAACACCGGTTTACGTTGCATGGTGGGGTTAGAGCTAGAAATAGCAAGT	5
ATGCTTAGCT	GAAACACCGGTTTACGTTGCATGTGGGGTTAGAGCTAGAAATAGCAAGTT	5
ATGCTTAGCT	GAAACACCGGTTACGTTGCATCGGTTGTGGGGTTAGAGCTAGAAATAGCA	3
ATGCTTAGCT	GAAACACCGGTTTACGTTGCATCGGTGTGGGTTAGAGCTAGAAATAGCAA	3
ATGCTTAGCT	GAAACACCGGTAAATTTGAGGCTCCGGCATGCAGGAGGCCGTGGGGTTAG	2
ATGCTTAGCT	GAAACACCGGTTACATTGAGGGTTAGAGCTAGAAATAGCAAGTTAACCTA	2
ATGCTTAGCT	GAAACACCGGTTTACTGTGGGGTTAGAGCTAGAAATAGCAGGTTAACCTA	2
ATGCTTAGCT	CAAAACACCGGTTTACGTTGCATCGGCTTTGTGGGGTTAGAGCTAGAAAT	1
ATGCTTAGCT	GAAAAACGGGTTTACGTTCCATCGGGGTGGGTTTAGACCTAGAATAAGCA	1
ATGCTTAGCT	GAAACACCGATGACATTGGGTACAGGGGTGGGGTTAGAGCTAGAAATAGC	1
ATGCTTAGCT	GAAACACCGGTAAATTTGAGGCTCCGGCATGCAGAAGGCCGGGGGGTGAG	1
ATGCTTAGCT	GAAACACCGGTATACGGTGCTTCTGCAGGGGCTTATCGCTAGTTATAGCC	1
ATGCTTAGCT	GAAACACCGGTCCGTAGGAGACCCGTGTGGCATGTACCTGTGGGGTTAGA	1
ATGCTTAGCT	GAAACACCGGTCCGTAGGAGACCCGTGTGGCATGTACCTTTGGGGTTAGA	1
ATGCTTAGCT	GAAACACCGGTCTCGAGTGAGGTGTTCAGGGTGGGGTTAGAGCTAGAAAT	1
ATGCTTAGCT	GAAACACCGGTGACATTAGGTGGGGTTAGAGCTAGAAATAGCAAGTTAAC	1
ATGCTTAGCT	GAAACACCGGTGTACGTATGGACTGAACCAGGGTGTGCAAGTGGGGTTAG	1
ATGCTTAGCT	GAAACACCGGTGTGGCTGAGAGTCCGGCAATGGTGTGGGGTTAGAGCTAG	1
ATGCTTAGCT	GAAACACCGGTTACATTGGGGTTAGAGCTAGAAATAGCAAGTTAACCTAA	1
ATGCTTAGCT	GAAACACCGGTTACGTTGCACCGGTTGTGGGGTTAGAGCTAGAAATAGCA	1
ATGCTTAGCT	GAAACACCGGTTACGTTGCATCGGGGTTAGAGCTAGAAATAGCAAGTTAA	1
ATGCTTAGCT	GAAACACCGGTTACGTTGCATCGGTGTGGGGTTAGAGCTAGAAATAGCAA	1
ATGCTTAGCT	GAAACACCGGTTACGTTGCATCGGTTGTGGGGTCAGAGCTAGAAATAGCA	1
ATGCTTAGCT	GAAACACCGGTTTAAGATGCATCGCATTGAGGGTAGAGCTAGCAATAGAA	1
ATGCTTAGCT	GAAACACCGGTTTACATTAGAACTAACAAGTTAAACTAAGACTAGTACGA	1
ATGCTTAGCT	GAAACACCGGTTTACGGTTCATCGTTTTGTGGGGGTATAGCTCGAAATAT	1
ATGCTTAGCT	GAAACACCGGTTTACGTTGCATCGTACGTTTTACGTTGAAAAAGTGGCAC	1
ATGCTTAGCT	GAAACACCGGTTTACGTTTCATCGGTGCGGGTTAGAGCTAGAAATAGCAG	1
ATGCTTAGCT	GGAACACCGGTTTACGTTGCGTCGGGGGTAGAGAATGTAATAGTAAGCTA	1
ATGCTTATAC	GAAACACCGGTAACTATATTCATGCGATATCGCCGTATCAGGGGGGATAA	1
ATGCTTCCTA	GAAACACCGGTTTACGTTGCATCGGTGCCGGGTTGGATCTAGAAATAACA	1
ATGCTTCGAC	GAAACACCGGTTTACGTTGCATCGGTGTGGGGTTAGAGCTAGAAATAGCA	1
ATGCTTCGTC	GAAACACCGGTTTACGTTGCATCGGTGTGGGGTTAGAGCTAGAAATAGCA	1
ATGCTTGGAC	GAAACACCGGTTTACGTTGCATAGGCGTAGGGGTCGAGCTAGAAATAGAA	1
ATGGACACGC	GAAACACCGGTCGGCGGGGCTAGAGCTAGGAATTGCAAGTTAAACTAAGG	1
ATGGAGCGCC	GAAACACCGGTTTACGTTGCATCGGTGTGGGGTTAGAGCTAGAAATAGCA	1
ATGGCACTAC	GAAACACCGGTGCCCTTACTCTCACCTGATTACTTAATCCGTGGGGTTAG	1
ATGGCTATTT	GAAACACCGGTTACAATTGGGGTTAGAGCTAGAAATAGCAAGTTAACCTA	1
ATGGCTATTT	GAAACACCGGTTACATTGGGGTTAGAGCTAGAAATAGCAAAGTAACCTAT	1
ATGGGCATAC	GAAACACCGGTTACGCCACGGGGATAGAGCTAGAAATAGCAAGTTAACAT	1
ATGGTGAGAT	GAAACACCGGTTTACGTTGCATCGGTTAGAGCTAGAAATAGCAAGTTAAC	1
ATGTATCGGT	GAAACACCGGTTATATTTGAGGGGTTCGGGCTGGGAATAGAACTTTAAAC	1
ATGTCTACGT	GAAACACCGGTTACATTGAGGGGTTAGAGCTAGAAATAGCAAGTTAAGCT	1
ATGTCTAGGT	GAAACACCGGTTTACGTTGCTTCGGTTGTGGGGTTAGAGCTAGAAATAGC	1
ATGTCTAGGT	GAAACACCGGTGCCCTTACTCTCATCTGATTACTAAATCTGTGGGGATAG	1
ATGTCTTTGA	GAAACACCGGTTGAATTTGGGGCTTAGAGCGAGTAGAAGTAGGAATAGCA	1
ATGTGCAACC	GAAACACCGGTTAAGCCGAGGTTAGAGCTAGAAATAGTAAGTTAACCTAA	1
ATGTGTATCC	GAAACACCGGTTAAGCCGAGGAGTTAGAGCTAGAAATAGCAAGTTAACCT	1
ATGTTAAGCC	GAAACACCGGTTTACGTTGCATCGGTGTGGGGTTAGAGCTAGAAATAGCA	1
ATGTTGAGTT	GAAACACCGGTTTACGTTGCATCGGTGTGGGGTTAGAGCTAGAAATAGCA	1
ATTAACTATG	CAAAACACCGGTTACATTGGGGTTAGAGCTAGAAATAGCAAGTTAACCTA	1
ATTAGATATG	GAAACACCGGTTACATCTCTGAGGGTTAGAGCTAGAAATAGCAAGTTAAC	1
ATTAGATATG	GAAACACCGGTTACATTGAGGGTTAGAGCTAGAAATAGCAAGTTAACCTA	1
ATTAGCAGAA	GAAACACCGGTTAAGCCGAGTGGGGTTAGAGCTAGAAATAGCAAGTTAAC	1
ATTAGCGGTG	GAAACACCGGTTACATTGAGGGTTAGAGCTAGAAATAGCAAGTTAACCTA	1
ATTAGGTATG	GAAACACCGGTTACATTGAGATTGGGGTTAGAGCTAGAAATAGCAAGTTA	1
ATTAGTTATG	GAACACGAGGGATTAGAGCTAGAAATAGCAAGTTAACCTAAGGCTAGTCC	1
ATTCGCAATG	GAAACACCGGTTACATTGAGGGTTAGAGCTAGAAATAGCAAGTTAACCTA	1
ATTCTCTATT	GAAACACCGGTTACATTGAGGGTTAGAGCTAGAAATAGCAAGTTAACCTA	1
ATTGAGAATA	GAAACACCGGTTAAGCCGAGGATGGGGTTAGAGCTAGAAATAGCAAGTTA	1
ATTGAGCCTA	GAAACACCGGTTAAGCCGAGGTTAGAGCTAGAAATAGCAAGTTAACCTAA	1
ATTGAGCGTA	GAAACACCGGTTAAGCCGAGGGGTTAGAGCTAGAAATAGCAAGTTAACCT	1
ATTGCGCATA	GAAACACCGGTTAAGCCGAGGAGTTTCGTTAGAGCTAGAAATAGCAAGTT	1
ATTGCTAAGT	GAAACACCGGTTACATTGAGGGTTAGAGCTGGATATAGCAAGTTAAACTA	1
ATTGCTGCCT	GAAACACCGGTGACCATGGGGTTAGATCTAGAAATAGCAAGTTAACCTAA	1
ATTGGCGATG	GAAACACCGGTTACATTGAGGGGTTAGAGCTAGAAATAGCAAGTTAACCT	1
ATTGGGAATA	GAAACACCGGTTAAGCCGAGTGGGGTTAGAGCTAGAAATAGCAAGTTAAC	1
ATTGTGCATA	GAAACACCGGTTAAGCCGAGGAGTTTCGTTAGAGCTAGAAATAGCAAGTT	1
ATTGTGCATA	GAAACACCGGTTAAGCCGAGTGGGGTTAGAGCTAGAAATAGCAAGTTAAC	1
ATTTACCGCC	GAAACACCGGTCGGGGCCACTCAGTGGTGGGGTTAGAGCTAGAAATAGCA	1
CAAAAAGCTC	GAAACACCGGTTTGAACTAGAAATAGCAAGTTAACCTAAGGCTAGTCCGT	1
CAAACAACGC	GAAACACCGGTTTGAACTACCTAGTTCAAACCGGTGGGGTTAGAGCTAGA	1
CAAAGCCCTT	GAAACACCGGTCTCGAGTGAGGTGTTCAGGGGTGGGGTTAGAGCTAGAAA	1
CAAATAGTTT	GAAACACCGGTCTCGGGTGAGGTGTTCAGGGTGGGGTTAGAGCTAGAAAT	1
CAAATCGCAA	GCTAGAAAAAGCAAGTTAACCTAAGGCTAGTCCGTTATCAACTAGAAAAA	1
CAACAAGTCA	GAAACACCGGTACCTTTGTTGATGCTGGGTAGAAGGTACACCGGTAACTT	1
CAACACGCAT	GGAACACCGGTTTGAACTACCTAGAAATAGCAAGTTAACCTAAGGCTAGT	1
CAACAGGCCC	GAAACACCGGTTTGAACTACCTAGTTCAAACACCGGTTTGAGCTACCTAG	1
CAACCCCGCG	GAAACACCGGTTTGAACTACCTAGTTCAAACCGGTGGGGTTAGAGCTAGA	1
CAACTTCTTC	GAAACACCGGTCTCGATATTGATGTTCAGGCGGCGTATAGAGCGAGAAAT	1
CAAGCTCTAC	GAAACACCGGTGCCCTTACTCTCACCTGATTACTTAATCCGTGGGGTTAG	1
CAAGGCCTTT	GAAACACCGGTCTCGAGGGAGGAGTTCAGGGTGGGGTTAGAGCTAGAAAT	1
CAATTACCAC	GAAACACCGGTCGGGGCCACTCAGTGGTGGGGTTAGAGCTAGAAATAGCA	1
CAATTTCTTT	GAAACACCGGTCTCGAGTGTGGTGTTCAGGGTGGGGTTAGAGCTAGAAAT	1
CACAAAGGCA	GAAACACGGGTTAGAGCTAGAAATAGCAAGTTAACCTAAGGCTAGTCCGT	1
CACAAAGTAC	GAAACACCGGTTTGAACTACCTAGTTCAAACCGGTGAGGTTAGAGCTAGA	1
CACAACGCCC	GAAACACCGGTTTGAACTAGAAATAGCAAGTTAACCTAAGGCTAGTCCGT	804
CACAACGCCC	GAAACACCGGTTTGAACTACCTAGTTCAAACCGGTGGGGTTAGAGCTAGA	582
CACAACGCCC	GCTAGAAATAGCAAGTTAACCTAAGGCTAGTCCGTTATCAACTTGAAAAA	393
CACAACGCCC	GAAACACGGGTTAGAGCTAGAAATAGCAAGTTAACCTAAGGCTAGTCCGT	167
CACAACGCCC	GAAACACCGGTTTGAACCGGTGGGGTTAGAGCTAGAAATAGCAAGTTAAC	84
CACAACGCCC	GAAACACCGGTTTGAACTACCTAGTTCAAACACCGGTTTGAACTACCTAG	52
CACAACGCCC	GAAACACCGGTTTGAACTACCTAGTAGCAAGTTAACCTAAGGCTAGTCCG	50
CACAACGCCC	GAAACACCGGTTTGAACTACCTAGAAATAGCAAGTTAACCTAAGGCTAGT	44
CACAACGCCC	GAAACACCGGTTTGAACTACCTAGGGGGTAGTTCAAACCGGGGTTAGAGC	40
CACAACGCCC	GAAACACCGGTTTGAACTACCTGGGGTTAGAGCTAGAAATAGCAAGTTAA	39
CACAACGCCC	GAAACACCGGTTTAGAGCTAGAAATAGCAAGTTAACCTAAGGCTAGTCCG	31
CACAACGCCC	GGGTTAGAGCTAGAAATAGCAAGTTAACCTAAGGCTAGTCCGTTATCAAC	26
CACAACGCCC	GAAACACCGGTTTGAACTACCTAGAGCTAGAAATAGCAAGTTAACCTAAG	25
CACAACGCCC	GAAACACCGGTTTGAACAGAGCTAGAAATAGCAAGTTAACCTAAGGCTAG	19
CACAACGCCC	GAAACACCGGTTTGAACTACCTAGTTCAAACCGGGTGGGGTTAGAGCTAG	18
CACAACGCCC	GAAACACCGGTTTGAACGCGGTGGGGTTAGAGCTAGAAATAGCAAGTTAA	16
CACAACGCCC	GAAACACCGGTTTGGGGTTAGAGCTAGAAATAGCAAGTTAACCTAAGGCT	16
CACAACGCCC	ATGTGGGGTTAGAGCTAGAAATAGCAAGTTAACCTAAGGCTAGTCCGTTA	14
CACAACGCCC	GAAACACCGGTTTGAACGGTGGGGTTAGAGCTAGAAATAGCAAGTTAACC	13
CACAACGCCC	ATTGTGGGGTTAGAGCTAGAAATAGCAAGTTAACCTAAGGCTAGTCCGTT	11
CACAACGCCC	GAAACACCGGTTTGAAAGGTGGGGTTAGAGCTAGAAATAGCAAGTTAACC	10
CACAACGCCC	GAAACACCGGTTTGAACTACCTAGAAAGGGTTAGAGCTAGAAATAGCAAG	10
CACAACGCCC	GAAACACCGGTTTGAACTAAGTGGGGTTAGAGCTAGAAATAGCAAGTTAA	7
CACAACGCCC	GAAACACTGGGGTTAGAGCTAGAAATAGCAAGTTAACCTAAGGCTAGTCC	5
CACAACGCCC	GAAATAGCAAGTTAACCTAAGGCTAGTCCGTTATCAACTTGAAAAAGTGG	5
CACAACGCCC	GAAACACCGGTTTGAACCGGTTTGAACCGGTGGGGTTAGAGCTAGAAATA	4
CACAACGCCC	GAACACGGGTTAGAGCTAGAAATAGCAAGTTAACCTAAGGCTAGTCCGTT	4
CACAACGCCC	AGGGCTAGAAATAGCAAGTTAACCTAAGGCTAGTCCGTTATCAACTTGAA	3
CACAACGCCC	CAAAACACCGGTTTGAACTAGAAATAGCAAGTTAACCTAAGGCTAGTCCG	3
CACAACGCCC	GAAACACCGGTTTGAACTACCTAGTTCAAACCGTGGGGTTAGAGCTAGAA	3
CACAACGCCC	GAAACACCGGTTTGCTAGAAATAGCAAGTTAACCTAAGGCTAGTCCGTTA	3
CACAACGCCC	GAAACACCGGTGCCCTTACTCTCACCTGATTACTTAATCCGTGGGGTTAG	2
CACAACGCCC	GAAACACCGGTTTGAACTACCTAGTTAACCTAAGGCTAGTCCGTTATCAA	2
CACAACGCCC	AAGCTAGAAATAGCAAGTTAACCTAAGGCTAGTCCGTTATCAACCTGAAA	1
CACAACGCCC	AGAGGCTAGAAATAGCAAGTTAACCTAAGGCTAGTCCGTTATCAACTTGA	1
CACAACGCCC	AGGAAGGAAAAACGGGTTTAACTAGAAATAGCAAGTTAACCTAAGGCTAG	1
CACAACGCCC	ATAGAAGAAGCAAGTTAACCTAAGGCTAGTCCGTTATCAACTTGAAAAAG	1
CACAACGCCC	ATGGCTAGAAATAGCAAGTTAACCTAAGGCTAGTCCGTTACCAACTTGAA	1
CACAACGCCC	ATGGCTAGAAATAGCAAGTTAACCTAAGGCTAGTCCGTTATCAACTTGAA	1
CACAACGCCC	CAAAACACCGGTTTGAACTACCTAGTTCAAACCGGTGGGGTTAGAGCTAG	1
CACAACGCCC	CAAAACACCGGTTTGAACTAGAAATATCAAGTTAACCTAAGGCTAGTCCG	1
CACAACGCCC	GAAACACCGGTACCTTTGTTGATGCTGGGTGGGGTTAGAGCTAGAAATAG	1
CACAACGCCC	GAAACACCGGTCACATTGAGGGGTTAGAGCTAGAAATAGCAAGTTAACCT	1
CACAACGCCC	GAAACACCGGTCGATTCATATCGAAACCTTCCCGTGACAGTGGGGTTAGA	1
CACAACGCCC	GAAACACCGGTGTCGACAGCCTCATTCACTGCGGGGATAGAGAAAGTAGT	1
CACAACGCCC	GAAACACCGGTTAAGCCGAGTGGGGTTAGAGCTAGAAATAGCAAGTTAAC	1
CACAACGCCC	GAAACACCGGTTCAACCGACCCAGTTCGACCAGCGGTTAGAGCTACAAAG	1
CACAACGCCC	GAAACACCGGTTTACGTTGCATCGGTGTGGGGTTAGAGCTAGAAATAGCA	1
CACAACGCCC	GAAACACCGGTTTGAAATACCTAGTTCTGACCGGAGAGGTTAGAGCTGGA	1
CACAACGCCC	GAAACACCGGTTTGAACTACCTAGTGGGGTTAGAGCTAGAAATAGCAAGT	1
CACAACGCCC	GAAACACCGGTTTGAACTACCTAGTTCAACCGGTGGGGTTAGAGCTAGAA	1
CACAACGCCC	GAAACACCGGTTTGAACTACCTAGTTCAGACCGTGGGGTTAGAGCTAGAA	1
CACAACGCCC	GAAACACCGGTTTGAACTACCTAGTTCGAACCGTGGGGTTAGAGCTAGAA	1
CACAACGCCC	GAAACACCGGTTTGAACTAGAATAACCAATTTACCCTAAGCCCAGTCGTT	1
CACAACGCCC	GAAACACCGGTTTGAACTTCACATTTCAAGGTGGCCTTAGGCTTAGAAAT	1
CACAACGCCC	GAAACACCGGTTTGATTTACCTGGGTGTAGAGCTAGAGCTAGAAAGATAA	1
CACAACGCCC	GAAATACCGGTTTGCTAGAAATAGCAAGTTAACCTAAGGCTAGTCCGTTA	1
CACAACGCCC	GAAATAGCAAGTTAACCTAAGGCTAGTCCGTTATCAACTTGAAAAGTGGC	1
CACAACGCCC	GAAATAGCAAGTTAACCTAAGGCTAGTCCGTTATCAACTTGAACAAGTGG	1
CACAACGCCC	GAAATAGCAAGTTAACCTAAGGCTAGTCCGTTATCAACTTGCAAAAGTGG	1
CACAACGCCC	GAACACGGGTTAGAGCTAGAAATAGCAAGTTAACATAAGGCTAGTCCGTT	1
CACAACGCCC	GAACACGGGTTAGAGCTAGAAATAGCAAGTTAACCTAAGGCTATTCCGTT	1
CACAACGCCC	GACTAGAAATAGCAAGTTAACCTAAGGCTAGTCCGTTATCAACTTGAAAA	1
CACAACGCCC	GAGACACCGGTTTAAGCAAATTGCTTGAGGCGTGAGAGCTAGAAATAGGA	1
CACAACGCCC	GCAACACCGGTTTGAACTACCTAGTTCAAGGGTTAGGGTTAGGGTTAGGG	1
CACAACGCCC	GCTAGAAATAGCAAGTTAACCTAAGTCTAGTCGGTTATCGACTTTGGAAA	1
CACAACGCCC	GCTAGAAATCGCAACTTAACCTAAGACTCGTCCGTGGTCTACTTGCAAGA	1
CACACCGACT	GAAACACCGGTTTGAACTAGAAATAGCAAGTTAACCTAAGGCTAGTCCGT	1
CACACCTCTA	GAAACACCGGTTTGAACTACCTAGTTCAAACCGGTGGGGTTAGAGCTAGA	1
CACACTGCAC	GAAACACCGGTTTGCACTGGTGGGGTTAGAGCTAGAAATAGCAAGTTAAA	1
CACACTGTGT	GCTAGAAATACCAAGTTATCCTGAGGCTAGTCCGTTATCAACTTGAAAAA	1
CACAGCCGTC	GAAACACCGGTGTACGTATGGACTGAACCAGGGTGTGCAAGTGGGGTTAG	1
CACAGCGGGG	GAAACACCGGTTTGAACTACCTAGTAGCAAGTTAACCTAAGGCTAGTCCG	1
CACATGGCTC	GAAACACCGGTTTGAACTAGTAATAGCAAGTTATCCTGATGCTAGTACGT	1
CACATGGTGG	GAAACACCGGTGTACGTATGGACTGAACCAGGGTGCGCAAAAGTGGGGTT	1
CACATTGTCC	GCTAGAAATAGCAAGTTAACCTAAGGCTAGCTCGTTATCAACTTGTAACA	1
CACCACACGC	GAAACACCGGTTTGAACTACCTAGTTCAAACCGGTGGTGTTAGAACTAGA	1
CACCTCGCTT	GAAACACCGGTTTGAACTAGAAATATCCTGTTAACCTAAGGCTTGGCCGT	1
CACGAATCCT	GAAACACCGGTCTCGAGTGAGGTGTTCAGGTGGGGTTAGAGCTAGAAATA	1
CACGACCCTA	GAAACACCGGTTTGAACTAGAAATAGCAAGTTAACCTAAGGCTAGTCCGT	1
CACGAGTTAT	GAAACACCGGTCTCGAGTGAGGCGTTCAGGGTGGGGTTAGAGCTAGAAAT	1
CACGCATTAC	GAAACACCGGTGCCCTTACTCTCACCTGATTACTTAATCCGTGGGGTTAG	1
CACGCGTTGT	GAAACACCGGTGACATTGTGGGGTTAGAGCTAGAAATAGCAAGTTAACCT	1
CACGCTATAC	GAAACACCGGTGCCCTTACTCTCACCTGATTACTTAATCCGTGGGGTTAG	1
CACGTCCTGC	GAAACACCGGTGCCCTTACTCTCACCTGATTACTTAATCCGTGGGGTTAG	1
CACTCAGAAA	GAAACACCGGTAGCAAGTGGGGTTAGAGCTAGAAATAGCAAGTTATCCTA	1
CACTTAGCGC	GAAACACCGGTCGGGGCCAGCTAGAAATAGCAAGTTAACCTAAGGCTAGT	1
CAGAACGCGA	GAAACACCGGTTTGAACTACCTAGTTCAAACCGGTGGGGTTAGAGCTAGA	1
CAGACACAGA	GAAACACCGGTAGCAAGTGCGTGGGGTTAGAGCTAGAAATAGCAAGTTAA	1
CAGATACTTT	GAAACACCGGTCTCGAGTGAGGTGTTCAGGTGAGGTTAGAGCTAGAAATA	1
CAGCATATAT	GAAACACCGGTTTACGTTGGGGTTAGAGCTAGAAATAGCAAGTTAACCTA	1
CAGCCAGGCC	GAAACACCGGTTTGTACAACCTAGAGTTAGAAATAGCAAGTTAAACTAAG	1
CAGCGTAGGC	GAAACACCGGTGTACGTATGGACTGAACCAGGGTGTGCAAGTGGGGTTAG	1
CAGCGTCTTA	GAAACACCGGTGTACGTATGGACTGAACCAGGGTGTGCAGCTAGAAATAG	1
CAGGACCTAC	GAAACACCGGTGCCCTTACTCTCACCTGATTACTTAATCCGTGGGGATAG	1
CATAAGCCTC	GAAACACCGGTCCGTAGGAGCCCCGTGTGGCGTGAAACTGTGGAGTTAGA	1
CATAATGGTC	GAAACACCGGTTTGAACTACCTAGAGCTAGAAATAGCAAGTTAACCTAAG	1
CATAGCAGTC	GAAACACCGGTGTACGTATGGACTGAACCAGGGTGTGCAAGTGGGGTTAG	1
CATAGCTTAT	GAAACACCGGTAACTATATTCATGCGATATCGCCGTATCAGTGGGGTTAG	1
CATAGGTGTC	GAAACACCGGTGTACGTATGGACTGAACCAGGGTGTGCAAGTGGGGTTAG	1
CATAGTAGTA	GAAACACCGGTGTACGTATGGACTGAACCAGGGTGTGCAAGTGGGGTTAG	1
CATATACCTC	GAAACACCGGTTTGAGCTACTTAGTTGAAACCGTGGGGTTAGAGCTAGAA	1
CATCACTCGC	GAAACACCGGTCCGTAGGAGACCCGTGTGGCATGTACCTGTGGGGTTAGA	1
CATCGCAGAA	GAAACGCCGGTGTACGTATGGACTGAACCAGGGTGTGCAAGTGGGGTTAG	1
CATCGGCACA	GAAACACCGGTTAATTTGAGGCTCCGGTGTGCTTAAAGCTAGAAATATCA	1
CATCGTCGTC	GAAACACCGGTGTACGTATGGACTGAACCAGGGTGTGCAAGTGGGGTTAG	2525
CATCGTCGTC	GAAACACCGGTGTACGTATGGACTGAACCAGGGTGTGCAAAAGTGGGGTT	108
CATCGTCGTC	GAAACACCGGTGTACGTATGGACTGAACCAGGGTGTGCAAAGTGGGGTTA	56
CATCGTCGTC	GAAACACCGGTGTACGTATGGACTGAACCAGGGTGTGGGGTTAGAGCTAG	38
CATCGTCGTC	GAAACACCGGTGTACGTATGGACTGAACCAGGGTGTGCAGTGGGGTTAGA	19
CATCGTCGTC	GAAACACCGGTGTACGTATGGACTGAACCAGGGGTGGGGTTAGAGCTAGA	18
CATCGTCGTC	GAAACACCGGTGTACGTATGGACTGAACCAGGGTGTGCGGGGTTAGAGCT	17
CATCGTCGTC	GAAACACCGGTGTACGTATGGACTGAACCAGGGTGTGCAGCTAGAAATAG	14
CATCGTCGTC	GAAACACCGGTGTACGTATGGAGCTAGAAATAGCAAGTTAACCTAAGGCT	13
CATCGTCGTC	GAAACACCGGTGTACGTATGGACTGAACCAGGTAGAAATAGCAAGTTAAC	11
CATCGTCGTC	GAAACACAAGTTAACCTAAGGCTAGTCCGTTATCAACTTGAAAAAGTGGC	8
CATCGTCGTC	GAAACACCGGTGTACGTATGGACTGAACCAGGGTGTGCATAAGGCTAGTC	8
CATCGTCGTC	GCTAGAAATAGCAAGTTAACCTAAGGCTAGTCCGTTATCAACTTGAAAAA	5
CATCGTCGTC	GAAACACCGGTGTACGTATGGACTGAACAGGGTGTGCAAGTGGGGTTAGA	3
CATCGTCGTC	GAAACACCGGTGTACGTATGGACTGAATTTCAGGGGTTAGAGCTAGAAAT	3
CATCGTCGTC	GAAACACAAGTTAACCTAAGGCTAGTCCGTTATCAACTCGAAAAAGTGGC	2
CATCGTCGTC	GAAACACCGGTCCGTAGGAGACCCGTGTGGCATGTACCTGTGGAGTTAGA	2
CATCGTCGTC	AGAGGGCGAAACACCGGTGTACGTATGGACTGAACCAGGGTGTGCAAGTG	1
CATCGTCGTC	CAAAACACCGGTGTACGTATGGACTGAACCAGGGTGTGCAAGTGGGGTTA	1
CATCGTCGTC	CAAAACACCGGTGTACGTATGGACTGAACCAGGGTGTGCAGTGGGGTTAG	1
CATCGTCGTC	GAAACACCGGTAAAGGGCTGTACTGAACCGGGGTGGGCATGTGGGGTTAG	1
CATCGTCGTC	GAAACACCGGTACCTTTGTTGATGCTGGGTGGAAGGAATGTGGGGTTAGA	1
CATCGTCGTC	GAAACACCGGTACCTTTGTTGATGCTGGGTGGAAGGAATTTGTGGGGTTA	1
CATCGTCGTC	GAAACACCGGTAGCAAAGTGGGGTTAGAGCTAGAAATAGCAAGTTAACCT	1
CATCGTCGTC	GAAACACCGGTAGCAAGTGCGAGACGTGTTAAATAGCAAGTTAACCTAAG	1
CATCGTCGTC	GAAACACCGGTCGGGGCGACTCAGTGGTGGGGGTAGAGGTAGAAATAGCA	1
CATCGTCGTC	GAAACACCGGTCTACGTATCAACTTAACGGGGGGGGGCAAGGGGAGAAAG	1
CATCGTCGTC	GAAACACCGGTGCCCTTACTCTCACCTGATTACTTAATCCGTGGGGTTAG	1
CATCGTCGTC	GAAACACCGGTGTACGCATGGAATGAACCAGGGTGTGCATGTGGAGATCG	1
CATCGTCGTC	GAAACACCGGTGTACGTATGGACCGAACAGGGTGTGCAAGTGGGGTTAGA	1
CATCGTCGTC	GAAACACCGGTGTACGTATGGACTGAACCAGGGGGGGCAAGGGTAGATAG	1
CATCGTCGTC	GAAACACCGGTGTACGTATGGACTGAACCAGGGTTGTCAAGTGTGGGGTG	1
CATCGTCGTC	GAAACACCGGTGTACGTATGGACTGAACCGGGGTGGGGTTAGAGCTAGAA	1
CATCGTCGTC	GAAACACCGGTGTACGTATGGACTGAGCGAGGGTGGGGATAGGAGGAGCG	1
CATCGTCGTC	GAAACACCGGTGTCCGTAGGGCCTGAACCTGGGTGTGCAAGTCGGGATAG	1
CATCGTCGTC	GAAACACCGGTGTGGCTGAGAGTCCGGCAATGGTGTGGCTGTGGGGTTAG	1
CATCGTCGTC	GAAACACCGGTTACATTGAGGGGTTAGAGCTAGAAATAGCAAGTTAACCT	1
CATCGTCGTC	GAAACACCGGTTATATTTGTAAGTGGGGTTAGAGCTAGAAATAGCAAGTT	1
CATCGTCGTC	GAAACACCGGTTTACGTTGCATCGGTTGTGGGGTTAGAGCTAGAAATAGC	1
CATCGTCGTC	GAAACACTGGTGTACGTATGGACTGAATTTCAGGGGTTAGAGCTAGAAAT	1
CATCGTCGTC	GAACACCGGTGTACGTATGGACTGAACCAGGGTGTGCAAGTGGGGTTAGA	1
CATCTCTTGC	GAAACACCGGTGCCGTCGAAAGTCCTGTCGTAGTGTGGATAGGGAGAGAG	1
CATGAACTGC	GAAACACCGGTCGGCGGCGAGCTAGAAATAGCAAGTTAACCTAAGGCTAG	1
CATGGTGTTC	GAAACACCGGTGACATTGGGTACAATAGCAAGTTAACCTAAGGCTAGTCC	1
CATTGAGCAT	GAAACACCGGTTAAGCCGAGTGGGGTTAGAGCTAGAAATAGCAAGTTAAC	1
CATTGCCAGA	GAAACACCGGTCGGGGCCACTCAGTGGTGGGGGTAGAGCTAGAAATAGCT	1
CATTGGATAA	GAAACACCGGTTAAGCAGAGTGGGGGTAGAGCTAGAAATAGCAAGTTAAC	1
CATTTACGGA	GAAACACCGGTCGGGGCCACTCAGTGGTGGGGTTAGAGCTAGAAATAGCA	1
CATTTCCCTC	GAAACACCGGTCGGGGCCACTCAGTGGTGGGGTTAGCGCTAGAAATAGCA	1
CCAAACGCCA	GAAACACCGGTTTGAACTACCTAGTTCAAGCCGGTGGGGGTAGAGGTAGT	1
CCAACACTCG	GAAACACCGGTGGGGATAAGATTCGGGGAGTGGGGTGAGTGCGAGGTTTA	1
CCAAGCCGTT	GAAACACCGGTCTCGAGTGAGGTGTTCAGGGTGGGGTTAGAGCTAGAAAT	1
CCAATCTTTG	GAAACACCGGTCTCGAGAGAGGTGGTCGGGGGGGGGTTAGGGCTGGAAAT	1
CCACAAGGAC	GAAACACCGGTACCTTTGTTGATGCTGGGTGGAAGGTGGGGTTAGAGCTA	1
CCACGACGTC	GAAACACCGGTGTACGTATGGACTGAACCAGGGCGTGCAAGTGGGGTTAG	1
CCACTACTTT	GAAACACCGGTCTCGAGTGAGGTGTTCAGGGTGGGGTTAGAGCTAGAAAT	1
CCACTAGCCC	GAAACACCGGTACCTTTGTTGCTGCTGGGGGGAAGGAATTTGTGGGGTTA	1
CCACTAGGTC	GAAACACCGGTAAATTTGTTGATGCTGAGAAGACGGAATTTTGTGGAGAT	1
CCACTCACTC	GAAACACCGGTAACTATATTCATGCTATATCGCCGGATCAGTGGGGTTAG	1
CCACTCGCTC	GAAACACCGGTACCTGTGTTGATGCTGCTAGGGGGGAAATAGCTGGAATT	1
CCAGACGGCC	GAAACACCGGTACCTTTGTTGATGCTGGGTGGAAGGAATTTGTGGGGTTA	1
CCATCAGGGC	GAAACACCGGTCGGGGCCACTCAGTGGCGGGGCTAGAGCTAGAAATAGCA	1
CCATTAGCTC	GAAACACCGGTCGGGGCCACTCAGTGGTGGGGTTAGAGCTAGAAATAGCA	1
CCATTAGGGC	GAAACACCGGTCGGGGCCACTCAGTGGTGGGGTTAGAGCTAGAAATGGCA	1
CCCAAATACC	GAAACACCGGTTTGAACTAGAAATAGCAAGCTAACCTAAGGCTAGTCCGT	1
CCCAACGTCA	GAAACACGGGTTATAGCTAGAAATAGCAATTTAACCTAAGGCTAGTCCGT	1
CCCACAGCCC	GAAACACCGGTTTGAACCGGTGGGGTTAGAGCCAGAAATAGCAAGTTAAC	1
CCCACAGGCG	GAAACACCGGTAGCAAGTGCGAGACGTGTGTGGGGTTAGAGCTGGAAATA	1
CCGAAGACAC	GAAACACCGGTTCCCGTCCAGTGGGGTTAGAGCTAGAAATAGCAATATCA	1
CCGATCGTGG	GAAACACCGGTTATATTTGTAAGTGTGTGGGGTTAGAGCTAGAAATAGCA	1
CCGTGACCAA	GAAACACCGGTTAGGCCGAGGAGTTAGAGGTAGAAGTAGCAGAATAACCA	1
CCGTTAACAC	GAAACACCGGTCGGGGCCACTCAGTGGTGGGGTTAGAGCTAGAAATAGCA	1
CCGTTAACGT	GCAACACCGGTCGGGGCCACTCAGTGGTGGGGTTAGAGCTAGAAATAGCA	1
CCGTTATCGA	GAAACACCGGTCGTGGCCACTCAGTGGTGGGGTTAGAGCTAGAAATAGCA	1
CCTAAAGCCC	GCTAGAAATAGCAAGTTAACCTAAGGCTAGTCCGTTATCAACTTGAAAAA	1
CCTAACGCGC	GAAACACCGGTTTGAACTGGAAATAGCAAGTTAACCTAAGGCTAGTCCGT	1
CCTACAGCGC	GAAACACCGGTTTGAACTAGAAATAGCAAGTTAACCTACTGCTAGTCCGT	1
CCTAGACGCC	GAAACACCGGTGTACGTATGGACTGAACCAGGGTGTGCAAGTGGGGTTAG	1
CCTATACTTC	GAAACACCGGTCTCGAGTGGAGCTAGAAATAGCAAGTTAACCTAAGGCTA	1
CCTATCACGT	GAAACACCGGTCGGGGCCACTAAGTGGGTGGGGTTAGAGCTAGAAATAGC	1
CCTATCCTGT	GAAACACCGGTCGCGGCCACTCAGTGGAGGGGTTAGAGATAGATATAGCT	1
CCTCGTTGTT	GAAACACCGGTGTACGTATGGACTGAACCAGGGTGTGCAAGTGGGGTTAG	1
CCTCTGCTGC	GAAACACCGGTCGGGGCCACTCAGTGGGGGGGTTAGAGCTAGAAATAGCA	1
CCTCTTCGTT	GAAACACCGGTGTACGTATGGACTGAACCAGGGTGTGCAAGTGGGGTTAG	1
CCTGCAACGC	GAAACACCGGTCGGGGCCACTCAGTGGTGGGGTTAGAGCTAGAAATAGCA	1
CCTGGTGGCT	GAAACACCGGTGACATTGGGTACAGGGTGGGGTTAGAGCTAGAAATAGCA	1
CCTTGACGTC	GAAACACCGGTGTACGTATGGACTGAACCAGGGTGTGCAAGTGGGGTTAG	1
CCTTTACCGC	GAAACACCGGTCGGGGCCACTCAGTGGTGGGGTTAGAGCTAGAAATAGCA	2179
CCTTTACCGC	GAAACACCGGTCGGGGCCACTCAGTGGGGTTAGAGCTAGAAATAGCAAGT	87
CCTTTACCGC	GAAACACCGGTCGGGGCCACTCAGTGGGTGGGGTTAGAGCTAGAAATAGC	46
CCTTTACCGC	GAGCTAGAAATAGCAAGTTAACCTAAGGCTAGTCCGTTACAACTTGAAAA	45
CCTTTACCGC	GAAACACCGGTCGGGGCCTGGGGTTAGAGCTAGAAATAGCAAGTTAACCT	23
CCTTTACCGC	GAAACACCGGTCGGGGCCACTCAGTGTGGGGTTAGAGCTAGAAATAGCAA	21
CCTTTACCGC	GAAACACCGGTCGGGGCCACTCGGTTAGAGCTAGAAATAGCAAGTTAACC	19
CCTTTACCGC	GAAACACCGGTCGGGGCCAGCTAGAAATAGCAAGTTAACCTAAGGCTAGT	17
CCTTTACCGC	GAAACACCGGTCGGGGCCACTCAGTGTGGTGGGGTTAGAGCTAGAAATAG	16
CCTTTACCGC	GAACCTAAGGCTAGTCCGTTACAACTTGAAAAAGTGGCACCGAGTCGGTG	16
CCTTTACCGC	GAAACACCGGTCGGGGTTAGAGCTAGAAATAGCAAGTTAACCTAAGGCTA	12
CCTTTACCGC	GAAACACCGGTCGGGGCCACGGGTTAGAGCTAGAAATAGCAAGTTAACCT	11
CCTTTACCGC	GAAACACCGGTCGGGGCCGAGCTAGAAATAGCAAGTTAACCTAAGGCTAG	11
CCTTTACCGC	GAAACACCGGTCGGGGCCACAAATAGCAAGTTAACCTAAGGCTAGTCCGT	10
CCTTTACCGC	GAAACACCGGTCGGGGCCACGGGGTTAGAGCTAGAAATAGCAAGTTAACC	9
CCTTTACCGC	GAAACACCGGTCGGGGCCACTCAGGGGTTAGAGCTAGAAATAGCAAGTTA	9
CCTTTACCGC	GAAACACCGGTCGGGGCCACTCAGGGTGGGGTTAGAGCTAGAAATAGCAA	9
CCTTTACCGC	GAAACACCGGTCGGGGCCACTAGCAAGTTAACCTAAGGCTATTCCGTTAC	4
CCTTTACCGC	GAAACACCGGTCGGGGCCACTCAGGGTTAGAGCTAGAAATAGCAAGTTAA	4
CCTTTACCGC	GAAACACCGGTCGGGGCCACTCAGTGGTGGGTTAGAGCTAGAAATAGCAA	4
CCTTTACCGC	GAAACACCGGTCGAAATAGCAAGTTAACCTAAGGCTAGTCCGTTACAACT	3
CCTTTACCGC	GAAACACCGGTCGCTAGAAATAGCAAGTTAACCTAAGGCTAGTCCGTTAC	3
CCTTTACCGC	GAAACACCGGTCGGGGCCACTAGCAAGTTAACCTAAGGCTAGTCCGTTAC	3
CCTTTACCGC	GAAACACCGGTCGTCCGTTACTAGTCCGTTACAACTTGAAAAAGTGGCAC	3
CCTTTACCGC	CAAAACACCGGTCGGGGCCACTAGCAAGTTAACCTAAGGCTATTCCGTTA	1
CCTTTACCGC	CTAAACACCGGTCGGGGCCACTCAGTGGGGTTAGAGCTAGAAATAGCAAG	1
CCTTTACCGC	GAAACACCGGTCCGTAGGACACCCGTGTGGCATTAACCTGAGGGGTTAGA	1
CCTTTACCGC	GAAACACCGGTCCGTAGGAGACCCGTGTGGCATGTACCTGTGGGGTTAGA	1
CCTTTACCGC	GAAACACCGGTCGGGCCACTCAGTGGTGGGGTTAGAGCTAGAAATAGCAA	1
CCTTTACCGC	GAAACACCGGTCGGGCGGGGTTAGAGCTAGAAATAGCAAGTTAACCTAAG	1
CCTTTACCGC	GAAACACCGGTCGGGGCCACTAGCAAGTCAACCTAAGGCTATTCCGTTAC	1
CCTTTACCGC	GAAACACCGGTCGGGGCCACTAGCAAGTTAACATAAGGCTATTCCGTTAC	1
CCTTTACCGC	GAAACACCGGTCGGGGCCACTCAGTGGCGGGGTTTGAGGTTGAAAAAACA	1
CCTTTACCGC	GAAACACCGGTCGGGGCCACTCTGGGGGAGGGAGCGAGCTATGAATATAG	1
CCTTTACCGC	GAAACACCGGTCGGGGCCCTCAGTTGTGGGGTTAGAGCTAGAAATAGCAA	1
CCTTTACCGC	GAAACACCGGTCGGGGCGGGGGTAGAGCTAGAAATAGCAAGTTAAACTAA	1
CCTTTACCGC	GAAACACCGGTCGGGGCGGGGGTAGAGCTAGAAATAGCAAGTTAACCTAA	1
CCTTTACCGC	GAAACACCGGTCGGGGCGGGGGTATAGCTAGAAATAGTAAATTTACCTAA	1
CCTTTACCGC	GAAACACCGGTCGGGGCGGGGTTAGAGCTAGAAATAGCAAGTTAATCTAA	1
CCTTTACCGC	GAAACACCGGTCGTCCGTTACTAGTCCGTTACAACTTGAAAAAGCGGCAC	1
CCTTTACCGC	GAAACACCGGTCTCGAGTGAGGTGTTCAGGGTGGGGTTAGAGCTAGAAAT	1
CCTTTACCGC	GAAACACCGGTGACATTGGGGTTAGAGCTAGAAATAGCAAGTTAACCTAA	1
CCTTTACCGC	GAAACACCGGTGACATTGGGTACAGGGTGGGGTTAGAGCTAGAAATAGCA	1
CCTTTACCGC	GAAACACCGGTGCCCTTACTCTCACCTGATTACTTAATCCGTGGGGTTAG	1
CCTTTACCGC	GAAACACCGGTTAAGCCGAGGGGTTAGAGCTAGAAATAGCAAGTTAACCT	1
CCTTTACCGC	GAAACACCGGTTACCGGGTTAGAGCTAGAAATAGCAAGTTAACCTAAGGC	1
CCTTTACCGC	GAAACACCGGTTCCCGTCCAGTGGGGTTAGAGCTAGAAATAGCAAGTTAA	1
CCTTTACCGC	GAAACACCGTCGGGGCCACTCAGTGGTGGGGTTAGAGCTAGAAATAGCAA	1
CCTTTACCGC	GAAGCACCGGTGCATTCGAAAGTCCGGTCGTAGTGTGGACGTGGGGTTAG	1
CCTTTACCGC	GACGAAACACCGGTCGGGGCCACTCAGTGTGGTGGGGTTAGAGCTAGAAA	1
CCTTTACCGC	GAGACACCGGTCGTCCGTTACTAGTCCGTTACAACTTGAAAAAGTAGCAC	1
CCTTTACCGC	GTAACACCGGTCGATTCATATCGAAACCTTCCCGTGACAGTGGGGTTAGA	1
CCTTTTGGTT	GAAACACCGGTCGATTCATATCGAAACCTTCCCGTGACAGTGGGGTTAGA	1
CGAAACCGAC	GAAACACCGGTGTGGCTGAGAGTCCGGCAATGGTGTGGCTGTGGGGTTAG	1
CGAAACCTCC	GAAACACCGGTCTCGAGTGAGGTGGTTAGGGCTGGGATAGAGCTAGAAAT	1
CGAAAGGTTT	GAAACACCGGTCTCGAGTGAGGTGTTCAGGGTGGGGTTAGAGCTAGAAAT	1
CGAACACTAT	GAAACACCGGTCTCGTGTGAGGTGTTGAGGGTGGGGTTAGAGCTAGAAAT	1
CGAACCGCGC	GAAACACCGGTGCATTCGAAAGTCCGGTCGTAGTGTGGACGTGGGGTTAG	1
CGAACCTCCC	GAAACACGGGTTAATGCGAGAAATAGCAAGTTAACCTAAGGCTAGGCCGT	1
CGAAGCAGTC	GAAACACCGGTGTACGTATGGACTGAACCAGGGTGTGCAAGTGGGGTTAG	1
CGAAGCGTGT	GAAACACCGGTCTCGAGTGAGGTGTTCAGGGTGGGGTTAGAGCTAGAAAT	1
CGAAGTCGTT	GAAACACCGGTCTAGGGATGGACTGTCCGAGTGGGGGTAGGTCTGGATAT	1
CGAATCCTTT	GAAACACCGGTCTCGAGTGAGGTGTTCAGGGTGGGGTTAGAGCTAGAAAT	2088
CGAATCCTTT	GAAACACCGGTCTCGAGTGAGGTGTTCAGGTGGGGTTAGAGCTAGAAATA	289
CGAATCCTTT	GAAACACCGGTCTCGAGTGAGGTGTTCAGGGGTGGGGTTAGAGCTAGAAA	106
CGAATCCTTT	GAAACACCGGTCTCGAGTGAGGTGTTCAGGTTGTGGGGTTAGAGCTAGAA	21
CGAATCCTTT	GAAACACCGGTCTCGAGTGAGGGCTAGAAATAGCAAGTTAACCTAAGGCT	12
CGAATCCTTT	GAAACACCGGTCTCGAGTGAGTTAGAGCTAGAAATAGCAAGTTAACCTAA	11
CGAATCCTTT	GAAACACCGGTCTCGAGTGGAGCTAGAAATAGCAAGTTAACCTAAGGCTA	11
CGAATCCTTT	GAAACACCGGTCTGAGCTAGAAATAGCAAGTTAACCTAAGGCTAGTCCGT	10
CGAATCCTTT	GAAACACCGGTCTTGAAAAAGTGGCACCGAGTCGGTGCTTTTTTTCCTGC	10
CGAATCCTTT	GAAACACCGGTCTCGAGTGAGGGGGTTAGAGCTAGAAATAGCAAGTTAAC	9
CGAATCCTTT	GAAACACCGGTCTCGAGTGAGGGGGGTTAGAGCTAGAAATAGCAAGTTAA	8
CGAATCCTTT	GAAACACCGGTCTCGAGTGAGGTGTTCAGAGCTAGAAATAGCAAGTTAAC	8
CGAATCCTTT	GAAACACCGGTCTCGAGTGAGGTGGGGTTAGAGCTAGAAATAGCAAGTTA	7
CGAATCCTTT	GAAACACCGGTCTCGAGTGAGGTGTTCAGGTTCAGGGTGGGGTTAGAGCT	7
CGAATCCTTT	GAAACACCGGTCTCGAGTGGGGGGTTAGAGCTAGAAATAGCAAGTTAACC	7
CGAATCCTTT	GAAATAGCAAGTTAACCTAAGGCTAGTCCGTTATCAACTTGAAAAAGTGG	7
CGAATCCTTT	CAAAACACCGGTCTCGAGTGAGGTGTTCAGGGTGGGGTTAGAGCTAGAAA	5
CGAATCCTTT	GAAACACCGGTCTCGAGTGAGGTGTTCAGTGGGGTTAGAGCTAGAAATAG	5
CGAATCCTTT	GAAACACCGAGCTAGAAATAGCAAGTTAACCTAAGGCTAGTCCGTTATCA	4
CGAATCCTTT	GACGAAACACCGGTCTCGAGTGAGGTGTTCAGGGTGGGGTTAGAGCTAGA	3
CGAATCCTTT	GAAACACCGGTCTCGAGTGAGGTGGGGTTAGAGCTAGAAATAGCAAGCTA	2
CGAATCCTTT	GAAACACCGGTTCCCGTCCAGTGGGGTTAGAGCTAGAAATAGCAAGTTAA	2
CGAATCCTTT	ATTGGGGTTAGAGCTAGAAATAGCAAGTTAACCTAAGGCTAGTCCGTTAT	1
CGAATCCTTT	GAAACACCGAGCTAGAAATAGCAGGTTAACCTAAGGCTAGTCCGTTATCA	1
CGAATCCTTT	GAAACACCGATCTCGAGTGAGGTGTTCAGTGGGGTTAGAGCTAGAAATAG	1
CGAATCCTTT	GAAACACCGGTCCCTTCGAAAGTCCTGACGTAGGGTGTAGAGCTAGATAT	1
CGAATCCTTT	GAAACACCGGTCGCGACTGAGGAAATCAGGTTCTAGAGCGGGTTAGAGCT	1
CGAATCCTTT	GAAACACCGGTCGCGAGGGAGATGTTCAGGTGTAGTTAGATCTAGTAATA	1
CGAATCCTTT	GAAACACCGGTCGGGGCCACTCAGTGGGGTTAGAGCTAGAAATAGCAAGT	1
CGAATCCTTT	GAAACACCGGTCTCGAGTGAGGTGTTCAGGTGGGTTAGAGCTAGAAATAG	1
CGAATCCTTT	GAAACACCGGTCTCGAGTGAGGTGTTCAGTGGGGTTAGAGCTAGAGATAG	1
CGAATCCTTT	GAAACACCGGTCTCGAGTGAGGTGTTTCTAGCTCTAACCCCACTCGAACA	1
CGAATCCTTT	GAAACACCGGTCTCGAGTGGGGAGTTCAGGGTAGGGTTAGAGATCGTAAT	1
CGAATCCTTT	GAAACACCGGTCTCGAGTGGGTAGTTCAGGGGGTGGATATAGCTAGAGAT	1
CGAATCCTTT	GAAACACCGGTCTCGCGGGAGGTCCGCAGATGGTGTTGCTAGCTGGATAT	1
CGAATCCTTT	GAAACACCGGTCTCGCGTGAGGTGTTCTGGGGTTAGGGTTGAGCTAGACA	1
CGAATCCTTT	GAAACACCGGTCTCGGGGGTGGAGATAAGAGTGTGGCTAGAGCTAGAAAT	1
CGAATCCTTT	GAAACACCGGTCTCGTGAGTGGCGTTCGGGTAGTTGATAGGGCTAGATAT	1
CGAATCCTTT	GAAACACCGGTGCATTCGAAAGTCCGGTCGTAGTGTGGACGTGGGGTTAG	1
CGAATCCTTT	GAAACACCGGTGTCGCTGAGAGTCCGGCAATGGGGTGGATGGCTGGTTAG	1
CGAATCCTTT	GAAACACCGGTTACATTGAGGGGTTAGAGCTAGAAATAGCAAGTTAACCT	1
CGAATCCTTT	GAAACACCGGTTACGTGGGGGGTGGGCATAGAGCTAGAAGTAGCAGGATA	1
CGAATCCTTT	GAAACACCGGTTTACGTTGCATCGGTTAGAGCTAGAAATAGCAAGTTAAC	1
CGAATCCTTT	GAAACACCGGTTTCGAGTGCGGCGTTCAGGTGGGAGTAGTGCTAGAAATA	1
CGAATCCTTT	GAAACACCGGTTTCGGTTGCGTCGGTGATGGAGGGGGTAGTGGTAGGTTA	1
CGAATCCTTT	GAAACACCGGTTTTGAGAGCGGCGTTGAGGGTGGGGATAGAGCTAGAAAT	1
CGAATCCTTT	GAAACACCGTGGGGTTAGAGCTAGAAATAGCAAGTTAACCTAAGGCTAGT	1
CGAATCCTTT	GAAACGCCGGTTCCCGTCCAGTGGGGTTAGAGCTAGAAATAGCAAGTTAA	1
CGAATCCTTT	GAACACCGGTCTCGAGGGAGGTGTTCAGGGTGGGGTTAGAGCTAGAAATA	1
CGAATCCTTT	GAGACACCGGTCTCGAGTGAGGTGTTTCTAGCTCTAACCCCACTCGAACA	1
CGAATTATTC	GAAACACCGGTCTCGAGTGAGGTGTTCAGGGTGGGGTTAGAGCTAGAAAT	1
CGACAGCCTC	GAAACACCGGTCCGTAGGAGACCCGTGTGGCATGTACCTGGGGGGTTAGA	1
CGACCCGCCA	GAAACACCGGTAAATCTGTCGCACCGGCATGTAGGGGTACGTGGGGTTAG	1
CGACCGTCGA	GAAACACCGGTGCATTCGAAAGTCCGGTCGTAGTGTGGACGTGGGGTTAG	1
CGACCTGCGC	GAAACACCGGTGACCACCGGGGTAGAGCTGGAGATAGCAAGTTAACCTAG	1
CGACGCGGCA	GAAACACCGGTACCTTTGTTGATGCTGGGTGGAAGGAGCTAGAGATAGCA	1
CGACTATCCG	GAAACACCGGTCCGTAGGAGACCCGTGTGGCATGGACATGGGGAGTTAGA	1
CGACTCGTGT	GAAACACCGGTCTCGCGTGAGGTGTTCAGCGTGGGGTTAGAGCTAGAAAT	1
CGACTGCTTC	GAAACACCGGTCCGTAGGAAACCCGTGTGGCATGTACCATGGGTGGATAT	1
CGAGATGCAA	GAAACGCCGGTTCCCGTCCAGTGGGGTTAGAGCTAGAAATAGCAAGTTAA	1
CGAGCGATGT	GAAACACCGGATTGGGGTTAGAGCTAGAAATAGCAAGTTAACCTAAGGCT	1
CGAGCTGTTT	GAAACACCGGTTACAATTGGGGTTAGAGCTAGAAATAGCAAGTTAACCTA	1
CGAGTCGTGC	GAAACACCGGTGACATTGGGTACAGGGGGGTGGGGTTAGAGCTAGAAATA	1
CGATACTCGC	GAAACACCGGTGCATTCGAAAGTCCGGTCGTAGTGTGGACGTGGGGTTAG	1
CGATCCACGC	GAAACACCGGTGCATTCGAAAGTCCGGTCGTAGTGTGGACGTGGGGTTAG	1
CGATCCGCGC	GAAACACCGGTGCATTCGAAAGTCCGGTCGTAGTGTGGACGTGGGGTTAG	1
CGATGCATGT	GAAACACCGGTCTCGAGTGAGGTGTTCAGGGGGGGGTTAGAGCTAGAAAT	1
CGATGCTTAG	GAAACACCGGTTTACGTTGCATCGGTGTGGGGTTAGAGCTAGAAATAGCA	1
CGCAACGAGC	GAAACACCGGTTTGAACTAGAAATAGCAAGTTAACCTAAGGCTAGTCCGT	1
CGCACCTACC	GAAACACCGGTAAATTTGAGGCTCCGGCATGCAGGAGGCCGTGGGGTTAG	1
CGCAGACGTC	GAAACACCGGTCTCGGGAGAGGCTGACAGAGGGGGGGCAAGGGGAGTTAG	1
CGCATCGTTC	GAAACACCGGTCTCGGGTGAGGTGTTCAGGGTGGGGTTAGAGCTAGAAAT	1
CGCCCCCCGC	GAAACACCGGTGCGTCTGAGAGTCCGGCAATGGTGTGGCTGTGGGGTTAG	1
CGCCCCTCGT	GAAACACCGGTGCATTCGAAAGTCCGGTCGTAGTGGGGACGGGGGGTTAG	1
CGCCTTCTTT	GAAACACCGGTCTCGAGTGAGGTGTTCAGGGTGGGGTTAGAGCTAGAAAT	1
CGCGAATCCT	GAAACACCGGTCTCGAGTGAGGTGTTCAGGGTGGGGTTAGAGCTAGAAAT	1
CGCGAATTCT	GAAACACCGGTCTCGAGTGAGGTGTTCAGGGGTGGGGTTAGAGCTAGAAA	1
CGCGATGCCT	GAAACACCGGTGTGAACTACCTAGTGCAAACCGGTGGGGTTAGAGCTAGA	1
CGCGATTTCT	GAAACACCGGTGACGTGGGGTTAGAGCTAGAAATAGCAAGTTAACCTAAG	1
CGCGCTCTCC	GAAACACCGGTGAGGCTGAGAGTCCGACTTTGGCGAGGCTTAGGGCGTTA	1
CGCGGTTCCC	GAAACACCGGTGACATTGAGTACAGGGGGTGGGGTTAGAGCTAGAAATAG	1
CGCGTTGGCA	GAAACACCGGTGACATTGGATTAGGGCTAGAAATAGCAAGTTAACCTAAG	1
CGCGTTGTTC	GAAACACCGGTGATATTGGGTACAGGGGGGTGGGGTTAGAGCTAGAGATA	1
CGCTTACTTC	GAAACACCGGTGTGGCTGAGAGTCCGGCAATGGTGTGGCTGTGGGGTTAG	1
CGGACCCCTA	GAAACACCGGTCTCGAGTGAGGTGTTCAGGGGTGGGGTTAGAGCTAGAAA	1
CGGACCCGTA	GAAACACCGGTCGCGGGAGCGGTGTTCAGGGTGGGGTTAGAGCTAGAAAT	1
CGGAGTCTTT	GAAACACCGGTCTCGAGTGAGGTGTTCAGGGGGGAGTTCGAGCTAGAACT	1
CGGATCCCTC	GAAACACCGGTCTCTAGAGAGGTGTTCAGGGTGGGGTTAGAGCTAGAAAT	1
CGGATTGTAC	GAAACACCGGTCTCGAGTGAGGTGTTCAGGGGGGGGTTAGAGCTAGAACT	1
CGGCGTGGTC	GAAACACTGGTGTACGTATGGACTGAACCAGGGTGTGCAAGTGGGGTTAG	1
CGGCTGAGCT	GAAACACCGGTTTACGTTGCATCGGTGTGGGGTTAGAGCTAGAAATAGCA	1
CGGCTGTCTC	GAAACACCGGTCCGTAGGAGACCCGTGTGGCATGTACCTGTGGGGTTAGA	1
CGGCTTCGCT	GAAAAACCGGTTTACGGTGCATCGGTGTGGGGTTAGAGCTAGAAATAGCA	1
CGGGACACTC	GAAACACCGGTGTGGCTGTGAGTCAGGCGCTGATGTGGCTGTGGGGTTAG	1
CGGGACTTGC	GAAACACCGGTGCATTCGAAAGTCCGGTCGTAGTGTGGACGTGGGGTTGG	1
CGGGCTGGCT	GAAACACCGGTGACATTGGGTACTAGAAATAGCAAGTTAACCTAAGGCTA	1
CGGGTGCTCT	GAAACACCGGTTCCCGTCCAGGGGGGTTAGAGCTAGAAATAGCAAGTTAA	1
CGGGTTGGTT	GAAACACCGGTGACCATAGGGTTAGAGCTAGAAATAGCAAGTTAACCTAA	1
CGGGTTGTAC	GAAACACCGGTGACATTGGGTACAGGGGTGGGGTTAGAGCTAGAAATAGC	1
CGTAGAAGAC	GAAACACCGGTGTACGTATGGAGCTAGAAGTAGTAAGTTAAGCTAAGGCT	1
CGTCACCCTC	GAAACACCGGTCTCGAGTGAGGTGTTCAGGGTGGGGGTAGAGCTAGAAAT	1
CGTCGAGCCA	GAAACACCGGTAGCAAGTGGGGTTAGAGCTAGAAATAGCAAGTTAACCTA	1
CGTCGGCCGC	GAAACACCGGTCCGTAGGAGACCCGTGTGGCATGTACCTGTGGGGTTAGA	1
CGTCGTACTC	GAAACACCGGTCCGTAGGAGACCCGTGTGGCATGTACCTGTGGGGTTATA	1
CGTCTGCATA	GAAACACTGGTCCGTAGGAGACCCGTGTGGCATGTACCTGTGGGGTTAGA	1
CGTCTGGATC	GAAACACCGGTACGAAGAAGACACGTGTGGCATGTACTTGTGGGGGTAAA	1
CGTGATGGCA	GAAACACCGGTGACATTGGTGGTGGGGTTAGAGCTAGGAATAGCAAGTTA	1
CGTGATGGCC	GAAACACCGGTGAGTGGGGTTAGAGCTAGAAATAGCAAGTTAACCTAAGG	1
CGTGGTGGCC	GAAACACCGGTGACATTGGGTACAGGGGAGGGGTTACAGCTAGAAATAGC	1
CGTGGTTTCA	GAAACACCGGTGACATTGGGTACGGGGTTAGAGCTAGAAATAGCAAGTTA	1
CGTGTAGCGC	GAAACACCGGTGACATTGGGTAGGGTTAGAGCTAGAAATAGCAAGTTAAC	1
CGTGTGACTC	GAAACACCGGTCCGTAGGAGACCCGTGTGGCATGTACCTGTGGGGTTAGA	1
CGTGTTGTCT	GAAACACCGGTGACATTGGGTACAGGGTGGGGTTAGAGCTAGAAATAGCA	268
CGTGTTGTCT	GAAACACCGGTGACATTGGGTACAGGGGTGGGGTTAGAGCTAGAAATAGC	253
CGTGTTGTCT	GAAACACCGGTGACATTGGGGTTAGAGCTAGAAATAGCAAGTTAACCTAA	217
CGTGTTGTCT	GAAACACCGGTGACATTGGGTTAGAGCTAGAAATAGCAAGTTAACCTAAG	115
CGTGTTGTCT	GAAACACCGGTGACATTGGGTAAAATAGCAAGTTAACCTAAGGCTAGTCC	101
CGTGTTGTCT	GAAACACCGGTGACAATTGGGGTTAGAGCTAGAAATAGCAAGTTAACCTA	66
CGTGTTGTCT	GAAACACCGGTGACATTGGGTACGGGGTTAGAGCTAGAAATAGCAAGTTA	65
CGTGTTGTCT	GAAACACCGGTGACAGGTGGGGTTAGAGCTAGAAATAGCAAGTTAACCTA	50
CGTGTTGTCT	GAAACACCGGTGACATGGGGTTAGAGCTAGAAATAGCAAGTTAACCTAAG	44
CGTGTTGTCT	GAAACACCGGTGACATTGGGTACAGGGTTAGAGCTAGAAATAGCAAGTTA	43
CGTGTTGTCT	GAAACACCGGTGACATTGGGTGGGGTTAGAGCTAGAAATAGCAAGTTAAC	43
CGTGTTGTCT	GAAACACCGGTGACATTGTGGGGTTAGAGCTAGAAATAGCAAGTTAACCT	40
CGTGTTGTCT	GAAACACCGGTGACATTGGGTATGGGGTTAGAGCTAGAAATAGCAAGTTA	38
CGTGTTGTCT	GAAACACCGGTGACATTGGGTACAGAAATAGCAAGTTAACCTAAGGCTAG	32
CGTGTTGTCT	GAAACACCAATGTCACCGGTGGGGTTAGAGCTAGAAATAGCAAGTTAACC	31
CGTGTTGTCT	GAAACACCGGTGACATTGGGTACGAGCTAGAAATAGCAAGTTAACCTAAG	30
CGTGTTGTCT	GAAACACCGGTGACATTGGGAGTGGGGTTAGAGCTAGAAATAGCAAGTTA	29
CGTGTTGTCT	GGTGGGGTTAGAGCTAGAAATAGCAAGTTAACCTAAGGCTAGTCCGTTAT	29
CGTGTTGTCT	ACCGGGGTTAGAGCTAGAAATAGCAAGTTAACCTAAGGCTAGTCCGTTAT	28
CGTGTTGTCT	GAAACACCGGTGACATTGGGTACTAGAAATAGCAAGTTAACCTAAGGCTA	26
CGTGTTGTCT	GAAACACCGGTGACATTGGGTAGTGGGGTTAGAGCTAGAAATAGCAAGTT	26
CGTGTTGTCT	GAAACACCGGTGACATTGGGTACAATTAGAGCTAGAAATAGCAAGTTAAC	25
CGTGTTGTCT	GATTGGGGTTAGAGCTAGAAATAGCAAGTTAACCTAAGGCTAGTCCGTTA	25
CGTGTTGTCT	GAAACACCGGTGACATGGTGGGGTTAGAGCTAGAAATAGCAAGTTAACCT	22
CGTGTTGTCT	GAAACACCGGTGACATTGGGTACAGGCCGTGGGGTTAGAGCTAGAAATAG	21
CGTGTTGTCT	GAAACACCGGTGACGTGGGGTTAGAGCTAGAAATAGCAAGTTAACCTAAG	21
CGTGTTGTCT	GAAACACCGGTGAGTGGGGTTAGAGCTAGAAATAGCAAGTTAACCTAAGG	21
CGTGTTGTCT	GCCTCCACGGCCACTAGTCTAAGGCTAGTCCGTTATCAACTTGAAAAAGT	21
CGTGTTGTCT	GAAACACCGGTGACATTGGGGGTTAGAGCTAGAAATAGCAAGTTAACCTA	20
CGTGTTGTCT	GAAACACCGGTGACATTGGGTAGAGCTAGAAATAGCAAGTTAACCTAAGG	20
CGTGTTGTCT	GAAACACCGGTGACATTGGGTAGGGGTTAGAGCTAGAAATAGCAAGTTAA	20
CGTGTTGTCT	CTAGTCCGTTATCAACTTGAAAAAGTGGCACCGAGTCGGTGCTTTTTTTC	19
CGTGTTGTCT	GAAACAAGGCTAGTCCGTTATCAACTTGAAAAAGTGGCACCGAGTCGGTG	19
CGTGTTGTCT	GAAACACCGGTGACATTGGTGGTGGGGTTAGAGCTAGAAATAGCAAGTTA	19
CGTGTTGTCT	GAAACACCGGTGACATTGGGTACAGAGAAATAGCAAGTTAACCTAAGGCT	18
CGTGTTGTCT	GAAACACCGGTGACATTGGGTACAGTGGGGTTAGAGCTAGAAATAGCAAG	18
CGTGTTGTCT	GAAACACCGGTGACATTGGTGGGGTTAGAGCTAGAAATAGCAAGTTAACC	18
CGTGTTGTCT	GAAACACCGGTGGTTAGAGCTAGAAATAGCAAGTTAACCTAAGGCTAGTC	18
CGTGTTGTCT	GAAACACCGGTGACATTGAGTGGGGTTAGAGCTAGAAATAGCAAGTTAAC	17
CGTGTTGTCT	GAAACACCGGTGACATTGGGTGGTGGGGTTAGAGCTAGAAATAGCAAGTT	17
CGTGTTGTCT	GGGTTAGAGCTAGAAATAGCAAGTTAACCTAAGGCTAGTCCGTTATCAAC	17
CGTGTTGTCT	GAAACACCGGTGACATTGAGGCTAGTCCGTTATCAACTTGAAAAAGTGGC	16
CGTGTTGTCT	GAAACACCGGTGACATTGAGGTGGGGTTAGAGCTAGAAATAGCAAGTTAA	16
CGTGTTGTCT	GAAACACCGGTGACATTGGGTACAGGAGGTGGGGTTAGAGCTAGAAATAG	16
CGTGTTGTCT	GAAACACCGGTGACATTAAGTGGGGTTAGAGCTAGAAATAGCAAGTTAAC	14
CGTGTTGTCT	GAAACACCGGTGACATTAGGTGGGGTTAGAGCTAGAAATAGCAAGTTAAC	14
CGTGTTGTCT	GAAACACCGGTGACATTGGGAAATAGCAAGTTAACCTAAGGCTAGTCCGT	14
CGTGTTGTCT	GAAACACCGGTGACATGGGTGGGGTTAGAGCTAGAAATAGCAAGTTAACC	13
CGTGTTGTCT	GAAACACCGGTGACATTGGGTACAAAATAGCAAGTTAACCTAAGGCTAGT	13
CGTGTTGTCT	GAAACACCGGTGACATTGGGTACAGGTGGTGGGGTTAGAGCTAGAAATAG	13
CGTGTTGTCT	GAAACACCGGTGACATTGGGAAAGGGTTAGAGCTAGAAATAGCAAGTTAA	12
CGTGTTGTCT	GAAACACCGGTGACATTGGGTACAAAAAGTGGGGTTAGAGCTAGAAATAG	12
CGTGTTGTCT	GAAACACCGGTGACATTGGGTACGCTAGAAATAGCAAGTTAACCTAAGGC	12
CGTGTTGTCT	GAAACACCTAGAAATAGCAAGTTAACCTAAGGCTAGTCCGTTATCAACTT	12
CGTGTTGTCT	GAAACACCGGTATTGGGTTAGAGCTAGAAATAGCAAGTTAACCTAAGGCT	11
CGTGTTGTCT	GAAACACCGGTGACATTGGGTACAAGAAATAGCAAGTTAACCTAAGGCTA	10
CGTGTTGTCT	GAAACACCGGTGACATTGGGTACATTAGAGCTAGAAATAGCAAGTTAACC	10
CGTGTTGTCT	GAAACACCGGTGGGGTTAGAGCTAGAAATAGCAAGTTAACCTAAGGCTAG	10
CGTGTTGTCT	GAAACACCGGTGACATTGGGTACAGTTAGAGCTAGAAATAGCAAGTTAAC	9
CGTGTTGTCT	GAAACACCGGTGACATTGGGTACAGTTTGTGGGGTTAGAGCTAGAAATAG	9
CGTGTTGTCT	GAAACACCGGTGGGTGGGGTTAGAGCTAGAAATAGCAAGTTAACCTAAGG	9
CGTGTTGTCT	GAAACACCGTTGGGGTTAGAGCTAGAAATAGCAAGTTAACCTAAGGCTAG	9
CGTGTTGTCT	GAAACACCGGTGACATTAGTGGGGTTAGAGCTAGAAATAGCAAGTTAACC	8
CGTGTTGTCT	GAAACACCGGTGACATTGGGTACGGCTAGTCCGTTATCAACTTGAAAAAG	8
CGTGTTGTCT	GAAACACCGGTGACATTGGGTCGTTAACCTAAGGCTAGTCCGTTATCAAC	8
CGTGTTGTCT	GAAACACCGGTGACATTGGGTACAAGAGCTAGAAATAGCAAGTTAACCTA	7
CGTGTTGTCT	GAAACACCGGTGACATTGGGTACAGGGGGGTGGGGTTAGAGCTAGAAATA	7
CGTGTTGTCT	GAAACACCGGTGACATTGGGTACAGGGGGTGGGGTTAGAGCTAGAAATAG	7
CGTGTTGTCT	GAAACGGGGTTAGAGCTAGAAATAGCAAGTTAACCTAAGGCTAGTCCGTT	7
CGTGTTGTCT	GAACCGGGGTTAGAGCTAGAAATAGCAAGTTAACCTAAGGCTAGTCCGTT	7
CGTGTTGTCT	GAAACACCGGTATTGGGTTAGAGCTAGAAATAACAAGTTAACCTAAGGCT	5
CGTGTTGTCT	GAAACACCGGTGACATTGGGTACATGATTCATGTAATGTATGTTTATGTA	5
CGTGTTGTCT	GAAACACCGGTGACATTGGGGGGGGGTGGGGTTAGAGCTAGAAATAGCAA	4
CGTGTTGTCT	GAAACACCGGTGACATTGGGTACAGGGCTAGAAATAGCAATAGCAAATAG	4
CGTGTTGTCT	GAAACACCGGTGACATTGGGTACAGTTTTTGTGGGGTTAGAGCTAGAAAT	4
CGTGTTGTCT	GAAACTAGAGCTAGAAATAGCAAGTTAACCTAAGGCTAGTCCGTTATCAA	4
CGTGTTGTCT	GAAGCACCGGCGACATGGGTGGGGTTAGAGCTAGAAATAGCAAGTTAACC	4
CGTGTTGTCT	GCTAGTCCGTTATCAACTTGAAAAAGTGGCACCGAGTCGGTGCTTTTTTT	4
CGTGTTGTCT	GAAACACCGGTCGGGGCCACTCAGTGGTGGGGTTAGAGCTAGAAATAGCA	3
CGTGTTGTCT	GAAACACCGGTGACATTGGAATAGCAAGTTAACCTAAGGCTAGTCCGTTA	3
CGTGTTGTCT	GAAACACCGGTGACATTGGGTACAGGGGGATGGGGTTAGAGCTAGAAATA	3
CGTGTTGTCT	GAAACACCGGTGACATTGGGTACAGGTGGGGTTAGAGCTAGAAATAGCAA	3
CGTGTTGTCT	CAAAACACCGGTGACATTGGGGTTAGAGCTAGAAATAGCAAGTTAACCTA	2
CGTGTTGTCT	GAAACACCGGTAAATTTGAGGCTCCGGCATGCAGGAGGCCGTGGGGTTAG	2
CGTGTTGTCT	GAAACACCGGTGACATTGGGTAGGATCGCGTATCAGGGGTTAGAGCTAGA	2
CGTGTTGTCT	GAAACATTGGGGTTAGAGCTAGAAATAGCAAGTTAACCTAAGGCTAGTCC	2
CGTGTTGTCT	AAGACTAGTCAGTTATCAACTTGAAAAAGTGGCACCGAGTCGGTGCTTTT	1
CGTGTTGTCT	CAAAACACCGGTGACATTGGGTACAGGGTGGGGTTAGAGCTAGAAATAGC	1
CGTGTTGTCT	CAAAACACCGGTGACATTGGGTGGTGGGGTTAGAGCTAGATATAGCAAGT	1
CGTGTTGTCT	GAAACACCGGTCCGTAGGAGACCCGTGTGGCATGTACCTGTGGGGTTAGA	1
CGTGTTGTCT	GAAACACCGGTCTCGAGTGAGGTGTTCAGGGTGGGGTTAGAGCTAGAAAT	1
CGTGTTGTCT	GAAACACCGGTGACATGGGTAGGGGTAGGGCTAGAGAGAGCGAGTTAACC	1
CGTGTTGTCT	GAAACACCGGTGACATTGGGTAAAATAGCAAGTTACCTAAGGCTAGTCCG	1
CGTGTTGTCT	GAAACACCGGTGACATTGGGTAAATTAGCAGTTTACCCAAAGGCTGTTCG	1
CGTGTTGTCT	GAAACACCGGTGATATTGGGTACAGGTGGGGTTAGAGCTAGAAATAGCAA	1
CGTGTTGTCT	GAAACACCGGTGCCCTTACTCTCACCTGATTACTTAATCCGTGGGGTTAG	1
CGTGTTGTCT	GAAACACCGGTGGCACCGGGAGGGTTAGAGCTAGGAATAGCCAGTTAACC	1
CGTGTTGTCT	GAAACACCGGTGTACGTATGGACAGAACCAGGGTGTGCAAGAGGGGTTAG	1
CGTGTTGTCT	GAAACACCGGTGTACGTATGGACTGAACCAGGGTGTGCAAGTGGGGTTAG	1
CGTGTTGTCT	GAAACACCGGTGTACTTGGGTTAGAGCTAGAAATAGCGAGATAACCAGCG	1
CGTGTTGTCT	GAAACACCGGTTACGTCGGTGGGGTTAAAACTAGAAATAACAAGTTAACC	1
CGTGTTGTCT	GAAACACCGGTTTACGTTGCATCGGTGTGGGGTTAGAGCTAGAAATAGCA	1
CGTGTTGTCT	GAAACACCGGTTTGAACCGGTGGGGTTAGAGCTAGAAATAGCAAGTTAAC	1
CGTGTTGTCT	GAAACACCGTAGAGCTAGAAATAGCAAGTTAACCTAAGGCTAGTCCGTTA	1
CGTGTTGTCT	GAAACTAGAGCTAGAGATAGCAAGTTAACCTAAGGCTAGTCCGTTATCAA	1
CGTGTTGTCT	GAAACTCCGGTGACATTGGGTACAGGGCTAGAAATAGCAATAGCAAATAG	1
CGTGTTGTCT	GACGAAACACCGGTGACATTGGGTACGGGGTTAGAGCTAGAAATAGCAAG	1
CGTGTTGTCT	GACGAAACACCGGTTACCATGGGGTTAAAGCTAGGAATAGCAAGTTAAAC	1
CGTGTTGTCT	GAGGATAGGACGAAACACCGGTGACATTGGGTTAGAGCTAGAAATAGCAA	1
CGTGTTGTCT	GCTAGTCCGTTATCAAATTGAAAAAGTGGCACCGAGTCGGTGCTTTTTTT	1
CGTGTTGTCT	GCTAGTCCGTTATCAACTTGAAAAAGTGGCACCGAGTCGGTGCTTTCTTT	1
CTAAGAATAA	GAAACACCGGTTCAGGCAAGCAGGTCGGGCTCGAGATAGTAAGTTGATCT	1
CTAAGCATGA	GAAACACCGGTTAAATTGAGGGTTAGAGCTAGAAATAGCAAGTTAACCTA	1
CTAATTCTGT	GAAACACCGGTTACATTGAGGGTTATAGCTAGAAATAGCAAGTTAACATA	1
CTAATTGGCA	GAAACACCGGTACCTTTGTTGATGCTGGGTGGAAGGAATTTGTGGGGTTA	1
CTAATTGTTT	GAAACACCGGTCTCGAGTGAGGTGTTCAGGGGGGGGTTAGAGCTAGAAAT	1
CTACACGGAA	GAAACACCGGTACCTTTGTTGATGCTGGGTGGGGTTAGAGCTAGAAATAA	1
CTACAGGGAT	GAAACACCGGTTATATTTGTAACTATTGTCGCATTAGAGCTAGAGGTTGC	1
CTACATTCGG	GAAACACCGGTCGATTCATATCGAAACCTTCCCGTGACAGTGGGGTTAGA	2
CTACCCGCGC	GAAACACCGGTGCATTCGAAAGGCCGGTCGGGTTATGGCTATAGGGATCG	1
CTACCCTTAA	GAAACACCGGTGTGGCTGAGAGTCCGGCAATGGTGTGGCTGTGGGGTTAG	1
CTACGCAGAC	GAAACACCGGTACCTTTGTTGATGCTGGGTGGAAGGGATTTGTGGGGTTA	1
CTACGCCACG	GAAACACCGGTACCTTTGGTGATTCTGGGGGGATGGAGTTTTGTGGGGTT	1
CTACTCGGCC	GAAACACCGGTACCTTTGTTGATGCTGGGTGGGGTTAGAGCTAGAAATAG	210
CTACTCGGCC	GAAACACCGGTACCTTTGTTGATGCTGGGTGGAAGGAATTTGTGGGGTTA	190
CTACTCGGCC	GAAACACCGGTACCTTTGTTGATGCTGGGTGGAAGGAATTTTGTGGGGTT	147
CTACTCGGCC	GAAACACCGGTACCTTTGTTGATGCTGGGTGGAAGGAATGTGGGGTTAGA	135
CTACTCGGCC	GAAACACCGGTACCTTTGTTGATGCTGGGTGGAAGGTGGGGTTAGAGCTA	103
CTACTCGGCC	GAAACACCGGTACCTTTGTTGATGCTGGGTGGAAGGAAAAAGTGGCACCG	92
CTACTCGGCC	GAAACACCGGTACCTTTGTTGATGCTGGGTGGAAGGTACCGGTGGGGTTA	49
CTACTCGGCC	GAAACACCGGTACCTTTGTTGATGCTGGGTGGAAGGATGCTGGGTGGGGT	48
CTACTCGGCC	GAAACACCGGTACCTTTGTTGATGCTGGGTGGAAGGAATGGTGGGGTTAG	34
CTACTCGGCC	GAAACACCGGTACCTTTGTTGATGCTGGGTGGAAGGTACACCGGTACCTT	32
CTACTCGGCC	GAAACACCGGTACCTTTGTTGATGCTGGGTGGAAGGAATGGGGTTAGAGC	25
CTACTCGGCC	GAAACACCGGTACCTTTGTTGATGCTGGGTGCTTTTTTTCCTGCAGGGGC	24
CTACTCGGCC	GAAACACCGGTACCTTTGTTGATGCTGGGTGGAAATAGCAAGTTAACCTA	22
CTACTCGGCC	GAAACACCGGTACCTTAGAGCTAGAAATAGCAAGTTAACCTAAGGCTAGT	21
CTACTCGGCC	GAAACACCGGTACCTTTGTTGATGCTGGGTGGAAGGGCTAGAAATAGCAA	21
CTACTCGGCC	GAAACACCGGTACCTTTGTTGATGCTGGGTGGAAGGAGCTAGAAATAGCA	20
CTACTCGGCC	GAAACACCGGTACCTTTGTTGATGCTGGTTAGAGCTAGAAATAGCAAGTT	20
CTACTCGGCC	GAAACACCGGTACCTTTGTTGATGCTGGGTGGAAGGAATTGTGGGGTTAG	19
CTACTCGGCC	GAAACACCGGTACCTTTGTTGATGCTGGAAATAGCAAGTTAACCTAAGGC	17
CTACTCGGCC	GAAACACCGGTACCTTTGACCTAGAAATAGCAAGTTAACCTAAGGCTAGT	16
CTACTCGGCC	GAAACACCGGTACCTTTGTTGATGCTGGGTGGAAGGTGTGGGGTTAGAGC	14
CTACTCGGCC	GAAACACCGGTACCTTGTGGGGTTAGAGCTAGAAATAGCAAGTTAACCTA	13
CTACTCGGCC	GAAACACCGGTACCTTTGTTGATGCTGGGTGGAAGGAATTGGAGCTAGAA	13
CTACTCGGCC	GAAACGAGCTAGAAATAGCAAGTTAACCTAAGGCTAGTCCGTTATCAACT	13
CTACTCGGCC	GAAACACCGGTACCTTTGTTGATGCTGGGGTGGGGTTAGAGCTAGAAATA	12
CTACTCGGCC	GAAACACCGGTACCTTTGTTGATGCTGGGTGGAAGGAATAGCAAGTTAAC	12
CTACTCGGCC	GAAACACCGGTACCTTTGTTGATGCTGGGTGTTGGGGTTAGAGCTAGAAA	12
CTACTCGGCC	GAAACACCGGTACCTTTGTTGATGCTGGTGGGGTTAGAGCTAGAAATAGC	12
CTACTCGGCC	GAAACACCGGTACCTTTGTTGATGCTGGGTGGAAGGAATTCTAGAAATAG	11
CTACTCGGCC	GAAACACCGGTACCCTAGAAATAGCAAGTTAACCTAAGGCTAGTCCGTTA	10
CTACTCGGCC	GAAACACCGGTACCTTTGTTAACCTAAGGCTAGTCCGTTATCAACTTGAA	10
CTACTCGGCC	GAAACACCGGTACCTTTGTTGATGCTGCTTGTGGGGTTAGAGCTAGAAAT	10
CTACTCGGCC	GAAACACCGGTACCTTTGTTGATGCTGGGTGGAAGGAAATAGCAAGTTAA	10
CTACTCGGCC	GAAACACCGGTACCTTTGTTGATGCTGGGTGGAAGGAAGTGGGGTTAGAG	10
CTACTCGGCC	GAAACACCGGTACCTTTGTTGATGCTGGGTGGAAGGGTTTGGGGTTAGAG	10
CTACTCGGCC	GGCAAGTTAACCTAAGGCTAGTCCGTTATCAACTTGAAAAAGTGGCACCG	10
CTACTCGGCC	GAAACACCGGTACCCGTGGGGTTAGAGCTAGAAATAGCAAGTTAACCTAA	9
CTACTCGGCC	GAAACACCGGTACCTTTGTTGATGCTGGGTGGAAGTAGAAATAGCAAGTT	9
CTACTCGGCC	GAAACACCGGTACCTTTGTTGATGCTGGGTGGGAGCTAGAAATAGCAAGT	9
CTACTCGGCC	GAAACACCGGTACCTTTGTTGATGCTGGTTGTGGGGTTAGAGCTAGAAAT	9
CTACTCGGCC	GAAACACCGGTACCTTTGTTGATGCTGGGTGGAAGGAAGCTAGAAATAGC	8
CTACTCGGCC	GAAACACCGGTACCTTTGTTGATGCTGGGTGGAAGGAATTTCCCGTGGGG	8
CTACTCGGCC	GAAACACCGGTACCTTTGTTGATGCTGGGTGGAAGGGTTAGAGCTAGAAA	8
CTACTCGGCC	GAAACACCGGTACCTTTGTTTGTGGGGTTAGAGCTAGAAATAGCAAGTTA	8
CTACTCGGCC	GAAACACCGGTACCTTTGTTGAGGTGGGTTAGAGCTAGAAATAGCAAGTT	7
CTACTCGGCC	GAAACACCGGTACCTTTGTTGATGCTGGGTGATTGTGGGGTTAGAGCTAG	7
CTACTCGGCC	GAAACACCGGTACCTTTGTTGATGCTGGGTGGAAGGAGTGGGGTTAGAGC	7
CTACTCGGCC	GAAACACCGGTTATATTTGTAAGTGTTGTGGGGTTAGAGCTAGAAATAGC	7
CTACTCGGCC	GAAACACCGGTACCTTTGTTGATGCTGGGTGGAAGAGCTAGAAATAGCAA	6
CTACTCGGCC	GAAACACCGGTACCTTTGTTGATGCTGGGTGGAAGGATGGGGTTAGAGCT	6
CTACTCGGCC	GAAACACCGGTACCTTTGTTGATGCTTTTTGGGTTAGAGCTAGAAATAGC	6
CTACTCGGCC	CAAAACACCGGTACCTTTGTTGATGCTGGTTGTGGGGTTAGAGCTAGAAA	5
CTACTCGGCC	GAAACACCGGTACCTTTGTTGATGCTGGGTGGAAGGAATTTCTCCGTGGG	5
CTACTCGGCC	GAAACACCGGTACCTTTGTTGATGTTGATGTTGATGGGTTAGAGCTAGAA	5
CTACTCGGCC	GAAACACCGGTACCTTTGTCTAGAAATAGCAAGTTAACCTAAGGCTAGTC	4
CTACTCGGCC	GAAACACCGGTACCTTTGTGGGGTTAGAGCTAGAAATAGCAAGTTAACCT	4
CTACTCGGCC	GAAACACCGGTACCTTTGTTGTGTAGAGCTAGAAATAGCAAGTTAACCTA	4
CTACTCGGCC	GAAACACCGGTACCTTTGTTGATGCTGGGTGGAAGGAATGACTAAGGATG	3
CTACTCGGCC	GAAACACCGGTACCTTTGTTGATGCTGGGTGGAAGGAATTCAAGTTAACC	3
CTACTCGGCC	GAAACACCGGTACCTTTGTTGATGCTGGGTGGAAGGAGGCTAGAAATAGC	3
CTACTCGGCC	CAAAACACCGGTACCTTTGTTGATGCTGGGTGGAAGGTGGGGTTAGAGCT	2
CTACTCGGCC	GAAACACCGGTACCTTTGTTGATGCTGGAGAGCTAGAAATAGCAAGTTAA	2
CTACTCGGCC	GAAACACCGGTACCTTTGTTGATGCTGGGTGGGTTAGAGCTAGAAATAGC	2
CTACTCGGCC	GAAACACCGGTACTTTGTTGATGCTGGGTGGGGTTAGAGCTAGAAATAGC	2
CTACTCGGCC	GAAACACCGGTTTACGTTGCATCGGTGTGGGGTTAGAGCTAGAAATAGCA	2
CTACTCGGCC	GAAACACCGGTTTACGTTGCATCGGTTGTGGGGTTAGAGCTAGAAATAGC	2
CTACTCGGCC	CAAAACACCGGTACCTTTGTTGAGGTGGGTTAGAGCTAGAAATAGCAAGT	1
CTACTCGGCC	CAAAACACCGGTACCTTTGTTGATGCTGGGTGGAAGGAAGCTAGAAATAG	1
CTACTCGGCC	CAAAACACCGGTACCTTTGTTGATGCTGGTTAGAGCTAGAAATAGCAGGT	1
CTACTCGGCC	CAAAACACCGGTACCTTTGTTGATGCTGGTTGTGGGGCTAGAGCTAGAAA	1
CTACTCGGCC	GAAACACCAGTACCTTTGTGGGGTTAGAGCTAGAAATAGCAAGTTAACCT	1
CTACTCGGCC	GAAACACCGGTAACTACGTTCATGCGATATCGCCGTATCAGTGGGGTTAG	1
CTACTCGGCC	GAAACACCGGTACCCGTGTTGTGGAGAGCGAGCTAGAGCAAGTTAGCTTA	1
CTACTCGGCC	GAAACACCGGTACCTTGTTGATGCTGGGTGGGGTTAGAGCTAGAAATAGC	1
CTACTCGGCC	GAAACACCGGTACCTTTGTAGGGATAGAGCTAGAAATAGCAAGTTAACCT	1
CTACTCGGCC	GAAACACCGGTACCTTTGTCTAGAAATAGCAAGTTAACCTAAGGCTAGTT	1
CTACTCGGCC	GAAACACCGGTACCTTTGTTGATGCTGGGTGGAAAGAATGACTAAGGATG	1
CTACTCGGCC	GAAACACCGGTACCTTTGTTGATGCTGGGTGGAGGGAATTCAAGTTAGCC	1
CTACTCGGCC	GAAACACCGGTACCTTTGTTGGTGCTGGGCGGCAGGCGTTTTGGGGGTTA	1
CTACTCGGCC	GAAACACCGGTACCTTTGTTGTGTAGAGCTAGAGATAGCAAGTTAACCTA	1
CTACTCGGCC	GAAACACCGGTACCTTTGTTTAGGCTGTGGGGTTATAGCTCGAGATAGCG	1
CTACTCGGCC	GAAACACCGGTACCTTTTTTGATGCTGGGTGGGTATAGAGATAGATAGAG	1
CTACTCGGCC	GAAACACCGGTACTTTGTTGATGCTGGGTGGAAGGTGTGGGGTTAGAGCT	1
CTACTCGGCC	GAAACACCGGTCCGTAGGAGACCCGTGTGGCATGTACCTGTGGGGTTAGA	1
CTACTCGGCC	GAAACACCGGTTTACGTTGCATCGGTGTGTGGTTAGAGCTAGAAATAGCA	1
CTACTCGGCC	GAAACGCCGGTACCTTTGTGGGGTTAGAGCTAGAAATAGCAAGTTAACCT	1
CTACTCGGCC	GACGAAACACCGGTACCTTTGTTGATGCTGGGTGGAAGGTGGGGTTAGAG	1
CTACTCGGCC	GGAACACCGGTTACATTGAGGGGTTAGAGCTAGAAATAGCAAGTTAACCT	1
CTACTCGGCC	GGAAGTACGAAACACCGGTACCTTTGTTGATGCTGGGTGGAAGGATGCTG	1
CTACTCGGCC	GGCAAAACACCGGTACCTTTGTTGATGCTGGGTGGGGCTAGAGCTAGAAA	1
CTACTTGTAT	GAAACACCGGTAACTATATTCATGCGATATCGCCGTATCAGTGGGGTTAG	1
CTAGATAGGT	GAAACACCGGTTACATTTTGAGGGTTAGAGCTAGAAATAGCAAGTTAACC	1
CTAGCCCTGT	GAAACACCGGTTACATGAGGGTTAGAGCTAGAAATAGCAAGTTAACCTAA	1
CTAGGCGTCC	GAAACACCAATTTCACCGGTGGGGTTAGAGCTAGAAATAGCAAGTTAACC	1
CTAGTCCGAA	GAAACACCGGTTCCTTTGTTGATGCTGGGGGCTTTTTTTCATGCAGGGGC	1
CTAGTTGGCT	GAAACACCGGTACCTTTGTTGATGCTGGGGGGAATAGATTTAGAGGGATA	1
CTAGTTGTGT	GAAACACCGGTGACATTGGGGATAGGCCGTGGGGTTAGAGCTAGAAATAG	1
CTATGTATGT	GAAACACCGGTTTGGGGTTAGAGCTAGAAATAGCAAGTTAACCTAAGGCT	1
CTATTAGGGC	GAAACACCGGTACCTTTGTTGATGCTGGGTGGAGGGAGCTGGTGGGGTTA	1
CTCAAAGGCC	GAAACACCGGTACCTTTGTTGATGCTGGTTAGAGCTAGAAATAGCAAGTT	1
CTCACTGCCG	GAAACACCGGTGTGGCTGAGAGTCCGGCAATGGTGTGGCTGTGGGGTTAG	1
CTCATAGGGC	GAAACACCGGTTATATTTGTACGTGTGTGGGTTTAGAGCTAGAAATAGCA	1
CTCCAAGGCC	GAAACACCGGTACCTTTGTTGATGCTGGGTGGAAGGAATTTGTGGGGTTA	1
CTCCCATGCA	GAAACACCGGTGTGGCTGAGAGTCCGGCGATGGTGTGGCTGTGGGGTTAG	1
CTCCCCGTCA	GAAACACCGGTGTGGCTGAGAGTCCGGCAATGGTGTGGCTGTGGGGTTAG	1
CTCCCCTGCA	GAAACACCGGTGTGGCTGAGAGTCCGGCAATGGTGTGGCTGTGGGGTTAG	12
CTCCCCTGCA	GAAACACCGGTGTGGCTGAGAGTCCGGCAATGGTGTGGCTGGGGGGTTAG	1
CTCCCCTGCA	GAAACACAGGTGTGGCTGAGAGTCCGGCAATGGTGTGGCTGTGGGGTTAG	1
CTCCCCTGCA	GAAACACCGGTGAGGCTGAGAGACCGGCAGTGGTATGGCTGGGGGGTTAT	1
CTCCCCTGCA	GAAACACCGGTGCGGCTGAGAGTCCGGCAATGGTGTGGCTGGCGGGTTAG	1
CTCCCCTGCA	GAAACACCGGTGTGGCTGAGAGTCCGGCAATGGTGTGGCTGCGGGGTTAG	1
CTCCCCTGCA	GAAACACCGGTGTGACTGAGAGTCCGGCAATGGTGTGGCTGTGGGGTTAG	1
CTCCCCTGCG	GAAACACCGGTGTGGCTGAGAGTCCGGCAATGGTGTGGCTGTGGGGTTAG	1
CTCCCCTTCA	GAAACACCGGTGTGGCTGAGAGTCCGGCAATGGTGTGGCTGTGGGGTTAG	1
CTCCCTTGGA	GAAACACCGGTGTGGCTGAGAGTCCGGCAATGGTGTGGCTGTGGGGTTAG	1
CTCCTCTGCA	GAAACACCGGTGTGGCTGAGAGTCCGGCAATGGTGTGGCTGTGGGGTTAG	1
CTCGAATTGA	GAAACACCGGTGCCGTTACTTTCACCTGATGGTTTAATCTGGGGGGATCG	1
CTCGCCATAC	GAAACACCGGTGCCCTTACTCTCACCTGATTACTTAATCCGTGGATATAG	1
CTCGCGATGT	GGAACACCGGTTACATTGAGGGGTTAGAGCTAGAAATAGCAAGTTAACCT	1
CTGAAGACCC	GAAACACCGGTGCTAGAAATAGCAAGTTAACCTAAGGCTAGTCCGTTATC	1
CTGAGCAGAC	GAAACACCGGTTAAGCCGGTGGGGTTAGAGCTAGAAATAGCAAGTTAACC	1
CTGAGCGTCA	GAAACACCGGTTCCGTTGTGTACGCTTAGAGCTAGATGGAGTAAAGTTAT	1
CTGAGCTGAA	GAAACACCGGTTAAGCCGAGGAGTTAGAGCTAGAAATAGCAAGTTAACCT	1
CTGAGTACAA	GAAACACCGGTTAAGCCGAGTGGGGTCAGAGCTAGAAATAGCAAGTTAAC	1
CTGATAATTC	GAAACACCGGTCTCGAGTGAGGTGGTCAGGGTGGGGTTAGAGCTAGAAAT	1
CTGATCGCTC	GAAACACCGGTTTGCACTAGAAATAGCTAGTTAGCCTAATGCTAGGCCAG	1
CTGATTACCT	GAAACACCGGTTTACGTTGCATCGGTGTGGGGTTAGAGCTAGAAATAGCA	1
CTGATTAGCC	GAAACACCGGTTTACGTTGCATCGGTTGTGGGGTTAGAGCTAGAAATAGC	1
CTGCACAGCA	GAAACACCGGTTTACGTTGCATCGGTGTGGGGTTAGAGCTAGAAGTAGCA	1
CTGCACATAA	GAAACACCGGTTAAGCCGAGTGGGGTTAGAGCTAGAAATAGCAAGTTAAC	1
CTGCACTTCA	GAAACACCGGTACCTTTGTTGATGCTGGGTGGAAGGAATGGGTGGGGGTA	1
CTGCGGCGTA	GAAACACCGGTGTACGTGTGACCTGAAGGGCGGTGTGCAGGTGGGGTTAG	1
CTGCTAAGGC	GAAACACCGGTTTACGCTGCATCGGTGTGGGGTTAGAGCTAGAAATAGCG	1
CTGCTTCGCC	GAAACACCGGTTTACGTTTCATCGGTGTGGGGTTAGAGCTAGAAATAACA	1
CTGCTTGGAC	GAAACACCGGTTTACGTTGCATCGGTTGTGGGGTTAGAGCTAGAAATAGC	1
CTGGCGACTC	GAAACACCGGTTCCCGTCCAGTGGGGTTAGAGCTAGAAATAGCAAGTTAA	1
CTGGGGGAAC	GAAACACCGGTTAAACCGCGGAGGTTCGTTATAGCTAGAAATAGCAAGTT	1
CTGGTTAGTT	GAAACACCGGTTTACGTTGCATCGGTGTGGGGTTAGAGCTAGAAATAGCA	1
CTGTGACAGA	GAAACACCGGTCGGGGCCACTCAGTGGTGGGGTTAGAGCGAGAAATAGCT	1
CTGTTCGGCA	GAAACACCGGTACTTCTGTTGGTGCTGGGGGGAAGGAGATAGAGACAGCG	1
CTTCTCGACT	GAGACACCGGTACCTTTGTTGATGCTGGGTGGAAGGAAGGTGGGGTTAGA	1
CTTCTCGCGG	GAAACACCGGTTATATTTGTAAGTGTGTGGGGTTAGAGCTAGAAATAGCA	1
CTTGTCGTCC	GAAACACCGGTGACATTGGGTACAGGGTGGGGTTAGAGCTAGAAATAGCA	1
CTTGTGACTT	GAAACACCGGTCCGTAGGAGACCCGTGTGGCATGTACCTGTGGGGATAGA	1
CTTGTGATGT	GAAACACCGGTGTGGAGGAGAGCCGTGTGGCGTTTAGGTTTGGGGGTAGA	1
CTTTTGTCGG	GAAACACCGGTGTAATCCAAAGCTATTAACATCATGAGTTGTGGGGTTAG	1
GAAAAAGCCA	GAAACACCGGTAGCAAGTGCGAGACGTGTTTGTGGGGTTAGAGCTAGAAA	1
GAAAACGCCA	GGGTTAGAGCTAGAAATAGCAAGTTAACCTAAGGCTAGTCCGTTATCAAC	1
GAAAATCTTT	GAAACACCGGTCTCGAGTGAGGTGTTCAGGGTGGGGTTAGAGCTAGAAAT	1
GAAACAAGAT	GTCGAATTCGGGCCCATTGGTATGGCAGATCGGAAGAGCACACGTCTGAA	1
GAAACGCCCT	GAAACACCGGTGCCCTTACTCTCACCTGATTACTTAATCCGTGGGGTTAG	1
GAAACTATCA	GAAACACCGGTTCCATTGAGGGGCTAGAGCGGGAAGTAGCAAGTTAACCT	1
GAAATAATAT	GAAACACCGGTAACTATATTCATGCGATATCGCCGTATCAGTGGGGTTAG	1
GAAATCCTTA	GAAACACCGGTCTCGAGTGAGGTGTTCAGGGGGGGGTTAGAGCTAGAAAT	1
GAAATCGAGC	GAAACACCGGTCGGCGGCAATCGTGGGTGGGGTTAGAGCTAGAAATAGCA	1
GAAATCTGAA	GAAACACCGGTAAATTTGAGGCTCCGGCATGCAGGAGGCCGTGGGGTTAG	1
GAAATTCGGT	GAAACACCGGTCGATTCATATCGAAACCTTCCCGTGACAAGTGGGGTTAG	1
GAACAACGAC	GAAACACCGGTTTGAACTACCTAGAGCTAGAAATAGCAAGTTAACCTAAG	1
GAACAACGCA	GAAACACCGGTTTGAACTAGAAATAGCAAGTTAACCTAAGGCTAGTCCGT	1
GAACAACGCC	ATAGAAATAGCAAGTTAACCTAAGGCTAGTCCGTTATCAACTTGAAAAAG	1
GAACAACGCC	GAAACACCGGTTTGAACTACCTAGTTCAAACCGGTGGGGTTAGAGCTAGA	1
GAACAAGCCA	GAAACACCGGTAGCAAGTGCGGGGTTAGAGCTAGAAATAGCAAGTTAACC	1
GAACACGCCG	GAAACACCGGTTTGAACTGCCTAGTTCAAACCGGTGGGGTTAGAGCTAGA	1
GAACCAGCCA	GAAACACCGGTAGCAAGTGGGGTTAGAGCTAGAAATAGCAAGTTAACCTA	1
GAACCAGTGG	GAAACACCGGTAGCAAGTGGGGGTAGAGCTAGAAATAGCAAGTTAACCCA	1
GAACCCAACC	GAAACACCGGTAAATTTGAGGCTCCGGTATCCAGGAGGCCGTGGGGTTAG	1
GAACGAGCTA	GAAACACCGGTGCCCTTACTCTCACCTGATTACTTAATCCGTGGGGTTAG	1
GAACGCACAA	GAAACACCGGTGCCCTTACTCTCACCTGATTACTTAATCCGTGGGGTTAG	1
GAACGCACCA	GAAACACCGGTGCCCTTACTCTCACCTGATTACTTAATCCGTGGGGTTAG	1
GAACGCGCTA	GAAACACCGGTGCCCTTACTCTCACCTGATTACTTAATCCGTGGGGTTAG	2
GAACTACTTT	GAAACACCGGTCTCGAGTGAGGTGTTCAGGGTGGGGTTAGAGCTAGAAAT	1
GAACTCATCA	GAAACACCGGTAACTATATTCATGCGATATCGCCGTATCAGTGGGGTTAG	1
GAACTTCAAC	GAAACACCGGTAACTATATTCATGCGATATCGCCGTATCAGTGGGGTTAG	1
GAAGAAATGC	GAAACACCGGTCGGCGGCAATCGTGGGTGGGGTTAGAGCTAGAAATAGCA	1
GAAGAAGCGG	GAAACACCGGTCGGCGGCCGGTTAGAGCTAGAAATAGCAAGTTAACCTAA	1
GAAGAATCTC	GAAACACTGGTCGGCGGCAATCGTGGGTGGGGTTAGAGCTAGAAATAGCA	1
GAAGACAAGA	GAAACACCGGTCGGCGGCAATCGTGGGTGGGGTTAGAGCTAGAAATAGCA	1
GAAGACAAGA	GAAACACCGGTCGGTGGGGCTAGAGCTAGAAATAGCAAGTTAACCTAAGG	1
GAAGACCCGC	GAAACACCGGTCGGCGGCAATCGTGGGTGGGGTTAGAGCTAGAAATAGCA	858
GAAGACCCGC	GAAACACCGGTCGGCGGCAATCGTGGGGTGGGGTTAGAGCTAGAAATAGC	186
GAAGACCCGC	GAAACACCGGTCGGCGGCCGGTTAGAGCTAGAAATAGCAAGTTAACCTAA	183
GAAGACCCGC	GAAACACCGGTCGGCGGCGGTGGGGTTAGAGCTAGAAATAGCAAGTTAAC	86
GAAGACCCGC	GAAACACCGGTCGGCTAGAAATAGCAAGTTAACCTAAGGCTAGTCCGTTA	62
GAAGACCCGC	GAAACACCGGTCGGCGGGGTTAGAGCTAGAAATAGCAAGTTAACCTAAGG	50
GAAGACCCGC	GAAACACCGGTGGGGTTAGAGCTAGAAATAGCAAGTTAACCTAAGGCTAG	41
GAAGACCCGC	GAAACACCGGTCGGCGGCAATCGTGGTATGAGCCACGTGGGGTTAGATCG	39
GAAGACCCGC	GAAACACCGGTCGGCGGCTAGAGCTAGAAATAGCAAGTTAACCTAAGGCT	39
GAAGACCCGC	GAAACACCGGTCGGCGGCAATCGTGGTAGAGCTAGAAATAGCAAGTTAAC	37
GAAGACCCGC	GAAACACCGGTCGGCGGTGGGGTTAGAGCTAGAAATAGCAAGTTAACCTA	33
GAAGACCCGC	GAAACACCGGTCGGCGGCAATCTGGGGTTAGAGCTAGAAATAGCAAGTTA	29
GAAGACCCGC	GGCTAGTCCGTTATCAACTTGAAAAAGTGGCACCGAGTCGGTGCTTTTTT	28
GAAGACCCGC	GAAACACCGGTCGGCGGCAATATAGCAAGTTAACCTAAGGCTAGTCCGTT	24
GAAGACCCGC	GAAACACCGGTCGGCGGCAATCGTGGTTAGAGCTAGAAATAGCAAGTTAA	24
GAAGACCCGC	GAAACACCGGTCGGCGGCAACGTGGGGTTAGAGCTAGAAATAGCAAGTTA	23
GAAGACCCGC	GAAACACCGGTCGGCGGCAATAGAAATAGCAAGTTAACCTAAGGCTAGTC	21
GAAGACCCGC	GAAACACCGGTCGGGGGGTTAGAGCTAGAAATAGCAAGTTAACCTAAGGC	19
GAAGACCCGC	GAAACACCGGTCGGTTAACCTAAGGCTAGTCCGTTATCAACTTGAAAAAG	19
GAAGACCCGC	GAAACACCGGTCGTGGGGTTAGAGCTAGAAATAGCAAGTTAACCTAAGGC	18
GAAGACCCGC	GAAACACCGACCGGTTAAAACATAATTTAAGTTAACCTAAGGCTAGTCCG	17
GAAGACCCGC	GAAACACCGGTCGGCGGCAAATGGGGTTAGAGCTAGAAATAGCAAGTTAA	17
GAAGACCCGC	GAAACACCGGTCGGTGGGGTTAGAGCTAGAAATAGCAAGTTAACCTAAGG	17
GAAGACCCGC	GAAACACCGGTTAGCAAGTTAACCTAAGGCTAGTCCGTTATCAACTTGAA	17
GAAGACCCGC	GAAACACCGGTCGGCGGCAAAATGGGGTTAGAGCTAGAAATAGCAAGTTA	15
GAAGACCCGC	GAAACACCGGTCGGCGGCAATCGTTAGAGTTAGAGTGGGGTTAGAGCTAG	15
GAAGACCCGC	GAAACACCGGTCGGCGGCAATTAGTTAGAGCTAGAAATAGCAAGTTAACC	15
GAAGACCCGC	GAAACACCGGTCGGCGGCAAGTTAACCTAAGGCTAGTCCGTTATCAACTT	14
GAAGACCCGC	GAAACACCGGTCGGCGGCGAGCTAGAAATAGCAAGTTAACCTAAGGCTAG	14
GAAGACCCGC	GAAACACCGGTCGGCGGCAATCGTGGGGTTAGAGCTAGAAATAGCAAGTT	13
GAAGACCCGC	GAAACACCGGTCGGCGGCAATCTAGAAATAGCAAGTTAACCTAAGGCTAG	13
GAAGACCCGC	GAAACACCGGTCGGCGGCTCGGTGGGGTTAGAGCTAGAAATAGCAAGTTA	13
GAAGACCCGC	GAAACACCGGTCGGCGGCAATCGCCGCCGGTGGGGTTAGAGCTAGAAATA	12
GAAGACCCGC	GAAACACCGGTCGGTAGAGCTAGAAATAGCAAGTTAACCTAAGGCTAGTC	12
GAAGACCCGC	GAAACACCGGTCGGCGGCAATCGTGGGGCTAGAAATAGCAAGTTAACCTA	11
GAAGACCCGC	GAAACACCGGTCGGCGGCTGGGGTTAGAGCTAGAAATAGCAAGTTAACCT	11
GAAGACCCGC	GAAACACCGGTCGGCGGTCTAGAAATAGCAAGTTAACCTAAGGCTAGTCC	11
GAAGACCCGC	GAAACACCGGTGGGTTAGAGCTAGAAATAGCAAGTTAACCTAAGGCTAGT	11
GAAGACCCGC	GAAACACGATTGCCGCCGACCGGTGTTTAAAACTGCAAACTTTTTTTTTT	11
GAAGACCCGC	GAAACACCGGTCGGCGGGGTGGGGTTAGAGCTAGAAATAGCAAGTTAACC	10
GAAGACCCGC	GAAACACGAGCAAGTTAACCTAAGGCTAGTCCGTTATCAACTTGAAAAAG	10
GAAGACCCGC	GAAACACCGGTCGGCGGGTGGGGTTAGAGCTAGAAATAGCAAGTTAACCT	9
GAAGACCCGC	GAAACACCGGGTGGGGTTAGAGCTAGAAATAGCAAGTTAACCTAAGGCTA	8
GAAGACCCGC	GAAACACCGGTCGGCGGAAGTTAACCTAAGGCTAGTCCGTTATCAACTTG	8
GAAGACCCGC	GAAACACCGGTCGGCGGCAATCGTGGGTTTAGATCGTGGGGTTAGATCGT	8
GAAGACCCGC	GAAACACCGGTCGGCGGCAATCGTTAGAGCTAGAAATAGCAAGTTAACCT	8
GAAGACCCGC	GAAACACCGGTCGGCGGCAGGGGTTAGAGCTAGAAATAGCAAGTTAACCT	8
GAAGACCCGC	GAATAGCAAGTTAACCTAAGGCTAGTCCGTTATCAACTTGAAAAAGTGGC	8
GAAGACCCGC	GAAACACCGGTCGGCGGCAATCCTGCAGGGCGGGTCTTCGAATTCGGGCC	7
GAAGACCCGC	GAAACACCGGTCGGCGGCAATCGTTAAAATAGAAATAGCAAGTTAACCTA	7
GAAGACCCGC	GAAACACCGGTCGGCGGCATGGGGTTAGAGCTAGAAATAGCAAGTTAACC	7
GAAGACCCGC	GAAACACCGGTCGGCGGCAACGTGGGTTAGAGCTAGAAATAGCAAGTTAA	6
GAAGACCCGC	GAAACACCGGTCGGGGTTAGAGCTAGAAATAGCAAGTTAACCTAAGGCTA	6
GAAGACCCGC	GAAACACCGGTCGGCGGCAATCGTGCGCCTAGCGCACCTAGCGGGGGGTG	5
GAAGACCCGC	GAAACACCGGTCGGCGGCAATCGTGGGGGGTGGGGTTAGAGCTAGAAATA	5
GAAGACCCGC	GAAACACCGGTCGGCGGCGTGAGGTTAGAGCTAGAAATAGCAAGTTAACC	5
GAAGACCCGC	GAAACACCGGTCGGCGGCGTGGGGTTAGAGCTAGAAATAGCAAGTTAACC	5
GAAGACCCGC	GAAACACCGGTCGGCGGCAATCGTGGAGCTAGAAATAGCAAGTTAACCTA	4
GAAGACCCGC	GAAACACCGGTCGGCGGCAATCGTGGGGGTGGGGTTAGAGCTAGAAATAG	4
GAAGACCCGC	GAAACACCGGTCGGCGGCAATCGTGGGGTTAGATTAGATTAATCGTGGGG	4
GAAGACCCGC	GAAACACCGGTCGGCGGCAATCGTGTGGGTGGGGTTAGAGCTAGAAATAG	4
GAAGACCCGC	GAAACACCGGTCGGCGGCAATGGGTTAGAGCTAGAAATAGCAAGTTAACC	4
GAAGACCCGC	GAAACACCGGTGCATTCGAAAGTCCGGTCGTAGTGTGGACGTGGGGTTAG	4
GAAGACCCGC	GCCGTTATCAACTTGAAAAAGTGGCACCGAGTCGGTGCTTTTTTTCCTGC	4
GAAGACCCGC	GAAACACCCTAAGGCTAGTCCGTTATCAACTTGAAAAAGTGGCACCGAGT	3
GAAGACCCGC	GAAACACCGGTCGGCGGCAATCGTGTGTGTGTGTGGGGTTAGAGCTAGAA	3
GAAGACCCGC	GAAACACCGGTGCTAGAAATAGCAAGTTAACCTAAGGCTAGTCCGTTATC	3
GAAGACCCGC	GAAACACCGGTCGGCGACAATCGTGCGCCTAGCGCACCTAGCGGGGGGTG	2
GAAGACCCGC	GAAACACCGGTCGGCGGCAATCGTGGTTAGAGCTAGGGGTTAGAGCTAGA	2
GAAGACCCGC	GAAACACCGGTCGGCGGCAATCGTGTGGGTGGGGTTAGAGCTAGAGATAG	2
GAAGACCCGC	GAAACACCGGTCGGCGGCAATCGTTTTTGTGGGGTTAGAGCTAGAAATAG	2
GAAGACCCGC	GAAACACCGGTGTGGCTGAGAGTCCGGCAATGGTGTGGCTGTGGGGTTAG	2
GAAGACCCGC	GAAACACCGGTTCCCGTCCAGTGGGGTTAGAGCTAGAAATAGCAAGTTAA	2
GAAGACCCGC	CAAAACACCGGTCGGCGGCAATCGTTAGAGTTAGAGTGGGGTTAGAGCTA	1
GAAGACCCGC	CAAAACACCGGTGTGGCTGAGAGTTAACCTAAGGCTAGTCCGTTATCAAC	1
GAAGACCCGC	CAGAACTCGGAACTTCACCTATCGTTGGTGGGTTTACAGCTTGAAATAGC	1
GAAGACCCGC	CTAAATACCGGTTCCCGTCCAGTGGGGTTAGAGCTAGAAATAGCAAGTTA	1
GAAGACCCGC	GAAAAACCGGTGTAATCCAAAGCTATTAACATCATGAGATGTGGGGATAA	1
GAAGACCCGC	GAAACACCCTAAGGCTAGTCCGTTATCAACTTGAAAAAGCGGCACCGAGT	1
GAAGACCCGC	GAAACACCGGTAGGCGACAATTGTGTTAGAGCTAGGAATAACAAATAAAC	1
GAAGACCCGC	GAAACACCGGTCCATTCGAAAGTCCGGTCGTAGTGTGGACGGGGGGATAG	1
GAAGACCCGC	GAAACACCGGTCGGCGGCAATCGCGGGGGTGGTTATAGCTAGATATAGTA	1
GAAGACCCGC	GAAACACCGGTCGGCGGCAATCGTGGGGGGGGGTAAGAGTAAGAATTACC	1
GAAGACCCGC	GAAACACCGGTCGGCGGCAATCGTGGGTGGGTTAGAGCTAGAAATAGCAA	1
GAAGACCCGC	GAAACACCGGTCGGCGGCAATCGTGGTGGGGTTAGAGCTAGAAATAGCAA	1
GAAGACCCGC	GAAACACCGGTCGGCGGCATCGTGGGTGGGGTTAGAGCTAGAAATAGCAA	1
GAAGACCCGC	GAAACACCGGTCGGCGGCCACCGTTTTGTGTGGTTAGAGCTAGAAATAGC	1
GAAGACCCGC	GAAACACCGGTCGGCGGCGATCGTGGGTGGGGTTAGAGCTAGAATAGCAA	1
GAAGACCCGC	GAAACACCGGTCGGCGGGGGTATAGGTCGAAATAGCGAGTTAAGCTAAGG	1
GAAGACCCGC	GAAACACCGGTGCATTCGAAAGTCCGGTCGGAGTGTGGACGTGGGGTTAG	1
GAAGACCCGC	GAAACACCGGTGCATTCGAAAGTCCGGTCGTAGTGTGGACGTGGGTTAGA	1
GAAGACCCGC	GAAACACCGGTGCCCTTACTCTCACCTGATTACTTAATCCGTGGGGTTAG	1
GAAGACCCGC	GAAACACCGGTGCTAGAAATAGCAAGTAAACCTAAGGCTAGTCCGTTATC	1
GAAGACCCGC	GAAACACCGGTGGGGGTCGGGCTAGAACTAGAAATAGCAACTTAACCTAG	1
GAAGACCCGC	GAAACACCGGTTACATTGAGGGGTTAGAGCTAGAAATAGCAAGTTAACCT	1
GAAGACCCGC	GAAACACCGGTTACATTGAGGGTTAGAGCTAGAAATAGCAAGTTAACCTA	1
GAAGACCCGC	GAAACACCGGTTTGAACTAGAAATAGCAAGTTAACCTAAGGCTAGTCCGT	1
GAAGACCCGC	GAAACACGATTGCCGCCGACCGGTGTTTAAAACTGCAAACTACCCAAGGG	1
GAAGACCCGC	GAAGCACCGGTCGGCGGCAATCGTGGGGGTGGGGTTAGAGCTAGAAATAG	1
GAAGACCCGC	GAATCACCGGTCGGCGGCAATCGTGTGGGTGGGGTTAGAGCTAGAGATAG	1
GAAGACCCGC	GCCGTTATCAACCTGAAAAAGTGGCACCGAGTCGGTGCTTTTTTTCCTGC	1
GAAGACCCGC	GCCGTTATCAACTTGAAAAAGTGGCACCGAGTCGGTGCTTTTTTTCTGCA	1
GAAGACGCTA	GAAACACCGGTCGGCGGCAATCGTGGGTGGGGTTAGAGCTAGAAATAGCA	1
GAAGATCAAC	GAAACACCGGTCGGCGGCCGGCTAGAGCTAGAAATAGCAAGTTAACATAA	1
GAAGGCATGA	GAAACACCGGTCGGCGGCAATCGTGGGTGGGGTTAGAGCTAGAAATAGCA	1
GAAGGCCAAC	GAAACACCGGTCGGCGGCAAAATGGGGTTAGAGCTAGAAATAGCAAGTTA	1
GAATAAGACA	GAAACACCGGTAGCAAGTGCGAGACGTGTTTGTGGGGTTAGAGCTAGAAA	1
GAATAATAGG	GGCAAGTTAACCTAAGGCTAGTCCGTTATCAACTTGAAAAAGTGGCACCG	1
GAATACCCTG	GAAACACCGGTCGGCGGCAATCGTGGGTGGGGTTAGAGCTAGAAATAGCA	1
GAATAGTCGT	GAAACACCGGTGTACGTATGGACTGAACCAGGGTGTGCAAGTGGGGTTAG	1
GAATCGTCGT	GAAACACCGGTGTACGTATGGACTGAACCAGGGTGTGCAAGTGGGGTTAG	2
GAATGCTTAG	GAAACACCGGTTTACGTTGCATCGGGGTTAGAGCTAGAAATAGCAAGTTA	1
GAATGCTTAG	GAAACACCGGTTTACGTTGCATCGGTTAGTGGGGTTAGAGCTAGAAATAG	1
GAATGTGTAA	GAAACACCGGTAACTATATTCATGCGATATCGCCGTATCAGTGGGGTTAG	1
GAATTAGGTA	GAAACACCGGTCGATTGATATCGAAACCTTCCCGTGACAGTGGGGTTAGA	1
GACAAAGAAC	GAAACACCGGTAGCAAGTGCGGGGTTAGAGCTAGAAATAGCAAGTTAACC	1
GACAAAGAAC	GAAACACCGGTAGCAAGTGCGAGCAAGTTAACCTAAGGCTAGTCCGTTAT	1
GACAAAGTAC	GAAACACCGGTAGCAAGTGCGGGGTTAGAGCTAGAAATAGCAAGTTAACC	1
GACAACAACC	GAAACACCGGTTTGAACTACCTAGTTCAAACCGGTGGGGTTAGAGCTAGA	1
GACACAAGAT	GTCGAATTCGGGCCCATTGGTATGGCAGATCGGAAGAGCACACGTCTGAA	6
GACACAGACA	GAAACACCGGTAGCAAGTGCGAGACGTGTTTGTGGGGTTAGAGCTAGAAA	552
GACACAGACA	GAAACACCGGTAGCAAGTGCGGGGTTAGAGCTAGAAATAGCAAGTTAACC	297
GACACAGACA	GAAACACCGGTAGCAAGTGCGAGACGTGTTAAATAGCAAGTTAACCTAAG	188
GACACAGACA	GAAACACCGGTAGCAAGTGGGGTTAGAGCTAGAAATAGCAAGTTAACCTA	118
GACACAGACA	GAAACACCGGTGGGGTTAGAGCTAGAAATAGCAAGTTAACCTAAGGCTAG	101
GACACAGACA	GAAACACCGGTAGCAAGTGCGAGACGTGTTTTTGTGGGGTTAGAGCTAGA	62
GACACAGACA	GAAACACCGGTAGCAAGTGCGAGAGAAATAGCAAGTTAACCTAAGGCTAG	28
GACACAGACA	GAAACACCGGTACAAGGGGTTAGAGCTAGAAATAGCAAGTTAACCTAAGG	24
GACACAGACA	GAAACACCGGTAGCAAGTGCGAGCTAGAAATAGCTAGAAATAGCAAGTTA	24
GACACAGACA	GAAACACCGGTAGCAAGTGCGAGACGTGGGGTTAGAGCTAGAAATAGCAA	23
GACACAGACA	GAAACACCGGTAGCAAGTGCGAAAAAGTGGGGTTAGAGCTAGAAATAGCA	22
GACACAGACA	GAAACACCGGTAGCAAGTTAACCTAAGGCTAGTCCGTTATCAACTTGAAA	21
GACACAGACA	GAACACCGGTAGCAAGTGCGAGACGTTTTTGTGGGGTTAGAGCTAGAAAT	17
GACACAGACA	GAAACACCGGTAGCAAGTGCGAGCTAGAAATAGCAAGTTAACCTAAGGCT	16
GACACAGACA	GAAACACCGGTAGCAAGTGCGTTTTGGTGGGGTTAGAGCTAGAAATAGCA	16
GACACAGACA	GAAACACCGGTAGAGTGGGGTTAGAGCTAGAAATAGCAAGTTAACCTAAG	14
GACACAGACA	GAAACACCGGTAGCAAAGTGGGGTTAGAGCTAGAAATAGCAAGTTAACCT	14
GACACAGACA	GAAACGTTAACCTAAAGCTAGTCCGTTATCAACTTGAAAAAGTGGCACCG	13
GACACAGACA	GAAACACCGGTAGAAGTGGGGTTAGAGCTAGAAATAGCAAGTTAACCTAA	12
GACACAGACA	GAAACACCGTGGGGTTAGAGCTAGAAATAGCAAGTTAACCTAAGGCTAGT	11
GACACAGACA	GAAACACCGGTAGCAAGTGCGAGACGTGTGTGGGGTTAGAGCTAGAAATA	10
GACACAGACA	GAAACACCGGTAGCAAGTGCGAGACGTGTTCCTTGTGGGGTTAGAGCTAG	10
GACACAGACA	GAAACACCGGTAGCAAGTGCGAGCAAGTTAACCTAAGGCTAGTCCGTTAT	10
GACACAGACA	GAAACACCGGTAGCAAGTGCGAGCAAGTTAGAGCTAGAAATAGCAAGTTA	10
GACACAGACA	GAAACACCGGTAGCAAGTGCGAGCAAGTTGTGGGGTTAGAGCTAGAAATA	10
GACACAGACA	GAAACACCGGTAGCAAGTGCGTTTTTTGTGGGGTTAGAGCTAGAAATAGC	10
GACACAGACA	GAAACACCGGTAGGATGGGGTTAGAGCTAGAAATAGCAAGTTAACCTAAG	10
GACACAGACA	GAAACACCGGTAGCAAGTGCGAGCAAGAGCTAGAAATAGCAAGTTAACCT	9
GACACAGACA	GAAACACCGGTAGCAAGTGCGAGCAAGTTAGTTAGTGGGGTTAGAGCTAG	9
GACACAGACA	GAAACACCGGTAGCAAGTGCGTTAGAGCTAGAAATAGCAAGTTAACCTAA	9
GACACAGACA	GAAACACCGGTAGCAAGTGCGAGCATTTTGTGGGGTTAGAGCTAGAAATA	8
GACACAGACA	GAAACACCGGTAGCAAGTGCGTGGGGTTAGAGCTAGAAATAGCAAGTTAA	8
GACACAGACA	GAAACACCGGTAGCAAGTGTGGGTTAGAGCTAGAAATAGCAAGTTAACCT	8
GACACAGACA	GAAACGTTAACCTAAGGCTAGTCCGTTATCAACTTGAAAAAGTGGCACCG	8
GACACAGACA	GAAACACCGGTAGCAAGTGCGAGACGTTGTGGGGTTAGAGCTAGAAATAG	7
GACACAGACA	GAAACACCGGTAGCAAGTGCGAGAGCTAGAAATAGCAAGTTAACCTAAGG	7
GACACAGACA	GAAACACCGGTAGCAAGTGCGAGCTAGAAATAGCAAGTTAACCTAAGGGG	7
GACACAGACA	GAAACACCGGTAGCACTTTGTGGGGTTAGAGCTAGAAATAGCAAGTTAAC	7
GACACAGACA	GAAACACCGGTAGCAAGTGCGAGCAACTAGAAATAGCAAGTTAACCTAAG	6
GACACAGACA	GAAACACCGGTAGCAAGTGCGAGCAAAAAAGTGGGGTTAGAGCTAGAAAT	5
GACACAGACA	GGAACACCGGTAGCAAGTGCGAGCAAGTTTTTTGTGGGGTTAGAGCTAGA	5
GACACAGACA	GAAACACCGGTAGCAAGTGCGAGACTTGCTACCGGTGTTTCGTCCGGTGG	4
GACACAGACA	GAAACACCGGTAGCGAGTGCGAGCAAGTTTTGTGGGGTTAGAGCTAGAAA	4
GACACAGACA	GAAACACCGGTAAATTTGAGGCTCCGGCATGCAGGAGGCCGTGGGGTTAG	3
GACACAGACA	GAAACACCGGTAGCAAGTGCGAGACGTGTTTCGTCTCGCACTTGCTACGT	3
GACACAGACA	GAAACACCGGTAGCAAGTGCGAGACGTTAGGTTAGGGTTAGAGCTAGAAA	3
GACACAGACA	GAAACACCGGTAGCAAGTGCGAGCAAAAGTGGGGTTAGAGCTAGAAATAG	3
GACACAGACA	GAAACACCGGTAGCAAGTGCGAGATGTGTTTCGTCTCGCACTTGCTACGT	2
GACACAGACA	CAAAACACCGGTAGCAAGTGCGAGACGTGTTAGAGCTAGAAATAGCAAGT	1
GACACAGACA	CAAAACACCGGTAGCAAGTGCGAGACGTGTTTGTGGGGTTAGAGCTAGAA	1
GACACAGACA	CAAAACACCGGTAGCAAGTGCGGGGTTAGGGCTAGAAATAGCAAGTCAAC	1
GACACAGACA	CAAAACACCGGTGGGGTTAGAGCTAGAAATAGCAAGTTAACCTAAGGCTA	1
GACACAGACA	CAAAGCACCGGTAGCAAGTGGGGTTAGAGCTAGAAATAGCAAGTTAACCT	1
GACACAGACA	GAAACACCGGTAGCAAGCGCGAGACGTGTTTCGTCTCGCACTTGCTACGT	1
GACACAGACA	GAAACACCGGTAGCAAGTACGAGACGTGTTTCGTCCCGCACTTGCTACGT	1
GACACAGACA	GAAACACCGGTAGCAAGTGCGAGACGTGTTAGAGCTAGAAACAGCAAGTT	1
GACACAGACA	GAAACACCGGTAGCAAGTGCGAGACGTGTTAGAGCTAGAAATAGCAAGTT	1
GACACAGACA	GAAACACCGGTAGCAAGTGCGAGACGTGTTTCGTCTCGCACTTGCTATGT	1
GACACAGACA	GAAACACCGGTAGCAAGTGCGAGACGTTAGATTAGGGTTAGAGCTAGAAA	1
GACACAGACA	GAAACACCGGTAGCAAGTGCGAGACTTGCCACCGGTGTTTCGTCCGGTGG	1
GACACAGACA	GAAACACCGGTAGCATGTGCGCGCTTAGATCTAGAAATAGCAAGGTATCC	1
GACACAGACA	GAAACACCGGTAGCTAGTGCGAGACGTGTTTCGTCTCGCACTTGCTACGT	1
GACACAGACA	GAAACACCGGTATCAAGAGCTGCGTTAGAGGTAGAGATAGCAAGATAACC	1
GACACAGACA	GAAACACCGGTCGGCGGCCGGTTAGAGCTAGAAATAGCAAGTTAACCTAA	1
GACACAGACA	GAAACACCGGTCGGCGGCGGTGGGGTTAGAGCTAGAAATAGCAAGTTAAC	1
GACACAGACA	GAAACACCGGTGCATTCGAAAGTCCGGTCGTAGTGTGGATGTGGGGTTAG	1
GACACAGACA	GAAACACCGGTGGCAATAGCGAGACATATTCCTAGTGGGGCTAGAGCTAG	1
GACACAGACA	GAAACACCGGTGGGGTTAGAGCTAGCATTAGCAAAGTAATCGAAGGCCAG	1
GACACAGACA	GAAACACCGGTGTACGTATGGACTGAACCAGGGTGTGCAAGTGGGGTTAG	1
GACACAGACA	GAAACACCGGTTAAGCCGAGTGGGGTTAGAGCTAGAAATAGCAAGTTAAC	1
GACACAGACA	GAAACACCGGTTATATTTGTAAGTGTGTGGGGTTAGAGCTAGAAATAGCA	1
GACACAGACA	GAAACACCGGTTTGAACCGGTGGGGTTAGAGCTAGAAATAGCAAGTTCAC	1
GACACAGACA	GAAACACCGGTTTGAACTAGAAATAGCAAGTTAACCTAAGGCTAGTCCGT	1
GACACAGACA	GAAACACCGTGGATTAGAGCTAGAAATAGCAAGTTAACCTAAGGCTAGTC	1
GACACAGACA	GAAACGCCGGTAGCAAGTGCGAGACGTGTTTCGTCCCGCACTTGCTACGT	1
GACACAGACA	GAACACCGGTAGCAAGTGCGAGCAAGTTTTTTGTGGGGTTAGAGCTAGAA	1
GACACAGACA	GAACCCCCGGTAAATTTAAGGCTCCGGCATGCAGCAGGCCGTGGGGTTAG	1
GACACAGACA	GAAGCACCGGTAGCAAGTGCGAGACGTGTTAGAGCTAGAAATAGCAAGTT	1
GACACAGACA	GAATCACCGGTAGCAAGTGCGAGACGTTAGGTTAGGGTTAGAGCTAGAAA	1
GACACAGACA	GCTAGAAATAGCAAGTTAACCTAAGGCTAGTCCGTTATCAACTTGAAAAA	1
GACACATAAC	GAAACACCGGTAGGAAGTGCGAGCGAGTTAACATAAGGCTAGAACGTTAT	1
GACACCAACC	GAAACACCGGTAGCAAGTGCGAGACGTGTTTGTGGGGTTAGAGCTAGAAA	1
GACACCGTAA	GAAACACCGGTAGCAAGAGTGAGACGTGTTTGTGGGGTTAGAGGTAGAAA	1
GACACGGATC	GAAACACCGGTAGCAAGTGGGGTTAGAGCTAGAAATAGCAAGTTAACCTA	1
GACACTGTGA	GAAACACCGGTAGCAAGTGCGAGACGTTTTTGTGGGGTTAGAGCTAGAAA	1
GACAGAGCAA	GAAACACCGGTAGCAAGTGCGAGAGAAATAGCAAGTTAACCTAAGGCTAG	1
GACAGAGTAA	GAAACACCGGTAGCAAGTGCGAGACGTGTTTGTGGGGTTAGAGCTAGAAA	1
GACAGCCGTC	GAAACACCGGTGTGGCTGAGAGTCCGGCAATGGTGTGGCTGTGGGGTTAG	1
GACAGCGATA	GAAACACCGGTAGCAAGTGCGAGACGTGTTTGTGGGGTTAGAGCTAGAAA	1
GACAGTGGTC	GAAACACCGGTGTCCGTATGGACTGAACCTGGGCGTGCAAGAGGGGTTAA	1
GACATACCGC	GAAACACCGGTCTGGGCGACTCAGTGGTAGTGTTGTAGCTAGAGGGAGCA	1
GACATAGATT	GAAACACCGGTAGCAAAGTGGGGTTAGAGCTAGAAATAGCAAGTTAACCT	1
GACATAGCTC	GAAACACCGGTTTGAACTAGAAATAGCAAGTTAACCTAAGGCTAGTCCGT	1
GACATCCCGC	GAAACACCGGTGGGGTTAGAGCTAGAAATAGCAAGTTAACCTAAGGCTAG	1
GACATCGACT	GAAACACCGGTAGCAAGTGCGGGGTTAGAGCTAGAAATAGCAAGTTAACC	1
GACCACTCCC	GAAACACCGGTTTGAGCTAGAAATAGCAAGTTAACCTAAGGCTAGTCCGT	1
GACCCCGAAA	GAAACACCGGTAGCAAGTGCGAGACGTGTTTGTGGGGTTAGAGCTAGAAA	1
GACCGTCGCC	GAAACACCGGTGTACGTATGGACTGAACCAGGGTGTGCAAGAGGGGTTAG	1
GACCTAGACC	GAAACACCGGTAGCAAGTGTGAGACGTGTTTGTGGGGTTAGAGCTAGAAA	1
GACCTCGACC	GAAACACCGGTAAATTTGAGGCTCCGGCATGCAGGAGGCCGTGGGGTTAG	1
GACCTTCGGT	GAAACACCGGTCGATTCATATCGAAACCTTTCCGTGACAGTGGGGTTAGA	1
GACGAAACGC	GAAACACCGGTCGGCGGCAATCGTGGGTGGGGTTAGAGCTAGAAATAGCA	1
GACGAACGGC	GAAACACCGGTCGGCGGCAATCGTGGGTGGGGTTAGAGCTAGAAATAGCA	1
GACGAATCCT	GAAACACCGGTCTCGAGTGAGGTGTTCAGGGTGGGGTTAGAGCTAGAAAT	1
GACGACCCAA	GAAACACCGGTCGGCGGCAATCGTGGGTGGGGTTAGAGCTAGAAATAGCA	1
GACGAGGCGA	GAAACACCGGTCGGCGGCAATCGTGGGTGGGGTTAGAGCTGGAAATAGCA	1
GACGAGGCTC	GAAACACCGGTTCCCGTCCAGTGGAGATAGAGCTAGAAATAGCAAGTTAA	1
GACGCACCGA	GAAACACCGGTCGGCGGCAATCGTGGGTGGGGTTAGAGCTAGAAATAGCA	1
GACGCAGCAA	GAAACACCGGTAGCACTTTGTGGGGTTAGAGCTAGAAATAGCAAGTTAAC	1
GACGTCGCGC	GAAACACCGGTCGGCGGCAATAGAAATAGCAAGTTAACCTAAGGCTAGTC	1
GACGTTATAC	GAAACACCGGTAACTATATTCCTGCGATATCGCCGTATCAGTGGTGTTAG	1
GACTACACGC	GAAACCCCGTTCGGCGGCAATCGTGGTTGGGGTTAGAGCTAGAAATAGCA	1
GACTATACCG	GAAACACCGGTCGGGGCCACTCAGTGGTGGGGTTAGAGCTAGAAATAGCA	1
GACTATGCCC	GAAACACGGGTTAGAGCTAGAAATAGCAAGTTAACCTTAGACCAGTCCGT	1
GACTCAGCTA	GAAACACCGGTAGCAAGTGCGAGACGTGTTTGTGGGGTTAGAGCTAGAAA	1
GACTTTACCG	GAAACACCGGTCGGGGCCACTCAGTGGTGGGGTTAGAGCTAGAAATAGCA	2
GAGAAAGCCC	GAAACACCGGTTTGAACTAGAAATAGCAAGTTAACCTAAGGCTAGTCCGT	1
GAGAACCGGC	GAAACACCGGTCGGCGGCAATTAGTTAGAGCTAGAAATAGCAAGTTAACC	1
GAGAACCTCG	GAAACACCGGTGCATTCGAAAGTCCGGTCGTAGTGTGGACGTGGGGTTAG	2
GAGAACGACA	GAAACACCGGTAGCAAGTGCGAGACGTGTTGGTGGGGTTAGAGCTAGAGA	1
GAGAAGACTA	GAAACACCGGTTCCCGTCCAGTGGGGTTAGAGCTAGAAATAGCAAGTTAA	1
GAGAAGACTC	GAAACACCGGTTCCCGTCCAGTGGGGTTAGAGCTAGAAATAGCAAGTTAA	1
GAGAAGCATC	GAAACACCGGTTCCCGTCCAGTGGGGTTAGTGCTAGAAATAGCAAGTTAA	1
GAGAAGCTCG	GAAACACCGGTGCATTCGAAAGTCCGGTCGTAGTGTGGACGTGGGGTTAG	1
GAGAAGGACA	GAAACACCGGTTCCCGTCCAGTGGGTTAGAGCTAGAAATAGCAAGTTAAC	1
GAGAAGGCTC	GAAACACCGGTTCCCGTCCAGTGGGGTTAGAGCTAGAAATAGCAAGTTAA	1
GAGAATCCTT	GAAACACCGGTCTCGAGTGAGGTGTTCAGGGTGGGGTTAGAGCTAGAAAT	1
GAGACACAGA	GAAACACCGGTGGGGTTAGAGCTAGAAATAGCAAGTTAACCTAAGGCTAG	1
GAGACACTCG	GAAACACCGGTGCATTCGAAAGTCCGGTCGTAGTGTGGACGTGGGGTTAG	2
GAGACAGAAC	GAAACACCGGTAGCAAGTGCGGGGTTAGAGCTAGAAATAGCAAGTTAACC	1
GAGACAGCAA	GAAACACCGGTAGCAAGTGCGAGACGTGTTTGTGGGGTTAGAGCTAGAAA	1
GAGACAGCGA	GAAAAACCGGTAGCACGTGCGTGGGGTTAGAGCTAGAAATAGCAAGATAA	1
GAGACGCTCG	GAAACACCGGTGCATTCGAAAGTCCGGTCGTAGTGTGGACGTGGGGTTAG	2
GAGACGCTCG	GAAACATCGGTGCATTCGAAAGTCCGGTCGTAGTGTGGACGTGGGGTTAG	1
GAGACGGCCT	GAAACACCGGTCCGTAGGAGACCCGTGTGGCATGTACCTGTGGGGTTAGA	1
GAGACGGGCC	GAAACACCGGTAGCAAGTGCGAGACGTGTTTGTGGGGTTAGAGCTAGAAC	1
GAGACTGCAG	GAAACACCGGTCCGTAGGAGACCCGTGTGGCATGTACCTGTGGGGTTAGA	1
GAGATCCGCG	GAAACACCGGTGCATTCGAAAGTCCGGTCGTAGTGTGGACGTGGGGTTGG	1
GAGCAACCGC	GAAACACCGGTCGGCGGCAATCGTGGTATGAGCCACGTGGGGTTAGATCG	1
GAGCAAGAAA	GAAACACCGGTAGCAAGTGCGAGCATTTTGTGGGGTTAGAGCTAGAAATA	1
GAGCACCGCC	GAAACACCGGTCGGCGGCAAATGGGGTTAGAGGGAGAAAGAGCAAGTTAA	1
GAGCACTCCC	GAAACACCGGTTTGAACCGGTGGGGTTAGAGCTAGAAATAGCAAGTTAAC	1
GAGCAGCCCC	GAAACACCGGTTCCCGTCCAGTGGGGTTAGAGCTAGAAATAGCAAGTTAA	1
GAGCCAGCCA	GAAACACCGGTAGCAAGTGCGAGACGTGTTTGTGGGGTTAGAGCTAGAAA	1
GAGCCTCGCC	GAAACACCGGTCGGCGGCAATCGTGGGGCTAGAAGTAGCAAGTTAACCTA	1
GAGCGCATAA	GAAACACCGGTTAAGCCGAGGAGTTAGAGCTAGAAATTACAAGTTGACAT	1
GAGCGGTGTA	GAAACACCGGTGCCCTTACTCTCACCTGATTACTTAATCCGTGGGGTTAG	1
GAGGAACCCA	GAAACACCGGTTCCCGTCCAGTGGGGTTAGAGCTAGAAATAGCAAGTTAA	1
GAGGAACGGA	GAAACACCGGTCGGCGGCAATCGTGGGTGGGGTTAGAGCTAGAAATAGCA	1
GAGGAACGGC	GAAACACCGGTCGGCGGCAATCGTGGGTGGGGTTAGAGCTAGAAATAGCA	1
GAGGACGAGA	GAAACACCGGTGGGTTAGAGCTAGAAATAGCAAGTTAACCTAAGGCTAGT	1
GAGGACGCCC	GAAACACCGGTTTGAACTAGAAATAGCAAGTTAACCTAAGGCTAGTCCGT	1
GAGGACGCGA	GAAACACCGGTCGGCGGCAATCGTGGGGTGGGGTTAGAGCTAGAAATAGC	1
GAGGAGAATC	GAAACACCGGTTCCCGTCCAGTGGGGTTAGAGCTAGAAATAGCAAGTTAA	1
GAGGAGACTG	GAAACACCGGTTCCCGTCCAGTGGGGTTAGAGCTAGAAATAGCACGTTAA	1
GAGGAGGATA	GAAACGCCGGTTCCCGTCCAGTGGGGTTAGAGCTAGAAATAGCAAGATAA	1
GAGGATACGT	GAAACACCGGTCGGCGGCGGTGGGGTTAGAGCTAGAAATAGCAAGTTAAC	1
GAGGCCCCAC	GAAACACCGGTGCCCTTACTCTCACCTGATTACTTAATCCGTGGGGTTAG	1
GAGGCCCCTC	GAAACACCGGTCGGCGGCAATCGTGGGGTGGGGTTAGAGCTAGAAATAGC	1
GAGGCCGTCG	GAAACACCGGTGCATTCGAAAGTCCGGTCGTAGTGTGGCCGTGGGGTTAG	1
GAGGCGTAGA	GAAACACCGGTTTACGTTGCATCGGTTGTGGGGTTAGAGCTAGAAATAGC	1
GAGGGCACGC	GAAACACCGGTCGGCGGCGAGCTAGAAATAGCAGGTTAACCTAAGGCTAG	1
GAGGTGACTC	GAAACACCGGTTCCCGTTCAGTGGGGTTAGAGCTAGAAATAGCAAGTTAA	1
GAGTACTCGG	GAAACACCGGTACCTTTGTTGATGCTGGGTGGAAGGAATGTGGGGTTAGA	1
GAGTATCCTC	GAAACACCGGTTCCCGTCCAGTGGGGTTAGAGCTAGAAATAGCAAGTTAA	1
GAGTCAGCCT	GAAACACCGGTCCGTAGGAGACCCGTGTGGCATGTACCTGTGGGGTTAGA	1
GAGTCGGCCT	GAAACACCGGTCCGTAGGAGACCCGTGTGGCATGTACCTGTGGGGTTAGA	1
GAGTCGGCTA	GAAACACCGGTTCCCGTCCAGCGGGGTTAGTGCTAGAAATAGCAAGTTAA	1
GAGTCGGGTA	GAAACACCGGTTCCCGTACAGTGGGGTTAGAGCTAGAAATAGCAAGTTAA	1
GAGTGGAGCC	GAAACACCGGTTCCCGTCCAGTGGGGTTAGAGCTAGAAATAGCAAGTTAA	1
GAGTGGAGGC	GAAACACCGGTTCCCGTCCAGTGGTGGTGGAGCTAGAAATAGCAAGTTAA	1
GAGTGTTGTC	GAAACACCGGTGACATTGGGTACAAAATAGCAAGTTAACCTAAGGCTAGT	1
GAGTTCTGCC	GAAACACCGGTACCTTTGTTGATGCTGGGTGGGGTTAGAGCTAGAAATAG	1
GATAAACCGG	GAAACACCGGTCGGCGGCTCGGTGGGGTTAGAGCTAGAAATAGCAAGTTA	1
GATACCCCTG	GAAACACCGGTAAATTTGAGGCTCCGGCATGCAGGAGGCCGTGGGGTTAG	1
GATACGCGGC	GAAACACCGGTACCTTTGTGGGGTTAGAGCTAGAAATAGCAAGTTAACCT	1
GATAGAGTGG	GAAACACCGGTTATATTTGTAAGTGTTGTGGGGTTAGAGCTAGAAATAGC	1
GATAGCCATT	GAAACACCGGTGCCCTTACTCTCACCTGATTACTTAATCCGTGGGGATAG	1
GATAGCGGCC	GAAACACCGGTGTGGCTGAGAGTCCGGCAATGGTGTGGCTGAGGGGTTAG	1
GATAGGACTC	GAAACACCGGTCCGTAGGAGACCCGTGTGGCATGTACCTGTGGGGTTAGA	1
GATAGTCGTA	GAAACACCGGTGTACGTATGGACTGAACCAGGGTGTGCAAGTGGGGTTAG	1
GATCGTTGTA	GAAACACCGGTGTACGTATGGACTGAACCAGGGTGTGCAAGTGGGGTTAG	1
GATGAACCGA	GAAACACCGGTCGGCGGCAATCGTGGGTGGGGTTAGAGCTAGAAATAGCA	1
GATGACGCTC	GAAACACCGGTTCTCGTCCAGTGGGGTTAGAGCTAGCAATAGCAAGTTAA	1
GATGATCCTC	GAAACACCGGTTCCCGTCCAGTGGGGTTAGAGCTAGAAATAGCAAGTTAA	1
GATGATCTGC	GAAACACCGGTCGGCGGGGGTAGAGCTAGAAATAGCAAGTTAACCTAAGG	1
GATGATTAGG	GAAACACCGGTTTAAGTTAGAGATAGGAATGGCTAGTTCAAGTAAGACTA	1
GATGATTCTC	GAAACACCGGTTTACGTTGCATCGGTTGTGGGGTTAGAGCTAGAAATAGC	1
GATGCCACGC	GAAACACCGGTCGGCGGCCGATTAGAGCTAGAAATAGCAAGTTAACCTAA	1
GATGCGATCG	GAAACACCGGTGCATTCGAAAGTCCGGTCGTAGTGTGGACGGGGGGTTAG	1
GATGCTCAGC	GAAACACCGGTTTACGTTGCATCGGTTAGAGCTAGAAATAGCAAGTTAAC	1
GATGCTGAGC	GAAACACCGGTTTACGTTGCATCGGTGTGGGGTTAGAGCTAGAAATAGCA	1
GATGGATAGC	GAAACACCGGTTTACGTTGCATCGGTGTGGGGTTAGAGCTAGAAATAGCA	1
GATGTACTAC	GAAACACCGGTGCCCTTACTCTCACCTGATTACTTAATCCGGGTGGTTAG	1
GATTACACGC	GAAACACCGGTCGGCGGCAATCGTGGTTAGAGCTAGAAATAGCAAGTTAA	1
GCAAAAGCCC	GAAACACCGGGTTGAACTACCTAGGGGGTAGTTCAAACCGGGGTTAGAGC	1
GCAAATCGTT	GAAACACCGGTCTCGAGTGAGGTGTTCAGGGTGGGGTTAGAGCTAGAAAT	1
GCAACCCGCC	GAAACACCGGTGTGGCTGAGAGTCCGGCAATGGTGTGGCTGTGGGGTTAG	1
GCAACGGATA	GAAACACCGGAGGGGTTAGAGCTAGAGATAGCAAGGTAACCTAAGGCTAG	1
GCACAAAGAA	GCTAGAAATAGCAAGTTAACCTAAGGCTAGTCCGTTATCAACTTGAAAAA	1
GCACAAAGCC	GAAACACAGGTTTGAACTACCTAGTTCAAACCGGTGGGGTTAGAGCTAGA	1
GCACAACGCA	GAAACACCGGTTTGAACTACCTAGTTCAAACACCGGTTTGAACTACCTAG	1
GCACAACGCA	GAAACACCGGTTTGAACTACCTAGTTCAAACCGGTGGGGTTAGAGCTAGA	1
GCACAAGGCC	GAAACACGGGTTAGAGCTAGAAATAGCAAGTTAACCTAAGGCTAGTCCGT	1
GCACACCGCC	GCTAGAAATAGCAAGTTAACCTAAGGCTAGTCCGTTATCAACTTGAAAAA	1
GCACAGACTT	GAAACACCGGTTCACGGCTAGATGTTGTAAATCTAGATAGAGCAAGAAAA	1
GCACCACGTC	GCTAGAAACAGCAAGTTAACCTAAGGCTAGTCCGTTATCAACTTGAAAAA	1
GCACGCACTA	GAAACACCGGTGCCCTTACTCTCACCTGATTACTTAATCCGTGGGGTTAG	1
GCACGCGCTA	GAAACACCGGTGCCCTTACTCTCACCCGATTACTTAATCCGTGGGGTTAG	1
GCACTTCCGC	GAAACACCGGTAACTATATTCATGAGATATCGCCGTATCAGTGGGGTTAG	1
GCACTTCTAC	GAAACACCGGTAACTATATTCATGCGATATCGCCGTATCAGTGGGGTTAG	1
GCAGAACAGC	GAAACACCGGTCGGCGGCAATCTAGGGTTAGAGCTAGAAATAGCAAGTTA	1
GCAGACCCTA	GAAACACCGGTCGGCGGCAATCGTGGGTGGGGTTAGAGCTAGAAATAGCA	1
GCAGAGGCGC	GAAACACCGGTCGGCGGCAATCGTGGGTGGGGTTAGAGCTAGAAATAGCA	1
GCAGCCAGTC	GAAACACCGGTCGGCGGCAATAGAGCAGGTTAACCTAAGGGTAGGCCGTT	1
GCAGCGTAGT	GAAACACCGGTGTACGTATGGACTGAACCAGGGTGTGCAAGTGGGTTAGA	1
GCAGGCCCGA	GAAACACCGGTCGGCGGCAATCGTGGGTGGGGTTAGAGCTAGAAATAGCA	1
GCAGTCGGTC	GAAACACCGGTCGATTCATATCGAAACCTTCCCTATGGGTATAGATCTCG	1
GCATAGTCGT	GAAACACCGGTGTACGTATGGACTGAACCAGGGTGTGCAAGTGGGGTTAG	1
GCATCGAAGT	GAAACACCGGTGTACGTATGGACTGAACCAGGGTGTGCAAGAGGGGTTAG	1
GCATCGTAGT	GAAACACCGGTGTACGTATGGACTGAACCAGGGCGTGCAAGTGGGGTTAG	1
GCATCGTCCT	GAAACACCGGTGTACGTATGGACTGAACCAGGGTGTGCAAGTGGGGTTAG	1
GCATTACAGC	GAAACACCGGTCGGGGCCACTCAGTGGTGGGGTTAGAGCTAGAAATAGCA	1
GCATTCGACA	GAAACACCGGTAGCAGGTGCGAGACGTGTTTGTGGGGGTAGAGCTAGAAA	1
GCATTCGGCA	GAAACACCGGTCGCTTCAGCGCGACGTCTTTGTGGGGCTAGAGCTAGAAA	1
GCCAACAGCC	GAAACACCGGTGTGGCTGAGAGTCCGGCAATGGTGTGGCTGTGGGGTTAG	1
GCCACCCTAT	GAAACACCGGTGCCCTTACTCTCACCTGATTACTTAATCCGTGGGGTTAG	1
GCCACCGACC	GAAACACCGGTGTGGCTGAGAGTCAGGCATTGGTGTAGCTGTGTGGCCTG	1
GCCACGTCGT	GAAACACCGGTGTACGTATGGACTGAACCAGGGTGTGCAAGTGGGGTTAG	1
GCCAGAGACC	GAAACACCGGTAGCAAGTGGGGTTAGAGCTAGAAATAGCAAGTTAACCTA	1
GCCAGCGGCA	GAAACACCGGTTGCCAGTGCGTTACGTGGTTCTTAGAGTAGAGCTGGTAG	1
GCCAGCTGCC	GAAACACCGGTAAATTTGAGGCTCCGGCATGCAGGAGGCCGTGGGGTTAG	1
GCCAGTGGCT	GAAACACCGGTTACCTTGGGAATAATAGCAAGTTAACCTAAGGCTAGTCC	1
GCCCACCTCC	GAAACACCGGTGTGGCTGCGTGTCCGGCAATGGGGGGGATGTGGGGATAG	1
GCCCGTCGAC	GAAACACCGGTAACTATATTCATGCGATATCGCTGTATCAGTGGGGTTAG	1
GCCGACACGC	GAAACACCGGTCGGCGGGGTGGGGTTAGAGCTAGAAATAGCAAGTTAACC	1
GCCGCAGCCC	GAAACACCGGTAGCAAGTGCGAGACGTGTTAAATAGCAATTTAACCTAAG	1
GCCGCCATAC	GAAACACCGGTGCCCTTACTCTCACCTGAGTACTTAATCCGTGGGGTTAG	1
GCCTATTGCG	GAAACACCGGTCGGGGCCACTCAGTGGGTGGGGTTAGAGCTAGAAATAGC	1
GCCTCACCGC	GAAACACCGGTGTGGCTGAGAGTCCGGCAATGGTGTGGCTGTTGGGATAG	1
GCCTCCGACA	GAAACACCGGTAAGTTACATTCCTCGGCAGGCATAGAGCTGTGGGTATAG	1
GCCTGACGGT	GAAACACCGGTCGGGGCCACACTGTGGTGGGGTTAGAGCTAGAAATAGCA	1
GCCTTGACCG	GAAACACCGGTCGGGGCCACTCAGTGGTGGGGTTAGAGCTAGAAATAGCA	1
GCCTTGAGCG	GAAACACCGGTCGGGGCCACTCAGTGGTGGGGTTAGAGCTAGAAATAGCA	1
GCCTTTAACG	GAAACACCGGTCGGGGCCACTCAGTGGTGGGGTTAGAGCTAGAAATAGCA	1
GCCTTTACAG	GAAACACCGGTCGGGGCCACTCGGTTAGAGCTAGAAATAGCAAGTTAACC	1
GCCTTTAGCT	GAAACACCGGTCGGGGCCACTCAGTGGTGGGGTTAGAGCTAGAAATAGCA	1
GCCTTTTGCG	GAAACACCGGTCGGGGCCACTCAGTGGTGGGGTTAGAGCTAGAAATAGCA	1
GCGAACCCTT	GAAACACCGGTCTCGAGTGAGGTGTTCAGGGTGGGGTTAGAGCTAGAAAT	1
GCGAAGCCTT	GAAACACCGGTCTCGAGTGAGGTGTTCAGGGTGGGGTTAGAGCTAGAAAT	1
GCGAAGCGTT	GAAACACCGGTCTCGAGTGAGGTGTTCAGGGTGGGGTTAGAGCTAGAAAT	1
GCGAAGGCTC	GAAACACCGGTTCCCGTCCAGTGGGGTCAGAGCTAGAAATAGCAAGTTAA	1
GCGAATCATT	GAAACACCGGTCTCGAGTGAGGTGTTCAGGGTGGGGTTAGAGCTAGAAAT	1
GCGAATCCTC	GAAACACCGGTTCCCTTCCAGTGGGGGTAGAGCTAGAGATAGCAAGATCA	1
GCGACCGAGA	GAAACACCGGTGTGGCTGAGAGTCCGGCAATGGTGTGGATGTGGGGTTAG	1
GCGACGCTCG	GAAACACCGGTGCATTCGAAAGTCCGGTCGTAGTGTGGACGTGGGGTTAG	1
GCGACGGGGG	GAAACACCGGTTATATTTGTAAGTGTGTGGGGTTAGAGCTAGAAATAGCA	1
GCGAGCCTAC	GAAACACCGGTTAAGCCGAGAGGGGTTAGAGCTAGAAATAGCAAGTTAAC	1
GCGAGTCCTT	GAAACACCGGTCTCGAGTGAGGTGTTCAGGGGTGGGGTTAGAGCTAGAAA	1
GCGATAGCGG	GAAACACCGGTTATATTTGTAAGTGTTTGTGGGGTTAGAGCTAGAAATAG	1
GCGATTTCTT	GAAACACCGGTCTCGAGTGAGGTGTTCAGGGTGGGGTTAGAGCTAGAAAT	1
GCGCATCCTT	GAAACACCGGTCTCGAGTGAGGTGTTCAGGGTGGGGTTAGGGCTAGAAAT	1
GCGCCTGGCT	GAAACACCGGTCCGTAGGAGACCCGTGTGGCATGTACCTGTGGGGATAGA	1
GCGCGTGGTC	GAAACACCGGTGTACGTATGGACTGAACCAGGGTGTGCAAGTGGGGTTAG	1
GCGGAACGTC	GAAACACCGGTTCCCGTACAGCGGGGTTAGAGGTAGTAATAGCAAGATAA	1
GCGGCCCCGC	GAAACACCGGTCGGCGGCTCGGTGGGGTTAGAGCTAGAAATAGCAAGTTA	1
GCGGGACCGC	GAAACACCGGTTCCCGTCCAGTGGGGTTAGAGCTAGAAATAGCAAGTTAA	1
GCGTCTGCCT	GAAACACCGGTCCGTAGGAGACCCGTGTGGCATGTACCTGCGGGGTTAGA	1
GCGTGGTGTC	GAAACACCGGTGACATTGGGTACAGGGTTAGAGCTAGAAATAGCAAGTTA	1
GCGTGGTGTC	GAAACACCGGTGACATTGGGTACAGGGTGGGGTTAGAGCTAGAAATAGCA	1
GCTAATCGGC	GAAACACCGGTACCTTTGTTGATGCTGGGTGGAAGGAATGGGGTTAGAGC	1
GCTACCCCCA	GAAACACCGGTCGGAAACGCTCAGAGGTGGGGTTAGAGCTAGAAATAGCA	1
GCTACGTAGC	GAAACACCGGTGTACGTATGGACTGAACCAGGGTGTGCAAGTGGGGTTAG	1
GCTACTAGGC	GAAACACCGGTACCTTTGTTGATGCTGGGTGGGAGGATGCTGGGTGGGGT	1
GCTACTAGGC	GAAACACCGGTACCTTTGTTGATGCTGGGTGGAAGGAATTTTGTGGGGTT	1
GCTACTCTGC	GAAACACCGGTACCTTTGTTGATGCTGGGTGGAAGGAAGGTGGGGTTAGA	1
GCTATTCGGC	GAAACACCGGTACCTTTGTTGATGCTGGTTAGAGCTAGAAATAGCAAGTT	1
GCTCAACGCC	GAAACACCGGTTTGAACTACCTAGTTCAAACCGGTGGGGTTAGAGCTAGA	1
GCTGACCGCA	GAAACACCGGTCGGGGCGGGGCTAAAGGTTGAAATAGTAAAGTTACCTAA	1
GCTGAGCATC	GAAACACCGGTTCCCGTCCAGTGGGGTTAGAGCTAGAAATAGCAAGTTAA	1
GCTGAGCGCC	GAAACACCGGTGCCAATGCGGTTGGGCTATGGCGAGATATAGCTAGAAAT	1
GCTGCCCTAC	GAAACACCGGTGCCCTTACTCTCACCTGATTACTTAATCCGTGGGGTTAG	1
GCTGGAAGTT	GAAACGCCGGTGACATTGGGTAAAATAGCAAGTTAACCCAAGGCAAGTCC	1
GCTGGTCGTC	GAAACACCGGTGTACGTATGGACTGAACCAGGGTGTGCAAGTGGGGTTAG	1
GCTGTGCCGC	GAAACACCGGTCGGGGCCACTCAGTGGTGGGGTTAGAGCTAGAAATAGCA	1
GCTTGCCGGC	GAAACACCGGTCGGGGCCACTCAGTGGTGGGGGTAGAGCTAGAAATAGCA	1
GCTTGTGGAT	GAAACACCGGTCGATTCATATCGAAACCTTCCCGTGACAGTGGGGTTAGA	1
GCTTTAAAGA	GAAACACCGGTAGGGGCCACGCAGTGGTGGGGTTAGAGCTAGAAATAGCA	1
GGAAACATCA	GAAACACCGGTGTGGCTGAGAGTCCGGCAATGGTGTGGCTGTGGGGTTAG	1
GGAAACCTTC	GAAACACCGGTGTGGCTGAGAGTCCGGCAATGGTGTGGCTGTGGGGTTAG	1
GGAACACGCC	GAAACACCGGTGTGGCTGAGAGTCCGGCAATGGTGTGGCTGTGGGGTTAG	1
GGAACAGATA	GAGACACCGGTAGCAAGTGCGTGGGGTTAGAGCTAGAAATAGCAAGTTAA	1
GGAACAGCCA	GAAACACCGGTAAAATGTACGCGCCGGCATTGAGGGGTTCGTGGGAGTAA	1
GGAACCGACA	GAAACACCGGTAAATTTGAGGCTCCGGCATGCAGGAGGCCGTGGGGTTAG	1
GGAACGCTCT	GAAACACCGGTGTGGCTGAGAGTCCGGCAATGGTGTGGCTGTGGGGTTAG	1
GGAACGGCCC	GAAACACCGGTGTGGCTGAGAGTCCGGCAATGGTGTGGCTGTGGGGGTAC	1
GGAACTCTAC	GAAACACCGGTGTGGCTGAGAGTCCGGCAATGGTGTGGCTGTGGGGTTAG	1
GGAAGAAGCG	GAAACACCGGTCGGCGGCAATAGAAATAGCAGGTTAACCTAAGGCTAGTC	1
GGAAGACTTG	GAAACACCGGTGGGGTTAGAGCTAGAAATAGCAAGTTAACCTAAGGCTAG	1
GGAAGAGGTT	GAAACACCGGTCGATTCATATCGAAACCTTCCCGTGACAGTGGGGGTAGA	1
GGAAGAGTAC	GAAACACCGGTGTGGCTGAGAGTCCGGCAATGGTGTGGCTGGGGGGATAG	1
GGAAGTCCCG	GAAACACCGGTCGGCGGCGGTGGGGTTAGAGCTAGAAATAGCAAGTTAAC	1
GGAATCAATT	GAAACACCGGTCTCGAGTGAGGTGTTCAGGGTGGGGTTAGAGCTAGAAAT	1
GGAATCAGAC	GAAACACCGGTAGCAAGTGGGGTTAGAGCTAGAAATAGCAAGTTAACCCA	1
GGAATCGGTT	GAAACACCGGTCTCGAGTGAGGTGTTCAGGGTGGGGTTAGAGCTAGAAAT	1
GGAATTCTCC	GAAACACCGGTAACTATATGCATGCGATATCGCCGTATCAGTGGGGTTAG	1
GGACACTAAA	GAAACACCGGTAAATTTGAGGCTCCGGCATGCAGGAGGCCCGTGGGGTTA	1
GGACAGAATC	GAAACACCGGTCAGTAGAAGACGCGAGTGGGGTTAGAGTTAGAAGTAGCA	1
GGACAGAGAC	GAAACACCGGTAGCAAGTGCGTTTTGGTGGGGTTAGAGCTAGAAATAGCA	1
GGACAGTACA	GAAACACCGGTACATTTGAGGCTCCGGCATGCAGGAGGCCGTGGGGTTAG	1
GGACATAGAC	GAAACACCGGTAGCAAGTGCGAGACGTGTTAAATAGCAAGTTAACCTAAG	1
GGACCAAACC	GAACCAACGGTTAAGACGGGCGGGGAGAAGGCTGGAAGTAGCGAGTTAGC	1
GGACCCATGA	GAAACACCGGTAAATTTGAGGCTACGGCATGCAGGAGGCCGTGGGGTTAG	1
GGACCTACCA	GAAACACCGGTAAATTTGAGGCTCCGGCATGCAGGAGGCCGTGGGGTTAG	1
GGACGCTACG	GAAACACCGGTAAATTTGAGGCTCCGGCATGCAGGAGGCCGTGGGGTTAG	1
GGACGCTCAA	GAAACACCGGTAAATTTGAGGCTCCGGCATGCAGGAGGCCGTGGGGTTAG	1
GGAGAACTCC	GAAACACCGGTGTGGCTGAGAGTCCGGCAATGGTGTGGCTGTGGGGTTAG	1
GGAGACGTGC	GAAACACCGGTCGGGGGGTTAGAGCTAGAAACAGCGAGTTAACCTAAGGC	1
GGAGAGACGC	GAAACACCGGTGTGGCTGAGAGTCCGGCAATGGTGTGGCTGTGGGGTTAG	1
GGAGCCCTCG	GAAACACCGGTGTGGCTGAGAGTCCGGCAATGGTGTGGCTGTGGGGTTAG	1
GGAGCCTATA	GAAACACCGGTAAATTTGAGGCTCCGGCATGCAGGAGGCCGTGGGGTTAG	1
GGAGCGGCTC	GAAACACCGGTGCATTCGAAAGTCCGGTCGTAGTGTGGACGTGGGGTTAG	1
GGAGCGTGGT	GGAACACCGGTGTACGTATGGACTGAACCAGGGTGTGCAAGTGGGGTTAG	1
GGAGCTCTCT	GAAACACCGGTGTGGCTGAGAGTCCGGCAATGGTGTGGCTGTGGGGTTAG	1
GGAGGAACCT	GAAACACCGGTTCCCGTCCAGTGGGGTTAGAGCTAGAAATAGCAAGTTAA	1
GGAGGAGCCT	GAAACACCGGTTCCCGTCCAGTGGGGTTAGAGCTAGAAATAGCAAGTTAA	1
GGAGTCCGGC	GAAACACCGGTCGGCGGCAATCGTGGGTGGGGTTAGAGCTAGAAATAGCA	1
GGAGTTGTCG	GAAACACCGGTGACATTGGGTACAGGGGTGGGGTTAGAGCTAGAAATAGC	1
GGATCATGCC	GAAACACCGGTAAATTTGAGGCTCCGGCATGCAGGAGGCCGTGGGGTTAG	1
GGATCCCTTC	GAAACACCGGTGTGGCTGAGAGTCCGGCAATGGTGTGGCTGTGGGGATAG	1
GGATCCTAAA	GAAACACCGGTAAATTTGAGGCTCCGGCATGCAGGAGGCCGTGGGGTTAG	1
GGATCCTACT	GAAACACCGGTAAATTTGAGGCTCCGGCATGCAGGAGGCCGTGGGGTTAG	1
GGATGACCCG	GAAACACCGGTGGGGGGCAATTGCGGGTGGGGTTAGAGCTAGAAATAGCA	1
GGCAAACTAC	GAAACACCGGTGTGGCTGAGAGTCCGGCAATGGTGTGGCTGTGGGGTTAG	1
GGCAAAGATA	GAAACACCGGTAAATTTGAGGCTCCAGCATGCAGGAGGCCGTGGGGTTAG	1
GGCAACCACA	GAAACACCGGTAAATTTGAGGCTCCGGCATGCAGGAGGCCGTGGGGTTAG	1
GGCAACGTAA	GAAACACCGGTGTGGCTGAGAGTCCGGCAGTGGTGTGGCTGGGGAGATAT	1
GGCACAACGA	GAAACACCGGTGGGGCCGACTGTACAGCAGTGGTATGGCTGGAGAGATAA	1
GGCACATAAA	GAAACACCGGTAAATTTGAGGCTCCGGCATGCAGGAGGCCGTGGGGTTAG	1
GGCACATTAC	GAAACACCGGTGTGGCTGAGAGTCCGGCAATGGTGTGGCTGTGGGGTTAG	1
GGCACCACAC	GAAACACCGGTAAATTCGAGGCTCCGGCATGCAGGAGGCCGTGGGGTTAG	1
GGCACCACAC	GAAACACCGGTGTGGCTGAGAGTCCGGCAATGGTGTGGCTGTGGGGTTAG	1
GGCACCATAA	GAAACACCGGTGTGGCTGAGAGTCCGGCAATGGTGTGGCTGTGGGGTTAG	1
GGCACCCTCC	GAAACACCGGTGTGGCTGAGAGTCCGGCAATGGTGTGGCTGTGGGGTTAG	2118
GGCACCCTCC	GAAACACCGGTAAATTTGAGGCTCCGGCATGCAGGAGGCCGTGGGGTTAG	9
GGCACCCTCC	CAAAACACCGGTGTGGCTGAGAGTCCGGCAATGGTGTGGCTGTGGGGTTA	3
GGCACCCTCC	GAAACACCGGTGTGGCTGAGAGTCCGGCAATGGTGGCTGTGGGGTTAGAG	2
GGCACCCTCC	GAAACACCGGTGTGGCTGAGAGTCCGGCAATGGTGTGGCTTGTGGGGGTA	2
GGCACCCTCC	GAAACACCGGTGTGGCTGAGAGTCCGGCAATGGTGTGGCTTGTGGGGTTA	2
GGCACCCTCC	CAAAACACCGGTGTGGCTGAGAGTCCGGCAATGGTGTGGCTGGGGGGTTA	1
GGCACCCTCC	GAAACACCGATCCGTAGGAGACCCGTGTGGCATGTACCTGTGGGGTTAGA	1
GGCACCCTCC	GAAACACCGGTAAATTTGAGGCTCCGGCATGCAGGAGGCGTGGGGTTAGA	1
GGCACCCTCC	GAAACACCGGTACCTTTGTTGATGCTGGGTGTTGGGGTTAGAGCTAGAAA	1
GGCACCCTCC	GAAACACCGGTAGCAAGTGCGAGACGTGTTGGTGGGGTTAGAGCTAGAAA	1
GGCACCCTCC	GAAACACCGGTCCGTAGGAGACCCGTGTGGCATGTACCTGTGGGGTTAGA	1
GGCACCCTCC	GAAACACCGGTCGGCGGCAATCGTGGGTGGGGTTAGAGCTAGAAATAGCA	1
GGCACCCTCC	GAAACACCGGTCGGGGCCACTCAGTGGTGGGGTTAGAGCTAGAAATAGCA	1
GGCACCCTCC	GAAACACCGGTCTCGCTGAGAGTCCTCCAGTGGGGGGTAGGGCGGGATAG	1
GGCACCCTCC	GAAACACCGGTGAGGCTTAGAGTCCGGCAGTGGTGGGGCTGGGGGGATAG	1
GGCACCCTCC	GAAACACCGGTGCGGCTGAGCGTACGTCAATGGTTAAGCTGTGGGGTTAG	1
GGCACCCTCC	GAAACACCGGTGGGTCTGAGAGTCCGGCAATGGGGGGGCTAGGGGGATAT	1
GGCACCCTCC	GAAACACCGGTGTACGTATGGACTGAACCAGGGTGTGCAAGTGGGGTTAG	1
GGCACCCTCC	GAAACACCGGTGTGGCTGACACTCCGGCGATGGTGTGGCTGGGAGGAGAA	1
GGCACCCTCC	GAAACACCGGTGTGGCTGAGAGTCAGGCAGTGGTGTGGCTAGGGAGATAG	1
GGCACCCTCC	GAAACACCGGTGTGGCTGAGAGTCCGCAATGGTGTGGCTGTGGGGTTAGA	1
GGCACCCTCC	GAAACACCGGTGTGGCTGAGAGTCCGGCACTAGAGTAGCAGTGTTGTTAG	1
GGCACCCTCC	GAAACACCGGTGTGGCTGAGTCCGGCAATGGTGTGGCTGTGGGGTTAGAG	1
GGCACCCTCC	GAAACACCGGTTAGGCCGAGAAGCTAGAGCTGGAGATAGCGAGTTAACCT	1
GGCACCCTCC	GAAACACCGGTTCCCGTCCAGTGGGGTTAGAGCTAGAAATAGCAAGTTGA	1
GGCACCCTCC	GAAACACCGGTTTACGTTGCATCGGGGTTAGAGCTAGAAATAGCAAGTTA	1
GGCACCCTCC	GAAACACCGGTTTCGTTGAGGGGCCAGAGCTAGAGTGGGCGAGTTAATCT	1
GGCACCCTCC	GAAACGCCGGTAAATTTGAGGCTCCGGCATGCAGGAGGCCTGGGGTTAGA	1
GGCACCCTCC	GAAACGCCGGTGTGGCTGAGAGTCCGGCAATGGTGTGGCTTGTGGGGGTA	1
GGCACCCTCC	GAAGCACCGGTGTGGCTGAGAGTCCGGCAATGGTGTGGCTTGTGGGGGTA	1
GGCACCCTCC	GACGAAACACCGGTGTGGCTGAGAGTCCGGCAATGGTGTGGCTGTGGGGT	1
GGCACCGGCT	GAAACACCGGTGTGGCTGAGAGTCCGGCAATGGTGTGGCTGTGGGGTTAG	1
GGCACGAACC	GAAACACCGGTGTGGCTGAGAGTCCGGCAATGGTGTGGCTGTAGGGTTAG	1
GGCACGTAAA	GAAACACCGGTAAATTTGAGGCTCCGGCATGCAGGAGGCCGTGGGGTTAG	1
GGCACGTACC	GAAACCCCGGTAAATTTGAGGCTCCGGCATGCATGCCATAGCTACAATTA	1
GGCAGAACTG	GAAACACCGGTCGGCGGCAATCGTGGGGTGGGGTTAGAGCTAGAAATAGC	1
GGCAGCAGAA	GAAACACCGGTGTGGCTGAGAGTCCGGCGATGGTGTGGCTGTGGGGTTAG	1
GGCAGCCCAC	GAAACACCGGTGTGGCTGAGAGTCCGGCAATGGTGTGGCTGTGGGGTTAG	1
GGCAGTCTCA	GAAACACCGGTGTGGCTGAGAGTCCGGCAATGGTGTGGCTGTGGGGTTAG	1
GGCATACGTC	GAAACACCGGTGTGGCTGAGAGTCCGGCAATGGTGTGGCTGTGGGGTTAG	1
GGCATCATTC	GAAACACCGGTTTTCCTGAGAGGCCGTCAATGGGGGGTCTGTGGAGGTAG	1
GGCCCATAAC	GAAACACCGGTAAATTTGAGGTTCCGGCATGCAGGTGGCCGGGGGGTTAG	1
GGCCCCTACA	GAAACACCGGTAAATTTGAGGCTCCGGCATGCAGGAGGCCGTGGGGTTAG	1127
GGCCCCTACA	GAAACACCGGTAAATTTGAGGCTCCGGCATGCAGGAGGCGTGGGGTTAGA	52
GGCCCCTACA	GAAACACCGGTAAATTTGAGGCTCCGGCATGCATGCCATAGCTACAATTA	4
GGCCCCTACA	GAAACACCGGTAAATTTGAGGCTCCGGCATGCAGGAGGCCCGTGGGGTTA	3
GGCCCCTACA	GAAACACCGGTAAATTTGAGGCTCCGGCATGCAGGAGGCCGAAGGCTAGT	3
GGCCCCTACA	GAAACACCGGTAAATTTGAGGCTCCGGCATGCAGGAGGCCGGTTAGAGCT	3
GGCCCCTACA	GAAACACCGGTAAATTTGAGGCTCCGGCATGCAGGAGTGGGGTTAGAGCT	3
GGCCCCTACA	GAAACCACCGGTAAATTTGAGGCTCCGGCATGCAGGAGGCCGTGGGGTTA	3
GGCCCCTACA	GAAACACCGGTAAATTTGAGGCTCCGGAAATAGCAAGTTAACCTAAGGCT	2
GGCCCCTACA	CAAAACACCGGTAAATTTGAGGCTCCGGCATGCAGGAGGCCGTGGGGATA	1
GGCCCCTACA	CAAAACACCGGTAAATTTGAGGCTCCGGCATGCAGGAGGCCGTGGGGTTA	1
GGCCCCTACA	CAGAACACCGGTAAATTTGAGGCTCCGGCATGCAGGAGGCGTGGGGTTAG	1
GGCCCCTACA	GAAACACCAGTGGGTGGGGTTAGAGCTAGAAATAGCAAGTTAACCTAAGG	1
GGCCCCTACA	GAAACACCGGAAATTTGAGGCTCCGGCATGCAGGAGGCCGTGGGGTTAGA	1
GGCCCCTACA	GAAACACCGGTAAATTTGAGCTCCGGCATGCAGGAGACCGTGGGGTTAGA	1
GGCCCCTACA	GAAACACCGGTAAATTTGAGGCTAGAGCATGCAGAACGACGTGTTGAGAG	1
GGCCCCTACA	GAAACACCGGTAAATTTGAGGCTCCGGCACGCAGGAGGCCCGTGGGGTTA	1
GGCCCCTACA	GAAACACCGGTAAATTTGAGGCTCCGGCATGCATGCCATAGTTACAATTA	1
GGCCCCTACA	GAAACACCGGTAAGTTTTATTCACCGGCATGCATGAAGCCAGGGAGATAG	1
GGCCCCTACA	GAAACACCGGTCTCGAGTGAGGTGTTCAGGGTGGGGTTAGAGCTAGAAAT	1
GGCCCCTACA	GAAACACCGGTGCCCTTACTCTCACCTGATTACTTAATCTGTGGGGTTAG	1
GGCCCCTACA	GAAACACCGGTGTACGTATGGACTGAACCAGGGTGTGCAAGTGGGGTTAG	1
GGCCCCTACA	GAAACACCGGTGTGGCTGAGAGTCCGGCAATGGTGTGGCTGTGGGGTTAG	1
GGCCCCTACA	GAAACACCGGTTTGAACTAGAAATAGCAAGTTAACCTAAGGCTAGTCCGT	1
GGCCCCTACA	GAAACACCGGTTTGAACTAGACATAGCCATTTAACCTGCCGCTAGTCCAT	1
GGCCCCTACA	GAAACACGGTAAATTTGAGGCTCCGGCATGCAGGAGGCCGTGGGGTTAGA	1
GGCCCCTACA	GAAACATCGGTAAATTTGAGGCTCAGTAATGCAAGGGGCCGTGGGGTTAG	1
GGCCCGTCAA	GAAACACCGGTAAATTTGAGGCTCCGGCATGCAGGAGGCCGTGGGGTTAG	1
GGCCCTTAAC	GAAACACCGGTAATTTGAGGCTCCGGCATGCAGGAGGCCGTGGGGTTAGA	1
GGCCGTTAAA	GAAACACCGGTAAATTTGAGGCTCCGGCATGCAGGAGGCCGTGGGGTTAG	1
GGCCTCGTCC	GAAACACCGGTGTGGCTGAGCGTCCGGCAATGGTGTGGCAGTGGGGTTAG	1
GGCCTCTCCC	GAAACACCGGTAAATTTGAGGCTCCGGCATGCAGGAGGCCGTGGGGTTAG	1
GGCGACCTAC	GAAACACCGGTGTGGCTGAGAGTCCGGCAATGGTGTGGCTGTGGGGTTAG	1
GGCGCCATGC	GAAACACCGGTGTGGCTGAGAGTCCGGCAATGGTGTGGCTGAGGGGATAG	1
GGCGCCTAGT	GAAACACCGGTAAATTTGAGGCTCCGGCATGCAGGAGGCCGTGGGGTTAG	1
GGCGGACAAG	GAAACACCGGTTCCCTTACTCTCACCTGATTACTTGCGCATAGAGCTAGA	1
GGCGGCGGCC	GAAACACCGGTGGGGTTAGAGCTAGAAATAGCAAGTTAACCTAAGGCTAG	1
GGCGGCTACC	GAAACACCGGTAAGTTTGAGGCTCCGGCATGCAGGAGGCCGTGGGGTTAG	1
GGCGGTGACT	CAAGATACCCTTAGGAAAGTGCGTTATAGCCTTGAATAGGTAGCAAAGCG	1
GGCTACATCC	GAAACACCGGTGTGGCTGAGAGTCCGGCAATGTTGTGGCTGTGGGATTAG	1
GGCTACCGCC	GAAACACCGGTGTGGCTGAGAGTCCGGCAATGGTGTGGCTGTGGGGTTAG	1
GGCTAGCGCG	GAAACACCGGTTATATTTGTAAGTGTGTGGGGTTAGAGCTAGAAATAGCA	1
GGCTCCGACC	GAAACACCGGTAAATTTGAGGCTCCGGCATGCAGGAGGCCGTGGGGTTAG	1
GGCTGCGTCC	GAAACACCGGTGTGGCTGAGAGTCCGGCAATGGTGTGGCTGTGGGGTTAG	1
GGGAACCTTC	GAAACACCGGTGTGGCTGAGAGTCCGGCAATGGTGTGGCTGTGGGGTTAG	1
GGGAATCGTT	GAAACACCGGTCTCGAGTGAGGTGTTCAGGGTGGGGTTAGAGCTAGAAAT	1
GGGACACTAC	GAAACACCGGTGTGGCTGAGAGTCCGGCAATGGTGTGGCTGTGGGGTTAG	1
GGGACACTAC	GAAACACCGGTGTGGCTGAGAGTCCGGCAATGGTGTGGCTGGGGGGTTAG	1
GGGACCCGAC	GAAACACCGGTGTGGCTGAGAGTCCGGCAATGGTGTGGCTGTGGGGTTAG	1
GGGACCCGGG	GAAACACCGGTGTGGCTGAGAGTCCGGCAATGGGGTGGATGGGGGGATAG	1
GGGACGGGGT	GAAACACCGGTGTGGCTGAGAGTCCGGCAATGGTGTGGCTGTGGGGTTAA	1
GGGACTCCCC	GAAACACCGGTGTGGCTGAGAGTCCGGCAGTGGTGTGGCTGTGGGGGTAG	1
GGGACTGCCT	GAAACACCGGTCCGTAGGAGACCCGTGTGGCATGTACCTGTGGGGTTAGA	1
GGGAGCTACA	GAAACACCGGTAAATTTGAGGCTCCGGCATGCAGGAGGCCGTGGGGTTAG	1
GGGATAGGCA	GAAACACCGGTAGCAAGTGCGAGACGTTTTTGTGGGGTTAGAGCTAGAAA	1
GGGATGCTTC	GAAACACCGGTCCCGAGTGAGGGGTTCAGGGTGTGGTTAGAGCTAGAAAT	1
GGGCAACCTC	GAAACACCGGTGTGGCTGAGAGTCCGGCAATGGTGTGGCTGTGGGGTTAG	1
GGGCACATAT	GAAACACCGGTAAATTTGAGGCTCCGGCATGCAGGAGGCCGTGGGGTTAG	1
GGGCACATTC	GAAACACCGGTGTGGCTGAGAGTCCGGCAAGGGTGTGGCTGTGGGGTTAG	1
GGGCACTATC	GAAACACCGGTAAATTTGAGGCTCCGGCATGCAGGAGTGGGGTTAGGGCT	1
GGGCAGCTTC	GAAACACCGGTTCGCGTCCAGTGGAGTTAGACATGGGACTGGCAGGTTAA	1
GGGCATAGAC	GAAACACCGGTAGCAAGTGCGAGACGTGTTAAATAGCGAGTTAACCTAAG	1
GGGCCATATA	GAAACACCGGTAAATTTGAGGCTCCGGCATGCAGGAGGCCGTGGGGTTAG	1
GGGCCCCTCG	GAAACACCGGTAAATTTGAGGCTCCGGCATGCAGGAGGCCGTGGGGTTAG	1
GGGCCGCACA	GAAACACCGGTAAATTTGAGGATCCGGCACGCAGGAGGACCGTGGGGTTA	1
GGGCCGTATC	GAAACACCGGTTCCCGTCCAGTGGGGTTAGAGCTAGAAATAGCAAGTTAG	1
GGGCGCCTCC	GAAACACCGGTAAATTTGAGGCTCCGGCATGCAGGAGGCGTGGGGTTAGA	1
GGGCGCGTCC	GAAACACCGGTGTGGCTGAGAGTCCGGCAATGGTGTGGCTGTGGGGTTAG	1
GGGCGCTACC	GAAACACCGGTAAATTTGAGGCTCCGGCATGCAGGAGGCCGTGGGGTTAG	1
GGGCTCAGCC	GAAACACCGGTGTGGGTGACAGCCTACGATTTATGTTGCTGAAGGGGTAC	1
GGGCTCCCTT	GAAACACCAGTCCGTAGGAGACCCGTGTGGCATGTACCTGTGGGGTTAGA	1
GGGGAACCTT	GAAACACCGGTTCCCGTCCAGTGGGGTTAGAGCTAGAAATAGCAAGTTAA	1
GGGGAGCTTA	GAAACACCGGTTCCCGTCCAGTGGGGTTAGAGCTAGAAATAGCAAGTTAA	1
GGGGAGGTCT	GAAACACCGGTGGGTGGGGTTAGAGCTAGAAATAGCAAGTTAACCTAAGG	1
GGGGATGCCT	GCCTCCACGGCCACTAGTCTAAGGCTAGTCCGTTATCAAATTGAGAAAGT	1
GGGGATGCTT	GAAACACCGGTTACAGTGGGGACAGGGTTAAACTTGGAATAACCAGGTAA	1
GGGGGAGCCT	CTAAACACCGGTTCCCGTCCAGTGGGGTTAGAGCTAGAAATAGCAAGTTA	1
GGGGGGCCTT	GAAACCCCGGTTCCCGTCCAGTGGGGTTATCGCTAGAGATAGCAAGTTAA	1
GGGGGGGCTC	GAAACACCGGTTCCCGTCCAGTGGGGTTAGAGCTAGAAATAGCAAGTTAA	1
GGGTCCCACA	GAAACACCGGTAAGTTTGAGGCTCCGGCATGCAGGAGGCCGTGGGGTTAG	1
GGGTTACAGG	GAAACACCGGTTGGGGCAACTCAGTGGGGTTAGATCTAGAAATAGCAAGT	1
GGTAACTACA	GAAACACCGGTAAATTTGAGGCTCCGGCATGCAGGAGGCCGTGGGGTTAG	1
GGTACAGATA	GAAACACCGGTAGCAAGTGCGGGGTTAGAGCTAGAAATAGCAAGTTAACC	1
GGTACCGAGG	GAAACACCGGTTATTTTTATACTCCGGCATGCATGGAGCCGTGGGGATCG	1
GGTACTATCC	GAAACACCGGTGTGGCTGAGAGTCCGGCAATGGTGTGGCTATGGGGTTAG	1
GGTAGATATG	GAAACACCGGTTATTGGGGTTAGAGCTAGAAATAGCAAGTTAACCTAAGG	1
GGTAGGCCTC	GAAACACCGGTCTGTAGGAGACACGTGTAGCATGTAACTGTGGGATTAGA	1
GGTATCCCTT	GAAACACCGGTCTCGAGTGAGGTGTTCAGGGTGGGGTTAGAGCTAGAAAT	1
GGTCACCCGC	GAAACACCGGTGTGGCTGAGAGTCCGGCAATGGTGTGGCTGTGGGGTTAG	1
GGTCAGACTC	GAAACACCGGTCCGTCGGCGAACCGTGTGGCATGTGCCTGTGGTGGTAGA	1
GGTCCCTTCC	GAAACACCGGTGAGGCTGAGAGTCAGGCAATGGTGTAGCTGGGGAGTTAG	1
GGTCGACCTA	GAAACACCCGTCCGTAGGAGACCCGTGTGGCATGTACCTGTGGGGTTAGA	1
GGTCGTCTTC	GAAACACCGGTGTACGTATGGACTGAACCAGGGTGTGCAAAAGTGGGGTT	1
GGTCTGGATA	GAAACACCGGTACGTAGGAGGCCAGGGTGGCATGTACCAGTGGGGCTAGG	1
GGTGCCTCCC	GAAACACCGGTAAATTTGAGGCTCCGGCATGCAGGAGGCCGTGGGGTTAG	1
GGTGCGCCTC	GAAACACCGGTTCCCGTCCAGTGGGGTTAGAGCTAGAAATAGCAAGTTAA	1
GGTGGACGCG	GAAACACCGGTCGGCGGCAATCGTGGGTGGGGTTAGAGCTAGAAATAGCA	1
GGTGGAGACT	GAAACACCGGTTCCCGTCCAGTGGGGTTAGAGCTAGAAATAGCAAGTTAA	1
GGTGGTGTAG	GAAACACCGGTGACATTGGGTCAGGGGTTAGAGCTAGAAATAGCAAGTTA	1
GGTTTACTCC	GAAACACCGGTCTGGGCCACTCAGTGGCGGGGTTAGAGCTAGAAATAGCA	1
GTAAATTATT	GAAACACCGGTAACTATATTCATGCGATATCGCCGTATCAGTGGGGCTAG	1
GTAACACCTT	GAAACACCGGTGTCGTTAGAGCTAGAAATAGCAAGCTAAGCTAAAGCTAG	1
GTAACAGCCA	GAAACACCGGTAGCAAGTGCGGGGTTAGAGCTAGAAATAGCAAGTTAACC	1
GTAACCGGCC	GAAACACCGGTGTGGCTGAGAGTCCGGCAATGGAGTGGCTGTGGGGTTAG	1
GTAACGCTCA	GAAACACCGGTGTGGATGAGGGTGCCCCACTGACGTGATTGTGGGGTTAG	1
GTAACTCATC	GAAACACCGGTGTGGCTGAGAGTCCGGCAATGGTGTGGCTGTGGGGTTAG	1
GTAACTCTCC	GAAACACCGGTGTGGCTGAGAGTCTGGCAATGGTGTGGCTGGGGGTATAA	1
GTAACTTCTG	GAAACACCGGTAACTATATTCATGCGATATCGCCGTATCAGTGGGGTTAG	1
GTAACTTGTA	GAAACACCGGTAACTATATTCATGCGATATCGCCGTATCAGTGGGGTTAG	1
GTAAGTCAGT	GAAACACCGGTTACATCTCTGAGGGTTAGAGCTAGAAATAGCAAGTTAAC	1
GTACAACGCA	GCTAGAAATAGCAAGTTAACCTAAGGCTAGTCCGTTATCAACTTGAAAAA	1
GTACACAGGG	GAAGCACCGGTACCTTTGTTGATGCTGGGTGGAAGGAGGGGTTAGAGCTA	1
GTACATTATA	GAAACACCGGTAACTATATTCATGCGATATCGCCGTATCAGTGGGGTTAG	1
GTACCAATCA	GAAACACCGGTAGCAAGTGCGAGACGTGTTAAATAGCAAGTTAACCTAAG	1
GTACTACGCC	GCTAGAAATAGCAAGTTAACCTAAGGCTAGTCCGTTATCAACTTGAAAAA	1
GTACTTCTAC	GAAACACCGGTAACTATATTCATGCGATATCGCCGTATCAGTGGGGATAG	1
GTAGACACGA	GAAACACCGGTCGGCGGCAATCGTGGGTGGGGTTAGAGCTAGAAATAGCA	1
GTAGACCCTA	GAAACACCGGTCGGCGGAAGTTAACCTAAGGCTAGTCCGTTATCAACTTG	1
GTAGAGAGTC	GAAACACCGGTTCCCGTCCAGTGGGGTTAGAGCTAGAAATAGCAAGTTAA	1
GTAGAGGATC	GAAACACCGGTTCCTGTCCAGTGGGGTTAGAGCTAGAAATAGCAAGTTAA	1
GTAGAGGCTA	GAAACACCGGTTCCCGTCCAGTGGGGCTAGTGATAGAATTAGTAAGTTAA	1
GTAGATACGC	GAAACACCGGTCGGCGGCAATCGTGGGTGGGGTTAGAGCTAGAAATAGCA	1
GTAGCGCTCC	GAAACACCGGTTCCCGTCCAGTGGGGTTAGAGCTAGAAATAGCAAGTTAA	1
GTAGCTAGGG	GAAACACCGGTTACATTGAGGGTTAGAGCTAGAAATAGCAAGTTAACCTA	1
GTAGCTTATA	GAAACACCGGTAACTATATTCATGCGATATCGCCGTATCAGTGGGGTTAG	1
GTAGTGGGCC	GAAACACCGGTACCTTTGTTGATGCTGGGTGGGGTTAGAGCTAGAAATAG	1
GTATACACGC	GAAACACCGGTCGGCGGCAATCGTGGGTGGGGTTAGAGCTAGAAATAGCA	1
GTATCGATGT	GAAACACCGGTTACATTGAGGGTTAGAGCTAGAAATAGCAAGTTAACCTA	1
GTATTCAGTT	GAAACACCGGTCAATTCATATCCAACCCTTCCCGAGACAGTGGGGTAAGA	1
GTCAAAGACC	GAAACACCGGTGTGGCTGAGAGTCCGGCAATGGTGTGGCTGTGGGGTTAG	1
GTCAAAGCTA	GTAACACCGGTAGAAAGTGCGGGGTTAGAGCTAGAAATAGCAAGTTATCC	1
GTCACAATCA	GAAACACCGGTGTGGCTGAGAGTCCGGCAATGGTGTGGCTGTGGGGTTAG	1
GTCACAGAGT	GAAACACCGGTAGCAAGTGCGAGACGTGTTTGTGGGGTTAGAGCTAGAAA	1
GTCACTATGC	GAAACACCGGTGTGGCTGAGAGTCCGGCAATGGTGTGGCTGAGGGGTTAG	1
GTCACTTATA	GAAACACCGGTAACTATATTCATGCGATATCGCCGTATCAGTGGGGTTAG	2
GTCATCCTAA	GAAACACCGGTGTGGCTGAGAGTCCGGCAATGGTGTGGCTGTGGGGGTAG	1
GTCATCGTCC	GAAACACCGGTACCTTTGTTGATGCTTTTTGGGTTAGAGCTAGAAATAGC	1
GTCATTCGGT	GAAACACCGGTCGATTCATATCGAAACCTTCCCGTGACAGTGGGGTTAGA	1
GTCCACTGCA	GAAACACCGGTGTGGCTGAGAGTCCGGCAATGGTGTGGCTGTGGGGTTAG	1
GTCCCCGTCC	GAAACACCGGTACGTCTGTTGGTGCTGCAAGGGAGGGGGGGTTAGGGTTG	1
GTCCCCGTCT	GACCGAACCACCGTTGTGGCTGATAGTCCGGCAATTATGTGGCTATCGGG	1
GTCCTCGCGC	GAAACACCGGTGTGGCTGGGAGTCCGGCAATGGTGTGGCTGTGGGGTTAG	1
GTCCTTTATC	GAAACACCGGTCGGGGCCACTCAGTGGTGGGGTTAGAGCTAGAAATAGCA	1
GTCGCGGTGC	GAAACACCGGTGCCCTTACTCTCACCTGATTACTTAATCCGTGGGGTTAG	1
GTCGCTACGT	GAAACACCGGTTACGTTGCGGCTAGAGCTAGAAATAGCAAGTTAACCTAA	1
GTCTACTCGG	GAAACACCGGTACCTTTGTTGATGCTGGGTGGAAGGTACCGGTGGGGTTA	1
GTCTAGAGAG	GAAACACCGGTTATATTTGTCAGTGTGTGGGGTTAAAGCTAGAAATAGCA	1
GTCTATCGCG	GAAACACCGGTGGGGTTAGAGCTAGAAATAGCAAGTTAACCTAAGGCTAG	1
GTCTATTGAG	GAAACACCGGTGGGGTTAGAGCTAGAAATAGCAAGTTAACCTAAGGCTAG	1
GTCTTTAGAG	GAAACACCGGTTATATTTGTGGGGTTAGAGCTAGAAATAGCAAGTTAACC	1
GTCTTTATCG	GAAACACCGGTCGGGGCCACTCAGTGGTGGGGTTAGAGCTAGAAATAGCA	1
GTGACCTTGC	GAAACACCGGTGTGGCTGAGAGTCCGGCAATGGTGTGGCTGGGGGGATAA	1
GTGAGCAGTA	GAAACACCGGTTAAGGCGAGGAGTTAGAGCTAGAAATAGCAAGTTAACCT	1
GTGATCATCC	GAAACACCGGTTAAGCCGAGGAGGTTCGTTAGAGCTAGAAATAGAAAGTT	1
GTGCCCGACA	GAAACACCGGTAGCAAGTGCGAGACGTGTTTGTGGGGTTAGAGCTAGAAA	1
GTGCCTCCCC	GAAACACCGGTTTACGTTAGAGCTAGAAATAGCAAGTTAACCTAAGGCTA	1
GTGCGTCGTC	GAAACACCGGTGTACGTATGGACTGAACCAGGGTGTGCAAGTGGGGTTAG	1
GTGCGTCTCT	GAAACACCGGCTTACGTTGCATCGGTGTGGGGTTAGAGCTAGAAGTAGCA	1
GTGCTTATCC	GAAACACCGGTTTACGTTGGGGTTAGAGCTAGACATAGCAAGTTAACCTA	1
GTGGACAGGC	GAAACACCGGTCTACGGCGATTGGGGTCGTTGTTTGAGCTAGTAGTAGCA	1
GTGGACGCGA	GAAACACCGGTCGGCGGCAATCGTGGGTGGGGTTAGAGCTAGAAATAGCA	1
GTGGAGCCTC	GAAACACCGGTTCCCGTCCAGTGGGGTTAGAGCTAGAAATAGCAAGTTAA	2603
GTGGAGCCTC	CAAAACACCGGTTCCCGTCCAGTGGGGTTAGAGCTAGAAATAGCAAGTTA	7
GTGGAGCCTC	GAAACACCGGTTCCCGTCCAGTGGGTTAGAGCTAGAAATAGCAAGTTAAC	7
GTGGAGCCTC	GAAACACCGGTTCCCGTCCAAGTGGGGTTAGAGCTAGAAATAGCAAGTTA	6
GTGGAGCCTC	GAAACACCGGTGTGGCTGAGAGTCCGGCAATGGTGTGGCTGTGGGGTTAG	2
GTGGAGCCTC	GAAACACCGGTTATATTTGTAAGTGTGTGGGGTTAGAGCTAGAAATAGCA	2
GTGGAGCCTC	GAAACACCGGTTCCCGTCCATGGGGTTAGAGCTAGAAATAGCAAGTTAAC	2
GTGGAGCCTC	AGAAAAAACCGTTTCCCGTCCGTGGGGGTTAAGCTTGAAATAGCCAGGTT	1
GTGGAGCCTC	AGAGGGCGAAACACCGGTTCCCGTCCAGTGGGGTTAGAGCTAGAAATAGC	1
GTGGAGCCTC	AGGGAGGAAACACCGGTTCCCGTCCAGTGGGGTTAGAGCTAGAAATAGCA	1
GTGGAGCCTC	GAAAAACCGGTGCCGGGCAGTGTGTTTAGAGCTAGGAAAAAGCAGGTAAT	1
GTGGAGCCTC	GAAACACCGATGCACGAATGGGCTGCACCAGGGTGTGCAAGGGGGTTTAG	1
GTGGAGCCTC	GAAACACCGGTAACCATCCCATGGGGTTAGGGCTAGAAAGAGCAAGTTAT	1
GTGGAGCCTC	GAAACACCGGTAACTATATTCATGCGATATCGCCGTATCAGTGGGGTTAG	1
GTGGAGCCTC	GAAACACCGGTAACTATATTCATGCGATATCGCCGTGGGGTTAGAGCTAG	1
GTGGAGCCTC	GAAACACCGGTACCCTTCCTGTGGCTGTAGAGCTAGAGATATCGAGATAA	1
GTGGAGCCTC	GAAACACCGGTCCGTAGGAAACGCGTGTGGCATGTGAATGAGGGGGTTAA	1
GTGGAGCCTC	GAAACACCGGTCGGCGCCACTCGGTGTTAGAGCTAGAACTAGCAATATCA	1
GTGGAGCCTC	GAAACACCGGTCGGGGCCACTCAGTGGTGGGGTTAGAGTTAGAAATAGCA	1
GTGGAGCCTC	GAAACACCGGTGACATTGGGTACAGGGTGGGGTTAGAGCTAGAAATAGCA	1
GTGGAGCCTC	GAAACACCGGTGCATTCGAAAGTCCGGTCGTAGTGTGGACGTGGGGTTAG	1
GTGGAGCCTC	GAAACACCGGTGGGGTTAGAGCTAGAAATAGCAAGTTAACCTAAGGCTAG	1
GTGGAGCCTC	GAAACACCGGTTAAGCCGAGTGGGGTTAGAGCTAGAAATAGCAAGTTAAC	1
GTGGAGCCTC	GAAACACCGGTTACATTTGAGGGTTAGTACTGGTAATGACAAGTAAATCT	1
GTGGAGCCTC	GAAACACCGGTTCCCGTCCAGTGGGGTTAGAGCTAGAATAGCAAGTTAAC	1
GTGGAGCCTC	GAAACACCGGTTGCTGTACCGAGCTGTTAGAGCTAGATATAGCTAGATAA	1
GTGGAGCCTC	GAAACACCGGTTTACGTTGCATCGGTGTGGGGTTAGAGCTAGAAATAGCA	1
GTGGAGCCTC	GACACACCGGCGCTCGTCCAGTGGGGGTAGATCTAGAAATAGAAAGCAAA	1
GTGGAGCCTC	GGAACACCGGTTTGAACTAGAAATAGCAAGTTAACCTAAGGCTAGTCCGT	1
GTGGAGCCTC	GGAGGGGCGAAACACCGGTTCCCGTCCAGTGGGGTTAGAGCTAGAAATAG	1
GTGGATGCGC	GAAACACCGGTTCCCGTCCAGTGGGGTTAGAGCTAGAAATAGCAAGTTAA	1
GTGGCGAATC	GAAGCACCGGTTCCCGTCCAGTGGGGTTAGAGCTAGAAATAGCAAGTTAA	1
GTGGCGACTA	GAAACACCGGTTCCCGTCCAGTGGGGTTAGAGCTAGAAATAGCAAGTTAA	1
GTGGCGGCAC	GAAACACCGGTTCCCGTCCAGTGGGGTTAGAGCTAGAAATAGCAAGTTAA	1
GTGGCTACTC	GAAACACCGGGTTACAGCTAGAAATAGCAAGTTAACCTAAAGCTAGTCAG	1
GTGGGCATAC	GAAACACCGGTTAAGCCGAGGAGTTTCGTTAGAGCTAGAAATAGCAAGTT	1
GTGGGGATAC	GAAACACCGGTTCACGCCCGGAGTTAGTACTAGTAATAGTAACATAACAT	1
GTGGGTACTC	GAAACACCGGTTCCCGTCCAGTGGGGTTAGAGCTAGAAATAGCAAGTTAA	1
GTGGTCTCGC	GAAACACCGGTCGGTGGCGGTGGGGAGAGAGCTAGAAATAGCAAGTTAAA	1
GTGGTGACCT	GAAACACCGGTTCCCGTCCAGTGAGGTTAAAGCTAGAAATAGCAAGTTAA	1
GTGGTTATGT	GAAACACCGGTTACATTGAGGGGTTAGAGCTAGGAATAGCGAGTTAACCT	1
GTGTTGCGTC	GAAACACCGGTACCCGGCCATTGGGCTTAGACCTAGCCTGAGCTCGTGCC	1
GTTACACTCC	GAAACACCGGTGTGGGTGAGGGTCGGGCAATGGCGTGGCTGTGTGGTAAG	1
GTTACTCTCC	GAAACACCGGTGTGGCTGAGAGTCCGGCAATGGTGTGGCTGTGGGGATAG	1
GTTGAGCGTA	GAAACACCGGTTAAGCCGAGTGGGGTTAGAGCTAGAAATAGCAAGTTAAC	1
GTTTGAGCCT	GAAACACCGGTTAAGCCGAGTGGGGTTAGAGCTAGAAATAGCAAGTTAAC	1
GTTTTGCGCC	GAAACACCGGTACATTTGAGGATCCGGCGTGCAGGGGACCGTGGGGTTGG	1
TAAAACGACC	GAAACACCGGTTTGAACTAGAAATAGCAAGTTAACCTAAGGCTAGTCCGT	1
TAAAGTATCC	GAAACACCGGTAACTATATTCATGCGATATCGCCGTATCAGTGGGGTTAG	1
TAAATAACAC	GAAACACCGGTAACTATATTCATGCGATATCGCCGTATCAGTGGGGTTAG	1
TAAATCGTGC	GAAACACCGGTAACTATATTCATGCGATATCGCCGTATCAGTGGGGTTAG	1
TAAATTATGA	GAAACACCGGTAACTATATTGATGCGATATCGCAGTATCAGGGGGGTTAG	1
TAACAACGCC	GAAACACCGGTTTGAACTAGAATTAGCAAGTTAACCTAAGGCTAGTCCGT	1
TAACAACGCC	GAAACACCGGTTTGAACTACCTAGTTCAAACCGGTGGGGTTAGAGCTAGA	1
TAACAATGCC	GAAACACCGGTTTGAACTACCTAGTTCAAACCGGTGGGGTTAGAGCTAGA	1
TAACCTACCT	GAAACACCGGTTACATTGAGGGTTAGAGCTAGAAATAGCAAGTTAACCTA	1
TAACGCCCCA	GAAACACCGGTGCCCTTACTCTCACCTGATTACTTAATCCGTGGGGTTAG	1
TAACGCCTTA	GAAACACCGGTGCCCTTACTCTCACCTGATTACTTAATCCGTGGGGTTAG	1
TAACGTCGTT	GAAACACCGGTTAACGTAACCACTGAAACAGGGTGGGCACGTGGGGCTAG	1
TAACTGCAAC	GAAAAACCGGTAACTATATTCATGCGATATCGCCGTATCAGTGGGGTTAG	1
TAACTTATAC	GAAACACCGGTAACTATATTCATGCGATATCGCCGTATCAGTGGGGTTAG	1889
TAACTTATAC	GAAACACCGGTAACTATATTCATGCGATATCGCCGTATCAAGTGGGGTTA	103
TAACTTATAC	GAAACACCGGTAACTATATTCATGCGATATCGCCGTATAGGGTTAGAGCT	25
TAACTTATAC	CAAAGTGGCACCGAGTCGGTGCTTTTTTTCCTGCAGGGTATAAGTTAGAA	21
TAACTTATAC	GAAACACCGGTAACTATATTCATGCGATATCGCCGTGGGGTTAGAGCTAG	21
TAACTTATAC	GAAACACCGGTAACTATATTCATGCGATATCGCCGTATCGTGGGGTTAGA	20
TAACTTATAC	GAAACACCGGTAAAGGCTAGTCCGTTATCAACTTGAAAAAGTGGCACCGA	16
TAACTTATAC	GAAACACCGGTAACTATATTCATGCGATATAACCGTGGGGTTAGAGCTAG	13
TAACTTATAC	GAAACACCGGTAACTATATTCGGGTTAGAGCTAGAAATAGCAAGTTAACC	12
TAACTTATAC	GAAACACCGGTAACTATATTCATGCGATATCCCGCGGGGTTAGAGCTAGA	11
TAACTTATAC	GAAACACCGGTAACTATATTCATGCGATATCGTAGTGGGGTTAGAGCTAG	11
TAACTTATAC	GAAACACCGGTAACTATATTCATGCGATATGTGGGGTTAGAGCTAGAAAT	11
TAACTTATAC	GAAACACCGGTAACTATATTCATGCGATATCGCCGTATCGTATCGTGGGG	10
TAACTTATAC	GAAACACCGGTAACTATATTCATGCGATATCGCCGTTAGAGCTAGAAATA	10
TAACTTATAC	GAAACACCGGTAACTATATTCATGCGATTGGGGTTAGAGCTAGAAATAGC	10
TAACTTATAC	TAGCAAGTTAACCTAAGGCTAGTCCGTTATCAACTTGAAAAAGTGGCACC	10
TAACTTATAC	ACACCGGTAACTATATTCATGCGATATCGCCGTATCAGTGGGGTTAGAGC	9
TAACTTATAC	GAAACACCGGTAACTATATTCATGCGAATAGCAAGTTAACCTAAGGCTAG	9
TAACTTATAC	GAAACACCGGTAACTATATTCATGCGATATCGCCGTATCGGGGTTAGAGC	9
TAACTTATAC	GAAACACCGGTAACTATATTCATGCGATAGAAATAGCAAGTTAACCTAAG	7
TAACTTATAC	GAAACACCGGTAACTATATTCATGCGATATCGCCGTAAGTGGGGTTAGAG	7
TAACTTATAC	GAAACACCGGTAACTATAGCTAGAAATAGCAAGTTAACCTAAGGCTAGTC	5
TAACTTATAC	GAAACACCGGTAACTATATTCATGCGATATCGCCGTAGAGCTAGAAATAG	5
TAACTTATAC	GAAACACCGGTAACTATATTCATGCGATATCGCCGTTAGATTTGCTAGAA	5
TAACTTATAC	GAAACACCGGTAACTATATTCATGCGATATCGCCGTTAGATATGTGGGGT	3
TAACTTATAC	CAAAACACCGGTAACTATATTCATGCGATATCGCCGTATCAGTGGGGTTA	2
TAACTTATAC	GAAACACCGGTAACTATATTCATGCGATATCGACGTAGAGCTAGAAATAG	2
TAACTTATAC	GAAACACCGGTAACTATATTCATGCGATATCGTCGTAGAGCTAGAAATAG	2
TAACTTATAC	CAAAACACCGGTAACTATATTCGGGTTAGAGCTAGAAATAGCAAGTTAAC	1
TAACTTATAC	GAAACACCGGACTCGAGTGAGGTGTTCAGGGTGGGGTTAGAGCTAGAAAT	1
TAACTTATAC	GAAACACCGGTAACTATAGCTAGGACTAGCAAGTTAACCTAAGGCTAGTC	1
TAACTTATAC	GAAACACCGGTAACTATATTCACGCGGTATCGCCGGATCGAGCGAGATAG	1
TAACTTATAC	GAAACACCGGTAACTATATTCATACGATATCGTCGTAGAGCTAGAAATAG	1
TAACTTATAC	GAAACACCGGTAACTATATTCATGCGATATCGCCGTTAGGTTTGCTAGAA	1
TAACTTATAC	GAAACACCGGTAGCAAGTGCGAGACGTGTTAAATAGCAAGTTAACCTAAG	1
TAACTTATAC	GAAACACCGGTAGCAAGTGCGAGACGTGTTTGTGGGGTTAGAGCTAGAAA	1
TAACTTATAC	GAAACACCGGTAGCAAGTGCGAGAGAAATAGCAAGTTAACCTAAGGCTAG	1
TAACTTATAC	GAAACACCGGTCCGTAGGAGACCCGTGTGGCATGTACCTGTGGGGTTAGA	1
TAACTTATAC	GAAACACCGGTCGATTCATGTCGAAACCTTCCCGTGACAGTGGGGTTAGA	1
TAACTTATAC	GAAACACCGGTCGGCGGTGGGGTTAGAGCTAGAAATAGCAAGTTAACCTG	1
TAACTTATAC	GAAACACCGGTCTCCGTATGGACTGAACCGGGGTGTGCAGGGGTGGTTAG	1
TAACTTATAC	GAAACACCGGTCTCGAGTGAGGTGTTCAGGGTGGGGTTAGAGCTAGAAAT	1
TAACTTATAC	GAAACACCGGTGCATTCGAAAGTCCGGTCGTAGTATGGACGTGGGGTTAG	1
TAACTTATAC	GAAACACCGGTGCATTCGAAAGTCCGGTCGTAGTGTGGACGTGGGGTTAG	1
TAACTTATAC	GAAACACCGGTGCCCTTACTCTCACCTGATTACTTAATCCGTGGGGTTAG	1
TAACTTATAC	GAAACACCGGTGTACGTATGGGCTGAACCAGGGTGTGCAAGTGGGGTTAG	1
TAACTTATAC	GAAACACCGGTTCCCGTCCAGTGGGGTTAGAGCTAGAAATAGCAAGTTAA	1
TAACTTATAC	GAAACACCGGTTTACGTTGCATCGGGTTAGAGCTAGAAATAGCAAGTTAA	1
TAACTTATAC	GAAATAGCACCGAGTCGGTACTTTTTTTTCTGCAGGGCATTAGTTAGAAA	1
TAACTTATAC	GAAGTGGCACCGAGTCGGTGCTTTTTTTCCTGCAGGGTATAAGTTAGAAT	1
TAACTTATAC	GACCGAAACCCCGGTAACTATATTCATGCGATATCCCCTAATCATTGGGG	1
TAACTTATAC	GCGGAGAGGACGAAACACCGGTAACTATATTCATGCGATATCGCCGTATC	1
TAAGAAACGC	GAAACACCGGTCGGCGGCCGGTTAGAGCTAGAAATAGCAAGTTAACCTAA	1
TAAGAGATGT	GAAACACCGGTTACATTGAGGGGTTAGAGCTAGAAATAGCAAGTTAACCT	1
TAAGATGTGT	GAAACACCGGTTACATTTGAGGGGTTAGAGCTAGAAATAGCAAGTTAACC	1
TAAGCCCTTC	GAAACACCGGTGCCCTTACTCTCACCTGATTACTTAATCCGTGGGGTTAG	1
TAAGCTACGA	GAAACACCGGTTACATTGAGGGGTTAGAGCTAGAAATAGCAAGTTAACCT	1
TAAGCTATTC	ATTGGGGTTAGAGCTAGAAATAGCAAGTTAACCTAAGGCTAGTCCGTTAT	1
TAAGCTCTAC	GAAACACCGGTTACATTTGAGTGATAGAGCTAGAAATAGCAAGTTAACCT	1
TAAGCTCTTG	GAAACACCGGTTACATTGAGGGGTTAGAGCTAGAAATAGCAAGTTAACCT	1
TAAGGCCTCC	GAAACACCGGTGCCCTTACTCTCACCTGATTACTTAATCCGTGGGGTTAG	1
TAAGGGCCGC	GAAACACCGGTCGGCGGCAACGTGGGTTAGAGCTAGAAATAGCAAGTTAA	1
TAAGGGCGGA	GAAACACCGGTGCCCTTACTCTCACCTGATTACTTAATCCGTGGGGTTAG	1
TAAGTGAGAC	GAAACACCGGTAACTATATTCGGGTTAGAGCTAGAAATAGCAAGTTAACC	1
TAAGTGCTCT	GAAACACCGGTGCACTTACTCTCACCTGATTACTTAATCCGTGGGGTTAG	1
TAATCGGGGT	GAAACACCGGTGTACGTATGGACTGAACCAGGGTGTGCAAGTGGGGTTAG	1
TAATCGTCGC	GAAACACCGGTGTACGTATGGACTGAACCAGGGTGTGCAAGTGGGGTTAG	1
TAATGCCCTA	GCTCTCACCTGATTACTTAATCCGTGGGGTTAGAGCTAGAAATAGCAAGT	1
TAATGTCTAA	GAAACACCGGTAACTATATTCATGCGATATCGCCGTATCAGTGGGGTTAG	1
TAATTCAGAC	GAAACACCGGTAACTATATTCATGCGATATCGCCGTATCAGTGGGGTTAG	1
TAATTTGGAC	GAAACACCGGTAACTATATTTATGAAATTTCCCGGTACCAGTGGGGTTAG	1
TAATTTGGTC	GAAACACTGGTCGATTCATATCGAAACCTTCCCGTGACAGTGGGGTTAGA	1
TACAACATCC	GAAACACCGGTTTGAACCGGTGGGGTTAGAGCTAGAAATAGCAAGTTAAC	1
TACAACGACA	GAAACACCGGTTTAGAGCTAGAAATAGCAAGTTAACCTAAGGCTAGCCCG	1
TACACAATCA	GAAACACCGGTAAATTTGAGGCTCCGGCATGCAGGAGGCCGTGGGGTTAG	1
TACACCTGCA	GAAACACCGGTAAATTTGAGGCTCCGGCATGCAGGAGGCCGTGGGGTTAG	310
TACACCTGCA	GAAACACCGGTAAATTTGAGGCTCCGGCATGCAGGAGGCGTGGGGTTAGA	12
TACACCTGCA	GAAACACCGGTAAATTTGAGGCTCCGGCATGCAGGAGGCCCGTGGGGTTA	3
TACACCTGCA	GAAACACCGGTGTGGCTGAGAGTCCGGCAATGGTGTGGCTGTGGGGTTAG	3
TACACCTGCA	CTAAACACCGGTAAATTTGAGGCTCCGGCATGCAGGAGGCCGTGGGGTTA	1
TACACCTGCA	GAAACACCGGTAAATTTGAGGCTCCGGCATGCAGGAGGCCGAAGGCTAGT	1
TACACCTGCA	GAAACACCGGTAAATTTGAGGCTCCGGCATGCAGGAGTGGGGTTAGAGCT	1
TACACCTGCA	GAAACACCGGTAAATTTGAGGCTCCGGCATGCATGCCATAGCTACAATTA	1
TACACCTGCA	GAAACACCGGTCGATTCATATCGAAACCTTCCCGTGACAGTGGGGTTAGA	1
TACACCTGCA	GAAACACCGGTGTGGCTGACAGTCCGGCAATGGTGTGGCTGGGGGGTTAG	1
TACACCTGCA	GAAACCACCGGTAAATCTGAGGCTCCGGCATGCAGGAGGCCGTGGGGTTA	1
TACACCTGCA	GAACACCGGTAAATTTGAGGCTCCGGCATGCAGGAGGCCGTGGGGTTAGA	1
TACACCTGCA	GACGAAACACCGGTGAATTTGAGGCTCCGGCATGCAGGAGGCCGTGGGGT	1
TACAGCATAC	GAAACACCGGTTACGTCACGTGCACCTGATTATTTAATTAGCGGGGTTAG	1
TACAGCGTAC	GAAACACCGGTTAAGGCGAGGAGTTAGAGCTAGAAATAGCAAGTTAACCT	1
TACATTCGGC	GAAACACCGGTCGATTCATATCGAAACCTTCCCGTGACAGTGGGGTTAGA	1
TACATTTGGT	GAAACACCGGTCGATTCATATCGAAACCTTCCCGTGACAGTGGGGTTAGA	1
TACCAACGCC	GAAACACCGGTTTGAACTAGGAATAGCAAGTTAACCTAAGGCTAGTCCGT	1
TACCAACTAC	GAAACACCGGTAACTATATTCATGCGATATCGCCGTATCAGTGGGGTTAG	1
TACCAATGCA	GAAACACCGGTAAATTTGAGGCTCCGGCATGCAGGAGGCCGTGGGGTTAG	1
TACCATATCC	GAAACACCGGTAACTATATTCATGCGAATAGCAAGTTAACCTAAGGCTAG	1
TACCCTCAAC	GAAACACCGGTGACTATGTTCGTGCGGTGGCGCCAGAGCAGTGGGGGGAT	1
TACCGTCGGC	GAAACACCGGTATACGGATGGAATGAACCAGGGTGTGCAAGGGGGGTTAG	1
TACCTGATAA	GAAACACCGGTAACTATATTCATGCGATATCGCCGTATCAGTGGGGTTAG	1
TACCTTCGAC	GAAACACCGGTAACTATATTCATGCGATATCGCCGTATCAGTGGGGTTAG	1
TACGATATGT	GAAACACCGGTTACATTGGGGTTAGAGCTAGAAATAGCAAGTTAACCTAA	1
TACGCCGCCT	GAAACACCGGTTTGAACTAGAAATAGCAAGTTAACCTAAGGCTAGTCCGT	1
TACGCTCTAA	GCTCTAGCCTGATTACTTAATGCGTGGGGTTATAGCTAGAAATAGCAAGT	1
TACGTACTAC	GAAACACCGGTGCCCTTACTCTCACCTGATTACTTAATCCGTGGGGTTAG	1
TACTCCGACT	GAAACACCGGTGTGGCTGAGAGTCCGGCAATGGTGTGGCTGTGGGGATAG	1
TACTGTCGAA	GAAACACCGGTAACTATATTCATAAGATATAACCGTTGGGATATAGATAG	1
TAGAAACTCG	GAAACACCGGTGCATTCGAAAGTCCGGTCGTAGTGTGGACGTGGGGTTAG	1
TAGACACCCG	GAAACACCGGTGCATTCGAAAGTCCGGTCGTAGTGTGGACGTGGGGTTGG	1
TAGACACTCG	GAAACACCGGTGCATTCGAAAGTTCGGTCGTAGTGTGGACGTGGGGTTAG	1
TAGACACTCG	GAAACACCGGTGCATTCGAAAGTCCGGTCGTAGTGTGGACGTGGGGTTAG	1
TAGACCGAGA	GAAACACCGGTTATATTTGTAAGCGAGTGGGGTTAGAGCTAGAAATAGCA	1
TAGACGATCG	GAAACACCGGTGCATTCGAAAGTCCGGTCGTAGTGTGGACGTGGGGTTAG	1
TAGACGCTCG	GAAACACCGGTGCATTCGAAAGTCCGGTCGTAGTGTGGACGTGGGGTTAG	2
TAGAGAATAC	GAAACACCGGTTAAGCCGAGTGGGGTTAGAGCTAGAAATAGCAAGTTAAC	1
TAGAGCGTAC	GAAACACCGGTTAAAGAGCTAGAAATAGCAAGTTAACCTAAGGCTAGTCC	1
TAGAGCTTAT	GAAACACCGGTTAAGCCGAGTGGGGTTAGAGCTAGAAATAGCAAGATAAC	1
TAGAGTCTCG	GAAACACCGGTGCATTCGAAAGTCCGGTCGTAGTGTGGACGTGGGGTTAG	1
TAGATCGATG	GAAACACCGGTTCTGTTTGTTAGTGTGTGGGGTTAGAGCTAGAAATAGCA	1
TAGATGATTC	GAAACACCGGTAACTATATTCATGCGATATCGCCGTATCAGTGGGGTTAG	1
TAGCAATGTC	GAAACACCGGCCGGGGCCACTCAGTGTCGGGTGTAGAGCTAGAAATAGAT	1
TAGCGACGTC	GAAACACCGGTGTACGTATGGACTGAACCAGGGTGTGCAAGTGGGGTTAG	1
TAGCGACGTC	GAAACACCGGTGGACGTATGGACTGAACCAGGGGGTGCAAGTGGGGTTAG	1
TAGCTGATTC	GAAACACCGGTAACTATATTCATGCGATATCGCCGTATCAGTGGGGTTAG	1
TAGCTTAGAT	GAAACACCGGTAACTATATTCACGCGATATGGCGGTATCAGTGGGGTTAG	1
TAGCTTTGTC	GAAACACCGGTTACATTGAGGGTTAGAGCTAGAAATAGCAAGTTAACCTA	1
TAGGAACGTC	GAAACACCGGTTCCCGTCCAGTCGGGTTAGAGCTAGAAATAGCAAGTTAA	1
TAGGATATGT	GAAGCACCGGTTACATTGAGGGGTTAGAGCTAGAAATAGCAAGTTAACCT	1
TAGGATCCTC	GAAACACCGGTCGGCGGCTATCGCGTGTGGGGTTAGAGCTAGAAATAGCA	1
TAGGCCCGAC	GAAACACCGGTGCCTTTACCCTCCTCTGATTACTTAATCGGGCTGGAAAT	1
TAGGCTTTGC	GAAACACCGGTTACATTGAGGGTTAGAGCTAGAAATAGCAAGTTAACCTA	1
TAGTCCAACA	GAAACACCGGTTAAGCCGAGGAGTTAGAGCTAGTAATAGCAAGTTAACCT	1
TAGTCTACAT	GAAACACCGGTCCGTAGGAGACCCGTGTGGCATGTACCTGTGGGGTTAGA	1
TAGTCTGCCA	GAAACACCGGTCCGTAGGAGACCCGTGTGGCATGTACCTTGTGGGGTTAG	1
TAGTCTGCCA	GAAACACCGGTCCGTAGGAGACCCGTGTGGCATGTACCTGTGGGGTTAGA	1
TAGTGTTGTC	GAAACACCGGTGACATTGAGTGGGGTTAGAGCTAGAAATAGCAAGTTAAC	1
TAGTGTTGTC	GAAACACCGGTGACATTGGGTAAAATAGCAAGTTAACCTAAGGCTAGTCC	1
TAGTTACCGC	GAAACACCGGTCGGGGCCACTCAGTGGTGGGGTTAGAGCTAGAAATAGCA	1
TATAATCCTT	GAAACACCGGTTAAGCCGAGTGGGGTTAGAGCTAGAAATAGCAAGTTAAC	1
TATACTCGGC	GAAACACCGGTACCTTTGTTGATGCTGAGTGGAAGGAAAAAGTGGCACCG	1
TATAGCACAA	GAAACACCGGTTAAGCCGAGTGGGGTTAGAGCCAGAAATAGCAAGTTAAC	1
TATAGCCGTC	GAAACACCGGTGTACGCATGGACTGAACGAGGGTGTACAAGGGGGGTTAG	1
TATATCGCCC	GAAACACCGGTTTGAACTACCTAGTTCAAACCGGTGGGGTTAGAGCTAGA	1
TATATTGGGG	GAAACACCGGTTATATTTGTAAGTGTTGTGGGGTTAGAGCTAGAAATAGC	1
TATCATCTAC	GAAACACCGGTAACTATATTCATGCGATATCGCCGTATCAGTGGGGTTAG	1
TATCCCTAGC	GAAACACCGGTTTACGTTGCATCGGTGTGGGGTTAGAGCTAGAAATAGCA	1
TATCTCGTGG	GAAACACCGGTTATATTTGTAAGTGTGTGGGGTTAGAGCTAGAAATAGCA	1
TATCTCTCGT	GAAACACCGGTGCATTCGAAAGTCCGGTCGTAGTGTGGACGTGGGGTTAG	1
TATGCATAGC	GAAACACCGGTTTACGTTGTATCGGGGTTAGAGCTAGAAATAGCAAGTTA	1
TATGCGCCGC	GAAACACCGGTTTACGTTGCATCGGTGTGGGGTCAGAGCTAGAAATAGCA	1
TATGCTTCGC	GAAACACCGGTTTACGTTGCATCGGTTGGGGGGGTAGAGCTGGAAGTAGC	1
TATGGAGGCG	GAAACACCGGTTCCCGTCCAGTGGGGTTAGAGCTAGAAATAGCAAGTTAA	1
TATTGACGGC	GAAACACCGGTGGACGCATGGACTGAAACAGAGTGTGCAGGTGGGGTTAG	1
TATTGTCCGC	GAAACACCGGTCGGGGCCACTCAGTGGTGGGGTTAGAGCTAGAAATAGCA	1
TATTTTGAGG	GAAACACCGGTTATATTTGTAAGTGTGTGGGTTTAGAGCTAGAAATAGCA	1
TCAACAGCGC	GAAACACCGGTAGCAAGTGCGAGACGTGTTAAATAGCAAGTTAACCTAAG	1
TCACAAAGTC	GAAACACCGGTTTGAACTAGAAATAGCAAGTTAACCTAAGGCTAGTCCGT	1
TCACAACGAC	GAAACACCGGTTTGAACGCGGTGGGGTTAGAGCTAGAAATAGCAAGTTAA	1
TCACACTTGT	GAAACACCGGTTACATTGAGGGTTAGAGCTAGAAATAGCAAGTTAACCTA	1
TCACATATCC	GAAACACCGGTAACTATATTCATGCGATATCGCCGTATCAGTGGGGTTAG	1
TCACCGTTGT	GAAACACCGGTAAATTTGAGGCTCCGGCATGCAGGAGGCCGTGGGGTTAG	1
TCACCTATTC	GAGACACCGGTAACTATATTCATGCGATATCGCCGTATCAGTGGGGTTAG	1
TCACTCACGC	GAAACACCGGTAACTATATTCATGCGATATCGCCGTATCAGTGGGGTTAG	1
TCACTGACAC	GAAACACCGGTAACTATATTCATGCGATATCGCCGTATCAGTGGGGTTAG	1
TCACTGATGC	GAAACACCGGTAACTATATTTATGCGATATCGCCGTATCAGTGGGGTTAG	1
TCAGAGACTC	GAAACACCGGTTCCCGTCACCTGAGGTTCTAGCTTGGGATAGCAGGCTAG	1
TCAGTTGTGG	GAAACACCGGTTATATTTGTAAGTGTTTTTTGGGGTTAGAGCTAGACCTA	1
TCATACGGGT	GAAACACCGGTCAATAACTATTCAAAGTTTCGCTAGACCTAGAAATTGCA	1
TCATAGTCGT	GAAACACCGGTGTACGTATGGACTGAACCAGGGTGTGCAAGTGGGGTTAG	1
TCATCGACGC	GAAACACCGGTGTACGTATGGACTGAACCAGGGTGTGCAAGTGGGGTTAG	1
TCATCGCCGT	GAAACACCGGTGTACGTATGGACTGAACCAGGGTGTGCAAGTGGGGTTAG	1
TCATCGTAGT	GAAACACCGGTGTACGTATGGACTGAACCAGGGTGTGCAGTGGGGTTAGA	1
TCATGACTCG	GAAACACCGGTCGGGGCCACTCAGTGGTGGGGTTAGAGCTAGAAATAGCA	1
TCATGTAAAC	GAAACACCGGTAACTATATTCATGCGATATCGCCGTATCAGTGGGGTTAG	1
TCATTCGGAC	GAAACACCGGTCGATTCATATCGAAACCTTCCCGTGACAGTGGGGTTAGA	1
TCATTTACCG	GAAACACCGGTCGGGGCCACTCAGTGGTGGGGTTAGAGCTAGAAATAGCA	1
TCATTTATGC	GAAACACCGGTCGGGGCCACTCAGTGGTGGGGTTAGAGCTAGAAATAGCA	1
TCATTTATTC	GAAACACCGGTAACTATATTCATGCGATATCGCCGTATCAGTGGGGTTAG	1
TCATTTCGAG	GAAACACCGGTACATCTATTCATGCGGTATCGCCGGTTAAGTGGGGATAG	1
TCCCATATCC	GAAACACCGGTGTGGCTGAGAGTCCGGCAATGGTGTGGCTGGGGGGTTAG	1
TCCCTTCTAC	GAAACACCGGTAACTATATTCATGCGATATCGCCGTATCAGTGGGGTTAG	2
TCCGATGCGC	GAAACATTGGGGTTAAAGCTAGACATATCAAGTTAACCTAAGGCTAGTCG	1
TCCGTGTGTT	GAAACACCGGTGACATTGGGGTTAGAGCTAGAAATAGCAAGTTAACCTAA	1
TCCTACGCCC	GGGCTAGAGCGAGAAATAGCAAGATAACTTATAACTAGTCCTTTATCAAC	1
TCCTCGTCGT	GAAACACCGGTGTACGTATGGACTGAACCAGGGTGTGCAAGTGGGGTTAG	1
TCCTCTCGTT	GAAACACCGGTTATATTTGTAAGTGTGTGGGGTTAGAGCTAGAAATAGCA	1
TCCTTTATCG	GAACCTAAGGCTAGTCCGTTACAACTTGAAAAAGTGGCACCGAGTCGGTG	1
TCGAAGGCCA	GAAACACCGGTTTGAACTAGAAATAGCAAGTTAACCTAAGGCTAGTCCGT	1
TCGAATACTT	GAAACACCGGTCTCGAGTGAGGTGTTCAGGTTCAGGGTGGGGTTAGAGCT	1
TCGAATCATT	GAAACACCGGTCTCGAGCGAGGTGTTCATGGTGGGGTTAGAGCTAGAAAT	1
TCGAATCATT	GAAACACCGGTCTCGAGTGAGGTGTTCAGGGGTGGGGTTAGAGCTAGAAA	1
TCGAATTCTT	GAAACACCGGTCTCGAGTGAGGTGTTCAGGGTGGGGTTAGAGCTAGAAAT	1
TCGACCGTGG	GAAACACCGGTTATATTTGTAAGTGTGTGGGGTTAGAGCTAGCAATAGAA	1
TCGACGGCGG	GAAACACCGGTTTTATTTGGAAGCGTGTGGGGGTAGAGCTAGATATAGCA	1
TCGAGCACAC	GAAACACCGGTTAAGCCGAGTGGGGTTAGAGCTAGAAATAGCAAGTTAAC	1
TCGAGCCTTA	GAAACACCGGTTACGCCGAGGTGGGGTTAGAGCTAGAAATAGCAAGTTAA	1
TCGAGCGAGA	GAAACACCGGTTATATTTGTAAGCGTGCGGGGTTAGAGCTAGAAATAGCA	1
TCGAGGTGTA	GGTGGGGCTAGAGCTAGAAATAGCAAGTTAACCTAAGGCTAGTCCGTTAT	1
TCGATAGCTG	GAAACACCGGTTATATTTGTAAGCGGGGTTAGAGCTAGAAATAGCAAGTT	1
TCGATCCACG	GAAAAACCGGTTATATTTGTAAGTGTGTGGGGTTAGAGCTAGAAATAGCA	1
TCGATCGTGC	GAAACACCGGTTATATTTGTAGGGGAGTGGGGTTAGAGCTAGAAATACCA	1
TCGATCTGGG	GAAACACCGGTTAGATTTGTAGTAGTGTTGGGGTGGAGCTAGAAAGAAAA	1
TCGCATCCTT	GAAACACCGGTCTCGAGTGAGGTGTTCAGGGTGGGGTCAGAGCTAGAAAT	1
TCGCCCTGCA	GAAACACCGGTGCATTCGAAAGTCCGGTCGTAGTGTGGACGTGGGGTTAG	1
TCGCCCTGCA	GAAACACCGGTGTGGCTGAGAGTCCGGCAATGGTGTGGCTGTGGGGTTAG	1
TCGCCCTGGA	GAAACACCGGTGCATTCGAAAGTCCGGTCGTAGTGTGGACGTGGGGTTAG	1
TCGCTACCTC	GAAACACCGGTCCGTAGGAGACCCGGGTTGCATGGACCTGTGGGGATAGA	1
TCGCTCGATG	GAAACACCGGTTATATTTGTAAGTGTGTGGGGTTAGAGCTAGAAATAGCA	1
TCGCTTATCA	GAAACACCGGTAACTATATTCATGCGATATCGCCGTATCAAGTGGGGTTA	1
TCGTGCGTTT	GAAACACCGGTTGAGCCATATCTAAAGCTTCACGTAACAAGTTGATTTGA	1
TCGTGTTGGC	GAAACACCGGTGACATTGGATACGAGCTAGAAATAGCAAGTTAACCTAAG	1
TCGTTACCGA	GAAACACCGGTCGGGGCCACTCAGTGGTGGGGTTAGAGCTAGAAATAGCA	1
TCGTTTCTTC	GAAACACCGGTTCCCGTCCAGTGAGGTTAGAGCTAGAAATAGCAAGTTAA	1
TCTAAAGATG	GAAACACCGGTTATATTTGTAAGTGTGTGGGGTTAGAGCTAGAAATAGCA	1
TCTACGCGGC	GAAACACCGGTACCTTTGTTGATGCTGGGTGGAAGGAATTCTAGAAATAG	1
TCTACTCGGT	GAAACACCGGTACCTTTGTTGATGCTGGGTGGAAGGAATGTGGGGTTAGA	1
TCTACTTGAA	GAAACACCGGTAAATTTGAGGCTCCGGCATGCAGGAGGCCGTGGGGTTAG	1
TCTAGAGACG	GAAACACCGGTTATATTTGCAAGAGTTTGTGGGGTTAGCGCTAGAAATAG	1
TCTAGAGTGG	GAAACACCGGTTATATTTGTAAGTGTTGTGGGGTTAGAGCTAGAAATAGC	1
TCTAGCATCA	GAAACACCGGTTAAGCCGAGGAGTTAGAGCTAGAAATAGCAAGTTAACAT	1
TCTAGCTATC	GAAACACCGGTTATATTTGTAAGTGTTGTGGGGTTAGAGCTAGAAATAGC	1
TCTATCATAG	GAAACACCGGTTATATTTGTAAGTGTTTGTGGGGTTAGAGCTAGAAATAG	1
TCTATCGAGG	GAAACACCGGTTATATTTGTAAGTGTGTGGGGTTAGAGCTAGAAATAGCA	1563
TCTATCGAGG	GAAACACCGGTTATATTTGTAAGTGGGGTTAGAGCTAGAAATAGCAAGTT	211
TCTATCGAGG	GAAACACCGGTTATATTTGTAAGTGTTGTGGGGTTAGAGCTAGAAATAGC	171
TCTATCGAGG	GAAACACCGGTTATATTTGTGGGGTTAGAGCTAGAAATAGCAAGTTAACC	154
TCTATCGAGG	GAAACACCGGTTATATTTGTAAGTGTTTGTGGGGTTAGAGCTAGAAATAG	87
TCTATCGAGG	GAAACACCGGTTATATTTGTAAGTGTTTTGTGGGGTTAGAGCTAGAAATA	40
TCTATCGAGG	GAAACACCGGTTATATTTGTAGGGGTTAGAGCTAGAAATAGCAAGTTAAC	26
TCTATCGAGG	GAAACACCGGTGGGGTTAGAGCTAGAAATAGCAAGTTAACCTAAGGCTAG	24
TCTATCGAGG	GCTAGAAATAGCAAGTTAACCTAAGGCTAGTCCGTTATCAACTTGAAAAA	21
TCTATCGAGG	GAAACACCGGTTATATTTGTGGGTTAGAGCTAGAAATAGCAAGTTAACCT	20
TCTATCGAGG	GAAACACCGGTTATATTTGTTGTGGGGTTAGAGCTAGAAATAGCAAGTTA	18
TCTATCGAGG	GAAACAGAGCTAGAAATAGCAAGTTAACCTAAGGCTAGTCCGTTATCAAC	16
TCTATCGAGG	GAAACACCGGTTATATTTGTAAGTGTTATATTTGTAAGTGATAACGGACT	15
TCTATCGAGG	GAAACACCGGTTATATTTGTAATGGGGTTAGAGCTAGAAATAGCAAGTTA	14
TCTATCGAGG	GAAACACCGGTTATAGGGTTAGAGCTAGAAATAGCAAGTTAACCTAAGGC	9
TCTATCGAGG	GAAACACCGGTTAGGGGTTAGAGCTAGAAATAGCAAGTTAACCTAAGGCT	8
TCTATCGAGG	GAAACACCGGTTATATTTGTAAAGTGGGGTTAGAGCTAGAAATAGCAAGT	8
TCTATCGAGG	GGAACACCGGTTAGGGGTTAGAGCTAGAAATAGCAAGTTAACCTAAGGCT	7
TCTATCGAGG	GAAACACCGGTTATTGTGGGGTTAGAGCTAGAAATAGCAAGTTAACCTAA	6
TCTATCGAGG	GAAACTGGGGTTAGAGCTAGAAATAGCAAGTTAACCTAAGGCTAGTCCGT	6
TCTATCGAGG	GAAACACCGGTTAGGGGTTAGAGCTAGAAATAGCAAGTTAGCCTAAGGCT	5
TCTATCGAGG	CAAAACACCGGTTATATTTGTAAGTGTGTGGGGTTAGAGCTAGAAATAGC	4
TCTATCGAGG	GAAACACCGGTTATATTTGTAAGTGTTTTTCAAGACAGGGTTTCTCTGTA	4
TCTATCGAGG	GAAACACCGGTTATATTTGTTAGAGCTAGAAATAGCAAGTTAACCTAAGG	4
TCTATCGAGG	GAGACACCGGTTATATTTGTTAGAGCTAGAAATAGCAAGTTAACCTAAGG	4
TCTATCGAGG	GAAAAAGCAAGTTAACCTAAGGCTAGTCCGTTATCAACTTGAAAAAGTGG	3
TCTATCGAGG	GAAACACCGGTCCGTAGGAGACCCGTGTGGCATGTACCTGTGGGGTTAGA	3
TCTATCGAGG	GAAACACCGGTTATATTTGCTAAGGCTAGTCCGTTATCAACTTGAAAAAG	3
TCTATCGAGG	GAAACACCGGTTATATTTGTAAGTGGGCCTGTGGGGTTAGAGCTAGAAAT	3
TCTATCGAGG	GAAACACCGGTAACTATATTCATGCGATATCGCCGTATCAGTGGGGTTAG	2
TCTATCGAGG	GAAACACCGGTGTACGTATGGACTGAACCAGGGTGTGCAAGTGGGGTTAG	2
TCTATCGAGG	GAAACACCGGTTACATTGAGGGTTAGAGCTAGAAATAGCAAGTTAACCTA	2
TCTATCGAGG	GAAACACCGGTTATATGTGGGGTTATAGCTAGAAATAGCAAGTTAACCTA	2
TCTATCGAGG	GAAACACCGGTTATATTTGTAAGTGTGGGGTTAGAGCTAGAAATAGCAAG	2
TCTATCGAGG	CAAAACACCGGTTATATTTGTAAGTGGGGTTAGAGCTAGAAATAGCAAGT	1
TCTATCGAGG	CAAAACACCGGTTATATTTGTAAGTGTGTGGGGTTAGAGCTAGAGATAGC	1
TCTATCGAGG	CAAAACACCGGTTATATTTGTAAGTGTTTGTGGGGTTAGAGCTAGAAATA	1
TCTATCGAGG	GAAAAAGCAAGTTAACCTAAGGCTAGTCCGTTATCAACTTGAAAAAGTGA	1
TCTATCGAGG	GAAAAAGCAAGTTAACCTAAGGCTAGTCCGTTATCGACTTGAAAAAGTGG	1
TCTATCGAGG	GAAAAAGCAAGTTAGCCTAAGGCTAGTCCGTTATCAACTTGAAAAAGTGG	1
TCTATCGAGG	GAAACACCGGTCGGCGGCAATCGTGGGTGGGGTTAGAGCTAGAAATAGCA	1
TCTATCGAGG	GAAACACCGGTCGGCGGCCGGTTAGAGCTAGAAATAGCAAGTTAACCTAA	1
TCTATCGAGG	GAAACACCGGTCGGGGCCACTCAGTGTGGTGGGGTTAGAGCTAGAAATAG	1
TCTATCGAGG	GAAACACCGGTGCATTCGAAAGTCCGGTCGTAGTGTGGACGTGGGGTTAG	1
TCTATCGAGG	GAAACACCGGTGTACGTATGGACTGAACCAGGGTGTGCAAGCGGGGTTAG	1
TCTATCGAGG	GAAACACCGGTTAAACTGATAAGGGTTATAGCTAGAAATATAGAATTAAC	1
TCTATCGAGG	GAAACACCGGTTAAGCCGAGGAGTTTCGTTAGAGCTAGAAATAGCAAGTT	1
TCTATCGAGG	GAAACACCGGTTATATGTGGGGTTAGAGCTAGAAATAGCAAGTTAACCTA	1
TCTATCGAGG	GAAACACCGGTTATATGTTGAAGGGTGGTTAGAGCTATAGATAGAGAGTT	1
TCTATCGAGG	GAAACACCGGTTATATTTGCTAAGGCTAGTCCGTTATCAACGTGAAAAAG	1
TCTATCGAGG	GAAACACCGGTTATATTTGGAAGTGTGCGGGGTTAGAGCTGGGGATATCA	1
TCTATCGAGG	GAAACACCGGTTATATTTGTAAGTGTTTAGAAATAGCAAGTTAACCTAAG	1
TCTATCGAGG	GAAACACCGGTTATATTTGTACGAATGCGGGGCTAGAGCGAGAAATAGCA	1
TCTATCGAGG	GAAACACCGGTTATATTTGTAGTGTGTGGGGTTAGAGCTAGAAATAGCAA	1
TCTATCGAGG	GAAACACCGGTTATGCCTAGGAGTGTTTTTAGAGCTAGAAATAGCAAGAG	1
TCTATCGAGG	GAAACTGGGTTAGAGCTAGAAATAGCAAGTTAACCTAAGGCTAGTCCGTT	1
TCTATCGAGG	GAACACCGGTTATATTTGTAAGTGTTTGTGGGGTTAGAGCTAGAAATAGC	1
TCTATCTATT	GAAACACCGGTTATATTTGTAGGGGTTAGAGCTAGAATTAGCAAGGTAAT	1
TCTATTGCGT	GAAACACCGGTTATATTTGTAAGTGTTGTGGGGTTAGAGCTAGAAATAGC	1
TCTCACGAAG	GAAACACCGGTTATATTTGTAAGTGTGTGGGGCTATAGCTAGAAATAGCA	1
TCTCACGCGT	GAAACACGGGTAAAATTGTAAGGGGTTTGTGGGGTTAGAGCTGGAATTAG	1
TCTCTACGCC	GAAACACGGGTTAGAGCTAGAAATAGCAAGTTAACCTAAGGCTAGTCCGT	1
TCTCTAGCGC	GAAACACCGGTCGCTAGAAATAGCAAGATAACCTAAGGCTAGTCCGTTAC	1
TCTCTTAGAC	GAAACACCGGTAACTATATTCATGCGATATCGCCGTATCAGTGGGGTTAG	1
TCTGCCCTAC	GAAACACCGGTGCCCTTACTCTCACCTGATTACTTAATCCGTGGGGTTAG	1
TCTGGTCGTT	GAAACACCGGTGTACGTATGGACTGAACCAGGGTGTGCAAGTGGGGTTAG	1
TCTGTCGCTG	GAAACACCGGTTATATTTGTAAGTGTGTGGGGTTAGAGCTAGAAATAGCA	1
TCTGTGGCGC	GAAACACCGGTTATATTTGTAAGTGTGTGGGGTTAGAGCTAGAAATAGCA	1
TCTTGCCATC	GAAACACCGGTGTACGTATGGACTGAACCAGGGTGTGCAAGTGGGGTTAG	1
TGAAGAATCG	GAAACACCGGTCGGCGGCAATCGTGGGGTTAGATTAGATTAATCGTGGGG	1
TGAAGACGCG	GAAACACCGGTCGGCGGCGGTGGGGTTAGAGCTAGAAATAGCAAGTTAAC	1
TGAAGACGCG	GAAACACCGGTCGGCGGCAATCGTGGGTGGGGTTAGAGCTAGAAATAGCA	1
TGAAGCCCCG	GAAACACCGGTCGGCGGCCGGTTAGAGCTAGAAATAGCAAGTTAACCTAA	1
TGAATACCCG	GAAACACCGGTCGGCGGCAATCGTGGGTGGGGTTAGAGCTAGAAATAGCA	1
TGACAAAGAC	GAAACACCGGTAGCAAGTGCGAGACGTGGGGTTAGAGCTAGAAATAGCAA	1
TGACAACGCC	GAAACACCGGTTTGAACTAGAAATAGCAAGTTAACCTAAGGCTAGTCCGT	1
TGACACAGGC	GAAACACCGGTAGCAGGTGCGAAAAAGTGGGGTTAGAGCTAGAAATAGCA	1
TGACACCGAC	GAAACACCGGTAGCAAGTGCGAGACGTGTTAAATAGCAAGTTAACCTAAG	1
TGACACTCTT	GAAACACCGGTGCATTCGAAAGTCCGGTCGTAGTGTGGACGTGGGGTTAG	1
TGACAGCGAC	GAAACACCGGTAGCAAGTGCGGGGTTAGAGCTAGAAATAGCAAGTTAACC	1
TGACCTAGAC	GAAACACCGGTAAGTATATTCATGCGATGTCGCCGTATCAGTGGGGTTAG	1
TGACTACTTT	GAAACACCGGTCTCGAGAGAGGTGTTCAGGGTGGGGTTAGAGCTAGAAAT	1
TGACTCATTC	GAAACACCGGTCTCGAGAGAGGTGTTCAGGGTGGGGATAGAGCTAGAAAT	1
TGAGACAGAC	GAAACACCGGTAGCAAGTGCGAGACGTGTTTGTGGGGTTAGAGCTAGAAA	1
TGAGACAGAC	GAAACACCGGTAGCAAGTGGGGTTAGAGCTAGAAATAGCAAGTTAACCTA	1
TGAGCCGTGA	GAAACACCGGTAAATTTGAGGGGCTAGAGTTCGGAATAGCGAGTTAACCT	1
TGATTTCATT	GAAACATCGGTCTCGAGTGAGGTGTTCAGGGTGGGGTTAGAGCTAGAAAT	1
TGATTTTAAG	GAAACACCGGTCGGGGCCACTCAGTGGTGTTAGAGCTAGCAATAGCACGT	1
TGCAACCTCA	GAAACACCGGTGTGGCTGAGAGTCCGGCAATGGTGTGGCTGTGGGGTTAG	1
TGCAACTTTA	GAAACACCGGTAAATTTGAGGCTCCGGCATGCAGGAGGCCGTGGGGTTAG	1
TGCACCTACC	GAAACACCGGTAAATTTGAGGCTCCGGCATGCAGGAGGCCGTGGGGTTAG	1
TGCAGCGTAC	GAAACACCGGTTAAGCCGAGGGATAAAGCTAGAGATAGCAAGTTAACCTA	1
TGCATACACG	GAAACACCGGTCGGCGGCAATCGTGGGTGGGGTTAGAGCTAGAAATAGCA	1
TGCCTAGCCG	GAAACACCGGTCGGCGGCAATCTAGAAATAGCAAGTTAACCTAAGGCTAG	1
TGCGCCTGGA	GAAACACCGGTAAATTTGAGGCTCCGGCATGCAGGAGGCCGTGGGGTTAG	1
TGCGGAGCCT	GAAACACCGGTTCCCGTCCAGTGGGGTTAGAGCTAGAAATAGCAAGTTAA	1
TGCTCCCGCA	GAAACACCGGTAAATTTGAGGCTCCGGCATGCAGGAGGCCGTGGGGTTAG	1
TGCTCCTATA	GAAACACCGGTAAATTTGAGGCTCCGGCATGCAGGAGGCCGTGGGGTTAG	1
TGCTTTACCG	GAAACACCGGTCGGGGCCACTCAGTGGTGGGGTTAGAGCTAGAAATAGCA	1
TGGAGCATCC	GAAACACCGGTTAAGCCGAGTGGGGTTAGAGCTAGAAATAGTAAGTTAAC	1
TGGATTAGGT	GAAACACCGGTCTGGCTGAGGGAACGACATGTGGGGGTAGAGCTAGATAT	1
TGGCAACCGC	GAAACACCGGTGTGGCTGAGAGTCCGGCAATGGTGTGGCTGTGGGGTTAG	1
TGGCACAGAC	GAAACACCGGTAGCAAGTGCGAGAGAAGTAGCAAGTTAACCTAAGGCTAG	1
TGGCCCCCAC	GAAACACCGGTAAATTTGAGGCTCCGGCATGCAGGAGGCCGTGGGGTTAG	1
TGGCGCATCA	GAAACACCGGTTAAGCCGAGTGGGGTTAGAGCTAGAAATAGCAAGTTAAC	1
TGGCTGAGAT	GAAACACCGGTTTACGTTGCATCGGTGTGGGGTTAGAGCTAGAAATAGCA	1
TGGCTTGCAC	GAAACACCGGTCCGTAGGAGACCCGTGTGGCATGTACCTGTGGGGTTAGA	1
TGGGCGCCTC	GAAACACCGGTTCCCGTCCAGTGGGGTTAGAGCTAGAAATAGCAAGTTAA	1
TGGGTTGTAT	GAAACACCGGTGACATTGGGTACGGGGTTAGAGCTAGAAATAGCAAGTTA	1
TGGTGACGGC	GAAACACCGGTGTGGCTGAGAGACCGGCGATGTTGTAGCTGTGGGTTTAG	1
TGTATCCTTC	GAAACACCGGTCTCGAGTGAGGTGTTCAGGGTGGGGTTAGAGCTAGTAAT	1
TGTATCGTTT	GAAACACCGGTTATATTTGTAAGTGTCAGGGGTTAGATCTAGCTATAACA	1
TGTATGGCTC	GAAACACCGGTTCGTAGGAGACCCGTGTGGGATTAGACTGAGAGGTAGCA	1
TGTATTGGCG	GAAACACCGGTGACATTGGGTGGTGGGGTTAGAGCTAGAAATAGCAAGTT	1
TGTGCCTGGT	GAAACACCGGTGACCTTAGTCTCACCTGAGTACTAAATCCGTGGGGATAG	1
TGTGGAGACT	GAAACACCGGTTCCCGTCCAGTGGGGTTAGAGCTAGAAATAGCAAGTTAA	1
TGTGGAGGCT	GAAACACCGGTTCCCGTCCAGTGGGGTTAGAGCTAGAAATAGCAAGTTAA	1
TGTGTAGTCC	GAAACTAGAGCTAGACATAGCAGGTTAACCTAAGGCTAGGCCGGTATCAG	1
TGTGTGCCTT	GAAACACTCGGTGCGTTTTTTCCTGCAGGGAGGCAGACTTAATTCTGGCC	1
TGTGTTATTT	GAAACACCGGTGACATTGGGTACAGGGGGGTGGTTAGGTCTAGAAATAGC	1
TGTGTTGTAC	GAAACACCGGTGACATTGGGTGGGGTTAGAGCTAGAAATAGCAAGTTAAC	1
TTAACCATAT	GAAACACCGGTTATTGGGGTTAGAGCTAGAAATAGCAAGTTAACCTAAGG	1
TTAACGATGA	GAAACACCGGTTACATTGAGGGGTTAGAGCTAGAAATAGCAAGTTAACCT	1
TTAAGTATAT	GAAACACCGGTTACATTGAGGGGTTAGAGCTAGAAATAGCAAGTTAACCT	1
TTAAGTATGC	GAAACACCGGTTACATTGAGGGTTAGAGCTAGAAATAGCAAGTTAACCTA	1
TTAATCCGTT	GAAACACCGGTCGATTCATGACGAACCCGTCCCGTGACAGTGGGGTTAGA	1
TTAATTAGAA	GAAACACCGGTAACTATATTCATGCGATATCGCCGTATCAGTGGGGTTAG	1
TTACCAATAA	GAAACACCGGTTACATTGAGGGTTAGAGCTAGAAATAGCAAGTTAACCTA	1
TTACCCTTGA	GAAACACCGGTGCATTCGACAGTCCGGTCGTAGTGTGGACGTGGGGTTAG	1
TTACTTACGC	GAAACACCGGTAACTATATTCATGCGATATCGCCGTATCAGTGGGGTTAG	1
TTACTTTTGA	GAAACACCGGTTACGATACCTTTGCGATATGGCTAGAGCTAGGAATAGAA	1
TTAGCAAGGC	GAAACACCGGTTACATTGAGGGTTAGAGCTAGAAATAGCAAGTTAACCTA	1
TTAGCCCAGT	GAAACACCGGTTACACTGAGGGGTTAGAGCTAGAAATAGCAAGTTAACCT	1
TTAGCTATGT	GAAACACCGGTTACATTGAGGGTTAGAGCTAGAAATAGCAAGTTAACCTA	1036
TTAGCTATGT	GAAACACCGGTTACATTGAGGGGTTAGAGCTAGAAATAGCAAGTTAACCT	881
TTAGCTATGT	GAAACACCGGTTACATTGGGGTTAGAGCTAGAAATAGCAAGTTAACCTAA	254
TTAGCTATGT	GAAACACCGGTTACATTGAGATTGGGGTTAGAGCTAGAAATAGCAAGTTA	140
TTAGCTATGT	GAAACACCGGTTACATTGAGTGGGGTTAGAGCTAGAAATAGCAAGTTAAC	117
TTAGCTATGT	GAAACACCGGTTACCGGGTTAGAGCTAGAAATAGCAAGTTAACCTAAGGC	42
TTAGCTATGT	GGGTTAGAGCTAGAAATAGCAAGTTAACCTAAGGCTAGTCCGTTATCAAC	41
TTAGCTATGT	GAAACACCGGTTACATTGAGATTAGAGCTAGAAAAGGCTAGTCCGTTATC	29
TTAGCTATGT	GAAACACCGGTTACATTTGAGGGGTTAGAGCTAGAAATAGCAAGTTAACC	27
TTAGCTATGT	GAAACACCGGGTTAGAGCTAGAAATAGCAAGTTAACCTAAGGCTAGTCCG	26
TTAGCTATGT	GAAACACCGGTTATTGGGGTTAGAGCTAGAAATAGCAAGTTAACCTAAGG	25
TTAGCTATGT	GAAACACCGGTTACATTTTGAGGGTTAGAGCTAGAAATAGCAAGTTAACC	23
TTAGCTATGT	GAAACACCGGTTTGGGGTTAGAGCTAGAAATAGCAAGTTAACCTAAGGCT	23
TTAGCTATGT	GAAACACCGGATTGGGGTTAGAGCTAGAAATAGCAAGTTAACCTAAGGCT	22
TTAGCTATGT	GAAACACCGTAGAGCTAGAAATAGCAAGTTAACCTAAGGCTAGTCCGTTA	22
TTAGCTATGT	ATTGGGGTTAGAGCTAGAAATAGCAAGTTAACCTAAGGCTAGTCCGTTAT	18
TTAGCTATGT	GAAACACCGGTTACATTGAGAGCTAGAAATAGCAAGTTAACCTAAGGCTA	18
TTAGCTATGT	GAAACACGAGCTAGAAATAGCAAGTTAACCTAAGGCTAGTCCGTTATCAA	18
TTAGCTATGT	GAACACGAGGGGTTAGAGCTAGAAATAGCAAGTTAACCTAAGGCTAGTCC	16
TTAGCTATGT	GAAACACCGGTTACTGAGGGTTAGAGCTAGAAATAGCAAGTTAACCTAAG	15
TTAGCTATGT	GAAACACCGGTTACATTGAGATCTCTTTTGTGGGGTTAGAGCTAGAAATA	14
TTAGCTATGT	GAAACACCGGTTATTGAGGGTTAGAGCTAGAAATAGCAAGTTAACCTAAG	12
TTAGCTATGT	GAAACACCGTTAGAGCTAGAAATAGCAAGTTAACCTAAGGCTAGTCCGTT	12
TTAGCTATGT	GAAACATTGGGGTTAGAGCTAGAAATAGCAAGTTAACCTAAGGCTAGTCC	11
TTAGCTATGT	GAAACGGGGTTAGAGCTAGAAATAGCAAGTTAACCTAAGGCTAGTCCGTT	10
TTAGCTATGT	GAAACACCGGCAGGGGTTAGAGCTAGAAATAGCAAGTTAACCTAAGGCTA	9
TTAGCTATGT	GAAACACCGGTTAAGGGTTAGAGCTAGAAATAGCAAGTTAACCTAAGGCT	9
TTAGCTATGT	GAAACACCGGTTACAGCTAGAAATAGCAAGTTAACCTAAGGCTAGTCCGT	9
TTAGCTATGT	GAAACACCGGTTACATGGGGTTAGAGCTAGAAATAGCAAGTTAACCTAAG	9
TTAGCTATGT	AGCTAGAAATAGCAAGTTAACCTAAGGCTAGTCCGTTATCAACTTGAAAA	8
TTAGCTATGT	GAAACACCGGTACAGGGTTAGAGCTAGAAATAGCAAGTTAACCTAAGGCT	8
TTAGCTATGT	GAAACACCGGTTACATCTCTGAGGGTTAGAGCTAGAAATAGCAAGTTAAC	8
TTAGCTATGT	GAAACACCGGTTACGGGTTAGAGCTAGAAATAGCAAGTTAACCTAAGGCT	8
TTAGCTATGT	GAAACACGGGGGGTTAGAGCTAGAAATAGCAAGTTAACCTAAGGCTAGTC	8
TTAGCTATGT	GATAGAGCTAGAAATAGCAAGTTAACCTAAGGCTAGTCCGTTATCAACTT	8
TTAGCTATGT	GAAACACCGGTGTTAGAGCTAGAAATAGCAAGTTAACCTAAGGCTAGTCC	5
TTAGCTATGT	GAACGGGGTTAGAGCTAGAAATAGCAAGTTAACCTAAGGCTAGTCCGTTA	5
TTAGCTATGT	GAAACATTGGGGTTAGAACTAGAAATAGCAAGTTAACCTAAGGCTAGTCC	4
TTAGCTATGT	GAAACACCGGTCGGGGCCACTCAGTGGTGGGGTTAGAGCTAGAAATAGCA	3
TTAGCTATGT	CAAAACACCGGTTACATTGAGGGGTTAGAGCTAGAAATAGCAAGTTAACC	2
TTAGCTATGT	GAAACAAATAGCAAGTTAACCTAAGGCTAGTCCGTTATCAACTTGAAAAA	2
TTAGCTATGT	GAAACACCGGTTACATTGAGGGGTTAGAGCTAGAAATAGCAGTTAACCTA	2
TTAGCTATGT	CAAAACACCGGTTACACTGAGATTGGGGTTAGAGCTAGAAATAGCAAGTT	1
TTAGCTATGT	CAAAACACCGGTTACATTGAGGGGTTAGAGCTAGAAATAGCAAGCTAACC	1
TTAGCTATGT	CAAAACACCGGTTACATTGAGGGTTAGAGCTAGAAATAGCAAGTTAACCT	1
TTAGCTATGT	CAAAACACCGGTTACATTGGGGTTAGAGCTAGAAATAGCAAGTTAACCTA	1
TTAGCTATGT	CACAACACCGGTTACATTGAGTGGGGTTAGAGCTAGAAATAGCAAGTTAA	1
TTAGCTATGT	CCAAACACCGGTTACATTGAGGGTTAGAGCTAGAAATAGCAAGTTAACCT	1
TTAGCTATGT	GAAACACAGTTACATTGAGGGGTTAGAGCTAGAAATAGCAAGTTAACCTA	1
TTAGCTATGT	GAAACACCGAGAGCTAGAAATAGCAAGTTTACCTAAGGCTAGTCCGTTAT	1
TTAGCTATGT	GAAACACCGGTACATTGAGGGGTTAGAGCTAGAAATAGCAAGTTAACCTA	1
TTAGCTATGT	GAAACACCGGTCCGTAGGAGACCCGTGTGGCATGTACCTGTGGGGTTAGA	1
TTAGCTATGT	GAAACACCGGTGACATTGGGTACAGGGTGGGGTTAGAGCTAGAAATAGCA	1
TTAGCTATGT	GAAACACCGGTGCATTCGAAAGTCCGGTCGTAGTGTGGACGTGGGGTTAG	1
TTAGCTATGT	GAAACACCGGTGCCCTTACTCTCACCTGATTACTTAATCCGTGGGGTTAG	1
TTAGCTATGT	GAAACACCGGTGTACGTATGGACTGAACCAGGGTGTGCAAGTGGGGTTAG	1
TTAGCTATGT	GAAACACCGGTGTGGCTGAGAGTCCGGCAATGGTGTGGCTGTGGGGTTAG	1
TTAGCTATGT	GAAACACCGGTTACATGGTGTGTGATACCTGGAAAGATAAAGCTAGCCTA	1
TTAGCTATGT	GAAACACCGGTTACATTGACGCTTAGAGATGGGAATAGCTAGTTAACCTA	1
TTAGCTATGT	GAAACACCGTTACATTGAGGGGTTAGAGCTAGAAATAGCAAGTTAACCTA	1
TTAGCTATGT	GAACACCGGTTACATTGAGGGTTAGAGCTAGAAATAGCAAGTTAACCTAA	1
TTAGCTATGT	GAACGGGGTTAGAGCTAGAAATAGCAAGTTAACCTAAGGCTAGCCCGTTA	1
TTAGCTATGT	GACGAAACACCGGTTACATTGAGGGGTTAGAGCTAGAAATAGCAAGTTAA	1
TTAGCTATGT	GAGCTAGAAATAGCAAGTTAACCTAAGGCTAGTCCGTTATCAACTTGAAA	1
TTAGCTCGTC	GAAACACCGGTGTACGTATGGACTGAAACCTGGAGTGCAAGTGGGGATAG	1
TTAGGAAGGT	GAACGGGGTTAGAGCTAGAAATAGCAAGTTAACCTAAGGCTAGACCGTTA	1
TTATATCGAG	GAAACACCGGTTATATTTGTAAGTGTGTGGGGTTAGAGCTAGAAATAGCA	1
TTATCTGGCT	GAAACACCGGTTACATTCAGGGTTAGAGCTAGATATAGCAAGTTAACCTA	1
TTCACCATGT	GAAACACCGGTTACATTGAGGGTTAGAGCTAGAAATAGCAAGTTAACCTA	1
TTCCACGGCC	GAAACACCGGTACCTTTGTTGATGCTGGGTGGAAGGAGTGGGGATAGAGC	1
TTCGCCCTGC	GAAACACCGGTGCCCTTACTCTCACCTGATTACTTAATCCGTGAGGATAG	1
TTCGCTAGGC	GAAACACCGGTTACATTGAGGGGTTAGAGCTAGAAGTAGCAAGTTAACCT	1
TTCGCTCTTA	GAAACACCGGTTACATTGAGATCTCTTTTGTGGGGTTAGAGCTAGAAATA	1
TTCGCTGTGC	GAAACACCGGTTACATTGAGGGGTTAGAGCTAGAAATAGCAAGTTAACCT	1
TTCTTTACAG	GAAACACCGGTCGGGGCCACTCAGTGGTGGGGTTAGAGCTAGAAATAGCA	1
TTGACGGCTG	GAAACACCGGTTATATTTGAAGGGGTTAGAGCTAGAAATAGCAAGTTAAC	1
TTGACTGTCA	GAAACACCGGTAGCATGTGCGGGGATAGAGCTAGAAATAGCAATTTAACC	1
TTGAGCATAA	GAAACACCGGTTAAGCCGAGTGGGGTTAGAGCTAGAAATAGCAAGTTAAC	975
TTGAGCATAA	GAAACACCGGTTAAGCCGAGGAGTTAGAGCTAGAAATAGCAAGTTAACCT	850
TTGAGCATAA	GAAACACCGGTTAAGCCGAGGAGTTTCGTTAGAGCTAGAAATAGCAAGTT	201
TTGAGCATAA	GAAACACCGGTTAAGCCGAGGTTAGAGCTAGAAATAGCAAGTTAACCTAA	90
TTGAGCATAA	GAAACACCGGTTAGAGCTAGAAATAGCAAGTTAACCTAAGGCTAGTCCGT	47
TTGAGCATAA	GAAACACCGGTTAAGCCGGTGGGGTTAGAGCTAGAAATAGCAAGTTAACC	32
TTGAGCATAA	GAAACACCGGTTAAAGAGCTAGAAATAGCAAGTTAACCTAAGGCTAGTCC	30
TTGAGCATAA	GAAACACCGGTTAAGCCGAGGGTTAGAGCTAGAAATAGCAAGTTAACCTA	30
TTGAGCATAA	GAAACACCGGTTAAGCCGAGGATGGGGTTAGAGCTAGAAATAGCAAGTTA	27
TTGAGCATAA	GAAACACCGGTTAAGCCGAGGAGGGGTTAGAGCTAGAAATAGCAAGTTAA	23
TTGAGCATAA	GAAACACCGGTTAAGCCGAGGTGGGGTTAGAGCTAGAAATAGCAAGTTAA	18
TTGAGCATAA	GAAACACCGGTTAAGCCGAGGTGTTTGTGACACTTACCGCATTGACAAGC	10
TTGAGCATAA	GAAACACCGGTTAAGCCTAGAAATAGAAATAGAAATAGAAAATGGGGTTA	10
TTGAGCATAA	GAAACACCGATAGCAAGTTAACCTAAGGCTAGTCCGTTATCAACTTGAAA	7
TTGAGCATAA	GAAACACCGGTTAAGTGGGGTTAGAGCTAGAAATAGCAAGTTAACCTAAG	7
TTGAGCATAA	GAAACACCGGTTATATTTGTAATGGGGTTAGAGCTAGAAATAGCAAGTTA	5
TTGAGCATAA	CAAAACACCGGTTAAGCCGAGGAGTTAGAGCTAGAAATAGCAAGTTAACC	4
TTGAGCATAA	GAAACACCGGTTCGGTGCTTTTTTCCTGCAGGTTATGCTCAAGAATTCGG	3
TTGAGCATAA	GAAACACCGGTTAAGAGCTAGAAATAGCAAGTTAACCTAAGGCTAGTCCG	2
TTGAGCATAA	GAAACACCGGTTAAGCCGAGGTTAAGTTAAGTTAAGTGGGGTTAGAGCTA	2
TTGAGCATAA	GAAACACCGGTTAAGCTAGAAATAGCAAGTTAACCTAAGGCTAGTCCGTT	2
TTGAGCATAA	CAAAACACCGGTTAAGCCGAGTGGGGTTAGAGCTAGAAATAGCAAGTTAA	1
TTGAGCATAA	CAAAACACCGGTTAGAGCTAGAAATAGCAAGTTAACCTAAGGCTAGTCCG	1
TTGAGCATAA	GAAACACCAGTTCGGTGCTTTTTTCCTGCAGGTTATGCTCAAGAATTCGG	1
TTGAGCATAA	GAAACACCGGTAACTATATTCATGCGATATCGCCGTATCAGTGGGGTTAG	1
TTGAGCATAA	GAAACACCGGTACCTTTGTTGATGCTGGGTGGGGTTAGAGCTAGAAATAG	1
TTGAGCATAA	GAAACACCGGTCGGGGCCACTCAGTGGTGGGGTTAGAGCTAGAAATAGCA	1
TTGAGCATAA	GAAACACCGGTGCCCTTACTCTCACCTGATTACTTAATCCGTGGGGTTAG	1
TTGAGCATAA	GAAACACCGGTGTGGCTGAGAGTCCGGCAATGGTGTGGCTGTGGGGTTAG	1
TTGAGCATAA	GAAACACCGGTTAAGCCGAGGAGTTTCGTAGAGCTAGAAATAGCAAGTTA	1
TTGAGCATAA	GAAACACCGGTTAAGCCGAGGGGTTAGAGCTAGAATAGCAAGTTAACCTA	1
TTGAGCATAA	GAAACACCGGTTAAGCCGGTTGCTAGAAATAGAAATAGAATAGAATAGAA	1
TTGAGCATAA	GAAACACCGGTTAAGGCGACTGGGGTTGGAGCTCGTAGTAGCAAGTTAAC	1
TTGAGCATAA	GAAACACCGGTTAAGTCGATTTCTTGGCTTTATATATCTTGTGGAAAGGA	1
TTGAGCATAA	GAAACACCGGTTATATTTGTAAGTGTGTGGGGTTAGACCTAGAAATAGAA	1
TTGAGCATAA	GAAACACCGGTTCCCGTCCAGTGGGGTTAGAGCTAGAAATAGCAAGTTAA	1
TTGAGCATAA	GAAACACCGGTTCGGTGCTTTTTTCCTGCAGGTTATACTCAAGAATTCGG	1
TTGAGCATAA	GAAACACCGGTTCGGTGCTTTTTTCCTGCAGGTTATGCTCTAGAATTCGG	1
TTGAGCATAA	GAAACACCGGTTCGGTGCTTTTTTCCTGGAGGTTATGCTCAAGAATTCGG	1
TTGAGCATAA	GACGAAACACCGGTTAAGCCGAGTGGGGTTAGAGCTAGAAATAGCAAGTT	1
TTGAGCATAA	GACTAGTCCGTTATCAACTTGAAAAAGTGGCACCGAGTCGGTGCTTTTTT	1
TTGAGCCTCC	GAAACACCGGTTAAGCCGAGGAGTTAGAGCTAGAAATAGCAAGTTAACCT	1
TTGAGGATCT	GAAACACCGGTTAATCCGAGGAGTTAGAGCTAGAAATAGCAAGTTAACCT	1
TTGCGATGGT	GAAACACCGGTAACTTTGGTGTTGCTGGGTGGAAGGTACCGGTGGGGTTA	1
TTGCGCATTT	GAAACACCGGTTAAGCCGAGTGGGGTTAGAGCTAGAAATAGCAAGTTAAC	1
TTGCGCGTCA	GAAACACCGGTTAAGCCGAGGAGTTAGAGCTAGAAATAGCAAGTTAACCT	1
TTGCGCTTAC	GAAACACCGGTTAAGCCGGTGGGGTTAGAGCTAGAAATAGCAAGTTAACC	1
TTGCGGCTCA	GAAACACCGGTTAAGCCGAGTGGGGTTAGAGCTAGAAATAGCAAGTTAAC	1
TTGCTAATAC	GAAACACCGGTTAAGCCGAGTGGGGTTAGAGCTAGAAATAGCAAGTTAAC	1
TTGCTATTGA	GAAACACCGGTTACATTGAGGGTTGGAGCTAGAAATAGCAAGTTAACCTA	1
TTGCTTAGAA	GAAACACCGGTTAGTAATAGCAAGTTGATATAAGGCTAGTCCGTTCTCAA	1
TTGCTTCTAC	GAAACACCGGTAACTATATTCATGCGATATCGCCGTATCAGTGGGGTTAG	1
TTGGAGTACA	GAAACACCGGTTCCCGTCCAGTGGGGTTAGAGCTAGAAATAGCAAGTTAA	1
TTGGCTTCGG	GAAACACCGGTTACATTGAGATTGGGGTTAGAGCTAGAAATAGCAAGTTA	1
TTGGGGATGC	GAAACACCGGTTATATTGAGTGGGGTTAGAGCTAGAAATAGCAAGTTAAC	1
TTGGTTATCT	GAAACACCGGTTTACGTTGCATCGGTTGTGGGGTTAGAGCTAGAAATAGC	1
TTGTGCAGAG	GAAACACCGGTTAAGCCGAGGTGGGGTTAGAGCTAGAAATAGCAAGTTAA	1
TTGTGGTGTC	GAAGCACCGGTGACATTGGGTAGGGGTTAGAGCTAGAAATAGCAAGTTAA	1
TTTAGCCGAC	GAAACACCGGTGAACGTATGGACTTAGCCCTAGAAATCACATGTTGATCG	1
TTTAGCTCTG	GAAACACCGGTTACATTGAGGGGTTAGAGCTAGAAATAGCAAGTTAACCT	1
TTTGTCGGGC	GAAACACCGGTTATATTTGTAAGTGTGTGGGGTTAGAGCTAGAAATAGCA	1
TTTTTACTGC	GAAACACCGGTCGGGGCCACTCAGGGGTGAGGTTAGTGCTAGAAATAGCA	1
