AACTTTACCG	GAAACACCGGTCGGGGCCACTCAGTGGTGGGGTTAGAGCTAGAAATAGCA	5	bc
CTCCCCTGCA	GAAACACCGGTGTGGCTGAGAGTCCGGCAATGGTGTGGCTGTGGGGTTAG	5	bc
AGAGGAGACT	GAAACACCGGTTCCCGTCCAGTGGGGTTAGAGCTAGAAATAGCAAGTTAA	3	bc
GCCAACGAGC	GAAACACCGGTAATCAGAGGTGAACGTAAGGTGGGGTTAGAGCTAGAAAT	3	bc
AGGCACCTAC	GAAACACCGGTAAATTTGAGGCTCCGGCATGCAGGAGGCCGTGGGGTTAG	3	bc
AAAAGCCCTA	GAAACACCGGTGCCCTTACTCTCACCTGATTACTTAATCCGTGGGGTTAG	3	bc
AAGACACTCG	GAAACACCGGTGCATTCGAAAGTCCGGTCGTAGTGTGGACGTGGGGTTAG	2	bc
TAGAATCCTT	GAAACACCGGTCTCGAGTGAGGTGTTCAGGGTGGGGTTAGAGCTAGAAAT	2	bc
AAGAATCCTT	GAAACACCGGTCTCGAGTGAGGTGTTCAGGGTGGGGTTAGAGCTAGAAAT	2	bc
AAGTCTGACT	GAAACACCGGTCCGTAGGAGACCCGTGTGGCATGTACCTGTGGGGTTAGA	2	bc
AGGCAACCTC	GAAACACCGGTGTGGCTGAGAGTCCGGCAATGGTGTGGCTGTGGGGTTAG	2	bc
AGTGAGCATA	GAAACACCGGTTAAGCCGAGGAGTTAGAGCTAGAAATAGCAAGTTAACCT	2	bc
GTGTGGAGCG	GAAACACCGGTTCCCGTCCAGTGGGGTTAGAGCTAGAAATAGCAAGTTAA	2	bc
ACGAATCGTT	GAAACACCGGTCTCGAGTGAGGTGTTCAGGGTGGGGTTAGAGCTAGAAAT	2	bc
AAATCGTCGT	GAAACACCGGTGTACGTATGGACTGAACCAGGGTGTGCAAGTGGGGTTAG	2	bc
AAATGCCCTA	GAAACACCGGTGCCCTTACTCTCACCTGATTACTTAATCCGTGGGGTTAG	2	bc
ACCTCGTCGT	GAAACACCGGTGTACGTATGGACTGAACCAGGGTGTGCAAGTGGGGTTAG	2	bc
AAACGCCCCA	GAAACACCGGTGCCCTTACTCTCACCTGATTACTTAATCCGTGGGGTTAG	2	bc
ACGAATCATT	GAAACACCGGTCTCGAGTGAGGTGTTCAGGGTGGGGTTAGAGCTAGAAAT	2	bc
AGTCCCCTAC	GAAACACCGGTAAATTTGAGGCTCCGGCATGCAGGAGGCCGTGGGGTTAG	2	bc
TACTTTACCG	GAAACACCGGTCGGGGCCACTCAGTGGTGGGGTTAGAGCTAGAAATAGCA	2	bc
GCGAATCGTT	GAAACACCGGTCTCGAGTGAGGTGTTCAGGGTGGGGTTAGAGCTAGAAAT	2	bc
CCAATACGTT	GAAACACCGGTCTCGAGTGAGGTGTTCAGGGTGGGGTTAGAGCTAGAAAT	2	bc
AAACGAACTA	GAAACACCGGTGCCCTTACTCTCACCTGATTACTTAATCCGTGGGGTTAG	2	bc
AAATCGTAGT	GAAACACCGGTGTACGTATGGACTGAACCAGGGTGTGCAAGTGGGGTTAG	2	bc
ACAAAACGCC	GAAACACCGGTTTGAACTAGAAATAGCAAGTTAACCTAAGGCTAGTCCGT	2	bc
AAGACGCTCG	GAAACACCGGTGCATTCGAAAGTCCGGTCGTAGTGTGGACGTGGGGTTAG	2	bc
ACGCATCCTT	GAAACACCGGTCTCGAGTGAGGTGTTCAGGGTGGGGTTAGAGCTAGAAAT	2	bc
AGGCACCATC	GAAACACCGGTGTGGCTGAGAGTCCGGCAATGGTGTGGCTGTGGGGTTAG	2	bc
AATGATTAGC	GAAACACCGGTTTACGTTGCATCGGTGTGGGGTTAGAGCTAGAAATAGCA	2	bc
ACCTATACCG	GAAACACCGGTCGGGGCCACTCAGTGGTGGGGTTAGAGCTAGAAATAGCA	2	bc
ACAACTTATA	GAAACACCGGTAACTATATTCATGCGATATCGCCGTATCAGTGGGGTTAG	2	bc
ATAACTTCTA	GAAACACCGGTAACTATATTCATGCGATATCGCCGTATCAGTGGGGTTAG	2	bc
CACTTTCTGC	GAAACACCGGTGACATTAGAGCTAGAAATAGCAAGTTAACCTAAGGCTAG	1	bc
ACTCAACGGC	GAAACACCGGTTTGAACTAGAAATAGCAAGTTAACCTAAGGCTAGTCCGT	1	bc
CGACTGCCAC	GAAACACCGGTCCGTAGGAGACCCGTGTGGCATGTACCTTGTGGGGTTAG	1	bc
CATAGTAGCC	GAAACACCGGTGTACGTATGGACTGAACCAGGGTGGGGTTAGAGCTAGAA	1	bc
ACATCGTAGT	GAAACACCGGTGTACGTATGGACTGAACCAGGGTGTTATCAACTTGAAAA	1	bc
GAAGAAACGA	GAAACACCGGTCGGCGGCAATTAGAGCTAGAAATAGCAAGTTAAACTAAG	1	bc
ACGCGTTGTA	GAAACACCGGTGACATTGGGTAGGGTTAGAGCTAGAAATAGCAAGTTAAC	1	bc
GTGAACTCTC	GAAACACCGGTTCCCGTCCAGTGGGGTTAGAGCTAGAAATAGCAAGTTAA	1	bc
AGAGTATCGA	GAAACACCGGTGACATTGGGAATAGGGGCGTGGTTAGGGCTAGAAATAGC	1	bc
CAATACGACC	GAGACACCGGTTTGGGGGTAGAGCTAGAAATAGCAAGTTAACCTAAGGCT	1	bc
GGCCAACACT	GCAACACCGGTAAATTTGAGGCTCCGGCATGCAGGAGGCCGTGGGGTTAG	1	bc
CGAGTAGGTT	GAAACACCGGTGGCATTGGGTAGGGTTAGAGCTAGAAATAGCAAGTTAAC	1	bc
AAGCCGCGCG	GAAACACCGGTGTACCTAAGGACTGAACCGGGGTGTGCCTGTGGGGATCG	1	bc
AGACCTCTAC	GAAACACCGGTAAATTTGAGGCTCCGGCATGCAGGAGGCCGTGGGGTTAG	1	bc
AAACCTGTAC	GAAACACCGGTAACTATATTCATGCGATATCGCCGTATCAGTGGGGTTAG	1	bc
AGACAGAGAC	GAAACACCGGTAGCAAGTGCGAGACGTGTTAAATAGCAAGTTAACCTAAG	1	bc
ACAAAGTATT	GAAACACCGGTGTACGTATGGACTGAACCAGGGTGTGCAAGTGGGGTTAG	1	bc
TCGACCCTCG	GAAACACCGGTGCATTCGAAAGTCCGGTCGTAGTGTGGACGTGGGGTTAG	1	bc
GTGAAGGATA	GAAACACCGGTTCCCGTCCAGTGGGGTTAGAGCTAGAAATAGCAAGTTAA	1	bc
AATCTACGTC	GAAACACCGGTGTACGTATGGACTGAACCAGGGTGTGCAAGTGGGGTTAG	1	bc
CACGCGATAA	GAAACACCGGTGCCCTTACTCTCACCTAATTACTTAATCCGTGGGGTTAG	1	bc
AGGCCCCAAA	GAAACACCGGTAAATTTGAGGCTCCGGCATGCAGGAGGCCGTGGGGTTAG	1	bc
TACAACGCAG	GCTAGAAATAGCAAGTTAACCTAAGGCTAGTCCGTTATCAACTTGAAAAA	1	bc
TCGAATCCGT	GAAACACCGGTCTCGAGTGAGGTGTTCAGGGTGGGGTTAGAGCTAGAAAT	1	bc
GGTGGAGCTT	GAAACACCGGTTCCCGTCCAGTGGGGTTAGAGCTAGAAATAGCAAGTTAA	1	bc
ATGCGGATAA	GAAACACCGGTTAAGCCGAGTGGGGTTAGAGCTAGAAATAGCAAGTTAAC	1	bc
GGAAGAATTT	GAAACACCGGTCTCGAGTGAGGTGTTCAGGGTGGGGTTAGAGCTAGAAAT	1	bc
TCTGCCGAGC	GAAACACCGATTCCCTTACTCTCACCTGATTACTTAATCCGTGGGGTTAG	1	bc
GTAGCACTGA	GAAACACCGGTTACATTGAGGGTTAGAGCTAGAAATAGCAAGTTAACCTA	1	bc
CTGAACGGAC	GGAACACCGGTACCTTTGTTGATGCTGGGTGGGGTTAGAGCTAGAAATAG	1	bc
TTACTCGTAC	GAAACACCGATACCTTTGTTGATGCTGGGTGGGGTTAGAGCTAGAAATAG	1	bc
GCAGCACTGT	GAAACACCGGTTACATTGAGGGTTAGAGCTAGAAATAGCAAGTTAACCTA	1	bc
ATTATAGAGG	GAAACACCGGTTATATTTGCAAGTGTTTTGTGGGGTTAGAGCTAGAAATA	1	bc
AAAACCGCGC	GAAACACCGGTGCATTCGAAAGTCCGGTCGTAGTGTGGACGTGGGGTTAG	1	bc
AGACGGCCAG	GAAACACCGGTCGGCGGCAATCTGGGGTTAGAGCTAGAAATAGCAAGTTA	1	bc
AGTACCTAGC	GAAACACCGGTGCATTCGAAAGTCCGGTCGTAGTGTGGACGTGGGGTTAG	1	bc
AATAGACGTC	GAAACACCGGTGTACGTATGGACCGAACCAGGGTGTGCAAGTGGGGTTAG	1	bc
GACGACGGCA	GAAACACCGGTACATGTATTGTTGCTGGGTGGGTATAGAGCTAGATATAG	1	bc
AATGCTTCAC	GGAACACCGGTTTACGTTGCATTGGTGTGGGGTTAGAGCTAGAAATAGCA	1	bc
TTATGTACGT	GAAACACCGGTTACATTGAGGGGTTAGAGTTAGAAATAACAAGTTGACAT	1	bc
GGAGGAGCCT	GAAACACCGGTTCCCGTCCAGTGGGGTTAGAGCTAGAAATAGCAAGTTAA	1	bc
AGGAACCCTC	GAAACACCGGTGTGGCTGAGAGTCCGGCAATGGTGTGGCTGTGGGGTTAG	1	bc
AGGAATCCTT	GAAACACCGGTCTCGAGTGAGGTGTTCAGGGTGGGGTTAGAGCTAGAAAT	1	bc
GAACGCCGTC	GAAACACCGGTGCCCTTACTCTCACCTGATTACTTAATCCGTGGGGTTAG	1	bc
GGCCAATAAC	GAAACACCGGTAAATTTGAGGCTCCGGCATGCAGGAGGCCGTGGGGTTAG	1	bc
GGGACCTAAA	GAAACACCGGTAAATTTGAGGCTCCGGCATGCAGGAGGCCGTGGGGTTAG	1	bc
AGTGGAGTCT	GAAACACCGGTTCCCGTCCAGTGGGGTTAGAGCTAGAAATAGCAAGTTAA	1	bc
AAACGTATAA	GAAACACCGGTAACTATATTCATGCGATATCGCCGTATCAGTGGGGTTAG	1	bc
TGCAACCTCA	GAAACACCGGTGTGGCTGAGAGTCCGGCAATGGTGTGGCTGTGGGGTTAG	1	bc
GAACGCCGAA	GAAACACCGGTGCCCTTACTCTCACCTGATTACTTAATCCGTGGGGTTAG	1	bc
ACAATACTTT	GAAACACCGGTCTCGAGTGAGGTGTTCAGGGTGGGGTTAGAGCTAGAAAT	1	bc
CGGAGCCGTC	GAAACACCGGTCTCGAGTGAGGTGTTCAGGGTGGGGTTAGAGCTAGAAAT	1	bc
AATGCTTATC	GAAACACCGGTTTACGTTGCATCGGGTTAGAGCTAGAAATAGCGAGTTAA	1	bc
AGGAACCGTC	GAAACACCGGTGTGGCTGAGAGTCCGGCAATGGTGTGGCTGTGGGGTTAG	1	bc
TCCCCCTCGC	GAAACACCGGTGCATTCGAAAGTCCGGTCGTAGTGTGGACGTGGGGTTAG	1	bc
GACCGATAGA	GAAACACCGGTAAATTTGAGGCTCCGGCATGCAGGAGGCCGTGGGGTTAG	1	bc
AATTTAGCGC	GAAACACCGGTCGGGGCCAGTGGGGTTAGAGCTAGAAATAGCAAGTTAAC	1	bc
ACGTGGCGTC	GAAACACCGGTGACATTGGGTTAGAGCTAGAAATAGCAAGTTAACCTAAG	1	bc
ATAATCGGGA	GAAACACCGGTCGATTCATATCTAATCCTTCCCGTGACGGTGGAGATAGA	1	bc
ATAGATACGC	GAAACACCGGTTTACGTTGCATCTAGAAATAGCAAGATAACCTAAGGCTA	1	bc
GTCAACCTTT	GAAACACCGGTGTGGCTGAGAGTCCGGCAATGGTGTGGCTGTGGGGGTAG	1	bc
ACAGCGTCGT	GAAACACCGGTGTACGTATGGACTGAACCAGGGTGTGCAAGTGGGGTTAG	1	bc
TTGACCTTGA	GAAACACCGGTTAACCCGATGAGTTAGAGCGAGAAATAGTAAATTAACCT	1	bc
TCGAGAACAA	GAAACACCGGTTAAGCCGAGGAGTTAGAGCTAGAAATAGCAAGTTAACCT	1	bc
AGACACAGCC	GAAACACCGGTAGCAAGTGCGAGACGTGTTTGTGGGGTTAGAGCTAGAAA	1	bc
AAAGAACTAC	GAAACACCGGTGCCCTTACTCTCACCTGATTACTTAATCCGTGGGGTTAG	1	bc
TTGCTGCCTA	GAAACACCGGTTCGTAGGAGACCCGGGTGTCGTGTACGTGTGGGGTTAGA	1	bc
CATAGACGTA	GAAACACCGGTGTACGTATGGACTGAACCAGGGTGTGCAAGTGGGGTTAG	1	bc
TAAGAGTCGC	GAAACACCGGTCGGCGGCAATCGTGGGTGGGGTTAGAGCTAGAAATAGCA	1	bc
CAACTGGCCT	GAAACACCGGTCCGTAGGAGACCCGTGTGGCATGTACCTGAGCGGGTAGT	1	bc
ACCTTCGGAC	GAAACACCGGTCGATTCATATCGAAACCTTCCCGTGACAGTGGGGTTAGA	1	bc
AGCCCCGAGC	GAAACACCGGTGCATTCGAAAGTCCGGTCGTAGTGTGGACGTGGGGTTAG	1	bc
ATGGCCAGGA	GAAACACCGGTTGAGCCGAGGTGTTATATCTAGAAATAGCAAGTTAACCT	1	bc
TAACGTAGTC	GAAACACCGGTGTACGTATGGACTGAACCAGGGTGTGCAAGTGGGGTTAG	1	bc
TTAAGCACAC	GAAACACCGGTTCAGACGAGGGGGGGTTAGAGCTAGAAATAGCAAGTTAG	1	bc
GCGTTTGGAT	GAAACACCGGTTGATTCATATCGGAACCTTCCCTTGACATTGGGATTGGA	1	bc
CTTCTACGGA	GAAACACCGGTCGGGGCCACTCAGTGGTGGGGTTAGAGCTAGAAATAGCA	1	bc
TGAACGTCGT	GAAACACCGGTGTACGTATGGACTGAACCAGGGTGTGCAAGTGGGGTTAG	1	bc
GGTCTATACA	GAAACACCGGTAAATTTGAGGCTCCGGCATGCAGGAGGCCGTGGGGTTAG	1	bc
ACGCGTTTTC	GAAACACCGGTGACATTGGGTACAGGGGGTGGGGTTAGAGCTAGAAATAG	1	bc
GACGGGGACA	GAAACACCGGTAGCAAGTGCGAGACGTGTTAAATAGCAAGTTAACCTAAG	1	bc
CGTACAGTCC	GAAACACCGGTGTGGCTGAGAGTCCGGCAATGGTGTGGCTGTGGGGTTAG	1	bc
GGATTCCTCC	GAAACACCGGTGTGGCTGAGAGTCCGGCAATGGTGTGGCTGTGGGTTAGA	1	bc
AGAACGCCCT	GAAACACCGGTGCCCTTACTCTCACCTGATTACTTAATCCGTGGGGTTAG	1	bc
AGTTAACAAC	GAAACACCGGTAAATTTGAGGCTCCGGCATGCAGGAGGCCGTGGGGTTAG	1	bc
ATTGCTTAGA	GAAACACCGGTTTACGTTGCATCGGTGTGGGGTTAGAGCTAGAGATAGCA	1	bc
GCTTTGACGC	GAAACACCGGTCGGGGCCACTCAGTGGTGGGGTTAGAGCTAGAAATAGCA	1	bc
AGTATGATTC	GAAACACCGGTCCGTAGGAGACCCGTGTGGCATGTACCTGTGGGGTTAGA	1	bc
CTGATTCGTT	GAAACACCGGTTTACGTTGCATCGGGGTTAGAGCTAGAAATAGCAAGATA	1	bc
ACGCTGATCT	GAAACACCGGTTTACGTTGCATCGGTGTGGGGTTAGAGCTAGAAATAGCA	1	bc
GTCGAGCTAC	GAAACACCGGTGCCCTTACTCTCACCTGATTACTTAATCCGTGGGGTTAG	1	bc
GACACCACAC	GAAACACCGGTGTGGCTGAGAGTCCGGCAATGGTGTGGCTGTGGGGTTAG	1	bc
TCTCTAGTGG	GAAACACCGGTTATATTTGTAAGTGTGTGGGGTTAGAGCTAGAAATAGCA	1	bc
GACGTGTTGT	GAAACACCGGTGACATTGGGTACAGGGGTGGGGTTAGAGCTAGAAATAGC	1	bc
AGATACTCGG	GAAACACCGGTACCTTTGTTGATGCTGGGTGGGGTTAGAGCTAGAAATAG	1	bc
AGAAGGCCCG	GAAACACCGGTCGGCGGCAATCGTGGGTGGGGTTAGAGCTAGAAATAGCA	1	bc
GATACTCGGC	GAAACACCGGTACCTTTGTTGATGCTGGGTGGAAGGAATTTTGTGGGGTT	1	bc
TCACACCGCC	GAAACACCGGTTTGAACTAGAAATAGCAAGTTAACCTAAGGCTAGTCCGT	1	bc
GACAGCTAAT	GAAACACCGGTAAATTTGAGGCTATGGCATGCAGGAGGACGTGGGGTTAG	1	bc
TAATTTATGT	GAAACACCGGTTACATTTGAGGGTTAGGGCTAGAAATAGCAAGTTAACCT	1	bc
AGGCATCATC	GAAACACCGGTGTGGCTGAGAGTCCGGCAATGGTGCGGCTGAGGGGCCAG	1	bc
ACATCTTCGA	GAAACACCGGTGTACGTATGGACTGAACCAGGGTGTGCAAAGTGGGGTTA	1	bc
AGCGAATAGT	GAAACACCGGTCTCGAGTGAGGTGTTCAGGGTGGGGTTAGAGCTAGAAAT	1	bc
ACTACTCGGA	GAAACACCGGTACCCTTGTTGATGCTGGGTGGAAGGAATGTGGGGTTAGA	1	bc
AACGTTACCG	GAAACACCGGTCGGGGCCACTCAGTGGTGGGGTTAGAGCTAGAAATAGCA	1	bc
ACACAACGCG	GAAACACCGGTTTGAACTAGAAATAGCAAGTTAACCTAAGGCTAGTCCGT	1	bc
TGAACACTCC	GAAACACCGGTGTGGCTGAGAGTCCGGCAATGGTGTGGCTGTGGGGTTAG	1	bc
TAACGCCATA	GAAACACCGGTGCCCTTACTCTCACCTGATTACTTAATCCGTGGGGTTAG	1	bc
CTCCCCTGCA	GAAACACTGGTGTGGCTGAGAGTCCGGCAATGGTGTGGCTGTGGGGTTAG	1	bc
GAAACGGAGA	GAAACACCGGTAGAGCCAGAAATAGCAAGTTAACCTAAGGCTAGTCCGTT	1	bc
CATAGGATAA	GAAACACCGGTCGGGGCCACTCAGTGGTGGGGTTAGAGCTAGAAATAGCA	1	bc
GCAGAACAGC	GAAACACCGGTCGGCGGCGAGGGGGGGTGGGGTTAGAGCTAGAAATAGCA	1	bc
ACAGCGTCGT	GAAACACCGGTGTACGTATGGACTGAACCAGGGTGTTATCAACTTGAAAA	1	bc
ATACTCGCAC	GAAACACCGGTACCTTTGTTGATGCTGGGTGGAAGGAAAAAGTGGCACCG	1	bc
AGGAACCCGA	GAAACACCGGTGTGGCTGAGAGTCCGGCAATGGTGTGGCTGTGGGGTTAG	1	bc
CAGAGCCTAG	GAAACACCGGTTAACCCGAGGAGTTAGAGCTGGAAGAAGCAAGTTAACCA	1	bc
AAAAGCGCTA	GAAACACCGGTGCCCTTACTCTCACCTGATTACTTAATCCGTGGGGTTAG	1	bc
ACATTTACAG	GCACCGGTCGGGGCCACTCAGTGGTGGGGTTAGAGCTAGAAATAGCAAGT	1	bc
AGAAAGTCTA	GAAACACCGGTGCATTCGAAAGTCCGGTCGTAGTGTGGACGTGGGGTTAG	1	bc
AACGCACAAA	GAAACACCGGTGCCCTTACTCTCACCTGATTACTTAATCCGTGGGGTTAG	1	bc
TCGTGACTGC	GAAACACCGGTCGGGGCCACTCAGTGGTGGGGTTAGAGCTAGAAATAGCA	1	bc
TGTGATTTGA	GAAACACCGGTAAATTTGAGGCTCCGGCATGCAGGAGGCCGTGGGGTTAG	1	bc
AGTCTTGCTA	GAAACACCGGTCCGTAGGAGACCCGTGTGGCATGTACCTCTGTGGGGTTA	1	bc
GCGCTTAGCC	GAAACACCGGTTTACGTTGCATCGGTGTGTGGTTAGAGCTAGAAATAGCA	1	bc
CCATACAGCC	GAGACACCGGTCGGGGCCACTCAGTGGTGGGGTTAGAGCTAGAAATAGCA	1	bc
AAGGGTTGTC	GAAACACCGGTGACATTAGAGCTAGAAATAGCAAGTTAACCTAAGGCTAG	1	bc
GACGAATCCT	GAAACACCGGTCTCGAGTGAGGTGTTCAGGGTGGGGTTAGAGCTAGAAGT	1	bc
GAACACCTCC	GAAACACCGGTGTGGCTGAGAGTCCGGCAATGGTGTGGCTGTGGGGTTAG	1	bc
GACGCACGGA	GAAACACCGGTCGGCGGCAATCGTGGGTGGGGTTAGAGCTAGAAATAGCA	1	bc
AAGAAGCCTC	GAAACACCGGTTCCCGTCCAGTGGGGTTAGAGCTAGAAATAGCAAGTTAA	1	bc
AGGCGGCCAC	GAAACACCGGTCCGTAGGAGACCCGTGTGGCATGTACCTGTGGGGTTAGA	1	bc
TCAATCATAA	GTTAACCTAAGGCTAGTCCGTTATCAACTTGAAAAAGTGGCACCGAGTCG	1	bc
GCGAATACTT	GAAACACCGGTCTCGAGTGAGGTGTTCAGGGTGGGGTTAGAGCTAGAAAT	1	bc
GACACCATAC	GAAACACCGGTGTGGCTGAGAGTCCGGCAATGGTGTGGCTGTGGGGTTAG	1	bc
ATCTAGCGAT	CAAGTTAACCTAAGGCTAGTCCGTTATCAACTTGAAAAAGTGGCACCGAG	1	bc
CGGAGCATTA	GAAACACCGGTTTTAGTGGGGGTAGACATAGAAATAGTAAATTAACCTAT	1	bc
GACTTCATCC	GAAACACCGGTGTGGCTGAGAGTCCGGCAATGGTGTGGCTGTGGGGTTAG	1	bc
AGTAAGTCTC	GAAACACCGGCCCGTAGGAGACCCGTGTGGCATGTACCTGTGGGGTTAGA	1	bc
TGACCCTAGA	GAAACACCGGTAAATTTGAGGCTCCGGCATGCAGGAGGCCGTGGGGTTAG	1	bc
AACGCCTAAG	GAAACACCGGTGCCCTTACTCTCACCTGATTACTTAATCCGTGGGGTTAG	1	bc
ACATCACCCC	GAAACACCGGTCCGTACGAGACCCGGGTGGCATGTACCTGGGGGGTTAGA	1	bc
AGAAGACACG	GAAACACCGGTCGGCGGCAATCGTGGGGTGGGGTTAGAGCTAGAAATAGC	1	bc
ATCTATAGAG	GAAACACCGGCTATATTTGTAAGTGTGTGGGGTTAGAGCTAGAAATAGCA	1	bc
TTGATCATTC	GAAACACCGGTTAAGCCGAGGAGTTAGAGCTAGAAATAGCAAGTTAACCT	1	bc
AACATGCCTC	GAAACACCGGTCCGTAGGAGACCCGTGTGGCATGTACCTGTGGGGTTAGA	1	bc
TTGCCTGCAG	GAAACACCGGTCTCGAGTGAGGTGTTCAGGTGGGGTTAGAGCTAGAAATA	1	bc
AACGCCATGT	GAAACACCGGTTCCCTTACTCTCACCTGATTACTTAATCCGTGGGGTTAG	1	bc
GACCAAAATT	GAAACACCGGTAGCAAGTGCGGGGTTAGAGCTATAAATAGCGAGTTAACC	1	bc
GGCTAGCACA	GAAACACCGGTAAATTTGAGGCTCCGGCATGCAGGAGGCCGTGGGGTTAG	1	bc
GGCTTACTCC	GAAACATCGGTGTGGCTGAGAGTCCGGCAATGGTGTGGCTGTGGGGTTAG	1	bc
CCTAGTCGTT	GAAACACCGGTGTACGTATGGACTGAACCAGGGTGTGCAAGTGGGGTTAG	1	bc
CGTGTCGTAC	GAAACACCGGTGCATTTGAATACCCGGTCGGAGTTAGGACTAGAGATTGG	1	bc
AACAAAGAAA	GAAACACCGGTAGCAAGTGCGAGACGTGTTTGTGGGGTTAGAGCTAGAAA	1	bc
TTGCCTAGAT	GAAACACCGGTTTACGTTGCATCGGTGTGGGGTTAGAGCTAGAAATAGCA	1	bc
CGAGCCATTT	GAAACACCGGTCTCGAATGAGGTGTTCAGGGTGGGGCTAGAGCTAGAAAT	1	bc
CATTTATGGC	GAAACACCGGTCGGGGCAAGTTAACCTAAGGCTAGTCCGTTACAACTTGA	1	bc
GTGCTCATCC	GAAACACCGGTTTACGTTGCATCGGTGCGGGGGTAGAGCTAGAAATAGCA	1	bc
AAAGTCTCAT	GAAACACCGGTCGGCGGCAAATGGGGTTAGAGCTAGAAATAGCAAGTTAA	1	bc
AGGCAGCGTC	GAAACACCGGTGTGGCTGAGAGTCCGGCAATGGTGTGGCTGTGGGGTTAG	1	bc
TATCGTGGGA	GAAACACCGGTTATATTTGTAAGTGTGTGGGGTTAGAGCTAGAGATAGCA	1	bc
AATTTACCCC	GAAACACCGGTCGGGGCCACTCAGTGGTGGGGTTAGAGCTAGAAATAGCA	1	bc
AAGTGTTTTA	GGTTAGAGCTAGAAATAGCAAGTTAACCTAAGGCTAGTCCGTTATCAACT	1	bc
AGGTACACTA	GAAGCACCGGTGTGGCTGAGAGTCCGGCAATGGTGTGGCTGTGGGGTTAG	1	bc
CACTCCGCAC	GAAACACCGGTTTGAACCGGTGGGGTTAGAGCTAGAAATAGCAAGTTAAC	1	bc
GAATGGCTGT	GAAACACCGGTTTGCGTTGCATCGGTGTGGGGTTAGAGCTAGAAATAGCA	1	bc
AAATAACTAG	GAGAAACCGGTGCATTCGCAAGTCCGTTCTTAGTGTTGACGTGGACTTCG	1	bc
GTAGGTAGGT	GAAACACTGGTTACATTGAGGGTTAGAGCTAGAAATAGCAAGTTAACCTA	1	bc
GCAACCCTAC	GAAACACCGGTGTGGCTGAGAGTCCGGCAATGGTGTGGCTGTGGGGTTAG	1	bc
GGGGTGACAC	GAAACACCGGTTCCCGTCCAGTGGGGTTAGAGCTAGAAATAGCAAGTTAA	1	bc
TGGCACATAC	GAAACACCGGTAAATTTGAGGCTCCGGCATGCAGGAGGCCGTGGGGTTAG	1	bc
GAAATCATAA	GAAACACCGATCGGCCGTGGGGGGTGAAGGAGGAAAAAAAAGCTAAACAA	1	bc
ATGAGCTATG	GAAACACCGGTTACATTGAGGGTTAGAGCTAGAAATAGCAAGTTAACCTA	1	bc
AAACGCACTA	GAAACACCGGTGCCCTTACTCTCACCTGATTACTTAATCCGTGGGGTTAG	1	bc
ACATGGTCGC	GAAACACCGGTGTACGTATGGACTGAACCAGGGTGTGCAAGTGGGGTTAG	1	bc
AATGCTAAGC	GAAACACCGGTTTACGTTGCATCGGTGTGGGGTCAGAGCTAGAAATAGCA	1	bc
AAAGTGCCTA	GAAACACCGGTGCCCTTACTCTCACCTGATTACTTAATCCGTGGGGTTAG	1	bc
AACGGACTCC	GAAACACCGGTGCCCTTGCTCTCACCTGATTACTTAATCCGTGGGGTTAG	1	bc
GGTGAGCATC	GAAACACCGGTTCCCGTCCAGTGGGGTTAGAGCTAGAAATAGCAAGTTAA	1	bc
GACGTACTCT	GAAACACCGGTTACATTGAGATTAGAGCTAGAAAAGGCTAGTCCGTTATC	1	bc
CCTTTCCCCA	GAAACACCGGTCGGGGCCACTCGGTGGTGGGGTTAGAGCTAGAAATAGCA	1	bc
ATAGCTTATA	GAAACACCGGTAACTATATTCATGCGATATCGCCGTATCAAGTGGGGTTA	1	bc
TATGCTTTGG	GAAACACCGGTTTACGTTGCATCGGTGTGGGGTTAGAGCTAGAAATAGCA	1	bc
GTGTCTATGT	GAAACACCGGTTACATTCTGAGGGTTAGAGCTAGAAATAGCAAGTTAACC	1	bc
GAATCGTAGT	GAAACACCGGTGTACGTATGGACTGAACCAGGGTGTGCAAGTGGGGTTAG	1	bc
AGAATCGGCC	GAAACACCGGTACCTTTGTTGATGCTGGGGTGGGGTTAGAGCTAGAAATA	1	bc
AGTGGAACCT	GAAACACCGGTTCCCGTCCAGTGGGGTTAGAGCTAGAAATAGCAAGTTAA	1	bc
ATTGATCATC	GAAACACCGGTTAAGCCGAGGATGGGGTTAGAGCTAGAAATAGCAAGTTA	1	bc
GAAAACTAGG	GAAACACCGGTACCTTTGTTGATGCTGGGTGGAAGGTGGGGTTAGAGCTA	1	bc
AACGAATAAT	GAAACACCGGTCTCGAGTGAGGTGTTCAGGGTGGGGTTAGAGCTAGAAAT	1	bc
GCACAACGAC	GAAACACCGGTTTGAACTAGAAATAGCAAGTTAACCTAAGGCTAGTCCGT	1	bc
AAGTCTGGCT	GAAACACCGGTCCGTAGGAGACCCGTGTGGCATGTACCTGTGGGGTTAGA	1	bc
AATGAGCATA	GAAACACCGGTTAAGCCGAGTGGGGTTAGAGCTAGAAATAGCAAGTTAAC	1	bc
ATAGGTGTCT	GAAACACCGGTGACATTGGGTACAGGGGTGGGGTTAGAGCTAGAAATAGC	1	bc
ATGTATAGTT	GAAACACCGGTTTACGTTGCATCGGTGTGGGGTTAGAGCTAGAAATAGCA	1	bc
TAACTGCTAA	GAAACACCGGTAACTATATTCATGCGATATCGCCGTATCAGTGGGGTTAG	1	bc
ATCTCTCGAG	GAAACACCGGTTATATTTGTAAGTGTGTGGGGTTAGAGCTAGAAATAGCA	1	bc
AACTGCTTAA	GAAACACCGGTGCCCTTACTCTCACCTGATTACTTAATCCGTGGGGTTAG	1	bc
AATAGACGTC	GAAACACCGGTGTACGTATGGACTGAACCAGGGTGTGGGTTAGAGCTGGA	1	bc
TATCTTCATC	GAAACACCGGTGTACGTATGGACTGAACCAGGGTGTGCAAGTGGGGTTAG	1	bc
GCTCCTCGGC	GAAACACCGGTACCTTTGTTGATGCTGGGTGGGGTTAGAGCTAGAAATAG	1	bc
GAGTATGCCT	GAAACACCGGTCCGTAGGAGACCCGTGTGGCATGTACCTCTGTGGGGTTA	1	bc
CGTGCATGCT	GAAACACCGGTGGCATTAGGAACAGGGGTGGGGTTAGAGCTAGAAGTAGC	1	bc
CGGGCTCTTA	GAAACACCGGTGACAGGTGGGGTTAGAGCTAGAGATAGCAAGTTAACATA	1	bc
GAAACGACCT	GAAACACCGGTGCCCTTACTCTCACCTGATTACGTAATCCGTGGGGTTAG	1	bc
TTAGCGATAC	GAAACACCGGTTACATTGAGGGGTTAGAGCTAGAAATAGCAAGTTAACCT	1	bc
GGTGATGACT	GAAACACCGGTGACATTGGGTTAGAGCTAGAAATAGCAAGTTAACCTAAG	1	bc
GCGAATCCAT	GAAACACCGGTCTCGAGTGAGGTGTCCAGGGTGGGGTTAGAGCTAGAAAT	1	bc
CAGTTAATGC	GAAACACCGGTCGGGGCCACTCAGTGGTGGGGTTAGAGCTAGAAATAGCA	1	bc
TCCTTCACCG	GAAACACCGGTCGGGGCCACTCAGTGGTGGGGTTAGAGCTAGAAATAGCA	1	bc
GCACAAGCCG	GAAACACCGGTTTGAACTAGAAATAGCAAGTTAACCTAAGGCTAGTCCGT	1	bc
CCCAACCCAT	GAAACACCGGTTTCGTGGGATGGGTTCAGGTGGGGTTAGAGCTAGTAATA	1	bc
GGAAACTACC	GAAACACCGGTAAATTTGAGGCTCCGGCATGCAGGAGGCCGTGGGGTTAG	1	bc
AAATCGTCGT	GAAACACCGGCGTACGTATGGACTGAACCAGGGTGTGCAAGTGGGGTTAG	1	bc
TCATTTAACG	GAAACACCGGTCGGGGCCACTCAGTGGTGGGGTTAGAGCTAGAAATAGCA	1	bc
GGCAAGATCA	GAAACATCGGTGTGGCTGAGAGTCCGGCAATGGTGTGGCTGTGGGGTTAG	1	bc
CAGCTTAGTC	GAAACACCGGTGTACGTATGGACTGAACCAGGGTGTGCAAGTGGGGTTAG	1	bc
AGACCCGGTC	GAAACACCGGTGCATTCGAAAGTCCGGTCGTAGTGTGGACGTGGGGTTAG	1	bc
AACGCTAAGC	GAAACACCGGTCTACGTTGCATCGGTGTGGGGTTAGAGCTAGAAATAGCA	1	bc
GCACGATCGA	GAAACACCGGTGCCCTTACTCTCACCTGATTACTTAATCCGTGGGGTTAG	1	bc
ACATCGTAGT	GAAACACCGGTGTACGTATGGACTGAACCAGGGTGTGCAAGTGGGGTTAG	1	bc
AATGTTCGGC	GAAACACCGGTACCTTTGTTGATGCTGGGTGGGGTTAGAGCTAGAAATAG	1	bc
CTGCGTCATC	GAAACACCGGTGTACGTCTGGACTGAACCAGGGTGTTATCAACTTGAAAA	1	bc
CGATTCTCTC	GAAACACCGGTGCATTCGAAAGTCCGGTCGTAGTGTGGACGTGGGGTTAG	1	bc
AGGCTCTAGA	GAAACACCGGTGCATTCGACAGTCCGGTCGTAGTGTGGACGTGGGGTTAG	1	bc
AAGTGTTGTC	GAAACACCGGTGACATTGGGTAAAATAGCAAGTTAACCTAAGGCTAGTCC	1	bc
ACGATCGGGG	GAAACACCGGTTATATTTGCAAGGGTTGTGGGTTTAAAGCTGGAAATAGC	1	bc
GGTATCCCTT	GAAACACCGGTCTCGAGTGACGCGTTCAGGGTGTGGTTATAGCTAGAAAT	1	bc
AGCGTTAGAG	GAAACACCGGTAGCAAGTGCGAGACGTGTTAAATAGCAAGTTAACCTAAG	1	bc
AGGGATACAT	GAAACACCGGTTCACGTTGCGTCGGCGTGGGGTTAGAGCTAGAAATAGCA	1	bc
GACATGGAGC	GAAACACCGGTAGCAAGTGGGGTTAGAGCTAGAAATAGCAGGTTAACCTA	1	bc
GAAAACACCC	GAAACACCGGTTTGAACTAGAAATAGCAAGTTAACCTAAGGCTAGTCCGT	1	bc
TGAAGACTCG	GAAACACCGGTCGGCGGTGGGGTTAGAGCTAGAAATAGCAAGTTAACCTA	1	bc
AATCAGCGCC	GAAACACCGGTTTGAACTAGAAATAGCAAGTTAACCTAAGGCTAGTCCGT	1	bc
GCAAACACGC	GAGACACCGGTCGGCGGCAATCGTGGGTGGGGTTAGAGCTAGAAATAGCA	1	bc
GATGTTCGTA	GAAACACCGGTGTACGTATGGACTGAACCAGGGTGTGCAAGTGGGGTTAG	1	bc
AAAAGACCTA	GAAACACCGGTGCCCTTACTCTCACCTGATTACTTAATCCGTGGGGTTAG	1	bc
CTGCGTAGGT	GAAACACCGGTTTACGTTGCATCGGTGTGGGGTTAGAGCTTGAAATAGCA	1	bc
AAGCGTGGTC	GAAACACCGGTGTACGTATGGACTGAACCAGGGTGTGCAAGTGGGGTTAG	1	bc
GACTTTAGCG	GAAACACCGGTCGGGGCCACTCAGTGGTGGGGTTAGAGCTAGAAATAGCA	1	bc
GTGCGGCCTA	GAAACACCGGTTCCCGTCCAGTGGGGTTATAGCTAGAAATAGCAAGTTAA	1	bc
ACTTGACCAC	GAAACACCGGTCGGGGCCACTCAAGTGGGGTTAGAGCTAGAAATAGCAAG	1	bc
CGTTTTGGTT	GAAACACCGGTGACATTGGGAGTGGGGTTAGAGCTAGAAATAGCAAGTTA	1	bc
ATGCGCATGC	GAAACACCGGTTAAGCCGAGTGGGGTTAGAGCTAGAAATAGCAAGTTAAC	1	bc
ATAATTTATT	GAAACACCGGTAACTATATTCACGCGATATCGCCGTATCAGTGGGGTTAG	1	bc
TATGCGTAGC	GAAACACCGGTTTACGTTGCATCGGTGTGGGGTTAGAGCTAGAAATAGCA	1	bc
AGATATCTGT	GAAACACCGGTCTCGAGTGAGGGGTTCAGGGTGGGGTTAGAGCTAGAAAT	1	bc
GTTCTGCTGT	GAAACACCGGTTTACGTTGCATCGGTGTGGGGTTAGAGCTAGGAATAGCA	1	bc
CAATACGGTT	GAAACACCGGTCGATTCATATCGAAACCTTCCCGTGACAGTGGGGTTAGA	1	bc
TAGAATCGTT	GAAACACCGGTCTCGAGTGAGGTGTTCAGGGTGGGGTTAGAGCTAGAAAT	1	bc
GGACAAAGAC	GAAACACCGGTAGCAAGTGCGAGACGTGTTTGTGGGGTTAGAGCTAGAAA	1	bc
AAATGCGTTA	GAAACACCGGTTAAGCCGAGTGGGGATATAGCTAGAAATAGCAAGCTAAC	1	bc
ATTGAGCATC	GAAACACCGGTTAAGCCGAGTGGGGTTAGAGCTGGAAATAGCAAGTTAAC	1	bc
AGGGTCCATC	GAAACACCGGTGTGGCTGGGAGTCCGGCAATGGTGTGGCTGTGGGGTTAG	1	bc
ATAATTCTCT	GAAACACCGGTTTCGAGTGAGGTGTTCAGGGTTGGGTTAGAGCTATAACT	1	bc
ACCTTTAGCG	GAAACACCGGTCGGGGCCACTCAGTGGTGGGGTTAGAGCTAGAAATAGCA	1	bc
ATAAATTATT	GAAACACCGGTAACTATATTCATGCGATATCGCCGTATCAAGTGGGGTTA	1	bc
ACACCCGCCC	GAAACACCGGTGCATTCGAAAGTCCGGTCGTAGTGTGGACGTGGGGTTAG	1	bc
ATATGCATAA	GAAACACCGGTTAAGCCGAGGAGTTAGAGCTAGAAATAGCAAGTTAACCT	1	bc
CTGTTAGCTC	GAAACACCGGTCGGGGCCACTCAGTGGTGGGGTTAGAGCTAGAAATAGCA	1	bc
ATCATCGTGG	GAAACACCGGTGTACGTATGGACTGAACCAGGGTGGGGTTAGAGCTAGAA	1	bc
AGACTGCATA	GAAACACCGGTAGCAAGTGCGAGACGTGTTAAATAGCAAGTTAACCTAAG	1	bc
ATACTGACTC	GAAACACCGGTCCGTAGGAGACCCGTGTGGCATGTACCTGTGGGGTTAGA	1	bc
GGTTAACCGC	GAAACACCGGTCGGGGCCACTCAGTGGTGGGGTTAGAGCTAGAAATAGCA	1	bc
GATACTCTCG	GAAACACCGGTGCATTCGAAAGTCCGGTCGTAGTGTGGACGTGGGGTTAG	1	bc
AAAGCCTCAC	GAAACACCGGTGCCCTTACTCTCACCTGATTACTTAATCCGTGGGGTTAG	1	bc
GTATTCCTCG	GAAACACCGGTGCATTCGAAAGTCCTTTCGTAGTGGGGACGTGGGGTTAG	1	bc
GCAATAGCGG	GAAACACCGGTTATATTTGTAAGTGTGTGGGGTTAGAGCTAGAAATAGCA	1	bc
ACGTCGTAGG	GAAACACCGGTGTACGTATGGACTGAACCAGGGTGTGCATGTGGGGTTAG	1	bc
TCTAATCGGC	GAAACACCGGTACCTTTGTTGATGCTGGGTGGAAGGAATTTTGTGGGGTT	1	bc
GATCTATCGA	GAAACACCGGTTATATTTGTAAGTGTTGTGGGGTTAGAGCTAGAAATAGC	1	bc
AAAACCTAGC	GAAACACCGGTGCATTCGAAAGTCCGGTCGTAGTGTGGACGTGGGGTTAG	1	bc
GAGACCGACT	GAAACACCGGTATCAAATGCGAGGCGTGGTGGGGGGGTTGGAGCTAAAAG	1	bc
ATGTATCGCT	GAAACACCGGTTTACGTTGCATCGGTGTGGGGTTAGAGCTAGAAATAGCA	1	bc
AGTCGAGACT	GAAACACCGGTTCCCGTCCAGTGGGGTTAGAGCTAGAAATAGCAAGTTAA	1	bc
CCTCTAGCTC	GAAACACCGGTTTGAACTAGAAATAGCAAGTTAACCTAAGGCTAGTCCGT	1	bc
CATAACGCGT	GAAACACCGGTTGAACCGGTGGGGTTAGAGCTAGAAATAGCAAGTTAACC	1	bc
TTTGGTTTGT	GAAACACCGGTTACATTGAGGGTTAGAGCTAGAAATAGCAAGTTAACCTA	1	bc
GCATTTAATG	GAAACACCGGTCGGGGCCACTCAGTGGTGGGGTTAGAGCTAGAAATAGCA	1	bc
ATGGATATGT	GAAACACCGGTTACATTGAGGGTTAGAGCTAGAAATAGCAAGTTAACCTA	1	bc
GACGTACGGT	GAAACACCGGTCGATTCATATCGAAACCTTCCCGTGACAGTGGGGTTAGA	1	bc
AACTTTACCG	GAAATACCGGTCGGGGCCACTCAGTGGTGGGGTTAGAGCTAGAAATAGCA	1	bc
GGCAACCATA	GAAACACCGGTTTGGCTGCGAGTCCGGCGATGGTGTGGCTGAGGGGTTAG	1	bc
ATACTAACGC	GAAACACCGGTGCATTCGAAAGTCCGGTCGTAGTGTGGACGTGGGGTTAG	1	bc
GAGAGCGTAA	GAAACACCGGTAGCAAGTGCGAGACGTGTTTGTGGGGTTAGAGCTAGAAA	1	bc
GAAGGCACTT	GAAACACCGGTCGGCGGCAATCGTGGGTGGGGTTAGAGCTAGAAATAGCA	1	bc
AGAGAACGCC	GAAACACCGGTTTGAACTAGAAATAGCAAGTTAACCTAAGGCTAGTCCGT	1	bc
CACGCCATTC	GAAACACCGGTGCCCTTACTCTCACCTGATTACTTGATCCGTGGGGTTAG	1	bc
ACGTGGTGTC	GAAACACCGGTGACATTAGAGCTAGAAATAGCAAGTTAACCTAAGGCTAG	1	bc
GGCGATCCGC	GAAACACCTAAGGCTAGTCCGTTATCAACTTGAAAAAGTGGCACCGAGTC	1	bc
GGAAGTGTAT	GAAACACCGGTCTCGAGTGAGGTGTTCAGGGGGGGTTAGAGCTAGAAATA	1	bc
TCACGCCCTA	GAAACACCGGTGCCCTTACTCTCACCTGATTACTTAGTCCGTGGGGTTAG	1	bc
ACGAATCCCT	GAAACACCGGTCTCGAGTGAGGTGTTCAGGGTGGGGTTAGAGCTAGAAAT	1	bc
AGACGCAGAC	GAAACACCGGTAGCAAGTGCGAGACGTGTTTGTGGGGTTAGAGCTAGGAA	1	bc
CAGATCGTCC	GAAACACGGGTTAGAGCTAGAAATAGCAAGTTAACCTAAGGCTAGTCCGT	1	bc
AGCGAGCTAC	GAAACACCGGTGCCCTTACTCTCACCTGATTACTTAATCCGTGGGGTTAG	1	bc
AAGTGGAGGA	GAAACACCGGTTCCCGTCCAGTGGGGTTAGAGCTAGAAATAGCAAGTTAA	1	bc
TTCACAAACC	GAAACACCGGTAGCAAGTGCGAGACGTGTTTGTGGGGTTAGAGCTAGAAA	1	bc
ATTATCTATG	GAAACGAGGGTTAGAGCTAGAAATAGCAAGTTAACCTAAGGCTAGTCCGT	1	bc
AGAACTATCC	GAAACACCGGTGTGGCTGAGAGTCCGGCAATGGTGTGGCTGTGGGGTTAG	1	bc
CACATCACAC	GAAACACCGGTGCCCTTACTCACACCTGATTACTTAATCCGTGGGGTTAG	1	bc
GAAAGTGATA	GAAACACCGGTAGCAAGTGCGAGACGTGTTAAATAGCAAGTTAACCTAAG	1	bc
TGTCTAGATA	GAAACACCGGTTAATTTGACGCGCCGTCATGCAGGAGGCGGGGGGGTTAG	1	bc
GACTCAGCAA	GAAACACCGGTAGCAAGTGGGGTTAGAGCTAGTTATAGCAAGTTAACCTA	1	bc
GATTAAGACA	GGAACACCGGTAGCAAGTGCGAGACGTGTTTGTGGGGTTAGAGCTAGAAA	1	bc
AGGCCCATAA	GAAACACCGGTAAATTTGAGGCTCCGGCATGCAGGAGGCCGTGGGGTTAG	1	bc
GCCAACCCGC	GAAACACCGGTCGGCGGCAATGGGGTTAGAGCTAGAAATAGCAAGTTACC	1	bc
CCGAAAGACC	GAAACACCGGTAATCAGAGGTGAACGTAAGGTGGGGTTAGAGCTAGAAAT	1	bc
TCATTTACCG	GAAACACCGGTCGGGGCCACTCAGTGGTGGGGTTAGAGCTAGAAATAGCA	1	bc
ATGCGTGGCA	GAAACACCGGTTTACGTTGCATCGGGGTTAGAGCAAGAAATAGCAAGTTA	1	bc
GCGATTACTT	GAAACACCGGTCTCGAGTGAGGTGTTCAGGGTGGGGTTAGAGCTAGAAAT	1	bc
GCACAATGGA	GAAACACCGGTTTGAACTAGAAATAGCAAGTTAACCTAAGGCTAGTCCGT	1	bc
TATTCTGACT	GAAACACCGGTCCGTAGGAGACCCGTGTGGCATGTACCTGTGGGGTTAGA	1	bc
ATGTGAAGCA	GAAACACCGGTTCCCGTCCAGTGGGGTTAGAGCTAGAAATAGCAAGTTAA	1	bc
ATTTAGCCTA	GAAACACCGGTTAAGCCGAGGAGTTAGAGCTAGAAATAGCAAGTTAACCT	1	bc
ACCAACGCGC	GAAACACAGCAAGTTAACCTAAGGCTAGTCCGTTATCAACTTGAAAAAGT	1	bc
CTAAGAAGTT	GAAACACCGGTGTACGTATGGACTGAACCAGGGTGTGCAAGCTGGGTTAG	1	bc
AAGCCAGAAA	GAAACACCGGTAAATTTGAGGCTCCGGCATGCAGGAGGCCGTGGGGTTAG	1	bc
GGTAACCTTC	GAAACACCGGTGTGGCTGAGAGTCCGGCAATGGTGTGGCTGTGGGGTTAG	1	bc
TTGGCGACGT	GAAACACCGGTTACATTGAGGGTTAGAGCTAGAAGTAGCAAGTTAACCTA	1	bc
TCACAGCGTC	GAAACACGGGTTAGAGCTAGAAATAGCAAGTTAACCTAAGGCTAGTACGT	1	bc
AATGATTAGC	GAAACACCGGTTTACGTTGGGGGTTAGAGCTAGAAATAGCAAGTTAACCT	1	bc
ACTATAGAGT	ATAGCAAGTTAACCTAAGGCTAGTCCGTTATCAACTTGAAAACGTGGCAC	1	bc
GAAAGTGACA	GAAACACCGGTAGCAAGTGCGAGACGTGTTTGTGGGGTTAGAGCTAGAAA	1	bc
AGTGTCGCCT	GAAACACCGGTTCCCGTCCAGTGGGGTTAGAGCTAGAAATAGCAAGTTAA	1	bc
CGGCGTCGTA	GAAACACCGGTGTACGTATGGACTGAACCAGGGTGTGCAAGTGGGGTTAG	1	bc
GACGACCCCA	GAAACACCGGTCGGCGGCAATCGTGGTTAGAGCTAGAAATAGCAAGTTAA	1	bc
GGACACTTCA	GAAACACCGGTAAATTTGAGGCTCCGGCATGCAGGAGGCCGAAATAGCAA	1	bc
AAACAACGAC	GAAACACCGGTTTACCGGGGTTAGAGCTAGAAATAGCAAGTTAACCTAAG	1	bc
AGTAGCTATG	GAAACACCGGTTACATTGAGGGTTAGAGCTAGAAATAGCAAGTTAACCTA	1	bc
GTGGATACAA	GAAACACCGGTTCCCGTCCAGTGGGGTTAGAGCTAGAAATAGCAAGTTAA	1	bc
GAAACGTAGT	GAAACACCGGTGTACGTATGGACTGAACCAGGGTGTTATCAACTTGAAAA	1	bc
CGCCTGTCTC	GAAACACCGGTCCGTAGGAGACCCGTGTGGCATGTACCTGTGGGGTTAGA	1	bc
AGATTCCGTA	GAAACACCGGTTTGAACTAGAAATAGCAAGTTAACCTAAGGCTAGTCCGT	1	bc
GTGCATCGCT	GAAACACCGGTTTACGTTGCATCGGAAAAAGTGGCACCTTTTTTTTTTCA	1	bc
AAAAGACACG	GAAACACCGGTCGGCGGCAATCGTGGGTGGGGTTAGAGCTAGAAATAGCA	1	bc
AGAACATCGA	GAAACACCGGTGCATTCGAAAGTCCGGTTGTAGTGTGGACGTGGGGTTAG	1	bc
ATAGATTAGA	GAAACACCGGTAACTATATTCATGCGATATCGCCGTATCAGTGGGGTTAG	1	bc
AATGTTTAGC	GAAACACCGGCTTACGTTGCATCGGTGTGGGGTTAGAGCTAGAAATAGCA	1	bc
CACCTTTACC	GAAACACCGGTCGGGGCCACTCAGTGGTGGGGTTAGAGCCAGAAATAGCA	1	bc
AGTGGAGCTT	GAAACACCGGTTCCCGTCCAGTGGGGTTAGAGCTAGAAATAGCAAGTTAA	1	bc
ACCTTTATCG	GAAACACCGGTCGGGGCCACTCAGTGGTGGGGTTAGAGCTAGAAATAGCA	1	bc
AAAGACATAC	GAAACACCGGTGCCCTTACTCTCACCTGATTTTGGGGTTAGAGCTAGAAA	1	bc
TAAAGCATTA	GAAACACCGGTCTCGAGGGAGGGGTTCAGGGGGGGGATAGAGCTAGAAAT	1	bc
GAAGCCACGT	GAAACACCGGTCGGCGGCAATCGTGGGGTGGGGTTAGAGCTAGAAATAGC	1	bc
CATAGCGGGA	GAAACACCGGTACCTTTGTTGATGCTGGGTGGAAGGAATTTGTGGGGTTA	1	bc
CACATCACAC	GAAACACCGGTTTGAACTAGAAATAGCAAGTTAACCTAAGGCTAGTCCGT	1	bc
AACTTGAGCG	GAAACACCGGTCGGGGCCACTCAGTGGTGGGGTTAGAGCTAGAAATAGCA	1	bc
ATGTTTATCC	GAAACACCGGTTTACACCGGTGGGGTTAGAGCTAGAAATAGCAAGTTAAC	1	bc
CCTTTCACGA	GAAACACCGGTCGGGGCCACTCAGTGGTGGGGTTAGAGCTAGAAATAGCA	1	bc
GCATCGGCGT	GAAACACCGGTGTACGTATGGACTGAACCAGGGTGTGCAAGTGGGGTTAG	1	bc
CAACACCCTT	GAAACACCGGTCGGCGGCAACGTGGGGTTAGAGCTAGAAATAGCAAGTTA	1	bc
CATTGAATTC	GAAACACCGGTGTACGTATGGACTGAACCAGGGTGTGCAAGTGGGGTTAG	1	bc
GCAGATCATC	GAAACACCGGTCGGCGGCAATCGTGGGTGGGGTTAGAGCTAGAAATAGCA	1	bc
TTGATGCCTA	GAAACACCGGTTAAGCCGAGGGGTTAGAGCTAGAAATAGCAAGTTAACCT	1	bc
TGCAACCACC	GAAACACCGGTTTGAACTACCTAGCAAGTTAACCTAAGGCTAGTCCGTTA	1	bc
ACGTGCTGTC	GGGTTAGAGCTAGAAATAGCAAGTTAACCTAAGGCTAGTCCGTTATCAAC	1	bc
TTTAGATATG	GAAACACCGGTTACATTGAGGGTTAGAGCTAGAAATAGCAAGTTAACCTA	1	bc
ACATTGATGC	GAAACACCGGTCGGGGCCACTCAGTGGTGGGGTTAGAGCTAGAAATAGCA	1	bc
AAACGTCGTA	GAAACACCGGTGCCCTTACTCTCACCTGATTACTTAATCCGTGGGGTTAG	1	bc
TACTTAATGT	GAAACACCGGTTAGGGGGTAGGGTTAGAGCTAGAAGTAGCAATTTGACCT	1	bc
TGACTCAGAC	GAAACACCGGTAGCAAGTGCGAGCAAGTTAACCTAAGGCTAGTCCGTTAT	1	bc
CGGCAGTTTA	GAAACACCGGTCCGTAGGAGACCCGTGTGGCATGTACCTGTGGGGTTAGA	1	bc
ATAATAGGCC	GAAACACCGGTACCTTTGTCGATGCTGGTGGGGTTAGAGCTAGAAATAGC	1	bc
CTCGTTTTCT	GAAACACCGGTGACATTGGTGGGGTCAGAGCTAGAAATAGCAAGTTAACC	1	bc
ACTCCTCGGA	GAAACACCGGTACCTTAGAGCTAGAAATAGCAAGTTAACCTAAGGCTAGT	1	bc
ACAGAACGCC	GCTAGAAATAGCAAGTTAACCTAAGGCTAGTCCGTTATCAACTTGAAAAA	1	bc
TATTTAGTGG	GAAACACCGGTTATATTTGTAAGTGTGTGGGGTTAGAGCTAGAAATAGCA	1	bc
CAGAAAGCTC	GAAACACCGGTTTGAACTACCTAGTTCAAACCGGTGGGGTTAGAGCTAGA	1	bc
GACACCAACC	GAAACACCGGTGTGGCTGAGAGTCCGGCAATGGTGTGGCTGTGGGGTTAG	1	bc
AAGTATGCCT	GAAACACCGGTCCGTAGGAGACCCGTGTGGCATGTACGTGGGGTTAGAGC	1	bc
GAGATTTGTC	GAAACACCGGTGACAGTGATGGGGTTAGAGCTAGAAATAGCAAGTTAACC	1	bc
ATGTTAAGAT	GAAACACCGGTTTACGTTGCATCGGTGTGGGGTTAGAGCTAGAAATAGCA	1	bc
AACGCTTGGT	GAAACACCGGTGTACGTATGGACTGAACCAGGGTGTGCAAGTGGGGTTAG	1	bc
TTGAGTGTCA	GAAACACCGGTTAAGCTAAGGTTAACCTAAGGCTAGTCCGTTATCAACTT	1	bc
AGGTGGCTCC	GAAACACCGGTCAGTAGGAGAGCCGTGTGGAATGTTCCTTTGTGGGGCTA	1	bc
ACTACTAGGC	GAAACACCGGTACCTTAGAGCTAGAAATAGCAAGTTAACCTAAGGCTAGT	1	bc
CGGCGGCGTT	GAAACACCGGCGTACGTATGGACTGAACCAGGGTGTGCAAGTGGGGTTAG	1	bc
AGAAGAACCG	GAAACACCGGTCGGCGGCAATCGTGGGTGGGGTTAGAGCTAGAAATAGCA	1	bc
AGGAAGCCTC	GAAACACCGGTCCGTAGGAGACCCGTGTGGCATGTACCTGTGGGGTTAGA	1	bc
AAGAGACGAA	GAAACACCGGTGTACGTATGGACTGAACCAGGGTGGGGTTAGAGCTAGAA	1	bc
ACGAGTTGTC	GAAACACCGGTGACATTGGGTACAGGGTGGGGTTAGAGCTAGAAATAGCA	1	bc
CAAAACTCTG	GAAACACCGGTGCATTCGAAAGTCCGGTCGTAGTGTGGACGTGGGGTTAG	1	bc
AATGATTAGA	GAAACACCGGTTTACGTTGCATCGGTGTGGGTTAGAGCTGGAAATAGCAA	1	bc
TTAAAATATC	GAAACACCGGTAACTATATTCATGCGATATCGCCGTATCAGTGGGGTTAG	1	bc
CGGCGGTTGC	GAAACACCGGTGTATTCGATAGGCCGGTCGGAGTGGAGACGAGAGATTAG	1	bc
ACCCACGCCC	GAAACACCGGTTAGAGCTAGAAATAGCAAGTTAACCTAAGGCTAGTCCGT	1	bc
TATGACAGAC	GAAACACCGGTGGGGTTAGAGCTAGAAATAGCAAGTTAACCTAAGGCTAG	1	bc
ATCTATCGTG	GAAACACCGGTTATATTTGTAAGTGTGTGGGGTTAGAGCTAGAAATAGCA	1	bc
CTTATATCGT	GAAACACCGGTCTCGAGTGAGGTGCTCAGGGTGGGGTTATAGCTAGAAAT	1	bc
ACCTTAACCG	GAAACACCGGTCGGGGCCACTCATGTGGGGTTAGAGCTAGAAATAGCAAG	1	bc
GTTGCGTAGG	GAAACACCGGTTTGTGGGGGTAGAGCTAGAAATAGCAAGTTAACCTAAGG	1	bc
AAAGCTCTAT	GAAACACCGGTGCCCTTACTCTCACCTGATTACTTAATCCGTGGGGATAG	1	bc
ACGAATCCTC	GAAACACCGGTCTCGAGTGAGGTGTTCAGGGTGGGGTTAGAGCTAGAAAT	1	bc
TGAAGCGTTT	GAAACACCGGTCTCGAGGGAGGTGTTCAGGGGGGGAAGTTAGAGCTAGAA	1	bc
ATGTACAGCT	GAAACACCGGTTTACGTTGCATCGGTGTGGGGTTAGAGCTAGAAATAGCA	1	bc
AATGAATCAT	GAAACACCGGTTCCCGTCCAGTGGGGTTAGAGCTAGAAATAGCAAGTTAA	1	bc
ACTCACGAGG	GAAACACCGGTTATATTTGTAAGTGTGTGGGGTTAGAGCTAGAAACAGCA	1	bc
AAAAAGTCGA	GAAACACCGGTGTACGTATGGACTGAACCAGGGTGTGCAAGTGGGGTTAG	1	bc
CACAACGTGT	GAAACACCGGTTTGAACTAGAAATAGCAAGTTAACCTAAGGCTAGTCCGT	1	bc
AGTGGGGCCT	GAAACACCGGTTCCCGTCCAGTGGGGTTAGAGCTAGAAATAGCAAGTTAA	1	bc
AAGTGATGGC	GAAACACCGGTGACAATGGGACGTGTGTTTAACGCTAGCCATGGCGAGAT	1	bc
GATCGTAGAC	GAAACACCGGTGTACGTATGGACTGAACCAGGGTGTGCAAAGTGGGGTTA	1	bc
CGTAACGCTC	GAAACACCGGTTTGAACTACCTAGTAGCAAGTTAACCTAAGGCTAGTCCG	1	bc
GAGGGAGGGG	GAAACACCGGTGCATTCGAAAGTCCGGTCGTAGTGTGGACGTGGGGTTAG	1	bc
TTGCGGCTAA	GAAACACCGGTTAAGCCGAGGAGTTAGAGCTAGAAATAGCAAGTTAACCT	1	bc
TTCGCCCTAT	GAAACACCGGTGCCCTTACTCTCACCTGATTACTTAATCCGTGGGGTTAG	1	bc
GCTACTTGGT	GAAACACCGGTACCTTTGTTGATGCTGGGTGGGGTTAGAGCTAGAAACAG	1	bc
CATATCGCCT	GAAACACCGGTTTGAACTAGAAATAGCAAGTTAACCTAAGGCTAGTCCGT	1	bc
GACATTAATC	GAAACACCGGTCGGGCAAGTTAACCTAAGGCTAGTCCGTTACAACTTGAA	1	bc
GCATACCCGA	GAAACACCGGTCGGCGGCAATCGTGGGGTGGGGTTAGAGCTAGAAATAGC	1	bc
ATAGCGTGAC	GAAACACCGGTTCCCGTCCAGTGGGGTTAGAGCTAGAAATAGCAAGTTAA	1	bc
AAACGGTCTA	GAAACACCGGTGCCCTTACTCTCACCTGATTACTTAATCCGTGGGGTTAG	1	bc
GTGGATGATT	GAAACACCGGTTCCCGTCCAGTGGGGTTAGAGCTAGAAATAGCAAGTTAA	1	bc
ATTCGGACGC	GAAACACCGGTCCGTATGGGACCCGTGTGGCATGTACCTGGTGGGCTAAA	1	bc
CAGGGTAGTA	GAAACACCGGTGTACGTATGGACTGAACCAGGGTGTGCAAGTGGGGTTAG	1	bc
AAACTCTCCC	GAAACACCGGTGCATTCGAAAGTCCGGTCGTAGTGTGGACGTGGGGTTAG	1	bc
CTAGCTAGGA	GAAACACCGGTTACATTGAGATCTCTTTTATGAGATCTCTGGGGTTAGAG	1	bc
TCTAGTGTGG	GAAACACCGGTTATATTTGTAAGTGTGTGGGGTTAGAGCTAGAAATAGCA	1	bc
GTGGCGCTTA	GAAACACCGGTTCCCGTCCAGTGGGGTTAGAGCTAGAAATAGCAAGTTAA	1	bc
GAGGTTAAGC	GAAACACCGGTCGGCGGTGGGGTTAGAGCTAGAAATAGCAAGATAACCTA	1	bc
TTCGTGATGT	GAAACACCGGTTACATTGAGGGTTAGAGCTAGAAATAGCAAGTTAACCTA	1	bc
CATTCAGAGC	GAAACACCGGTCGGGGCCACTCAGTGGTGGGGTTAGAGCTAGAAATAGCA	1	bc
ACTGCGTAGA	GAAACACCGGTTTACGTTGCATCGGTGTGGGGTTGGAGCTAGAAATAGCA	1	bc
TTATCCATAA	GAAACACCGGTTAAGCCGAAGAGTTAGAGCTAGAAATAGCAAGTTAACCT	1	bc
GATCATGAAC	GAAACACCGGTAGCAAGTGCGAGACGTGTTTGTGGGGTTAGAGCTAGAAA	1	bc
TCCCCAGGCC	GAAACACCGGTAAATTTGAGGCTCCGGCATGCAGGAGGCCGTGGGGTTAG	1	bc
CTGATTCGCC	GAAACACCGGTCTGCGGCAATCGGGGGATGAGCCACGTGTGGATAGATCG	1	bc
CATCTACCTC	GAAACACCGGTAGCAAGTGCGAGACGTGTTTGTGGGGTTAGAGCTAGAAA	1	bc
ACATAGTCGT	GAAACACCGGTGTACGTATGGACTGAACCAGGGTGTGCAAGTGGGGTTAG	1	bc
GAACGCACTA	GAAACACTGGTGCCCTTACTCTCACCTGATTACTTAATCCGTGGGGTTAG	1	bc
GACGCACTAT	GAAACACCGGTGCCCTTACTCTCACCTGATTACTTAATCCGTGGGGTTAG	1	bc
GACAGCCGGC	GAAACACCGGTCGGCGGCAATCGTGGGTGGGGTTAGAGCTAGAAATAGCA	1	bc
ACGGTCCTAC	GAAACACCGGTGCCCTTACTCTCACCTGATTACTTAATCCGTGGGGTTAG	1	bc
ATATATCTTA	GAAACACCGGTACTCCGGAAGGCTAAATGGAGTTATAGCTAGTAATCGTA	1	bc
AGGCCACTAC	GAAACACCGGTGAATTTGAGGCTCCGGCATGCAGGAGGCCGTGGGGTTAG	1	bc
ACGGGCCTCC	GAAACACCGGTGCCCTTACTCTCACCTGATTACTTAATCCGTGGGGTTAG	1	bc
GAAGTATGCC	GAAACACCGGTCCGTAGGAGACCCGTGTGGCATGTACCTGTGGGGTTAGA	1	bc
ATCCTGGATC	GAAACACCGGTCCGTAGGAGACCCGTGTGGCATGTACCTGTGGGGTTAGA	1	bc
ACGTGTTTTC	GAAACACCGGTGACATTGGGTAGTGGGGTTAGAGCTAGAAATAGCAAGTT	1	bc
TATGATGAGC	GAAACACCGGTTTACGTTGCATCGGTGTGGGGTTAGAGCTAGAAATAGCA	1	bc
AAATTAGCTC	GAAACACCGGTCGATTCATATCGAAACCTTCCCGTGACAGTGGGGTTAGA	1	bc
CTGAGTGCTC	GAAACACCGGTTTGGGGTTAGAGCTAGAAATAGCAAGTTAACCTAAGGCT	1	bc
AGGAACCATC	GAAACACCGGTGTGGCTGAGAGTCCGGCAATGGTGTGGCTGTGGGGTTAG	1	bc
AGTAGGAATC	GAAACACCGGTCCGTAGGAGACCCGTGTGGCATGTACCTGTGGGGTTAGA	1	bc
GTGGTGCTTT	GAAACACCGGTTCCCGTCCAGTGGGGTTAGAGCTAGAAATAGCAAGTTAA	1	bc
CTGGTCGTCC	GAAACACCGGTGTACGTATGGACTGAACCAGGGTGTGCAAAGTGGGGTTA	1	bc
TTGAGAAACA	GAAACACCGGTTAAGCCGAGGAGTTAGAGCTAGAAATAGCAAGTTAACCT	1	bc
ATTTAGCATA	GAAACACCGGTTAAGCCGAGGAGTTAGAGCTAGAAATAGCAAGTTAACCT	1	bc
CTAAACCCTA	GAAACACCGGTTCCCGTCCAGTGGGGTTAGAGCTAGAAATAGCAAGTTAA	1	bc
AGGAATAGCT	GAAACACCGGTTTACGTTGCATCGGTTGTGGGGTTAGAGCTAGAAATAGC	1	bc
ACCTTTACAG	GAAACACCGGTCGGGGCCACTCAGTGGTGGGGTTAGAGCTAGAAATAGCA	1	bc
CAAGCATCGC	GAAACACCGGTCGGCGGCCGGTTAGAGCTAGAAATAGCAAGTTAAAATAA	1	bc
ACCTTTAACG	GAAACACCGGTCGGGGCCACTCAGTGGTGGGGTTAGAGCTAGAAATAGCA	1	bc
AACGGTCTAT	GAAACACCGGTGCCCTTACTCTCACCTGATTACTTAATCCGTGGGGTTAG	1	bc
TCGAATACTT	GAAACACCGGTCTCGAGTGAGGTGTTCAGGGTGGGGTTAGAGCTAGAAAT	1	bc
ACTCGCCGGG	GAAACACCGGTGTACGTATGGACTGAACCAGGGTGTGCAAGTGGGGTTAG	1	bc
GAACGCACTA	GAAACACCGGTGCCCTTACTCTCACCTGATTACTTAATCCGTGGGGTTAG	1	bc
TACTCTTCGT	GAAACACCGGTGTACGTATGGACTGAACCAGGGTGTGCAAGTGGGGTTAG	1	bc
AGACTAGTGC	GAAACACCGGTGCATTCGAAAGTCCGGTCGTAGTGTGGACGTGGGGTTAG	1	bc
CGAATGCCTC	GAAACACCGGTCTCGAGTGAGGTGTTCAGGTGGGGTTAGAGCTAGAAATA	1	bc
TCATTGACGC	GAAACACCGGTCGGGGCCACTCAGTGGTGGGGTTAGAGCTAGAAATAGCA	1	bc
AGCCTCCCTT	GAAACACCGGTTCCCGTCCAGTGGGGTTAGAGCTAGAAATAGCAAGTTAA	1	bc
GTGATACAGA	GAAACACCGGTAGCAAGTGGGGTTAGAGCTAGAAATAGCAAGTTAACCTA	1	bc
ACACAGCGGG	GAAACACCGGTTTGAACTACCTAGTAGCAAGTTAACCTAAGGCTAGTCCG	1	bc
ACTTTATGGC	GAAACACCGGTCGGGGCCACTCAAGTGGGGTTAGAGCTAGAAATAGCAAG	1	bc
CTCCCCGACC	GAAACACCGGTGCAAGTTAACCTAAGGCTAGTACGTTATCAACTTGAAAA	1	bc
GTGCATAGCC	GAAACACCGGTTTACGTTGCATCGGATGTGGGGGTAGAGCTAGAAATAGC	1	bc
CACACCCCTC	GAAACACCGGTTTGAACTAGAAATAGCAAGTTAACCTAAGGCTAGTCCGT	1	bc
GACTCAACGC	GCTAGAAATAGCAAGTTAACCTAAGGCTAGTCCGTTATCAACTTGAAAAA	1	bc
CAACGACTAC	GAAACACCGGTGTACGCATGGACTGAACCAGGGTGTGCAAGTGGGGTTAG	1	bc
AGTTAGTCGC	GAAACACCGGTGCATTCGAAAGTCCGGTCGTAGTGTGGACGTGGGGTTAG	1	bc
AAGAATCATT	GAAACACCGGTCTCGAGTGAGGTGTTCAGGGTGGGGTTAGAGCTAGAAAT	1	bc
ATAGCTTATA	GAAACACCGGTAACTATATTCATGCGATATCGCCGTATCAGTGGGGTTAG	1	bc
AGAGGTGCCT	GAAACACCGGTTCCCGTCCAGTGGGGTTAGAGCTAGAAATAGCAAGTTAA	1	bc
CGCGAATCCT	GAAACGCCGGTCTCGAGTGAGGTGTTCAGGGTGGGGTTAGAGCTAGAAAT	1	bc
ATCTTTACCG	GAAACACCGGTCGGGGCCACTCAGTGGTGGGGTTAGAGCTAGAAATAGCA	1	bc
TGGGTTGGCT	GAAACACCGGTGACATTGGGGTTAGAGCTAGAAATAGCAAGTTAACCTAA	1	bc
ACACAATGCC	GAAACACCGGTTTGAACTAGAAATAGCAAGTTAACCTAAGGCTAGTCCGT	1	bc
TCCTTTACTG	GAAACACCGGTCGGGGCCACTCAGTGGTGGGGTTAGAGCTAGAAATAGCA	1	bc
TGAAGACCAG	GAAACACCGGTCGGCGGCAATGGGGTTAGAGCTAGAAATAGCAAGTTAAC	1	bc
ATGATAACCG	GAAACACCGGTTTACGTTGCATCGGTGTGGGGTTAGAGCTAGAAATAGCA	1	bc
ACATCTGCGT	GAAACACCGGTGTACGTATGGACTGAACCAGGGTGTGCAAAGTGGGGTTA	1	bc
GATGGCCTGC	GAAACACCGGTCGCCGGCCGGTTAGAGCTAGAAATAGCAAGTTAACCTAA	1	bc
AATCAATCGA	GAAACACCGGTTATATTTGTAAGTGGGGTTAGAGCTAGAAATAGCAAGTT	1	bc
CGTATTATTT	GAAACACCGGTCTCGAGTGAGGTGTTCAGGGTGGGGTTAGAGCTAGAAAT	1	bc
CTGGTGAGCT	GAAACACCGGTTTACGTTGCATCGGTGTGGGGTTAGAGCTAGAAATAGCA	1	bc
AGAAGACTCG	GAAACACCGGTCGGTGGGGTTAGAGCTAGAAATAGCAAGTTAACCTAAGG	1	bc
AAACGCCCTT	GAAACACCGGTGCCCTTACTCTCACCTGATTACTTAATCCGTGGGGTTAG	1	bc
AAGGCCTTCG	GAAACACCGGTGCATTCGAAAGTCCGGTCGTAGTGTAGACGTGGGGTTAG	1	bc
TACTTTACGT	GAAACACCGGTCGATTCATATCGAAACCTTCCCGTGACAGTGGGGTTAGA	1	bc
TCTACGCGGT	GAAACACCGGTACCTTTGTTGATGCTGGGTGGGGTTAGAGCTAGAAATAG	1	bc
AAGAATCATT	GAAACACCGGTCTCGAGTGAGGTGTTCAGGGCGGGGTTAGAGCTAGAAAT	1	bc
CTATCTCTCT	GAAACACCGGTGTGGCTGAGAGTCCGGCAATGGTGTGGCTGTGGGGTTAG	1	bc
CAACACCTTT	GAAACACCGGTCGGGGGGGTTAGAGCTAGAAATAGCATGTTAACATAAGG	1	bc
ACATCAGCCT	GAAACACCGGTCCGTAGGAGACCCGTGTGGCATGTACCTGTGGGGTTAGA	1	bc
ATTATAAGAA	GAAACACCGGTTTACGTTGCATCGGTTGTGGGGTTAGAGCTAGAAATAGC	1	bc
AAGTCGGCCT	GAAACACCGGTCCGTAGGAGACCCGTGTGGCATGTACCTGTGGGGTTAGA	1	bc
GCGAATGCTT	GAAACACCGGTCTCGAGTGAGGTGTTCAGGGTGGGGTTAGAGCTAGAAAT	1	bc
CAAGCAATAT	GAAACACCGGTGCCCTCACTCTCACCTGATTACTTAATCCGTGGGGTTAG	1	bc
GAACCCCCCA	GAAACACCGGTGTGGCTGAGAGTCCGGCAATGGTGTGGCTGTGGGGTTAG	1	bc
GACCCCATCC	GAAACACCGGTGTGGCTGAGGGTCCGGCAATGGTGTGGCTGTGGGGTTAG	1	bc
GATAGTTGTC	GAAACACCGGTGTACGTATGGACTGAACTAGGGTGTGCAAGTGGGGTTAG	1	bc
AGAAGCATTC	GAAACACCGGTCTCGAGTGAGGTGTTCAGGGTGGGGTTAGAGCTAGAAAT	1	bc
TCTCTCCCTC	GAAACACCGGTCCGTAGGAGACCCGTGTGGCATGTACCTGTGGGGTTAGA	1	bc
ACAAAACGCC	GAAACACCGGTTTACCGGGGTTAGAGCTAGAAATAGCAAGTTAACCTAAG	1	bc
ACGCTGTCTA	GAAACACCGGTCCGTAGGAGACCCGTGTGGCATGTACCTGTGGGGTTAGA	1	bc
TGTGGATCCT	GGAACACCGGTTCCCGTCCAGTGGGGTTAGAGCTGGAAATAGCAAGATAA	1	bc
GGAACCAGCC	GAAACACCGGAGTGGCTGAGAGTCCGGCAATGGTGTGGCTGTGGGGTTAG	1	bc
TAAAAACGCC	GAAACACCGGTTTGAACTAGAAATAGCAAGTTAACCTAAGGCTAGTCCGT	1	bc
GAAGACATGA	GAAACACCGGTCGGCGGCAAGGGGGGGTTAGAGCTAGAAATAGCAAGTTA	1	bc
GCAGCCCAGC	GAAACACCGGTCGGCGGCAATCGTGGTTAGAGCTAGAAATAGCAAGTTAA	1	bc
GAATCTGCCT	GAAACACCGGTCCGTAGGAGACCCGTGTGGCATGTACCTGTGGGGTTAGA	1	bc
TAACATCCAA	GAAGCACCGGTAACTATATTCATGCGATATCGCCGTATCAGTGGGGTTAG	1	bc
CTGCAGACGC	GAAACACCGGTTCCCGTCCAGTGAGGTTAGAGCTAGAAATAGCAAGTTAA	1	bc
AGCATCATTT	GAAACACCGGTCTCGAGTGAGGTGTTCAGGTGGGGTTAGAGCTAGAAATA	1	bc
AGACAACGCC	GAAACACCGGTTTGAACTACCTAGTAGCAAGTTAACCTAAGGCTAGTCCG	1	bc
GTAATCATCC	GAAACACCGGTGTGGCTGAGAGTCCGGCAATGGTGTGGCTGTGGGGTTAG	1	bc
AGGCACCTAC	GAAACACCGGTAAATTTGAGGCTCCGGCATGCAGGAGGCCCGTGGGGTTA	1	bc
GCGACTCCTT	GAAACACCGGTCTCGAGTGAGGTGTTCAGGGTGGGGTTAGAGCTAGAAAT	1	bc
GTGAAGATGC	GAAACACCGGTTCCCGTCCAGTGGGGTTAGAGCTAGAAATATCAAGTTAA	1	bc
GAGGAGCAGA	GAAACACCGGTCGGCGGCAATCGTGGGTGGGGTCAGAGCTAGAAATAGCA	1	bc
AAGGGGCGTC	GAAACACCGGTGTACGTATGGACTGAACCAGGGTGGGCAAATGGAGTTAG	1	bc
ACACAGCGCC	GAAACACCGGTTTGAACTAGAAATAGCTAGATAACCTAAGGCTAGTCCGA	1	bc
AATCTAGCTA	GAAACACCGGTCCGTAGGAGACCCGTGTGGCATGTACCTGTGGGGTTAGA	1	bc
TAACGTATTA	GAAACACCGGTAACTATATTCATGCGATATCGCCGTATCAGTGGGGTTAG	1	bc
AGTATGACTA	GAAACACCGGTCCGTAGGAGACCCGTGTGGCATGTACCTGTGGGGTTAGA	1	bc
AGTGGGGACA	GAAACACCGGTTCCCGTCCAGTGGGGTCAGAGCTAGAAATAGCAAGTTAA	1	bc
AACTACTTGG	GAAACACCGGTACCTTTGTTGATGCTGGGTGGAAGGAATCTGTGGGGTTA	1	bc
ATTGAGCAGA	GAAACACCGGTTAAGCCGAGGTTAGAGCTAGAAATAGCAAGTTAACCTAA	1	bc
TCTACAGTCA	GAAACACCGGTAGCAAGTGCGAGACGTGTTTGTGGGGTTAGAGCTAGAAA	1	bc
AGCCCTCTTC	GAAACACCGGTCCGTAGGAGACCCGTGTGGCATGTACCTGTGGGGTTAGA	1	bc
CACACACATC	GAAACACCGGTAGCAAGTGCGAGCAAGTTTTTGTGGGGTTAGAGCTAGAA	1	bc
ATGCTCTGCC	GAAACACCGGTGCATTCGAAAGTCCGGTCGTAGTGTGGCCGGGGGGTTAG	1	bc
ACGAATACTT	GAAACACCGGTCTCGAGTGAGGTGTTCAGGGTGGGGTTAGAGCTAGAAAT	1	bc
TAGCCGAGCT	GAAACACCGGTTTACGTTGCATCGGAGTGGGGTTAGAGCTAGAAATAGCA	1	bc
GACAACGATA	GAAACACCGGTAGCAAGTGCGAGCAAGTGTGGGGTTAGAGCTAGAAATAG	1	bc
TGCGGAGCCT	GAAACACCGGTTCCCGGGGTTAGAGCTAGAAATAGCAAGTTAACCTAAGG	1	bc
ATGAGGATTA	GAAACACCGGTTAAGCCGAGGAGTTAGAGCTAGAAATAGCAAGTTAACCT	1	bc
CTACTCACTT	GAAACACCGGTGGCTGGGTGGATGCTGGTTGTAGGGATTGAGTTAGAGAT	1	bc
GAGCTTTATC	GAAACACCGGTCGGGGCCACTCAGTGGTGGGGTTAGAGCTAGAAATAGCA	1	bc
ATGAACGTAC	GAAACACCGGTTAAGCCGAGGAGTTAGAGCTAGAAATAGCAAGTTAACCT	1	bc
ATGTCTGTCT	GAAACACCGGTCCGTAGGAGACCCGTGTGGCATGTACCTGTGGGGTTAGA	1	bc
AGGGACCCTC	GAAACACCGGTGTGGCTGAGAGTCCGGCAATGGTGTGGCTGTGGGGTTAG	1	bc
GCCAGCGCCC	GAAACACCGGTTTGAACTAGAAATAGCAAGTTAACCTAAGGCTAGTCCGT	1	bc
CCATTAGTAT	GAAACACCGGTCGATTCATATCGAAACCTTCCCGTGACAGTGGGGTTAGA	1	bc
AAAGCTTAGC	GAAACACCGGTTTACGTTGCATCGGTGTGGGGTTAGAGCTAGAAATAGCA	1	bc
GGAAACGTTT	GAAACACCGGTCTCGAGTGAGGTGTTCAGGGTGGGGTTAGAGCTAGAAAT	1	bc
GAGAAGAACC	GAAACACCGGTCGGCGGCAATCGTGGTTAGAGCTAGAAACAGCAAGTTAA	1	bc
AGCGTGGTGT	GAAACACCGGTGACATTGGGTACAGGGTGGGGTTAGAGCTAGAAATAGCA	1	bc
ACAAAAGCCC	GAAACACCGGTTAGAGCTAGAAATAGCAAGTTAACCTAAGGCTAGTCCGT	1	bc
CGACGCTATT	GAAACACCGGTGCATTCGAAAGTCCGGTCGTAGTGTGGACGTGGGGTTAG	1	bc
TGTACCCCCC	GAAACACCGGTGTGGCTGAGAGTCCGGCAATGGTGTGGCTGTGGGGTTAG	1	bc
GACCTTTACC	GCAAGTTAACCTAAGGCTAGTCCGTTACAACTTGAAAAAGTGGCACCGAG	1	bc
ATAGTCTGCC	GAAACACCGGTCCGTAGGAGACCCGTGTGGCATGTACCTGTGGGGTTAGA	1	bc
GCATTCCCGC	GAAACACCGGTCGGGGCCACTCAGTGGTGGGGTTAGAGCTAGAAATAGCA	1	bc
TCAGTTATAA	GAAACACCGGTAACTATATTCATGCGATATCGCCGTATCAGTGGGGTTAG	1	bc
GTGGTTCCTT	GAAACACCGGTTCCCGTCCAGTGGGGTTAGAGCTAGAAATAGCAAGCTAA	1	bc
GTGCAGAACC	GAAACACCGGTTCCCGTCCAGTGGGGTTAGAGCTAGAAATAGCAAGTTAA	1	bc
AGCGTTGTAT	GAAACACCGGTGCCCTTACTCTCACCTAATTACATCATCCGTGGGGTTAG	1	bc
ACCGCCACAC	GAAACACCGGTGCCCTTACTCTCACCTGATTACTTAATCCGTGGGGTTAG	1	bc
CACTAAGCCA	GAAACACCGGTTTGAACTGGAAATAGCAAGTTATCGTAAGGCTAGTCCGA	1	bc
GAAGTATCGC	GAAACACCGGTCGGCGGCGGTGGGGTTAGAGCTAGAAATAGCAAGTTAAC	1	bc
CGAACCTTCC	GAAACACCGGTGTGGCTGAGAGTCCGGCAATGGTGTGGCTGTGGGGATAG	1	bc
ATACTGCCTA	GAAACACCGGTCCGTAGGAGACCCGTGTGGCATGTACCTGTGGGGTTAGA	1	bc
TGATTGCTGC	GAAACACCGGTCCGTAGGAGACCCGTGTGGCATGTACCTGTGGGGTTAGA	1	bc
ATGCCCATAA	GAAACACCGGTAAATTTGAGGCTCCGGCATGCAGGAGGCCGTGGGGTTAG	1	bc
ACACAACGCT	GAAACACCGGTTTGAACTACCGGGGTTAGAGCTAGAAATAGCAAGTTAAC	1	bc
ATGTGTTGTA	GAAACACCGGTGACAGGTGGGGTTAGAGCTAGAAATAGCAAGTTAACCTA	1	bc
CCTAGTAGTC	GAAACACCGGTTTACGTCTGGACTGAACCAGCCAGTTAACCTAAGGCTAG	1	bc
ACGCTGCCGA	GAAACACCGGTCCGTAGGAGACCCGATTGGCATGTACCTGTGCTGGTAGA	1	bc
TCCTTTATAG	GAAACACCGGTCGGGGCCACTCAGTGGTGGGGTTAGAGCTAGAAATAGCA	1	bc
GCACAGCGCA	GAAACACCGGTTTGAACTAGAAATAGCAAGTTAACCTAAGGCTAGTCCGT	1	bc
TACTGCGTAT	GAAACACCGGTTAAGCCGAGGAGTTAGAGCTAGAAATAGCAAGTTAACCT	1	bc
AACATTCGGA	GAAACACCGGTCGATTCATATCGAAACCTTCCCGTGACAGAGGGGTTAGA	1	bc
TTGACGAGAA	GAAACACCGGTTAAGCCGAGGAGTTAGAGCTAGAAATAGCAAGTTAACCT	1	bc
CGACCCTACC	GAAACACCGGTAAATTTGAGGCTCCGGCATGCAGGAGGCCGTGGGGTTAG	1	bc
CAGAGTCCTC	GAAACACCGGTGTACGTATGGACTGAACCAGGGTGTGCAAGTGGGGTTAG	1	bc
CCATTCCCTC	GAAACACCGGTCGGGGCCACTCAGTGGTGGGGTTATAGCTAGAAATAGCG	1	bc
CACAGCAGTC	GAAACACCGGTGTACGTATGGACTGAACCAGGGTGTGCAAGTGGGGTTAG	1	bc
ACGAAGCCTT	GAAACACCGGTCTCGAGTGAGGTGTTCAGGTGGGGTTAGAGCTAGAAATA	1	bc
TCGACTCGCT	GAAACACCGGTCTCGAGTGAGGTGTTCAGGGGGTGGGGTTAGAGCTAGAA	1	bc
AGTCCGAGCC	GAAACACCGGTTTACGTTGCATCGGTGTGGGGTTAGAGCTAGAAATAGCA	1	bc
GTGGCGATTC	GAAACACCGGTTCCCGTCCAGTGGGGTTAGAGCTAGAAATAGCAAGTTAA	1	bc
CACCGAATTC	GAAACACCGGTGTACGTATGGACTGAACCGGGGTGTGCAAGTGGGGTTTG	1	bc
CGGGTAGGCT	GAAACACCGGTGGCATTGGGTACATGGTGGGGTTAGAGCTAGAAATAGCA	1	bc
CCCCTGGGGT	GAAACACCGGTCGATTCATATCACCACCTTCCCGTGACAGTGCGGTTAGT	1	bc
ATTAGATATG	GAAACACCGGTTACATTGAGGGTTAGAGCTAGAAATAGCAAGTTAACCTA	1	bc
GTGGAGAATT	GAAACACCGGTTCCCGTCCAGTGGGGTTAGAGCTAGAAATAGCAAGTTAA	1	bc
AGTCACCCTG	GAAACACCGGTGTGGCTGAGAGTCCGGCAATGGTGTGGCTGTGGGGTTAG	1	bc
TCATTACGGC	CACCGGTCGGGGCCACTCAGTGGTGGGGTTAGAGCTAGAAATAGCAAGTT	1	bc
CGCATAGCCC	GAAACACCGGTTTCATTTGGCATAGAGCTAGAAATAACAAGTTAACCTAA	1	bc
GTGATCGCGG	GAAACACCGGTTATATTTGTAAGCGTTGTGGGGTTAGAGCTAGAAATAGC	1	bc
ATCTTTAGTG	GAAACACCGGTCGGGGCCACTCAGTGGTGGGGTTAGAGCTAGAAATAGCA	1	bc
GTGAGACTAA	GAAGCACCGGTTAAGCCGAGGAGTTAGAGCTAGAGATAGCAAGTTAACCT	1	bc
CATGCTCTCC	GAAACACCGGTGCCCTTACTCTCACCTGATTACTTAATCCGTGGGGTTAG	1	bc
TCGTGTTGTA	GAAACACCGGTGACATTGGGTACAGGGGTGGGGTTAGAGCTAGAAATAGC	1	bc
GGGACAAACA	GAAACACCGGTAAATTTGAGGCTCCGGCATGCAGGAGGCCGTGGGGTTAG	1	bc
GTGCACCCTA	GAAACACCGGTTCCCGTCCAGTGGGGTTAGAGCTAGAAATAGCAAGTTAA	1	bc
GATATCCCCT	GAAACACCGGTCTCGAGTGAGGCGTTCAGGGTGTGGATAGAGCAAGAAAT	1	bc
TCTGCTTCGC	GAAACACCGGTTTACGTTGCATCGGTGTGGGGTTAGAGCTAGAAATAGCA	1	bc
GAATACGGGC	GAAACACCGGTCGGCGGCAATCGTGGGTGGGGTTAGAGCTAGAAATAGCA	1	bc
AATACTTCGC	GAAACACCGGTACCTTTGTTGATGCTAGAAATAGCAAGTTAACCTAAGGC	1	bc
AAGTCTTAAT	GAAACACCGGTCGATTCATATCTAAACCTTCCCGTGACAGTGGGGGTAGT	1	bc
AGGCAACTAT	GAAACACCGGTAAATTTGAGGCTCCGGCATGCAGGAGGCCGTGGGGTTAG	1	bc
TGCATTATAC	GAAACACCGGTAACTATATTCATGCGATATCGCCGTATCAGTGGGGTTAG	1	bc
GAGGAATCTC	GAAACACCGGTTCCCGTCCAGTGGGGTTAGAGCTAGAAATAGCAAGTTAA	1	bc
TTACATCTGT	GAAACACCGGTTACATTGGGGTTAGAGCTAGAAATAGCAAGTTAACCTAA	1	bc
GCCCCATACC	GAAACACCGGTAGCAAGTGCGAGACGTGTTTGTGGGGTTAGAGCTAGAAA	1	bc
AGTCGGACTT	GAAACACCGGTCCGTAGGAGACCCGTGTGGCATGTACCTGTGGGGTTAGA	1	bc
CGCCAACTAC	GAAACACCGGTGCGGCTGAGAGTCCGGCAATGGTGTGGCTGTGGGGTTAG	1	bc
GAAGATGCCT	GAAACACCGGTCGGCGGCAAGTTAACCTAAGGCTAGTCCGTTATCAACTT	1	bc
AGGGTTGTAT	GAAACACCGGTGACGTGGGGTTAGAGCTAGAAATAGCAAGTTAACCTAAG	1	bc
AATAGGAGTC	GAAACACCGGTGTACGTATGGACTGAACCAGGGTGTGCAAGTGGGGTTAG	1	bc
AAGTCAGTCA	GAAACACCGGTGGGGTTAGAGCTAGAAATAGCAAGTTAACCTAAGGCTAG	1	bc
CTGCGTCGCT	GAAACACCGGTTTACGTTGCATCGGTGTGGGGTTAGAGCTAGAAATAGCA	1	bc
TATACCAGCC	GAAACACCGGTAAATTTGAGGCTCCGGCATGCAGGAGGCCGTGGGGTTAG	1	bc
GAAGATTAGC	GAAACACCGGTCGGCGGCAATCGTAGAAATAGCAAGTTAACCTAAGGCTA	1	bc
ATGCGTCGTT	GAAACACCGGTTTACGTTGCATCGGTGTGGGGTTAGAGCTAGAAATAGCA	1	bc
AACATCCGGT	GAAACACCGGTCGATTCATATCGAAACCTTCCCGTGACAGTGGGGTTAGA	1	bc
CATCTTCTGC	GAAACACCGGTCGGGGCCACTCAGTGTTAGAGCTAGAAATAGCGAGTTAA	1	bc
GTGTAGGCGC	GAAACACCGGTTCCCGCTATTGGGGTTAGAGCTAGAAATAGCAAGTTATC	1	bc
GCCTTTACTG	GAAACACCGGTCGGGGCCACTCAGTGGTGGGGTTAGAGCTAGAAATAGCA	1	bc
GTGCTCTCCC	GAAACACCGGTAAATTTGAGGCTCCGGCATGCAGGAGGCCGTGGGGTTAG	1	bc
AATAGCAGTC	GAAACACCGGTGTACGTATGGACTGAACCAGAAATAGCAAGTTAACCTAA	1	bc
CGGAACCCAT	GAAACACCGGTCTCGAGTGAGGTGTTCAGGGTGGGGTTAGAGCTAGAAAT	1	bc
GTGGGGACGC	GAAACACCGGTTCCCGTCCAGTGGGGTTAGAGCTAGAAATAGCAAGTTAA	1	bc
AATAGTAGTC	GAAACACCGGTGTACGTATGGACTGAACCAGGGTGTGCAAGTGGGGTTAG	1	bc
ACAACTCGGA	GAAACACCGGTACCTTTGTTGATGCTGGGTGGAAGGAATTTGTGGGGTTA	1	bc
TAGAGAGTAA	GAAACACCGGTTAAGCCGAGGAGTTAGAGCTAGAAATAGCAAGTTAACCT	1	bc
TAGCTTACAA	GAAACACCGGTAACTATATTCATGCGATATCGCCGTATCAAGTGGGGTTA	1	bc
TTCGTAAGTC	GAAACACCGGTGTGGAGAGGGGCGCGCGGGGTTGGGGCGAGAAGTGGTAA	1	bc
CTGCGCAGTA	GAAACACCGGTTAACGCATGGACCTAACTTCGGTGTGCAAGTGCGGATAG	1	bc
CTCCCCCGAC	GAAACACCGGTGCCCTTACTCTTACCTGATTACTTAATCCGTGGGGTTAG	1	bc
CGACGCATTT	GAAACACCGGTCTCGAGTGAGGTGTTCAGGGTGGGGTTAGAGCTAGAAAT	1	bc
TAACGACCAC	GAAACACCGGTGCCCTTACTCTCACCTGATTACTTAATCCGTGGGGTTAG	1	bc
AGGAACACTC	GAAACACCGGTGTGGCTGAGAGTCCGGCAATGGTGTGGCTGTGGGGTTAG	1	bc
AGACATAGAC	GAAACACCGGTGCAAGTTAACCTAAGGCTAGTCCGTTATCAACTTGAAAA	1	bc
GGCAATTATC	GAAACACCGGTAAATTTGAGGCTCCGGCATGCAGGAGGCCGTGGGGTTAG	1	bc
GCTATTAGGC	GAAACACCGGTACCTTTGTTGATGATAGCAAGTTAACCTAAGGCTAGTCC	1	bc
ATTGCATAGC	GAAACACCGGTTTACGTTGCATCGGTGTGGGGTTAGAGCTAGAAATAGCA	1	bc
ATCTAAAGTG	GAAACACCGGTTATATTTGTAAGTGTGGGGTTAGAGCTAGAAATAGCAAG	1	bc
ACTATACAGC	GAAACACCGGTCGGGGCCACTCAGTGGTGGGGTTAGAGCTAGAAATAGCA	1	bc
AAACATAGAC	GAAACACCGGTTTACGTTGCATCGGTGTGGGGTTAGAGCTAGAAATAGCA	1	bc
GCATGACTTT	GAAACACCGGTCTCGAGTGAGGTGTTCAGGGTGGGGTTAGAGCTAGAAAT	1	bc
CTCCCCTTCA	GAAACACCGGTGTGGCTGAGAGTCCGGCAATGGTGTGGCTGTGGGGTTAG	1	bc
TTCAACGCAC	GAAACACCGGTTTGAATTAGAAATAGCAAGTTAACCTAAGGCTAGTCCGT	1	bc
CGACTTACAC	GAAACACCGGTAACTATATTCATGCGATATCGCCGTAGTTAGAGCTGGAA	1	bc
AAAAACCTAC	GAAACACCGGTGCCCTTACTCTCACCTGATTACTTAATCCGTGGGGTCAG	1	bc
ACACCACGCC	GAAACACCGGTTTGAACTAGAAATAGCAAGTTAACCTAAGGCTAGTCCGT	1	bc
GGGCAGCATC	GAAACACCGGTTCCCGTCCAGTGGGGTTAGAGCTAGAAATAGCAAGTTAA	1	bc
AACGTTCGGT	GAAACACCGGTCGATTCATATCGAAACCTTCCCGTGACAGTGGGGTTAGA	1	bc
GTATAGTTAT	GAAACACCGGTGTACGTATGGACTGAACCAGGGTGTGCAAGTGGGGTTAG	1	bc
ATTTAGCATA	GAAACACCGGTTAAGCCGGTGGGGTTAGAGCTAGAAATAGCAAGTTAACC	1	bc
AAGCACTCTA	GAAACACCGGTGCCCTTACTCTCACCTGATTACTTAATCCGTGGGGTTAG	1	bc
CCACCCCTTT	GAAACACCGGTATCGGGAGCGGTTAGAGGGGGGGGTAGAGCTAGAAATAG	1	bc
AACATGGCCC	GAAACACCGGTTTGAACTAGAAATAGCAAGTTAACCTAAGGCTAGTCCGT	1	bc
GGCAACAACC	GAAACACCGGTGTGGCTGAGAGTCCGGCAATGGTGTGGCTGTGGGGTTAG	1	bc
AAGCCTCGAA	GAAACACCGGTTTACGTTGCATCAGCTAGAAATAGCAAGTTAACCTAAGA	1	bc
ATTTGAATGA	GAGACACCGGTCGGGGCCACTCAGTGGTGGGGTTAGAGCTAGAAATAGCA	1	bc
AAAAGATACG	GAAACACAAGTTAACCTAAGGCTAGTCCGTTATCAACTTGAAAAAGTGGC	1	bc
AAAAGTCGTC	GAAACACCGGTGTACGTATGGACTGAACCAGGGTGTGCAAGTGGGGTTAG	1	bc
CTAATAGGGC	GAAACACCGGTACCTTTGTTGATGCTGGGTGGAAGGAATTTGTGGGGTTA	1	bc
AACTCGTCGT	GAAACACCGGTGTACGTATGGACTGAACCAGGGTGTGCAAGTGGGGTTAG	1	bc
GAGAGTCATT	GAAACACCGGTCTCGAGTGAGGTTAGAGCTAGAAATAGCAAGTTAACCTA	1	bc
GGAAGCATCA	GAAACACCGGTGTGGCTGAGAGTCCGGCAATGGTGTGGCTGTGGGGTTAG	1	bc
CGCCACCGCA	GAAACACCGGTAAATTTGAGGCTCCGGCATGCAGGAGGCCGTGGGGTTAG	1	bc
AAGAAGACCC	GAAACACCGGTCGGCGGCAATCGTGGTATGAGCCACGTGGGGTTAGATCG	1	bc
AGAATAACCG	GAAACACCGGTCGGCGGCAATCGTGGGTGGGGTTAGAGCTAGAAATAGCA	1	bc
AAGTGCGGTT	GAAACACCGGTCGATTCATATCGAAACCTTCCCGTGACAGTGGGGTTAGA	1	bc
TAGCGTCGTA	GAAACACCGGTGTACGTATGGACTGAACCAGGGTGTGCAAGTGGGGTTAG	1	bc
GAGGATTCGT	GAAACACCGGTCGGCGGCAATCGTGGGTGGGGTTAGAGCTAGAAATAGCA	1	bc
AATAGCTATG	GAAACACCGGTTACATTGAGGGGTTAGAGCTAGAAATAGCAAGTTAACCT	1	bc
ACTAATAGGC	GAAACACCGGTACCTTTGTTGATGCTGGGTGGAAGGAATTTGTGGGGTTA	1	bc
GGCGAAGACC	GAAACACCGGTCCCAACAGAACCGTTAGAGCTAGAAATAGCACGATAACT	1	bc
GTAGTCTGCC	GAAACACCGGTCCGTAGGAGACCCGTGTGGCATGTACCTGTGGGGTTAGA	1	bc
AGACTCATTC	GAAACACCGGTCTCGAGTGAGGTGTTCAGGGTGGGGTTAGAGCTAGAAAT	1	bc
ACTACACGGT	GAAACACCGGTACCTTTGTTGATGCTGGGTGGAAGGAATTTGTGGGGTTA	1	bc
CCGCTAAGCG	GAAACACCGGTTTACGTTGCATCGGTGTGGGGTTAGAGCTAGAAATAGCA	1	bc
TCTAATAAGC	GAAACACCGGTTATATTTGTAAGTGTGTGGGGTTAGAGCTAGAAATAGCA	1	bc
AAAACTTATA	GAAACACCGGTAACTATATTCATGCGATATCGCCGTATCAGTGGGGTTAG	1	bc
TCAGCTCAGT	GAAACACCGGTCGGGGCCACTCAGTGGTGGGGTTAGAGCTAGAAATAGCA	1	bc
GACGCTGTGT	GAAACACCGGTTGCATTGGGTAGGGTTAGTGTTAGTACTACAGGGTTCTG	1	bc
AGAAGACACG	GACCGGTGTTTCGTGGGGTTAGAGCTAGAAATAGCAAGTTAACCTAAGGC	1	bc
ACACAAAGCC	GAAACACGGGTTAGAGCTAGAAATAGCAAGTTAACCTAAGGCTAGTCCGT	1	bc
CAACTTGAAC	GAAACACCGGTAAGTATATTCATGTGATATCGCCGTATCAAGTGGTGTTA	1	bc
TGCATGCTCC	GAAACACCGGTTTGGCTGAGAGTCCGGCAATGGTGTGGCTGTGGGGTTAG	1	bc
GTGAGATTCC	GAAACACCGGTCGGCGCCACTCAGTGGCGGGGTTAGAGCTAGCAATAGCA	1	bc
AAGTGGAGCA	GAAACACCGGTTCCCGTCCAGTGGGGTTAGAGCTAGAAATAGCAAGTTAA	1	bc
ATTAAACATA	GAGACACCGGTTAAGCCGAGGAGTTAGAGCTAGAAATAGCAAGTTAACCT	1	bc
TACCTATGTC	GAAACACCGGTAAGTTTGAGGCTCCGGCATGCAGGAGGCCGTGGGGTTAG	1	bc
AGTAGCGATG	GAAACACCGGTTACAATTGGGGTTAGAGCTAGAAATAGCAAGTTAACCTA	1	bc
AACGCCGTTA	GAAACACCGGTGCCCTCACTCTCACCTGATTACTTAATCCGTGGGGTTAG	1	bc
ATTCTGACTT	GAAACACCGGTCCGTAGGAGACCCGTGTGGCATGTACCTGTGGGGTTAGA	1	bc
GTGGGGAGCC	GAAACACCGGTTCCCGTCCAGTGGGGTTAGAGCTAGAAATAGCAAGTCAA	1	bc
ATTGAGAATA	GAAACACCGGTTAAGCCGAGGAGTTAGAGCTAGAAATAGCAAGTTAACCT	1	bc
ACCCCCGGCG	GAAACACCGGTGTGGCTGAGAGTTCGGCAATGGTGTGGCTGTGGGGTTAG	1	bc
GTGACCCCTC	GAAACACCGGTTTGGCTGAGGTACCGGTAATGGTGTGGCTGGGGGGTTAA	1	bc
CCGAACGCGT	GAAACACCGGTTTGACCTACCTAGTAGCAAGTTAACCTAAGGCTAGTCCG	1	bc
ATAATCGCCC	GAAACACCGGTGTCTCTGTTGGTGGGTCTAGAGCTGGTATTGGCAGATTA	1	bc
AGACTGTATC	GAAACACCGGTCCGTAGGAGACCCGTGTGGCATGTACCTGGGGTTAGAGC	1	bc
ACACCCAGCC	GAAACACGGGTTAGAGCTAGAAATAGCAAGTTAACCTAAGGCTAGTCCGT	1	bc
TAATGTGCCT	GAAACACCGGTCCGTAGGAGACCCGTGTGGCATGTACCTGTGGGGTTAGA	1	bc
GAAGAACTGT	GAAACACCGGTCGGCGGCCGGTTAGAGCTAGAAATAGCAAGTTAACCTAA	1	bc
CGACTTGTCC	GAAACACCGGTAACTATATTCATGCGATATCGCCGTATCAGTGGGGTTAG	1	bc
AGCCACTACT	GAAACACCGGTAAATTTGAGGCTCCGGCATGCAGGAGGCCGTGGGGTTAG	1	bc
GTGATAAGGC	GAAACACCGGTTTACGTTGCATCGGTGTGGGTGTAGATCTAGCAATAGCA	1	bc
TCCGGCCTCT	GAAACACCGGTGCCCTTACTCTCACCTGATTACTTAATCCGTGGGGTTAG	1	bc
ACGCGCACAA	GAAACACCGGTTAAAGCCGAGGTTAGAGCTAGAGATAGCAAGTTAACCTA	1	bc
ATTTTACCGT	GAAACACCGGTCGGAGCCACTCAGTGGCGGGGGTAGAGATTAAAAAACAA	1	bc
ATTCCCTACA	GAAACACCGGTAAATTTGAGGCTCCGGCATGCAGGAGGCCGTGGGGTTAG	1	bc
GAGTATGCCT	GAAACACCGGTCCGTAGGAGACCCGTGTGGCATGTACCTGTGGGGTTAGA	1	bc
CCTTGAATGC	GAAACACCGGTCGGGGCCACTCAGTGGTGGGGTTAGAGCTAGAAATAGCA	1	bc
AGACCCAGCC	GAAACACCGGTAGCAAGTGCGAGCAAGTTGTGGGGTTAGAGCTAGAAATA	1	bc
ATTAGGTATG	GAAACACCGGTTACTTGGGGTTAGAGCTAGAAATAGCAAGTTAACCTAAG	1	bc
AAGTCTTCCT	GAAACACCGGTCCGTAGGAGACCCGTGTGGCATGTACCTGTGGGGTTAGA	1	bc
GCAAACGATC	GAAACACCGGTAATCAGAGGTGAACGTAAGGTGGGGTTAGAGCTAGAAAT	1	bc
TCGTGTAAAT	GAAACACCGGTCCGCAGGAGACCCGTGTGGCATGTACCTGGGGTTAGAGC	1	bc
CACTGCGGAC	GAAACACCGGTGCCCTTACTCTCACCTGATTACTTAATCCGTGGGGGTAG	1	bc
GCTTTTCAGC	GAAACACCGGTCGGGGCCACTCAGTGGTGGGGTTAGAGCTAGAAATAGCA	1	bc
TAGTCTAAGA	GAAACACCGGTAACTATAATCATGCGATGTCGCCGTATCAGTGGGGTTAG	1	bc
ATCGTTAGTT	GAAACACCGGTTTTCGTTGCATCGGAAGCAAGTTAACCTAAAACTAGTCC	1	bc
AAGTGTTGTC	GAAACACCGGTGACATTGGGAGTGGGGTTAGAGCTAGAAATAGTAAGTTA	1	bc
CCCGACCTAC	GAAACACCGGTGCCCTTACTCTCACCTGATTACTTAATCCGTGGGGTTAG	1	bc
GCCCCAGCGC	GAAACACCGGTAGCGAGTGCGAGACGTGTTAAATAGCAAGTTAACCTAAG	1	bc
TATATGGAAG	GAAACACCGGTTATATTTGTGGGTTAGAGCTAGAAATAGCAAGTTAACCT	1	bc
TAAATTAGAA	GAAACACCGGTAACTATATTCATGCGATATCGCCGTATCAGTGGGGTTAG	1	bc
GGCTGATAGC	GAAACACCGGTAAATTTGAGGCTCCGGCATGCAGGAGGCCGTGGGGTTAG	1	bc
TGAATCGATT	GAAACACCGGTCTCGAGTGAGGTGTTCAGGGTGGGGTTAGAGCTAGAAAT	1	bc
TCTTACATAC	GAAACACCGGTAAGGAGCTTTTTTTCTACAGTGTGTGCACAGCTATTCAT	1	bc
CTACTGGTAC	GAAACACCGGTACCTTTGTTGATGCTGGGTGGGGTTAGAGCTAGAAATAG	1	bc
CAACCTCGGC	GAAACACCGGTGCATTCGAAAGTCCGGTCGTAGTGTGGACGTGGGGTTAG	1	bc
CTCGCAAGAC	GAAACACCGGTGCCCTTACTCTCACCTGATTACTTAATCCGTGGGATTAG	1	bc
GAAAAGGACA	GAAACACCGGTAGCAAGTGCGGGGTTAGAGCTAGAAATAGCAAGTTAACC	1	bc
AGTCTGATTT	GAAACACCGGTCCGTAGGAGACCCGTGTGGCATGTACCTGTGGGGTTAGA	1	bc
GAATAGTCGT	GAAACACCGGTGTACGTATGGACTGAACCAGGGTGCGCAAGTGGGGTTAG	1	bc
AGATCGTCGT	GAAACACCGGTGTACGTATGGACTGAACCAGGGTGTGCAAGTGGGGTTAG	1	bc
ACGTGTTGTG	GTTAGAGCTAGAAATAGCAAGTTAACCTAAGGCTAGTCCGTTATCAACTT	1	bc
GTAGAACCGA	GAAACACCGGTCGGCGGCAATGGGGTTAGAGCTAGAAATAGCAAGTTAAC	1	bc
ACTCAACGCC	GAAACACCGGTTTGAACTAGAAATAGCAAGTTAACCTAAGGCTAGTCCGT	1	bc
GCTAGATATG	GAAACACCGGTTACATTGAGGGTTAGAGCTAGAAATAGCAAGTTAACCTA	1	bc
GACGAACTTC	GAAACACCGGTCGGCGGCAATCGTGGGGTGGGGTTAGAGCTAGAAATAGC	1	bc
CGTCTACATA	GAAACACCGGTCCGTAGGAGACCCGGGTGTCGTGTACCTGTGGGAATAGA	1	bc
GAACAACGCC	GAAACACCGGTTTGAACTACTTAGTTCAAACCGGTGGGGTTAGAGCTAGA	1	bc
ATTGCTTATA	GAAACACCGGTAACTATATTCATGCGATATCGCCGTATCGTGGGGTTAGA	1	bc
TATATGGAGA	GAAACACCGGTTATATTAGGAAGTGAATGAGGTTAGTGATAGAAATAGAG	1	bc
GAGGACCTAC	GAAACACCGGTGCCCTTACTCTCACCTGACTACTTAATCCGTGGGGTTAG	1	bc
ATCAAACCAC	GCTAGAAATAGCAAGTTAACCTAAGGCTAGTCCGTTATCAACTTGAAAAA	1	bc
CGGACACTTC	GAAACACCGGTCTCGATTGAAGTGTTCCGGGTGGGGTTAGAGCTAGAAAT	1	bc
ACATAACGCA	GAAACACGGGTTAGAGCTAGAAATAGCAAGTTAACCTAAGGCTAGTCCGT	1	bc
CCTTTCGGTC	GAAACACCGGTCGATTCATATCGAAACCTTCCCGTGACAGTGGGGTTAGA	1	bc
ACTTACCGCC	GAAACACCGGTCGGGGCCACTCAGTGGTGGGGTTAGAGCTAGAAATAGCA	1	bc
GATCGCCCTA	GAAACACCGGTCCGTAGGAGACCCGTGCGGCATGTACCTGTGGGGTTAGA	1	bc
CATAGCGCGC	GAAACACGGGTTAGAGCTAGAAATAGTAAGTTAACCTAAGGCTAGTCCGT	1	bc
AGAAGCCGCG	GAAACACCGGTCGGCGGCAATCGTGGGGTGGGGTTAGAGCTAGAAATAGC	1	bc
AGAATACCCG	GAAACACCGGTCGGCGGCAATCGTGGGTGGGGTTAGAGCTAGAAATAGTA	1	bc
CAGAGGCGTC	GAAACACCGGTGTACGTATGGACTGAACCAGGGTGTGCAAGTGGGGTTAG	1	bc
CCATTAGTGC	GAAACACCGGTCGGGGCCACTCAGTGGTGGGGTTAGAGCTAGAAATAGCA	1	bc
ATCATAGTCG	GAAACACCGGTGTACGTATGGACTGAACCAGGGTGTGCAAGTGGGGTTAG	1	bc
AAAAACGCCA	GAAACACCGGTTTGAACTAGAAATAGCAAGTTAACCTAAGGCTAGTCCGT	1	bc
GAGAATAATT	GAAACACCGGTCTCGAGTGAGGTGTTCAGGGTGGGGTTAGAGCTAGAAAT	1	bc
CGAAACGACC	GAAACACCGGTTTGAACTAGAAATAGCAAGTTAACCTAAGGCTAGTCCGT	1	bc
ACATTCGAGG	GAAACACCGGTTAGCAAGTTAACCTAAGGCTAGTCCGTTATCAACTTGAA	1	bc
GTAGCCTTGT	GAAACACCGGTTACATTGAGGGTTAGAGCTAGAAATAGCAAGTTAACCTA	1	bc
GTGAGTAGAA	GAAATACCGGTTAAGCCGAGGATGGGATTAGAGCTAGCAATAGCAGGTTA	1	bc
AAACTCGTCG	GAAACACCGGTGTACGTATGGACTGAACCAGGGTGTGCAAGTGGGGTTAG	1	bc
ATTAGAATAA	GAAACACCGGTTAAGCCGAGGAGTTAGAGCTAGAAATAGCAAGTTAACCT	1	bc
AATGGAACTA	GAAACACCGGTGCCCTTACTCTCACCTGATTACTTAATCCGTGGGGTTAG	1	bc
GGGACGTGCC	GAAACACCGGTGTGGCTGAGAGTCCGGCAATGGTGTGGCTGTGGGGTTAG	1	bc
GTGGCGCTTT	GAAACACCGGTTACATTGAGGGTTAGAGCTAGATATAGCAAGCTAACCAA	1	bc
GATGATTAGC	GAAACACCGGTTTACGTTGCATCGGTGTGGGGTTAGAGCTAGAAATAGCG	1	bc
ACGTATCCTT	GAAACACCGGTCTCGAGTGAGGTGTTCAGGGTGGGGTTAGAGCTAGAAAT	1	bc
AGCGGCCTAG	GGTGCCCTTACTCTCACCTGATTACTTAATCCGTGGGGTTAGAGCTAGAA	1	bc
TCATTGTCGT	GAAACACCGGTGTACGTATGGACTGAACCAGGGTGTGCAAGTGGGGTTAG	1	bc
GAAGGACAGC	GAAACACCGGTCAGCGGCAATCGTGGTTAGAGCTAGAAATAGCAAGTTAA	1	bc
AAAAGCAGTA	GAAACACCGGTGCCCTTACTCTCACCTGATTACTTAATCCGTGGGGTTAG	1	bc
ACGAATCCTA	GAAACACCGGTCTCGAGTGAGGTGTTCAGGGTGGGGTTAGAGCTAGAAAT	1	bc
AATGTCGTAC	GAAACACCGGCGCCCTTACTCTCACCTGATTACTTAATCCGTGGGGTTAG	1	bc
AGGCACCGTC	GAAACACCGGTGTGGCTGAGAGTCCGGCAATGGTGTGGCTGAGGGGTTAG	1	bc
ACATAACGCC	GAAACACCGGTTTGAACTAGAAATAGCAAGTTAACCTAAGGCTAGTCCGT	1	bc
CAAAAAGACC	GAAACACCGGTTTGAACCGGTGGGGTTAGAGCTAGAAATAGCAAGTTAAC	1	bc
GCACTTCGTC	GAACACCGGTGTACGTATGGACTGAACCAGGGTGTGCAAGTGGGGTTAGA	1	bc
AAGATAGGCA	GAAACACCGGTAGCAAGTGCTGGGTTAGAGCTAGAAATAGCAAGTTAACC	1	bc
TAATCGGTCA	GAAACACCGGTTTGAACTACCGTGGCTTACTCTACTAATTGCAGGGTTAC	1	bc
ACTACTTGGA	GAAACACCGGTACCTTTATTGATGCTGGGTGCCACTTGAAAAAGTGGCAC	1	bc
AATCAATAAA	GAAACACCGGTAGCAAGTGCGAGACGTGTTTGTGGGGTTAGAGCTAGAAA	1	bc
ATACGCTCGA	GAAACACCGGTGCATTCGAAAGTCCGGTCGTAGTGTGGACGTGGGGTTAG	1	bc
ATACTCAGCA	GAAACACCGGTACCTTTGTTGATGCTGGGTGGAAGGAATTGGAGCTAGAA	1	bc
GACGCCGACC	GAAACACCGGTAAATTTGAGGCTCCGGCATGCAGGAGGCCGTGGGGTTAG	1	bc
TCTAATCGTC	GAAACACCGGTACCTTTGTTGATGCTGGGTGGAAGGAATGTGGGGGTAGA	1	bc
AAGACACTCG	GAAACACCGGTGCATTCGAAAGTCCGGTCGTAGTGTGGACGCGGGGTTAG	1	bc
AGGTCATCGC	GAAACACCGGTGCATTCGAAAGTCCGGTCGAAGTGTGGACGTGGGGTTAG	1	bc
AGATGTACGT	GAAACACCGGTGTACGTATGGACTGAACCAGGGTGTGCAAGTGGGGTTAG	1	bc
ACATCTGTTT	GAAACACCGGTCGATTCATATCGAAACCTTCCCGTGACAGTGGGGTTAGA	1	bc
GTTATCTATG	GAAACACCGGTTACATTGAGGGTTAGAGCTAGAAATAGCAAGTTAACCTA	1	bc
TTAGATAGCT	GAAACACCGGTTTACGTTGCATCGGTGTGGGGTTAGAGCTAGAAATAGCA	1	bc
GACGAAGCGC	GAAACACCGGTCGGCGGCAATCGTGCTTTTACTAGAAATAGCAAGTTAAC	1	bc
TAAAATGTAC	GAAACACCGGTAACTATATTCATGCGATATCGCCGTATCAGTGGGGTTAG	1	bc
TTCACTTATA	GAAACACCGGTAACTATATTCATGCGATATCGCCGTATCAGTGGGGTTAG	1	bc
GACAACGAGC	GAAACACCGGTAATCAGAGGTGAACGTAAGGTGGGGTTAGAGCTAGAAAC	1	bc
CCAACCGCCA	GAAACACCGGTTTGAACTAGAAATAGCAAGTTAACCTAAGGCTAGTCCGT	1	bc
GCGTAGCCCC	GAAACACCGGTTCCCGTCCAGTGGGGTTAGAGCTAGAAATAGCAAGTTAA	1	bc
GGAACATACA	GAAACACCGGTAGCAAGTGCGGGGTTAGAGCTAGAAATAGCAAGTTAACC	1	bc
GAACCAGACC	GAAACACCGGTAGCAAGTGCGAGACGTGTTGGTGGGGTTAGAGCTAGAAA	1	bc
GAGGCTATAC	GAAACACCGGTTCCCGTCCAGTGGGGTTAGAGCTAGAAATAGCAAGTTAA	1	bc
GAAAATGGCC	GAAACACCGGTTTGAACTAGAAATAGCAAGTTAACCTAAGGCTAGTCCGT	1	bc
ATACTGGATC	GAAACACCGGTCCGTAGGAGACCCGTGTGGCATGTACCTTTGTGGGGTTA	1	bc
AGGATACCCC	GAAACACCGGTACGCAGGGAATCCGCATGGCATGAACCTGAGGGGGTAGA	1	bc
AACTTAACGC	GAAACACCGGTCGGGGCCACTCAGTGGTGGGGTTAGAGCTAGAAATAGCA	1	bc
AACGGCGGAC	GAAACACCGGTGCCCTTACTCTCACCTGATTACTTAATCCGTGGGGTTAG	1	bc
TCGTCTATGT	GAAACACCGGTTACATTGAGTGGGGTTAGAGCTAGAAATAGCAAGTTAAC	1	bc
ATACTTCTTA	GAAACACCGGTAACTATATTCATGCGATATCGCCGTATCAGTGGGGTTAG	1	bc
GTCCTTTACC	GAAACACCGGTACCTTTGTTGATGCTGGGTGGAAGGAATTTGTGGGGTTA	1	bc
AATGCGTAGC	GAAACACCGGTTTACGTTGCATCGGTGTGGGGTTAGAGCTAGAAATAGCA	1	bc
AGACTCGGAC	GAAACACCGGTACCTTTGTTGGTGGGGTTAGAGCTAGACATAGCAAGTTA	1	bc
AACAGTCGGT	GAAACACCGGTCGATTCATATCGAAACCTTCCCGTGACAGTGGGGTTAGA	1	bc
AATATACTAT	GAAACACCGGTCTCGAGTGAGGTGTTCAGGGTGGGGTTAGAGCTAGAAAT	1	bc
CACAGAGGAC	GAAACACCGGTGCCCTTACTCTCACCTGATTACTTAATCCGTGGGGTTAG	1	bc
CGAGCTGTCA	GAAACACCGGTGACATTGGGTAAAATAGCAAGTTAACCTAAGGCTAGTCC	1	bc
TAAACCCTCG	GAAACACCGGTGCATTCGAAAGTCCGGTCGTAGTGTGGACGTGGGGTTAG	1	bc
AAGGCTTTAC	GAAACACCGGTGCCCTTACTCTCACCTGATTACTTAATCCGTGGGGTTAG	1	bc
TTGCTGCGCT	GAAACACCGGTTTACAGCAAGTTAACCTAAGGCTAGTCCGTTATCAACTT	1	bc
TACCCATGCT	GAAACACCGGTAAATTTGAGGCTCCGGCATGCAGGAGGCCGTGGGGTTAG	1	bc
TAAACAGCTA	GAAACACCGGTAGCAAGTGCGAGACGTGTTAAATAGCAAGTTAACCTAAG	1	bc
CAGATCGAGG	GAAACACCGGTTATATTTGTAAGTGTGTGGGGTTAGAGCTAGAAATAGCA	1	bc
TGTCATCGAC	GAAACACCGGTAGCAAGTGCGAGCAAGTTTGTGGGGTTAGAGCTAGAAAT	1	bc
GTGGTGCATA	GAAACACCGGTTAAGCCGAGGTTAGAGCTAGAAATAGCAAGTTAACCTAA	1	bc
CTTTTGGCGC	GAAACACCGGTCTAATCCACTCCGTGGAGGATCTAGAGCTAGAAAGATCA	1	bc
TATAGCATAC	GAAACACCGGTCAACGGCAATCGTGGTTGGGGTTAGAGCAAGAAATAGCA	1	bc
GACAGCGACT	GAAACACCGGTTCCCGTACCGTGAAGATACAGCATGCGATATCAGGTTAA	1	bc
CAATCTCTGG	GAAACACCGGTGAGGGTTAGAGCTAGAAATAGCTAATTAACCTAAGGCTA	1	bc
GACATCGTCG	GAAACACCGGTGTACGTATGGACTGAACCAGGGTGTTATCAACTTGAAAA	1	bc
AAGACAATCG	GAAACACCGGTGCATTCGAAAGTCCGGTCGTAGTGAGGACGTGGGGTTAG	1	bc
TGCATCGGGG	GAAACACCGGTACCTTTGTTGATGCTAGAAATAGCAAGTTAACCTAAGGC	1	bc
GGCAACATAC	GAAACACCGGTGTGGCTGAGAGTCCGGCAATGGTGTGGCTGTGGGGTTAG	1	bc
TCTTTAAAGC	GAAACACCGGTCGGGGCCACTCAGTGGTGGGGTTAGAGCTAGAAATAGCA	1	bc
GACGCACCAC	GAAACACCGGTCGGCGGGGGGTTAGAGCTAGAAATAGCAAGTTAACCTAA	1	bc
GACGACAAGC	GAAACACCGGTCGGCGGCAATCGTGGGTGGGGTTAGAGCTAGAAATAGCA	1	bc
TTTGAGAAGA	GAAACACCGGTTAAGCCGAGGAGTTAGAGCTAGAAATAGCAAGTTAACCT	1	bc
AGAAACCGGC	GAAACACCGGTGCATTCGAAAGTCCGGTCGTAGTGTGGACGTGGGGTTAG	1	bc
AGTCGGAGAC	GAAACACCGGTTCCCGTCCAGTGGGGTTAGAGCTAGAAATAGCAAGTTAA	1	bc
ATAATCGAGG	GAAACACCGGTTATATTTGTAAGTGGGTGGGGTTAGAGCTAGAAATAGCA	1	bc
ACTCCGCGTC	GAAACACCGGTGTACGTATGGACTGAACCAGGGTGTGCAAAGTGGGGTTA	1	bc
ACTAGAGAGG	GAAACACCGGTTATATTTGTAAGTGGGGTTAGAGCTAGAAATAGCAAGTT	1	bc
AACATACGGT	GAAACACCGGTCGATTCATATCGAAACCTTCCCGTGACAGTGGGGTTAGA	1	bc
AAGACCATCG	GAAACACCGGTGCATTCGAAAGTCCGGTCGTAGTGTGGACGTGGGGTTAG	1	bc
AATGCTGAGC	GAAACACCGGTTTACGTTGCATCGGTGTGGGGTTAGAGCTAGAAATAGCA	1	bc
TATACGTCTC	GAAACACCGGTCCGTAGGAGACCCGTGTGGCATGTACCTGTGGGGTTAGA	1	bc
CAATTCGTTT	GAAACACCGGTATCAAGGGAGGTGTTCAGGGTGGGGTTAGAGCTAGAAAT	1	bc
TGTGATGTAT	GAAACACCGGTGACATTGGGAGTGGGGTTAGAGCTAGAAATAGCAAGTTA	1	bc
AGGCCACTAC	GAAACACCGGTAAATTTGAGGCTCCGGCATGCAGGAGGCCGTGGGGTTAG	1	bc
CTATGGAGGT	GAAACACCGGTTACATTGAGGGGTAGAGCTAGAAATAGCAAGTTAACCTG	1	bc
TCCTTTACAG	GAAACACCGGTCGGGGCCACTCAGTGGTGGGGTTAGAGCTAGAAATAGCA	1	bc
CAGGCCCTCC	GAAACACCGGTGCCCTTACTCTCACCTGATTACTTAATCCGTGGGGTTAG	1	bc
GGAACAAGCC	GAAACACCGGTGTGGCTGAGAGTCCGGCAATGGTGTGGCTGTGGGGTTAG	1	bc
AACACACCGG	GAAACACGGGTTAGAGCTAGAAATAGCAAGTTAACCTAAGGCTAGTCCGT	1	bc
AGAGGAGCCT	GAAACACCGGTTCCCGTCCAGTGGGGTTAGAGCTAGAAATAGCAAGTTAA	1	bc
ATTGCGTATA	GAAACACCGGTTAAGCCGAGGAGTTAGAGCTAGAAATAGCAAGTTAACCT	1	bc
CGATAGGTTT	GAAACACCGGTCGATTCATATCGAAACCTTCCCGTGACAGTGGGGTTAGA	1	bc
CCTCTGCATC	GAAACACCGGTCCGTAGGAGTCCCGTGTGGCATTTACCTGTGGGGTTAGA	1	bc
AGGAGAATAA	GAAACACCGGTTAAGCCGAGGGGTTAGAGCTAGAAATAGCAAGTTAACCT	1	bc
AGGGGAGCTC	GAAACACCGGTTCCCGTCCAGTGGGGTTAGAGCTAGAAATAGCAAGTTAA	1	bc
TTGGCAATGC	GAAACACCGGTTACATTGAGGGTTAGAGCTAGAAATAGCAAGTTAACCTA	1	bc
GCCGTATGTC	GAAACACCGGTAGCAAGTGCGAGATACTACAAAAGTGGGGTTAGAGCTAG	1	bc
AAATTCGCCT	GAAACACCGGTCGATTCATATCGAAACCTTCCCGTGACAGTGGGGTTAGA	1	bc
GAAAGAGATG	GAAACACCGGTAGCAAGTGCGAGCAAGTTTGTGGGGTTAGAGCTAGAAAT	1	bc
GGGAGCGCAA	GAAACACGGGTTAGAGCTAGAAATAGCAAGTTAACCTACGGCTAGTCCGT	1	bc
ACTGATCGCT	GAAACACCGGTTTGAACCGGTGGGGTTAGAGCTAGAAATAGCAAGTTAAC	1	bc
ATAGCACTGT	GAAACACCGGTTACATTGAGATCTCTTTTGTGGGGTTAGAGCCAGAAATA	1	bc
GAGGAGAATC	GAAACACCGGTTCCCGTCCAGTGGGGTTAGAGCTAGAAATAGCAAGTTAA	1	bc
AACATAAGGT	GAAACACCGGTCGATTCATATCGAAACCTTCCTGTGACAGTGGGGTTAGA	1	bc
ACATATCGAG	GAAACACCGGTTATATTTGTAAGTGTGTGGGGTTAGAGCTAGAAATAGCA	1	bc
GCCAACGCGC	GAAACACCGGTAATCAGAGGTGAACGTAAGGTGGGGTTAGAGCTAGAAAT	1	bc
ACTAATCGGG	GAAACACCGGTACCTTTGTTGATGCTGGGTGGGGTTAGAGCTAGAAATAG	1	bc
ACACAACGTC	GAAACACCGGTTTGAACCGGTGGGGTTAGAGCTAGAAATAGCAAGTTAAC	1	bc
CGAATCAGCT	GAAACACCGGTCTCGAGTGAGGTGTTCAGGGTGGGGTTAGAGCTAGAAAT	1	bc
AACTCTACAG	GAAACACCGGTCGGGGCCACTCAGTGGTGGGGTTAGAGCTAGAAATAACA	1	bc
AAACAACGGC	GAAACACCGGCCGATTAATAACGAAACCTTCCCGTGACAGTGGGGTTAAA	1	bc
AAGCCCATCG	GAAACACCGGTGCATTCGAAAGTCCGGTCGTAGTGTGGACGTGGGGTTAG	1	bc
GGCACGATCT	GAAACACCGGTGTGGCTGAGAGTCCGGCAATGGTGTGGCTGTGGGGTTAG	1	bc
AGTGGGGCCT	CAAAACACCGGTTCCCGTCCAGTGGGGTTAGAGCTAGAAATAGCAAGTTA	1	bc
ACCGGCGCTA	GAAACACCGGTGCCCTTACTCCCACCTGATTACTTAATCCGTGGGGTTAG	1	bc
CTTATCATAA	GAAACACCGGTTAAGCCGAGGGTTAGAGCTAGAAATAGCAAGTTAACCTA	1	bc
CACCGCACTT	GAAACACCGGTGTACGTATGGACTGAACCAGGGTGTGTAAGGGGGGTTAG	1	bc
GAAGGATCGC	GAAACACCGGTCGGCGGCAATCGTGGGTGGGGTTAGAGCTAGAAATAGCA	1	bc
ACAAAGCGCC	GAAACACGGGTTAGAGCTAGAAATAGCAAGTTAACCTAAGGCTAGTCCGT	1	bc
AAAGGAGGTA	GAAACTAGAAATAGCAAGTTAACCTAAGGCTAGTCCGTTATCAACTTGAA	1	bc
AGTGGTGCCT	GAAACACCGGTTCCCGTCCAGTGGGGTTAGAGCTAGAAATAGCAAGTTAA	1	bc
TCCTATACAT	GAAACACCGGTCGGGGCCACTCAGTGGTGGGGTTAGGGCTAGAAATAGCA	1	bc
ATCATCGCCC	GAAACACCGGTACCTTTGTTGATGCTGGGGGGAAGGATGCTTTTTTTCCA	1	bc
CGACTTGCGT	GAAACACCGGAGCATTCGAAAGACCGGTCGTAGTGTGGACGAGGGGTTAG	1	bc
AGTGATTAGC	GAAACACCGGTTTGCGTTGCATCGGTGTGGGGTTAGAGCTAGAAATAGCA	1	bc
GGAACCCTAA	GAAACACCGGTGTGGCTGAGAGTCCGGCAATGGTGTGGCTGTGGGGTTAG	1	bc
CAGAATGTCC	GAAACACCGGTTTGAACTAGAAATAGCAAGGTAACATAAGGCTAGTCCGT	1	bc
TGATCTGTCT	GAAACACCGGTAACCATCGCATCCGCCAAAGGGTAGATAGAGCTATAGAT	1	bc
GTGACCAGAA	GAAACACCGGTTAAGCCGAGTGGGGTTAGAGCTAGAAATAGCAAGTTAAC	1	bc
TCTTTAACGA	GACGAAAAATAGCAAGTTAACCTAAGGCTAGTCCGTTACAACTTGAAAAA	1	bc
ATTTTAACGA	GAAACACCGGTCGGGGCCACTCAGTGGTGGGGTTAGAGCTAGAAATAGCA	1	bc
GTGAGTCCTA	GAAACACCGGTTCCCGTCCAGTGGGGTTAGAGCTAGAAATAGCAAGTTAA	1	bc
AGGGGAGTCT	GAAACACCGGTTCCCGTCCAGTGGGGTTAGAGCTAGAAATAGCAAGTTAA	1	bc
AACGTGCTCC	GAAACACCGGTGCCCTTACTCCCACCTGATTACTTAATCCGTGGGGTTAG	1	bc
AGGCGGACTA	GAAACACCGGTCCGTAGGAGACCCGTGTGGCATGTACCTGTGGGGTTAGA	1	bc
CGATATTCGC	GAAACACCGGTGCATTCGAAAGTCCAGTCGTAGTGTGGACGTGGGGTTAG	1	bc
TCTGTAGAGC	GAAACACCGGTTATATTTGTAAGTGTGTGGGGTTAGAGCTAGAAATAGCA	1	bc
CACAACGTTA	GAAACACCGGTTTGAACTAGAAATAGCAAGTTAACCTAAGGCTAGTCCGT	1	bc
GTTCGCTATG	GAAACACCGGTTACATTGAGGGTTAGAGCTAGAAATAGCAAGTTAACCTA	1	bc
AAGTCTGAGT	GAAACACCGGTCCGTAGGAGACCCGTGTGGCATGTACCTGTGGGGTTAGA	1	bc
TACAAATGCC	GAAACACCGGTAAATTTGAGGCTCCGGCATGCAGGAGGCCGTGGGGTTAG	1	bc
TCGCTCTGCA	GAAACACCGGTGCATTCGAAAGTCCGGTCGTAGTGTGGACGTGGGGTTAG	1	bc
TTAAGGATCA	GAAACACCGGTTAAGCCGAGGAGTTAGAGCTAGAAATAGAAAGTTAACCT	1	bc
GCTGCTTAGC	GAAACACCGGTTTACGTTGCATCGGTTGTGGGGTTAGAGCTAGAAATAGC	1	bc
CACCACGTAC	GAAACCACGGGTTAGAGCTAGAAATAGCAAGTTAACCTAAGGCTAGTCCG	1	bc
TCAATCGGGC	GAAACACCGGTTATATTTGTTAGTATGTGGGGTTAGAGCTAGAAATAGCA	1	bc
ACATTACAGC	GAAACACCGGTCGGGGCCACTCAGTGGTGGGGTTAGAGCTAGAAATAGCA	1	bc
AGGCCCCCTC	GAAACACCGGTGTGGCTGAGAGTCCGGCAATGGTGTGGCTGTGGGGTTAG	1	bc
CGTCTTGCTC	GAAACACCGGTCCGTAGGAGACCCGTGTGGCATGTACCTGTGGGGTTAGA	1	bc
TAGTATGCCC	GAAACACCGGTCCGTAGGAGACCCGTGTGGCATGTACCTGTGGGGTTAGA	1	bc
ATGCTCGGGA	GAAACACCGGTATCTTTTTTGATGCTGGGTGGAAGGTGGGGTTAGGGCGA	1	bc
CACGCTCTAA	GAAACACCGGTGCCCTTACTCTCACCTGATTACTTAATCCGTGGGGTTAG	1	bc
AATCCAGAAA	GAAACACCGGTATCAAGAGCGAGACGCGTTGAATGGCAAGTTATCCTAAT	1	bc
ATATGCGGGT	GAAACACCGGTCGATTCATATCGAAACCTTCCCGTGACAGTGGGGTTAGA	1	bc
ATACTGGCTC	GAAACACCGGTCCGTAGGAGACCCGTGTGGCATGTACCTGTGGGGTTAGA	1	bc
CTGTCTAGGT	GAAACACCGGTTTACGTTGCATCGGTGTGGGGTTAGAGCTAGAAATAGCA	1	bc
AATGCTTAGA	GAAACACCGGTTTACGTTGCATCGGTGTGGGGTTAGAGCTAGAAATAGCA	1	bc
TATGCTTCGC	GAAACACCGGTTTACGTTGTGGGGTTAGAGCTAGAAATAGCAAGTTAACC	1	bc
GTAGACACGT	GAAACACCGGTCGGCGGCAATCGTGGGGGGGGTTAGAGCTAGAAATAGCA	1	bc
GAAAGCGCTA	GAAACACCGGTGCCCTTACTCTCACCTGATTACTTAATCCGTGGGGTTAG	1	bc
CGGCCTGGTC	GAAACACCGGTCCACGTATGGACTAAACCAGGGTGTGCCTAGGGGTATAG	1	bc
GCATACCTGC	GAAACACCGGTCGGCGGCAATCGTGGGTGGGGTTAGAGCTAGAAATAGCA	1	bc
AGAATCTTGT	GAAACACCGGTCTCGAGTGAGGTGTTCAGGGTGGGGTTAGAGCTAGAAAT	1	bc
AATCGAAGTC	GAAACACCGGTGTACGTATGGACTGAACCAGGGTGTGCAAGTGGGGTTAG	1	bc
GGAATCTATT	GAAACACCGGTCTCGAGTGAGGTGTTCAGGGTGGGGTTAGAGCTAGAAAT	1	bc
GTACACCGCC	GAAACACCGGTGTGGCTGAGAGTCCGGCAATGGTGTGGCTGTGGGGTTAG	1	bc
AGGAAAGGCC	GAAACACCGGTTTGAACTAGAAATAGCAAGTTAACCTAAGGCTAGTCCGT	1	bc
CCTCTGCCCC	GAAACACCGGTCCGTAGGAGACCCGTGTGGCAGGTTCCTGTGGGGATAGA	1	bc
ACTTCTCGGA	GAAACACCGGTACCTTTGTTGATGCTGGGTGGAAGGAATTTGTGGGGTTA	1	bc
CAGCTTAGAT	GAAACACCGGTTTACGTTGCATCGGTGTGGGGTTAGAGCTAGAAATAGCA	1	bc
GTGTAGTCGC	GAAACACCGGTTCCCGTCCAGTGGGGTTAGAGTTAGAAATAGCAAGTTAA	1	bc
ACCGTTACCG	GAAACACCGGTCGGGGCCACTCAGTGGTGGGGTTAGAGCTAGAAATAGCA	1	bc
TCTAATCATT	GAAACACCGGTCTCGTGTGCGGGGTTGAGGGGGGAGATCTAGCTAGAACT	1	bc
ATTATGCGTC	GAAACACCGGTCCGTAGGAGACCCGTGTGGCATGTACCTGTGGGGTTAGA	1	bc
GAGCTCATAA	GAAAGAGCTAGAAATAGCAAGTTAACCTACGACTAGGCCGTTATCAACTT	1	bc
AAGACAGCAT	GAAACACCGGTCCGTAGGAGACCCGTGTGGCATGTACCTGTGGGGTTAGA	1	bc
GACCCCCGCG	GAAACACCGGTGTGGCTGAGAGTCCGGCAATGGTGTGGCTGTGGGGTTAG	1	bc
GAACGGCGCT	GAAACACCGGTGCCCTTACTCTCACCTGATTACTTAATCCGTGGGGTTAG	1	bc
GGTACATACA	GAAACACCGGTAAATTTGAGGCTCCGGCATGCAGGAGGCCGTGGGGTTAG	1	bc
ACGAGCAGAA	GAAACACCGGTTAAGCCGAGTGGGGTTAGAGCTAGAAATAGCAAGTTAAC	1	bc
AACGCTTAGA	GAAACACCGGTTTACGTTGTGGGGTTAGAGCTAGAAATAGCAAGTTAACC	1	bc
GGGAACGCTC	GAAACACCGGTGTGGCTGAGAGTCCGGCAATGGTGTGGCTGTGGGGTTAG	1	bc
GGAGAGCAGC	GAAACACCGGTCGGCGGCAATCGTGGAAATAGCAAGTTAACCTAAGGCTA	1	bc
AGTAGTCCTC	GAAACACCGGTCCGTAGGAGACCCGTGTGGCATGTACCTGTGGGGTTAGA	1	bc
GTATGTCTAG	GAAACACCGGTTTACGTTGCATCGGGGTTAGAGCTAGAAATAGCAAGTTA	1	bc
GGCCCTCTCT	GAAACGCCGGTGTGGCTGAGAGTCCGGCGATGGTGTGGCTGTGGGGTTAG	1	bc
GAACGCGCTA	GAAACACCGGTGCCCTTACTCTCACCTGATTACTTAATCCGTGGGGTTAG	1	bc
GGCACTTACC	GAAACACCGGTAAATTTGAGGCTCCGGCATGCAGGAGGCCGTGGGGTTAG	1	bc
GTGGCACCCT	GAAACACCGGTGTGGCTGAGAGTCCGGCAATGGTGTGGCTGTGGGGTTAG	1	bc
ATACACGGAC	GAAACACCGGTACCTTTGTTGATGCTGGGTGGGGTTAGAGCTAGAAATAG	1	bc
GTGTATACTC	GAAACACCGGTTCCCGTCCAGTGGGGTTAGAGCTAGAAATAGCAAGTTAA	1	bc
AATGCGATCG	GAAACACCGGTGCATTCGAAAGTCCGGTCGTAGTGTGGACGTGGGGTTAG	1	bc
AACTATAGTG	GAAACACCGGTTATATTTGGGGTTAGAGCTAGAAATAGCAAGTTAACCTA	1	bc
ACTACTCGGA	GAAACACCGGTACCTTTGTTGATGCTGGGTGGGGGGTTAGAGCTAGAAAT	1	bc
GGTCGTTATA	GAAACACCGGTAAATTTGAGGCTCCGGCATGCAGGAGGCCGTGGGGTTAG	1	bc
TTTGGAGCCT	GAAACACCGGTTCCCGTCCAGTGGGGTTAGAGCTAGAAATAGCAAGTTAA	1	bc
TACTCGTACA	GAAACACCGGTAGCAAGTGCGAGACGTGTTTGTGGGGTTAGAGCTAGAAG	1	bc
AATGAGACTA	GAAACACCGGTTAAGCCGAGTGGGGTTAGAGCTAGAAATAGCAAGTTAAC	1	bc
AGTGAGCATA	GAAACACCGGTTAAGCCGAGGGTTAGAGCTAGAAATAGCAAGTTAACCTA	1	bc
GGGCGGCTCC	GAAACACCGGTGTGGCTGAGAGTCCGGCAATGGTGTGGCTGTGGGGTTAG	1	bc
CGATTCACTC	GAAACACCGGTCTCGAGTGAGGTGTTCAGGGTGGGGTTAGAGCTAGAAAT	1	bc
TAAATCTACA	GAAACACCGGTAAATTTGAGGCTCCGGCATGCAGGAGGCCGTGGGGTTAG	1	bc
TCACAACGCA	GAAACACCGGTTTGAACTAGAAATAGCAAGTTAACCTAAGGCTAGTCCGT	1	bc
ACACAGCGCC	GAAACACGGGTTAGAGCTAGAAATAGCAAGTTAACCTAAGGCTAGTCCGT	1	bc
GGAGTCTTTT	GAAACACCGGTCTCGAGTGAGGTGTTCAGGGTGGGGTTAGAGCTAGAAAT	1	bc
TGGAATCCTC	GAAACACCGGTGTGGCTGAGAGTCCGGCAATGGTGTGGCTGTGGGGTTAG	1	bc
AATGTTTAAC	GAAACACCGGTTTACGTTGCATCGGTGTGGGGTTAGAGCTAGAAATAGCA	1	bc
CATGTACAGC	GAAACACCGGTCGGGGCCACTCAGTGGTGGGGTTAGAGCTAGAAATAGCA	1	bc
TCTATTAGGG	GAAACACCGGTTATATTTGTAAGTGTGTGGGGTTAGAGCTAGAAATAGCA	1	bc
ACTCTAACGC	GAAACACCGGTCGGGGCCACTCAGTGGTGGGGTTAGAGCTAGAAATAGCA	1	bc
ACAACCCGGC	GAAACACCGGTACCTTTGTTGATGCTGGGTGGAAGGAAAAAGTGGCACCG	1	bc
GAAGTTATAA	GAAACACCGGTAACTATATTCATGCGATATCGCCGTATCAGTGGGGTTAG	1	bc
GTGAAACGTT	GAAACACCGGTTCCCGTCCAGTGGGGTTAGAGCTAGAAATAGCAAGTTAA	1	bc
GGTCCGACCC	GAAACACCGGTCCGTAGGAGACCCGTGTGGCATGTACCTGGGGGGTTAGA	1	bc
AGGAGCCTTT	GAAACACCGGTCTCGAGTGAGGAGTTTCGGGTGGGGTTAGAGCTAGCAAT	1	bc
TAGATTAAAC	GAAACACCGGTAACTATATTCCTGCGATCTCTCCGTCTCATTGTGGTTAG	1	bc
ATCAGCTATG	GAAACACCGGTTACATTGAGGGTTAGAGCTAGAAATAGCAAGTTAACCTA	1	bc
CGGTTATCTC	GAAACACCGGTCGGGGCCACTGGGGGGGTTAGAGCTAGAAATAGCAAGTT	1	bc
CAAATCGAGG	GAAACACCGGTTATATTTGTAAGTGTGTGGGGTTAGAGCTAGAAATAGCA	1	bc
AATAGATATG	GACACACCGGTTACATTGAGGGGTTAGAGCTAGAAATAGCAAGTTAACCT	1	bc
GGCACAGGCC	GAAACACCGGTAGCACGTGCGACAGGAGTTGGGGGGGTTAGATCTAGAAA	1	bc
AGCCGGCCAC	GAAACACCGGTCCGTAGGAGACCCGTGTGGCATGTACCTGAGGGGTTACA	1	bc
CTACGTCCGC	GAAACACCGGTGTACGTATGGACTGAACCAGGGTGTGCAAGTGGGGTTAG	1	bc
AGAACCTAGT	GAAACACCGGTGCATTCGAAAGTCCGGTCGTAGTGTGGACGTGGGGTTAG	1	bc
AAGACCTTCG	GAAACACCGGTGCATTCGAAAGTCCGGTCGTAGTGTGGACGTGGGGTTAG	1	bc
AGCAAGGCTC	GAAACACCGGTTTGAACTAGAAATAGCAAGTTAACCTAAGGCTAGTTCGT	1	bc
GATATCGTGG	GAAACACCGGTGTACGTATGGACTGAACCAGGGTGTGCAAGTGGGGTTAG	1	bc
AGACAGGCTA	GAAACACCGGTCCGTAGGAGACCCGTGCGGCATGTACCTGTGGGGTTAGA	1	bc
GTCGCGCCCC	GAAACACCGGTTCCCGTACAGTGGGGTTAGAGCTAGATATAGCAAGTTAA	1	bc
GAGACCGTTC	GAAACACCGGTGTGGCTGAGAGTCCGGCAATGGTGTGGCTGTGGGGTTAG	1	bc
AACTTTTGGT	GAAACACCGGTCGATTCATATCGAAACCTTCCCGTGACAGTGGGGTTAGA	1	bc
ACCTTAGGAT	GAAACACCGGTCGATTCATATCGAAACCTTCCCGTGACAGTGGGGTTAGA	1	bc
CTATTCTGGT	GAAACACCGGTCGATTCATACCGAAACCTTCCCGTGACAAGTGGGGTTAG	1	bc
GATAATCCTT	GAAACACCGGTCTCGAGTGAGGTGTTCAGGGGTGGGGTTAGAGCTAGAAA	1	bc
TAGATCGCGG	GAAACACCGGTTATATTTGTAAGAGTGTGGGGTTAGAGCTAGAAATAGCA	1	bc
AGAAACAGAA	GAAACACCGGTAGCAAGTGCGAGACGTTTGTGGGGTTAGAGCTAGAAATA	1	bc
AATAGCGAGG	GAAACACCGGTTATATTTGTAAGTGTGTGGGGTTAGAGCTGGAAATAGCA	1	bc
GAAGACAGAC	GAAACACCGGTAGCAAGTGCGAGACGTGTTTGTGGGGATAGAGCTAGAAA	1	bc
AGACTCCCAC	GAAACACCGGTGTGGCTGAGAGTCCGGCAATGGTGTGTCTGGCGGGATAT	1	bc
TGTCTGGCTA	GAAACACCGGTGCGAAGGAGCTCCGTGTGGCGTGAGCCCTTGGAGTTGCA	1	bc
CGTAACGTAC	GAAGCACGGGTTAGAGCTAGAAATAGCAAGTTAACCTAAGGCTAGTCCGT	1	bc
AGATAAAGAC	GAAACACCGGTAGCAAGTGCGAGACGTTAGAGCTAGAAATAGCAAGTTAA	1	bc
CACCCCTCCC	GAAACACCGGTTAGAGCTAGAAATAGCAAGTTAACCTAAGGCTAGTCCGT	1	bc
CGACTCTTGC	GAAACACCGGTGCATTCGAAAGTCCGGTCGTAGTGTGGACGTGGGGTTAG	1	bc
CGCTTCATTC	GAAACACCGGTCTCGAGTGAGGGGTTCAGTAGGGGTTAAAGCTAGAAATA	1	bc
GAGGCCCCGT	GAAACACCGGTGTGGCTGAGAGTCCGGCAATGGTGTGGCTGTGGGGTTAG	1	bc
ATGCTGCTCC	GAAACACCGGTTTACGTTGCATCGGTGTGGGGTTAGAGCTAGAAATAGCA	1	bc
CCGATCATAC	GAAACACCGGTTAAGCCGGTGGGGTTAGAGCTAGAAATAGCAAGTTAACC	1	bc
CACATGCTCT	GAAACACCGGTTTGAACTACCTAGCAAGTTAACCTAAGGCTAGTCCGTTA	1	bc
TTGAGCGCCA	GAAACACCGGTTTAAACTAGGAGGTAGAGCTAGAAATAGTAAGTTAAGCT	1	bc
AACCTTTACC	GAAACACCGGTCGGGGCCACTCATGTGGGGTTAGAGCTAGAAATAGCAAG	1	bc
CAGGATGTTG	GAAACACCGGTGACATTGGGTACAGGGGTGGGGTTAGAGCTAGAAATAGC	1	bc
CACAAAGAGC	GAAACACCGGTCGGGGCCACTCAGTGGTGGGGTTAGAGCTAGAAATAGCA	1	bc
AATCTCCGTC	GAAACACCGGTGTACGTATGGACTGAACCAGGGTGTGCAAGTGGGGTTAG	1	bc
AACGACTTAT	GAAACACCGGTGCCCTTACTCTCACCTGATTACTTAATCCGTGGGGTTAG	1	bc
ATTAGATATG	GAAACACCGGTTACATTGAGGGGTTAGAGCTAGAAATAGCAAGTTAACCT	1	bc
GGCAGATACA	GAAACACCGGTAAATTTGAGGCTCCGGCATGCGGGAGGCCGTGGGGTTAG	1	bc
ATGCTCCTTT	GAAACACCGGTCTCGAGTGAGGCGGTCAGGGGTGGGGTTAGAGCTAGACA	1	bc
TCGAGAGAGG	GAAACACCGGTTATATTTGTAAGTGGGGTTAGAGCTAGAAATAGCAAGTT	1	bc
AAACAACGCC	GAAACACCGGTTAGAGCTAGAAATAGCAAGTTAACCTAAGGCTAGTCCGT	1	bc
CAGCGTCGGT	GAAACACCGGTGTACGTATGGACTGAACCAGGGTGTGCAAGTGGGGTTAG	1	bc
AGTGGAGACT	GAAATAGCAAGTTAACCTAAGGCTAGTCCGTTATCAACTTGAAAAAGTGG	1	bc
AGTGGAGCAT	GAAACACCGGTTCCCGTCCAGTGGGGTTAGAGCTAGAAATAGCAAGTTAA	1	bc
CCAAACTCCC	GAAACACCGGTTAGAGCTAGAAATAGCAAGTTAACCTAAGGCTAGTCCGT	1	bc
ATACAACGCC	GAAACACCGGTTTGAACTAGAAATAGCAAGTTAACCTAAGGCTAGTCCGT	1	bc
ACCCAATGCG	GACACGGGTTAGAGCTAGAAATAGCAAGTTAACCTAAGGCTAGTCCGTTA	1	bc
AACGAGTGGC	GAAACACCGGTGCATTCGAAAGGCCGGTCGTAGTGGGTACGTGGGGTTAG	1	bc
AGTGATGCCT	GAAACACCGGTTCTCGGGCAGGGGGGTTAGGGCTAGAAATAGCAAGTTAA	1	bc
GCAGTCACGC	GAAACACCGGTCGGCGGCAATCGTGGGTGGGGTTAGAGCTAGAAATAGCA	1	bc
AGCAGCATCA	GAAACACCGGTTACGCCGAGGCGATAGAGTTAGAAATAGCAAGTTAACCT	1	bc
TTAATCGGCA	GAAACACCGGTACCTTTGTTGATGCTGGGTGGAAGGAAGTGGGGTTAGAG	1	bc
AGCCGCAGTC	GAAACACCGGTAGCAAGTGCGAGACGTGTTAACTAGCACGTTAACCTAAG	1	bc
TACACCATAC	GAAACACCGGTGCCCTTACTCTCACCTGATTACTTAATCCGTGGGGTTAG	1	bc
ATACGCGGCT	GAAACACCGGTACCTTTGTTGATGCTGGGTGGGGTTAGAGCTAAAAATAG	1	bc
GACAGTGCCA	GAAACACCGGTGGGGTTAGAGCTAGAAATAGCAAGTTAACCTAAGGCTAG	1	bc
GCTTCGTCGT	GAAACACCGGTGTACGTATGGACTGAACCAGGGTGCGCAAGTGGGGTTAG	1	bc
CGAACCCGCC	GAAACACCGGTGTGGCTGAGAGTCCGGCAATGGTGTGGCTGTGGGGTTAG	1	bc
CTACACGGGA	GAAACACCGGTACCTTTGTTGATGCTGGGTGGAAGGAATGGGTGGGGTTA	1	bc
ATTCGCTATG	GAAACACCGGTTACATTGAGGGGTTAGAGCTAGAAATAGCAAGTTAACCT	1	bc
TAGTGTTGTC	GAAACACCGGTGACATTGGGTATAGCAAGTTAACCTAAGGCTAGTCCGTT	1	bc
ATGCAGCGCT	GAAACACCGGTTTACGTTGCATCGGTGTGGGGTTAGAGCTAGAAATAGCA	1	bc
GGACACATGC	GAAACACCGGTAGCAAGCGGGGTTAGAGCTAGAAATAGCAAGTTAACCTA	1	bc
GCACAACGCT	GAAACACCGGTTTGAACTAGAAATAGCAAGTTAACCTAAGGCTAGTCCGT	1	bc
AAGGGTTTAA	GAAACACCGGTGCCCTTACTCTCACCTGATTACTTAATCCGTGGGGTTAG	1	bc
GCATCTGCCT	GAAACACCGGTCCGTAGGAGACCCGTGTGGCATGTACCTGTGGGGTTAGA	1	bc
GAGGTAGTCT	GAAACACCGGTGACATTGGGTAAAATAGCAAGTTAACCTAAGGCTAGTCC	1	bc
AAACAACGCC	GAAACACCGGTTTGAACTACCTAGTTCAAACCGGTGGGGTTAGAGCTAGA	1	bc
GTCCTCAGCT	GAAACACCGGTTTACGTTGTGGGGTTAGAGCTAGAAATAGCAAGTTAACC	1	bc
GCCAACGAGC	GAAACACCGGTAATCAGAGATGAACGTAAGGTGGGGTTAGAGCTAGAAAT	1	bc
AGTGTTGGTT	GAAACACCGGTCCGTAGGAGACCCGTGTGGCATGTACCTGTGGTGTTAGA	1	bc
GTCACCTCCA	GAAACACCGGTATATTTGAGACTCCGGCATTGGGGTGGCCGTGGGGTTAG	1	bc
GGGGTGCATA	GAAACACCGGTTCCCGTCCAGTGGGGTTAGAGCTAGAAATAGCAAGTTAA	1	bc
GATTGACCCT	GAAACACCGGTTAAGCCGAGTGGGGTTAGAGCTAGAAATAGCAAGTTAAC	1	bc
AGGCAACTTC	GAAACACCGGTGTGGCTGAGAGTCCGGCAATGGTGTGGTTGTGGGGTTAG	1	bc
AAATATACCG	GAAACACCGGTCGGGGCCACTCAGTGGTGGGGTTAGAGCTAGAAATAGCA	1	bc
AAAGACGTAC	GAAACACCGGTGCCCTTACTCTCACCTGATTACTTAATCCGTGGGGTTAG	1	bc
GTCCCAGGAA	GAAACACCGGTAGCAAGTGCGAGACGTGTTAAATAGCAAGTTAACCTAAG	1	bc
ACCATGCCTA	GAAACACCGGTCCGTAGGAGACCCGTGTGGCATGTACCTGTGGGGTTAGA	1	bc
AACCTTTACC	GAAACACCGGTCGGGGCCACTCAGTGGTGGGGTTAGAGCTAGAAATAGCA	1	bc
TCGAATGCTT	GAAACACCGGTCTCGAGTGAGGTGTTCAGGGTGGGGTTAGAGCTAGAAAT	1	bc
GAACCTGATT	GAAACACCTGGGGTTAGAGCTAGAAATAGCAAGTTAACCTAAGGCTAGTC	1	bc
ACTTAAAAGG	GAAACACCGGTCGGGGCCACTCAGTGGTGGGGTTAGAGCTAGAAATAGCA	1	bc
TTTCTCGATG	GAAACACCGGTTATATTTGTAAGTGTTTGTGGGGTTAGAGCTAGAAATAG	1	bc
AAGTTTGCCT	GAAACACCGGTCCGTAGGAGACCCGTGTTGTGGGGTTAGAGCTAGAAATA	1	bc
AGACACGAGC	GAAACACCGGTGCATTCGAAAGTCCGGTCGTAGTGTGGACGTGGGGTTAG	1	bc
CTTAGCCTAC	GTTAACCTAAGGCTAGTCCGTTATCAACTTGAAAAAGTGGCACCGAGTCG	1	bc
GGGTAATCTC	GAAACACCGGTTCCCGTCCAGTGGGGTTAGAGCTAGAAATAGCAAGTTAA	1	bc
GATCAGCCGC	GAAACACCGGTCGGTGGGGGTAGAGCTAGAAATAGCACGTTAACCTAAGG	1	bc
TAACATCTAA	GAAACACCGGTAACTATATTCATGCGATATCGCCGTATCAGTGGGGTTAG	1	bc
GACCTTTAAC	GAAACACCGGTCGGGGCCACTCAGTGGTGGGGTTAGAGCTAGAAATAGCA	1	bc
TCTATTGAAC	GAAACACCGGTTATATTTGTAAGTGTTGTGGGGTTAGAGCTAGAAATAGC	1	bc
TAACGCACTA	GAAACACCGGTGCCCTTACTCTCACCTGATTACTTAATCCGTGGGGTTAG	1	bc
TAAAACGTCC	GAAACACCGGTAAATTTGAGGCTCCGGCATGCAGGAGGCCGTGGGGTTAG	1	bc
GAACTCAACA	GAAACACCGGTAAATATATTGCTGCGATATCCACGAATCAGTGGGGTTGG	1	bc
AACCTTCGGT	GAAACACCGGTCGATTCATATCGAAACCTTCCCGTGACAGTGGGGTTAGA	1	bc
ACGAGTTGGA	GAAACACCGGTGACATTGGGTACAGGGGTGGGGTTAGAGCTAGAAATAGC	1	bc
GCAGTCTCGC	GAAACACCGGTTTGCAGCTCTCGCGGGTGGGGTTAGAGCTAGAAATAGCA	1	bc
ATACCATCAC	GAAACACCGGTGCATTCGAAAGTCCGGTCGTAGTGTGGACGTGGGGTTAG	1	bc
GCCACCCGCA	GAAACACCGGTGTGGCTGAGAGTCCGGCAATGGTGTGGCTGTGGGGTTAG	1	bc
GACCGTGACC	GAAACACCGGTACCTTTGTTGATGCTGGGTGGAAGGATTTTTGTGGGTTT	1	bc
AAGAGCCTCG	GAAACACCGGTGCATTCGAAAGTCCGGTCGTAGTGTGGACGTGGGGTTAG	1	bc
GAGGCCCCTA	GAAACACCGGTAAATTTGAGGCTCCGGCATGCAGGAGGCCGTGGGGTTAG	1	bc
GCCAACGAGC	GAAACACCGGTAACTATATTCATGCGATATCGCCGTATCAGTGGGGTTAG	1	bc
TGGTACCATA	GAAACACCGGTGTGGCTGAGAGTCCGGCAATGGTGTGGCTGTGGGGTTAG	1	bc
GAGCTTAGAT	GAAACACCGGTTTACGTTGCATCGGGGTTAGAGCTAGAAATAGCAAGTTA	1	bc
ATAGAAAGCT	GAAACACCGGTCGGCGGCAATCGGGGAATGAGCCAAGTGGGGATAGATCG	1	bc
GAGACCCACG	GAAACACCGGTGCATTCGAAAGTCCGGTCGTAGTGTGGCCGTGGGGTTAG	1	bc
GCACCCTGGA	GAAACACCGGTAAATTTGAGGCTCCGTCATGCAGGAGTCCGTGTGGTTAG	1	bc
ACATTTAGCG	GAAACACCGGTCGGGGCCACTCAGTGGTGGGGTTAGAGCTAGAAATAGCA	1	bc
ATTCTCTATG	GAAACACCGGTTTAGAGCTAGAAATAGCAAGTTAACCTAAGGCTAGTCCG	1	bc
TAGTCTGCAT	GAAACACCGGTCCGTAGGAGACCCGTGTGGCATGTACCTGTGGGGTTAGA	1	bc
CTAAACGCCA	GAAACACCGGTTTGAACTAGAAATAGCAAGTTAACCTAAGGCTAGTCCGT	1	bc
GCGATCAAGG	GAAACACCGGTTATATTTGTAAGTGGGTTAGAGCTAGAAATAGCAAGTTA	1	bc
TTATTCCCTT	GAAACACCGGTCTCGAGTGAGGTGTTCAGGTGGGGTTAGAGCTAGAAATA	1	bc
GGAAACTTCT	GAAACACCGGTAAATTTGAGGCTCCGGCATGCAGGAGGCCGTGGGGTTAG	1	bc
AGCCAACCTC	GAAACACCGGTGTGGCTGAGAGTCCGGCAATGGTGTGGCTGTGTGGTTAG	1	bc
ACTACTAGGC	GAAACACCGGTACCTTTGTTGATGCTGGGTGGAAGTGTGGGGTTAGAGCT	1	bc
GACACAAAAC	GAAACACCGGTAGCAAGTGCGAGACGTGTTTGTGGGGTTAGAGCTAGAAA	1	bc
AGTGCCGTCT	GAAACACCGGTGACATTGGGTACAGGGTGGGGTTAGAGCTAGAAATAGCA	1	bc
CGTTCTGGGT	GAAACACCGGTGACATTTGGGGTTAGAGCTAGAAATAGCAAGTTAACCTA	1	bc
ATACAACGCC	GAAACACCGGTTTGAACTACCTAGTTCAAACCGGTGGGGTTAGAGCTAGA	1	bc
AGGACGATGC	GAAACACCGGTAAATTTGAGGCTCCGGCATGCAGGAGGCCGTGGGGTTAG	1	bc
CATGTAGTCA	GAAACACCGGTAGCAAGTGGGGTTAGAGCTAGAAATAGCAAGTTAACCTA	1	bc
GGCACAGTAC	GAAACACCGGTAGCAAGTGCGAGACGTGTTAAATAGCAAGTTAACCTAAG	1	bc
AAGTATGCCT	GAAACACCGGTCCGTAGGAGACCCGTGTGGCATGTACCTGTGGGGTTAGA	1	bc
ACCCAACGCC	GAAACACGGGTTAGAGCTAGAAATAGCAAGTTAACCTAAGGCTAGTCCGT	1	bc
AGAATGAATC	GAAACACCGGTCCGTAGGAGACCCGTGTGGCATGTACCTTGTGGGGTTAG	1	bc
ACTTTAACGA	GAAACACCGGTCGGGCAAGTTAACCTAAGGCTAGTCCGTTACAACTTGAA	1	bc
CCGAACCAGG	GAAACACCGGTCGGGGCCACTCAGGGGTGGGGTTAGAGCTAGAAATAGCA	1	bc
AGCAGACCCG	GAAACACCGGTCGGCGGGTTAGAGCTAGAAATAGCAAGTTAACCTAAGGC	1	bc
AGATGACAAG	GAAACACCGGTCGGGGTTAGAGCTAGAAATAGCAAGTTAACCTAAGGCTA	1	bc
CACTTACCGA	GAAACACCGGTCGGGGCCACTCAGTGGTGGGGTTAGAGCTAGAAATAGCA	1	bc
GCAATAGACA	GAAACACCGGTAGTAAGTGGGGTTAGAGCTAGAAATAGCAAGTTAACCTA	1	bc
TTGAATAGCT	GAAACACCGGTTTACGTTGCATCGGTGTGGGGTTAGAGCTAGAAATAGCA	1	bc
AAACATAGAC	GAAACACCGGTAACTATACTCATGCGATATCGCCGTATCAGTGGGGTTAG	1	bc
GCGTGTTGTA	GAAACACCGGTGACATTTGGGGTTAGAGCTAGAAATAGCAAGTTAACCTA	1	bc
GACTTTACGG	GAAACACCGGTGGGGTTAGAGCTAGAAATAGCAAGTTAACCTAAGGCTAG	1	bc
TGAAGACGAG	GAAACACCGGTCGGCGGTGGGGTTAGAGCTAGAAATAGCAAGTTAACCTA	1	bc
AGGCAACGTC	GAAACACCGGTGTGGCTGAGAGTCCGGCAATGGTGTGGCTGTGGGGTTAG	1	bc
AAAAACCGTG	GAAACACCGGTAGCAAGTGAGGAGTTCAGGTGGGGTTACAACTAGAAGTA	1	bc
AAATGCTTAG	GAAACACCGGTTTACGTTGCATCGGTGTGGGGTTAGAGCTAGAAATAGCA	1	bc
TAAGGACCTA	GAAACACCGGTGCCCTTACTCTCACCTGATTACTTAATCCGTGGGGTTAG	1	bc
TCTATAGGTG	GAAACACCGGTTATATTTGTAAGTGTGTGGGGTTAGAGCTAGAAATAGCA	1	bc
ACACAACGCG	GAAACACGGGTTAGAGCTAGAAATAGCAAGTTAACCTAAGGCTAGTCCGT	1	bc
TGGCAACCTC	GAAACACCGGTGTGGCTGGGAGTCCGGCAATGGTGTGGCTGTGGGGTTAG	1	bc
TTAGCCACGC	GAAACACCGGTTACATTGAGGGGTTAGAGCTAGAAATGGCAAGTTAACCT	1	bc
CGTTAAGTTT	GAAACACCGGTCTCGAGTGAGGTGTTCAGGGTGGGGTTAGAGCTAGAAAT	1	bc
GTAGCTTTCA	GAAACACCGGTAAATTTGAGGCCCCGGCATGCAGGAGGCTCGTGGGGTTA	1	bc
AAGACCATCT	GAGACACCGGTGCATTCGAAAGTCCGGTCGTAGTGTGGACGTGGGGTTAG	1	bc
GCTACAGGCA	GAAACACCGGTAGCAAGTGCGGGGTTAGAGCTAGAAATAGCAAGTTAACC	1	bc
AAGTGTTGTA	GAAACACCGGTGACATTTGGGGTTAGAGCTAGAAATAGCAAGTTAACCTA	1	bc
ACATCTGGGT	GAAACACCGGTCGATTCATATCGAAACCTTCCCGTGACAGTGGGGTTAGA	1	bc
ACGCTACTCC	GAAACACCGGTGCCCTTACTCTCACCTGATTACTTAATCCGTGGGGTTAG	1	bc
TGCAACTAGG	GAAATAGCAAGTTAACCTAAGGCTAGTCCGTTATCAACTTGAAAAAGTGG	1	bc
CACAAATGCA	GAAACACCGGTAGCAAGTGCGAGCAAGTTTGTGGGGTTAGAGCTAGAAAT	1	bc
ATACTTGGTC	GAAACACCGGTACCTTTGTTGATGCTGGGTGGAAGGAAGGTGGGGTTAGA	1	bc
CACAACCACT	GAAACACCGGTTTGAACTAGAAATAGCAAGTTAACCTAAGGCTAGTCCGT	1	bc
CAAACATCGC	GAAACACCGGTGCATTCGAAAGTCCGGTCGTAGTGTGGACGTGGGGTTAG	1	bc
TAACGACATA	GAAACACCGGTGCCCTTACTCTCACCTGATTACTTAATCCGTGGGGTTAG	1	bc
AGGCACATAC	GAAACACCGGTAAATTTGAGGCTCCGGCATGCAGGAGGCCGTGGGGTTAG	1	bc
GGAAGCATAC	GAAACACCGGTGTGGCTGAGAGTCCGGCAATGGTGTGGCTGTGGGGTTAG	1	bc
GACTTAGAGA	GAAACACCGGTAGCAAGTGCGAGACGTGTTAAATAGCAAGTTAACCTAAG	1	bc
GTGAGTATAT	GAAACACCGGTTAAGCCGGTGGGGTTAGAGCTAGAAATAGCAAGTTAACC	1	bc
AATGTGGGAC	GAAACACCGGTCCGTCGCAGACCCGTGTGGCATGTACCTTGTGGGGTTAG	1	bc
AGGCACGAGC	GAAACACCGGTGCATTCGAGAGTCCGGTCGTAGTGTGGACGTGGGGTTAG	1	bc
AGATCCGATA	GAAACACCGGTGAATTTGAGGCTCCGGCATGCAGGAGGCCCGTGGGGTTA	1	bc
ATTGAGAATA	GAAACACCGGTTAGAGCTAGAAATAGCAAGTTAACCTAAGGCTAGTCCGT	1	bc
GAACCCATAC	GAAACACCGGTGTGGCTGAGAGTCCGGCAATGGTGTGGCTGTGGGGCTAG	1	bc
TTGATCTTAT	GAAACACCGGTTAAGCCGAGTGGGGTTAGAGCTAGAAATAGCAAGTTAAC	1	bc
AGACACAGCC	GAAACACCGGTAGCAAGTGCGGGGTTAGAGCTAGAAATAGCAAGTTAACC	1	bc
CTATTGGGCA	GAAACACCGGTACCTTTGTTGATGCTGGGTGGAAGGATTTTTGTGGGGTT	1	bc
AGGGTTGCTC	GAAACACCGGTTCCCGTCCAGTGAGGGTAGAGTTAGAGATAGCAAGTTAA	1	bc
GACGGGGTGC	GAAACACCGGTGACATTGGGAGTGGGGTTAGAGCTAGAAATAGCAAGTTA	1	bc
ACATTTTCCC	GAAACACCGGTCGGGGCCACTCAGTGGTGGGGATAGAGCTAGAAATAGCA	1	bc
ACACAACGCA	GAAACCACGGGTCAGAGCTAGAAATAGCAAGTTAACCTAAGGCTAGTCCG	1	bc
ACGCTGCGCC	GAAACACCGGTCCGTAGGAGACCCCCTAAGGCTAGTCCGTTATCAACTTG	1	bc
CAGCGTGGGC	GAAACACCGGTGTACGTATGGACTGAACCAGGGTGTGCAAGTGGGGTTAG	1	bc
ATTCTGCATA	GAAACACCGGTCCGTAGGAGACCCGTGTGGCATGTACCTGTGGGGTTAGA	1	bc
GCCGTAATTT	GAAACACCGGTCTCGAGTGAGGTGTTCAGGGTGGGGCTAGAGCTAGAAAT	1	bc
ATCTATCGCG	GAAACACCGGTTATATTTGTAAGTGTGTGGGGTTAGAGCTAGAAATAGCA	1	bc
AGAGTGCCTA	GAGACACCGGTCCGTAGGAGACCCGTGTGGCATGTACCTGTGGGGTTAGA	1	bc
ACGTCCGGTG	GAAACACCGGTCGATTCATATCGAAACCTTCCCGTGACAGTGGGGTTAGA	1	bc
CTGCCACAGA	GAAACACCGGTAGCAAGTGCGAGACGTGTTTGTGGGGTTAGAGCTAGAAA	1	bc
AGAAACTCGA	GAAACACCGGTGCATTCGAAAGTCCGGTCGTAGTGTGGACGTGGGGTTAG	1	bc
AGACTTTCCC	GAAACACCGGTGACATTGGGTACACAGTGGGGTTGGAGCTAGAAATAGCA	1	bc
AGGATCCTCC	GAAACACCGGTTTACGTTGCATCGGTGTGGGGTTAGAGCTAGAAATAGCA	1	bc
AACAATGTCC	GAAACACCGGTTTGAACTAGAAATAGCAAGTTAACCTAAGGCTAGTCCGT	1	bc
AGAATTTCGC	GAAACACCGGTGCATTCGAAAGTCCGGTCGTAGTGTGGACGTGGGGTTAG	1	bc
AAACCACTAC	GAAACACCGGTGCCCTTACTCTCACCTGATTACTTAATCCGTGGGGTTAG	1	bc
AAACAACGCC	GAAACACCGGTTTGAACCGGTGGAGTTAGAGCTAGAAATAGCAAGTTAAC	1	bc
GACGTCCGTC	GAAACACCGGTCGGCGGAGGGGTTAGAGCTAGAAATAGCAAGATAAGCTA	1	bc
AACAACAACC	GAAACACCGGTTTGAACTAGAAATAGCAAGTTAACCTAAGGCTAGTCCGT	1	bc
AGATTGTGTT	GAAACACCGGTCGATTCATATCGAAACCTTCCCGTGACAAGTGGGGTTAG	1	bc
GCTATACTTC	GAAACACCGGTGTCAATGTAGGTGTTCCAGGTGGGGTTAGAGCTAGAAAT	1	bc
TTAGATCCGT	GAAACACCAGTCACGGTCACTCCGTGGGGGTAGTGCTGGTAATAGTAAGT	1	bc
AACATATCCC	GAAACACCGGTTTGAAATAGAAATAGCAAGTTAACCTAAGGCTAGTCCGT	1	bc
AATAGTCGTA	GAAACACCGGTGTACGTATGGACTGAACCAGGGTGTGCAAGTGGGGTTAG	1	bc
GAAATTGACA	GAAACACCGGTAGCAAGTGCGGGGTTAGAGCTAGAAATAGCAAGTTAACC	1	bc
GATGCATAGC	GAAACACCGGTTTACGTTGCATCGGTGTGGGGTTAGAGCTAGAAATAGCA	1	bc
GTGCGCATCC	GAAACACCGGTTAAGCCGAGTGGGGTTAGAGCGAGGATTAGCAAGTTAAC	1	bc
CAGAAGCCTC	GAAACACCGGTTCCCGTCCAGTGGGGTTAGAGCTAGAAATAGCAAGTTAA	1	bc
TTAATCGAGC	GAAACACCGGTTATATTTGTAAGTGTGTGGGGTTAGAGCTAGAAATAGCA	1	bc
GGAAACCTCT	GAAACACCGGTGTGGCTGAGGGTCCGGCAATGGTGTGGCTGTGGGGTTAG	1	bc
GAACGGCGTC	GAAACACCGGTGTACGTATGGACTGAACCAGGGTGTGCAAGTGGGGTTAG	1	bc
GAGGATCCTT	GAAACACCGGTTCCCGTCCAGTGGGGTTAGAGCTAGAAATAGCAAGTTAA	1	bc
TTAGAAATGC	GAAACACCGGTTACATTGAGGGTTAGAGCTAGAAATAGCAAGTTAACCTA	1	bc
GGACACCGAA	GAAACACCGGTAGCAAGTGCGAGACGTGTTAAATAGCAAGTTAACCTAAG	1	bc
CGTTCTGTCG	GAAACACCGGTGACATTGGGTACAGGGTGGGGTTAGAGCTAGAAATAGCA	1	bc
ATCAATAATA	GAAACACCGGTTAAGCCGAGGGTTAGAGCTAGAAATAGCAAGTTAACCTA	1	bc
CAACGCGTCC	GAAACACCGGTACCTTTGTTGATGTTGATGTGGGGTTAGAGCTAGAAATA	1	bc
AGACCTACGT	GAAACACCGGTTTACGCTGCATCGCGGTAGAGCTGGAGATAGCAAGTTAG	1	bc
AGAAGACCAG	GAAACACCGGTCGGCGGCAATCGTGGGTGGGGTTAGAGCTAGAAATAGCA	1	bc
ATTCAACATA	GAAACACCGGTTAAGCTAAGGTTAACCTAAGGCTAGTCCGTTATCAACTT	1	bc
AATCGTTCGC	GAAACACCGGTGCATTCAAAAGTCCGGTCGTAGTGTGGACGTGGGGTCAG	1	bc
GTGTAGCTGC	GAAACACCGGTTCCCGTCCAGCGGGGTTAGAGCTAGACATAGCAAGTTAA	1	bc
GAGTTGCGTC	GAAACACCGGTTCCCGTCCAGTGGGGTTATAGCTAGAAATAGCAAGTTAA	1	bc
ATGTCTACCT	GAAACACCGGTTTACGTTGGGGGTTAGAGCTAGAAATAGCAAGTTAACCT	1	bc
TTGCTAACAA	GAAACACCGGTTAAGCCGAGTGGGGTTAGAGCTAGAAATAGCAAGTTAAC	1	bc
AATCTACTGC	GAAACACCGGTCGGGGCGGGTTAGAGCTAGAAATAGCAAGTTAACCTAAG	1	bc
AACATACGAT	GAAACACCGGTCGATTCATATCGAAACCTTCCCGTGACAGTGGGGTTAGA	1	bc
GTAAGAACAA	GAAACACCGGTTAAGCCGAGGTTAGAGCTAGAAATAGCAAGTTAACCTAA	1	bc
ATGGAGCATA	GAAACACCGGTTAAGCCGAGTGGGGTTAGAGCTAGAAATAGCAAGTTAAC	1	bc
AACCTTACCG	GAAACACCGGTCGGGGCCACTCAGTGGTGGGGTTAGAGCTAGAAATAGCA	1	bc
CACACAGCAC	GAAACACCGGTTTGAACTAGAAATAGCAAGTTAACCTAAGGCTAGTCCGT	1	bc
TCCCTATGCG	GAAACACCGGTTTGAACTACCTAGTTCAAACCGGTGGGGTTAGAGCTAGA	1	bc
CATAGTAGAC	GAAACACCGGTGTACGTATGGACTGAACCAGGGTGTGCAAGTGGGGTTAG	1	bc
CGTCGGACTC	GAAACACCGGTCCGTAGGAGACCCGTGTGGCATGTACCTGTGGGGTTAGA	1	bc
CCAATCATAC	GAAACACCGGTACCTTTGTTGATGATAGCAAGTTAACCTAAGGCTAGTCC	1	bc
CGGATCATTC	GAAACACCGGTCTCGAGTGAGGTGTTCAGGGTGGGGTTAGAGCTGGAAAT	1	bc
AATAGAAGGC	GAAACACCGGTACCTTTGTTGATGCTGGGTGGGGTTAGAGCTAGAAATAG	1	bc
GATGAACTGC	GAAACACCGGTCGGCGGCAATCGTGGGTGGGGTTAGAGCTAGAAATAGCA	1	bc
GTGCAATATC	GAAACACCGGTTCCCGTCCAGTGGGGTTAGAGCTAGAAATAGCAAGTTAA	1	bc
TTGTGTTGTC	GAAACACCGGTGACATTGGGTACTACAGGGTGGGGTTAGAGCTAGAAATA	1	bc
ACTATCCCGC	GAAACACCGGTTATATTTGTACGTGTGTGGGGTTAGAGCTAGAAATAGCA	1	bc
GAGATCCCCC	GAAACACCGGTTCAAGTCCAGTGGGGGTAGAGCTAGAAATAGCAAGTTAA	1	bc
AGGTTCGGTG	GAAACACCGGTCGATTCATATCGAAACCTTCCCGTGGGGTTAGAGCTAGA	1	bc
ACTTTAGCGT	GAAACACCGGTCGATTCATATCGAAACCTTCCCGTGACAAGTGGGGTTAG	1	bc
AAGGTTCTTC	GAAACACCGGTGTACGTATGGACTGAACAAGGGTGTGAAAGAGAGGTTAG	1	bc
GATACCGCCA	GAAACACCGGTGAAAAATGTGCTAGAAATAGCATGGTAATAGAAGTCGAG	1	bc
ATCACACTGC	GAAACACCGGTGTGGCTGAGAGTCCGGCAATGGTGTGGCTGTGGGGTTAG	1	bc
GTATCTCGAG	GAAACACCGGTTATATTTGTAAGTGTGTGGGGTTAGAGCTAGAAATAGCA	1	bc
ACTGATCGGG	GAAACACCGGTACCTTTGTTGATGCTGGGTGGGGTTAGAGCTAGAAATAG	1	bc
GTCTATGGAG	GAAACACCGGTTATATTTGTAAGTGTTGTGGGGTTAGAGCTAGAAATAGC	1	bc
CGGCTTCGCT	GGAACACCGGTTTACGTTGCATCGGGGTTAGAGCTAGAAATAGCAAGTTA	1	bc
AGGTACACTC	GAAACACCGGTGTGGCTGAGAGTCCGGCAATGGTGTGGCTGTGGGGTTAG	1	bc
GAGGCTCGTG	GAAACACCGGTTCCCGTCGAGTGGGGTTAGAGCTAGAAATAGCAATTTAA	1	bc
GCAGCGCCGC	GAAACACCGGTTCCCGTCCAGTGGGGTTAGAGCTAGAAATAGCAAGTTAA	1	bc
GTCTATCGTG	GAAACACCGGTTATATTTGTAAGTGTGTGGGGTTGGAGCTAGAAATAGCA	1	bc
ATCTATTGAG	GAAACACCGGTTATATTTGTAAGTGTGTGGGGTTAGAGCTAGAAATAGCA	1	bc
TAACAATGCC	GAAACACCGGTTTGAACTAGAAATAGCAAGTTAACCTAAGGCTAGTCCGT	1	bc
ATAACTTAAA	GAAACACCGGTAACTATATTCATGCGATATCGCCGTATCAGTGGGGTTAG	1	bc
CGACACTGCA	GAAACACCGGTGTGGCTGAGAGTCCGGCAATGGCGTGGCTGTGGGGTTAG	1	bc
AAATAGTCGT	GAAACACCGGTGTACGTATGGACTGAACCAGGGTGTGCAAGTGGGGTTAG	1	bc
ACACAAAGCC	GAAACACCGGTTTGAACTACCTAGTTCAAACCGGTGGGGTTAGAGCTAGA	1	bc
AGAGACAGAC	GAAACACCGGTAGCAAGTGCGAGACGTGTTTGTGGGGTTAGAGCTAGAAA	1	bc
ACTTTACAGA	GAAACACCGGTCGGGGCCACTCAGTGGTGGGGTTAGAGCTAGAAATAGCA	1	bc
CTAGACGCCC	GAAACACCGGTTACATTTAGGGTTATAGCTAGATATAGCAAGATATCCTA	1	bc
ACGTGTCGTC	GAAACACCGGTGACATTGGGTAGTGGGGTTAGAGCTAGAAATAGCAAGTT	1	bc
CAGGTAGGCT	GAAACACCGGTGACATTGGGCTAGAAATAGCAAGTTAACCTAAGGCTAAT	1	bc
AAGAAGACCC	GAAACACCGGTCGGCGGCAATCGTGGGTGGGGTTAGAGCTAGAAATAGCA	1	bc
ACATCATCGT	GAAACACCGGTTAACGTATGGACTGAACGGGGGTGGGCAAGTGGAGATAG	1	bc
ACCATTACCG	GAAACACCGGTCGGGGCCACTCAGTGGTGGGGTTAGAGCTAGAAATAGCA	1	bc
TAAAAGTTGG	GAAACACCGGTCTCGAGTGAGGTGTTCAGGGTGGGGTTAGAGCTAGAAAT	1	bc
ACAAAACGCA	GAAACACCGGTTTGAACTAGAAATAGCAAGTTAACCTAAGGCTAGTCCGT	1	bc
TAGACACACG	GAAACACCGGTGCATTCGAAAGTCCGGTCGTAGTGTGGACGTGGGGTTAG	1	bc
CACGAGGTCC	GAAACACCGGTTTGAACTACCTAGTAGCAAGTTAACCTAAAGCTAGAACG	1	bc
ATGGAGCATA	GAAACACCGGTTAAGCCGAGGAGTTAGAGCTAGAAATAGCAAGTTAACCT	1	bc
GCGTGTGGTC	GAAACACCGGTGACATTGGTGGGGTTAGGGCTAGAAATAGCAAGTTAACC	1	bc
AGACGCAGAC	GAAACACCGGTAGCAAGTGCGAGACGTGTTTGTGGGGTTAGAGCTAGAAA	1	bc
ATACTCATGT	GAAACACCGGTACCTTTGTTGATGCTGGGTGGAAGGAATTTGTGGGGTTA	1	bc
GGACACAGCC	GAAACACCGGTAGCAAGTGCGAGACGTGTTAAATAGCAAGTTAACCTAAG	1	bc
AGATACTAGC	GAAACACCGGTGCATTCGAAAGTCCGGTCGTAGTGTGGACGTGGGGTTAG	1	bc
TACAGATGGA	GAAACACCGGTAAATTTGAGGCTCCGGCATGCAGGAGGCCGTGGGGTTAG	1	bc
AACGCTCTTA	GAAACACCGGTGCCCTTACTCTCACCTGATTACTTAATCCGTGGGGTTAG	1	bc
GTGCCGCTTT	GAAACACCGGTCTCGAGTGAGGTGTTCAGGGTGGGGTTAGAGCTAGAAAT	1	bc
TGTCCGCTTC	GAAACACCGGTCCGTAGGAGACCCGTGTGGCATGTACCTGTGGGGTTAGT	1	bc
CGTAGTCGTT	GAAACACCGGTGTACGTATGGACTGAACCAGGGTGTGCAAGTGGGGTTAG	1	bc
AGTCTAATCT	GAAACACCGGTTTACGTTGCATCGGTGTGGGGTTAGAGCTAGAAATAGCA	1	bc
CAAAACGAAA	GAAACACCGGTTTGAACTACCGGGGTTAGAGCTAGAAATAGCAAGTTAAC	1	bc
TCGTCTGCCT	GAAACACCGGTCCGTAGGAGACCCGTGTGGCATGTACCTGTGGGGTTAGA	1	bc
ATCGAATTCT	GAAACACCGGTCTCGAGTGAGGTGTTCAGGGTGGGGTTAGAGCTAGAAAT	1	bc
CCTTCATCCA	GAAACACCGGTCGTGGCCACTCCGTGGTGGGGTTAGAGCTAGAAATAGCA	1	bc
TCGCTCAAGG	GAAACACCGGTTATATTTGTAAGTGGGGTTAGAGCTAGAAATAGCAAGTT	1	bc
GACAATGTGT	GAAACACCGGTTTCAACTAGCTAGTAGCAAGTTAACCTATGGCTATTCCG	1	bc
GAGGGGCATC	GAAACACCGGTTCCCGTCCAGTGGGGTTAGAGCTAGAAATAGCAAGTTAA	1	bc
ACCCTTACCG	GAAACACCGGTCGGGGCCACTCAGTGGTGGGGTTAGAGCTAGAAATAGCA	1	bc
CACTATGCTC	GAAACACGGGTTAGAGCTAGAAATAGCAAGTTAACCTAAGGCTAGTCCGT	1	bc
GTTAGCGATG	GAAACACCGGTTACATTGAGGGTTAGAGCTAGAAATAGCAAGTTAACCTA	1	bc
ACACTCAGCC	GAAACACCGGTACCTTTGTTGATGATAGCAAGTTAACCTAAGGCTAGTCC	1	bc
TCCACCGCCC	GCTAGAAATAGCAAGTTAACCTAAGGCTAGTCCGTTATCAACTTGAAAAA	1	bc
ACGTGGTGTC	GAAACACCGGTGACATTGGGTACGGGTAGAGCTAGAAATAGCAAGTTAAC	1	bc
CATCACCCCC	GAAACACCGGTTTGAACTAGAAATAGCAAGTTAACCTAAGGCTAGTCCGT	1	bc
GACCCCTGCG	GAAACACCGGTAAATTTGAGGCTCCGGCATGCAGGGGGCCGTGGGGTTAG	1	bc
AGTGTGCTCG	GAAACACCGGTGACATTGGGTACGCTAGAAATAGCAAGTTAACCTAAGGC	1	bc
AACACTGCTA	GAAACACCGGTAGCAAGTGCGGGGTTAGTGCTAGAAATAGCAATATAACC	1	bc
AGACACGCGA	GAAACACCGGTGCATTCGAAAGTCCGGTCGTAGTGTGGACGTGGGGTTAG	1	bc
GGAAGATGCG	GAAACACCGGTCGGCGGCAATCGGGGTTAGAGCTAGAAATAGCAAGTTAA	1	bc
GTGATTGACT	GAAACACCGGTTTACGTTGCATCGGTGTGGGGTTAGAGCTAGAACTAGCA	1	bc
AGGCCACGAC	GAAACACCGGTAAATTTGAGGCTCCGGCATGCAGGAGGCCGTGGGGTTAG	1	bc
CAACTTTCGG	GAAACACCGGTCGATTCATATCGAAACCTTCCCGTGACAGTGGGGTTAGA	1	bc
GAAATAGCGG	GAAACACCGGTTATATTTGTAAGTGTGTGGGGTTAGAGCTAGAAATAGCA	1	bc
GACGATCCAC	GAAACACCGGTCGGCGGCAATGTGGGGTTAGAGCTAGAAATAGCAAGTTA	1	bc
GAATCGACGT	GAAACACCGGTGTACGTATGGACTGAACCAGGGTGTGCAAGTGGGGTTAG	1	bc
TCGTGTATTC	GAAACACCGGTCACGTTTCCTAGAATGTGGGGGTTGAGCTTGAAATAGGC	1	bc
CTGATCGCCC	GAAACACGGGTTAGAGCTAGAAATAGCAAGTTAACCTAAGGCTAGTCCGT	1	bc
AATACTCGGC	GAAACACCGGTACCTTTGTTGATGCTGGGTGGAAGGAAGGAAGGTGGGGT	1	bc
AAGAACCTCG	GAAACACCGGTGCATTCGAAAGTCCGGTCGTAGTGTGGACGTGGGGTTAG	1	bc
AGTCGGTGTC	GAAACACCGGTTCGTAGGAGACCCGTGTAGCATGTACCTGTGGGGTTAGA	1	bc
CATAGGCGTT	GAAACACCGGTGTACGTATGGACTGAACCAGGGTGTGCAAGTGGGGTTAG	1	bc
AATACTCGTC	GAAACACCGGTACCTTTGTTGATGCTGGGTGGAAGGAATGTGGGGTTAGA	1	bc
AAAACCCCGG	GAAACACCGGTGTGGCTGAGTGTCCGGCAATGGTGTGGCTGTGGGGTTAG	1	bc
GACCCCTCCT	GAAACACCGGTAAATTTGAGGCTCCCGCATGCAGGAGTCCGTCGGGTTAT	1	bc
CGGTCGCCAG	GAAACACCGGTCCGCAGGAGACCCGTGTGGCATGTACCTGTGGGGTTAGA	1	bc
TAGACTGCGT	GAAACACCGGTCCGTAGGAGACCCGTGTGGCATGTACCTGTGGGGTTAGA	1	bc
GAGAAACCAC	GAAACACCGGTTCCCGTCCAGTGGGGTTAGAGCTAGAAATAGCAAGTTAA	1	bc
TCAGTTTGTT	GAAACACCGGTGACATTGGGTTAGAGCTAGAAATAGCAAGTTAACCTAAG	1	bc
GAATCGTCGT	GAAACACCGGTGTACGTATGGACTGAACCAGGGTGTGCAAGTGGGGTTAG	1	bc
AGACAGCCGT	GAAACACCGGTGCATTCGAAAGTCCGGTCGTAGTGTGGACGTGGGGTTAG	1	bc
TAACGACCTA	GAAACACCGGTGCCCTTACTCTCACCTGATTACTTAATCCGTGGGGTTAG	1	bc
AATACTAGGC	GAAACACCGGTACCTTTGGTGGGGTTAGAGCTAGAAATAGCAAGTTAACC	1	bc
AGTGGAGGCT	GAAACACCGGTTCCCGTCCAGTGGGGTTAGAGTTAGAAATAGCAAGTTAA	1	bc
TGAAGCCGTT	GAAACACCGGTCTCGAGTGAGGTGTTCAGGGTGGGGTTAGAGCTAGAAAT	1	bc
AAAGCACAGC	GAAACACCGGTCGGCGGCAATCGTGGGTGGGGTTAGAGCTAGAAATAGCA	1	bc
CGATCCTGGT	GAAACACCGGTGCATTCGAAAGTCCGGTCGTAGTGTGGACGTGGGGTTAG	1	bc
AGTTCGACTC	GAAACACCGGTCCGTAGGAGACCCGTGTGGCATGTACCTGTGGGGTTAGA	1	bc
ATACGCACGC	GAAACACCGGTGCATTCGAAAGTCCGGTCGTAGTGTGGACGTGGGGTTAG	1	bc
CCTAGTGGTC	GAAACACCGGTGTACGTATGGACTGAACCAGGGAGTGCAAGTGGGGTTAG	1	bc
AGTCGGGATG	GAAACACCGGTCCGTAGGAGACCCGTGTGGCATGTACCTGGGGTTAGAGC	1	bc
GAATACTAAG	GAAACACCGGTACCTTTGTTGATGCTGGGTGGAAGGTGGGGTTAGAGCTA	1	bc
ACGCATGCTT	GAAACACCGGTCTCGAGTGAGGTGTTCAGGGTGGGGTTAGAGCTAGAAAT	1	bc
CGATTACCGA	GAAACACCGGTCGGGGCCACTCAGTGGTGGGGTTAGAGCTAGAAATAGCA	1	bc
GAATTCCTGC	GAAACACCGGTCGGGGGCCGGTTAGAGTTAGAAATAGCAAGTTAACATAA	1	bc
GGTATGCCTA	GAAACACCGGTCCGTAGGAGACCCGTGTGGCATGTACCTGTGGGGTTAGA	1	bc
ACTGAGAATA	GAAACACCGGTTAAGCCGAGGGTTAGAGCTAGAAATAGCAAGTTAACCTA	1	bc
GTGCTGGGTC	GAAACACCGGTTCCCGTCCAGGGGGGTTAGGGCTGGAAATAGCAAGTTAA	1	bc
ATAGCTGCGC	GAAACACCGGTGCATTCGAAAGTCCGGTCGTAGTGTGGACGTGGGGTTAG	1	bc
GAAACGGAAA	GAAACACCGGTGGGGTTAGAGCTAGAAATAGCAAGTTAACCTAAGGCTAG	1	bc
GCAGACCGGT	GAAACACCGGTCGGCGGCAATCGTGGGTGGGGTTAGAGCTAGAAATAGCA	1	bc
CCCAGAGCCC	GAAACACGGGTTAGAGCTAGGAATAGCAAGTTAACCTAAGGCTAGTCCGT	1	bc
CAACGCCGTT	GAAACACCGGTCTCGAGTGAGGTGTTCAGGGTGGGGATAGAGCTAGAAAT	1	bc
AGAATGTCTC	GAAACACCGGTCCGTAGGAGACCCGTGTGGCATGTACCTGGGGTTAGAGC	1	bc
GTGCTCATCC	GAAACACCGGTTTGGCTGAGAGTACGGCACTGGAGTGGCTGTGGGGTTAG	1	bc
AGTGGAGGCC	GAAACACCGGTTCCCGTCCAGTGGGGTTAGAGCTAGAAATAGCAAGTTAA	1	bc
CTAATTATTT	GAAACACCGGTCTCGAGTGAGGTGTTCAGGTGGGGTTAGAGCTAGAAATA	1	bc
ACCTTTACGG	GAAACACCGGTCGGGGCCACTCAGTGGTGGGGTTAGAGCTAGAAATAGCA	1	bc
AGATCCTTTT	GAGACACCGGTGCATTCGAAAGTCCGGTCGTAGTGTGGACGTGGGGTTAG	1	bc
TTGGCGAGGG	GAAACACCGGTTACATTGAGATTAGAGCTAGAAAAGGCTAGTCCGTTATC	1	bc
AGCCACTACT	GAAACACCGGTAAATTTGAGGCTCCGGCATGCAGGGGGCCGTGGGGTTAG	1	bc
ATTGAGTATA	GAAACACCGGTTAAGCCGAGGAGTTAGAGCTAGAAATAGCAAGTTAACCT	1	bc
ATTATTCATA	GAAACACCGGTCCGTAGGAGACCCGTGTGGCATGTACCTGTGGGGTTAGA	1	bc
CGTGGTGACA	GAAACACCGGTGACATTGGGTACAGGGGTGGGGTTAGAGCTAGAAATAGC	1	bc
AAAGTACTAC	GAAACACCGGTGCCCTTACTCTCACCTGATTACTTAATCCGTGGGGTTAG	1	bc
AGACGCGCGA	GAAACACCGGTGCCCTTACTCTCACCTGATTACTTAATCCGTGGGGTTAG	1	bc
ATACTCGGGT	GAAACACCGGTACCTTTGTTGATGCTGGGTGGAAGGAATTTTTTGTGGAT	1	bc
AACAGACCTC	GAAACACCGGTGCCCTTACTCTCACCTGATTACTTAATCCGTGGGGTTAG	1	bc
ACGCCAACCG	GAAACACCGGTTTACGTTGCATCGGTGGGGGGTTAGAGCTAGAAATAGCA	1	bc
CCGCACCTTC	GAAACACCGGTATCGCGTGAGGTGATCAGGGTGTAGTTAGAGATATAGAT	1	bc
GAGGCGCGTC	GAAACACCGGTTCCCGTCCCGTGGGGTTAGGGCGAGAAATAGCAAGTTAA	1	bc
AAAGATCTAC	GAAACACCGGTGCCCTTACTCTCACCTGATTACTTAATCCGTGGGGTTAG	1	bc
TCGAATTCTT	GAAACACCGGTCTCGAGTGAGGTGTTCAGGGTGGGGTTAGAGCTAGAAAT	1	bc
CGTATGCACC	GAAACACCGGTCCGTAGGAGACCCGTGTGGCATGTACCTGTGGGGTTAGA	1	bc
AACAACGTTC	GAAACACCGGTTTGAACTACCTAGTTCAAACCGGTGGGGTTAGAGCTAGA	1	bc
AATCGTGATC	GAAACACCGGTGTACGTATGGACTGAACCAGGGTGTGCGAGTGGGGTTAG	1	bc
GACCGGCTTA	GAAACACCGGTGCCCTTACTCTCACCTGATTACTTAATCCGTGGGGTTAG	1	bc
AGTTTGCTAC	GAAACACCGGTCCGTAGGAGACCCGTGTGGCATGTACCTGTGGGGTTAGA	1	bc
AAAGCCATAA	GAAACACCGGTAAATTTGAGGCTCCGGCATGCAGGAGGCCGTGGGGTTAG	1	bc
GTGCGCATCA	GAAACACCGGTTAAGCCGAGGAGTTAGGGCTAGAAATAGCAAGTTAACCT	1	bc
AATCTGAATA	GAAACACCGGTCCGTAGGAGACCCGTGTGGCATGTACCTGTGGGGTTAGA	1	bc
GGCAAAGTAC	GAAACACCGGTGTGGCTGAGAGTCCGGCAATGGTGGGGCTGTAGGGATAG	1	bc
GGGGTGCCGC	GAAACACCGGTACCCGTCCAGTGGGGTTAGAGCTAGAAATAGCAAGTTAA	1	bc
ACGAAGCCTT	GAAACACCGGTCTCGAGTGAGGTGTTCAGGGTGGGGTTAGAGCTAGAAAT	1	bc
ACTCGACCCA	GAAACACCGGTCGATTCATATCGAAACCTTCCCGTGACAGTGGGGGTAGA	1	bc
GACAACCGCC	GAAACACCGGTGTGGCTGAGAGTCCGGCAATGGTGTGGCTGTGGGGGTAG	1	bc
ATCGAGAGAG	GAAACACCGGTTATATTTGTAAGTGTGTGGGGTTAGAGCTAGAAATAGCA	1	bc
GGAACCAGTA	GAAACACCGGTGTGGCTGAGAGTCCGGCAATGGTGTGGCTGTGGGGTTAG	1	bc
GGAGACCGCC	GAAACACCGGTAGAGCTAGAAATAGCAAGTTAACCTATGGCTAGTCCGTT	1	bc
AGAACCAGTC	GAAACACCGGTAGCAAGTGCGTGGGGTTAGAGCTAGAAATAGCAAGTTAA	1	bc
TTAGAACGCG	GAAACACCGGTTTGAACTAGAAATAGCAAGTTAACCTAAGGCTAGTCCGT	1	bc
ACAGCCCTAA	GAAACACCGGTGCCCTTACTCTCACCTGATTACTTAATCCGTGGGGTTAG	1	bc
TAGACACTCG	GAAACACCGATGCATTCGAAAGTCCGGTCGTAGTGTGGACGTGGGGTTAG	1	bc
AAATTTACCG	GAAACACCGGTCGGGGCCACTCAGTGGTGGGGTTAGAGCTAGAAATAGCA	1	bc
CAGGCACCCT	GGAACACCGGTGTGGCTGAGAGTCCGGCAATGGTGTGGCTGTGGGGTTAG	1	bc
CGGGTTGTTC	GAAACACCGGTGACATTGGGTACAGGGGTGGGGTTAGAGCTAGAAATAGC	1	bc
ACAGATGGAC	GAAACACCGGTTTGAACTAGAAATAGCAAGTTAACCTAAGGCTAGTCCGT	1	bc
AGGCTGCTAC	GAAACACCGGTAAATTTGAGGCTCCGGCATGCAGGAGGCGTGGGGTTAGA	1	bc
TGGCACACTC	GAAACACCGGTGTGGCTGAGAGTCCGGCAATGGTGTGGCTGTGGGGTTAG	1	bc
AAGGAGCGTC	GAAACACCGGTTCCCGTCCAGTGGGGTTAGAGCTAGAAATAGCAAGTTAA	1	bc
AAGTGTGCCT	GAAACACCGGTCCGTAGGAGACCCGTGTGGCATGTACCTGTGGGGTTAGA	1	bc
CACAGAGATC	GAAACACCGGTTTGAAATAGCAAGTTAACCTAAGGCTAGAAATAGCAAGA	1	bc
GAATTCTTTT	GAAACACCGGTCGATTCATATCGAAACCTTCCCGTGACAGTGGGGTTAGA	1	bc
AACAAAGCAC	GAAACACCGGTTTGAACTAGAAATAGCAAGTTAACCTAAGGCTAGTCCGT	1	bc
CAGATGGCTC	GAAACACCGGTCCGTAGGAGACCCGTGTGGCATGTACGTGTGGGGTTAGA	1	bc
ATTGAGTATA	GAAACACCGGTTAAGCCGAGTGGGGTTAGAGCTAGAAATAGCAAGTTAAC	1	bc
ATTTACATAT	GAAACACCGGTTACATTGAGATTGGGGTTAGAGCTAGAAATAGCAAGTTA	1	bc
AAGGATAGAC	GAAACACCGGTAATTATATTCATGCGATATCGTCGTATTAGTGGTGGTAG	1	bc
TTGAGCAACG	GAAACACCGGTTAAGCCGAGGTGGGGTTAGAGCTAGAAATAGCAAGTTAA	1	bc
ATTCTGACTA	GAAACACCGGTCCGTAGGAGACCCGTGTGGCATGTACCTGTGGGGTTAGA	1	bc
ATAAGGTATA	GAAACACCGGTTACATTGAGGGTTAGAGCTAGAAATAGCAAGTTAACCTA	1	bc
CAAAACGGCA	GAAACACGGGTTAGAGCTAGAAATAGCAAGTTAACCTAAGGCTAGTCCGT	1	bc
TATTATAAAC	GAAACACCGGTCGGGGCCACTCAGTGGTGGGGTTAGAGCTAGAAATAGCA	1	bc
AAAACCCTCG	GAAATACCGGTGCATTCGAAAGTCCGGTCGTAGTGTGGACGTGGGGTTAG	1	bc
ACATTCATCT	GAAACACCGGTCGATTCATATAGAAACCTTCCCGTGACAGTGGGGTTAGA	1	bc
GACGCCCTCT	GAAACACCGGTGTGGCTGAGAGTCCGGCAATGGTTTGTCTGTGGGGTTAG	1	bc
CGTCGCCGCC	GAAACACCGGTGTACGTATGGACTGAACCAGGGTGTGCAAGTGGGGTTAG	1	bc
GTGCATAGGG	GAAACACCGGTTTACGTTGCATCGGTGTGGGGTTAGAGCTAGAAATAGCA	1	bc
TTGAGTAGTC	GAAACACCGGTTAAGCCGAGGTTAGAGCTAGAAATAGCAAGTTAACCTAA	1	bc
GCAATCGACA	GAAACACCGGTTATATTTGTAAGTGTGGGGTTAGAGCTAGAAATAGCAAG	1	bc
ATAGAGGGCC	GAAACACCGGTACCTTTGTTGATGCTGGGTGGAAGGTGGGGTTAGAGCTA	1	bc
TGTAGTATAA	GAAACACCGGTTAAGTTGAGGAGTTTCGTTAGAGCTAGAAATAGCCAGTT	1	bc
TAATGCCCTA	GAAACACCGGTGCCCTTACTCTCACCTGATTACTTAATCCGTGGGGTTAG	1	bc
TTACCAGCAC	GAAACACCGGTTTGAACTAGAAATAGCAAGTTAACCTAAGGCTAGTCCGT	1	bc
GTAGTGCTAC	GAAACACCGGTAACTATATTCATGCGATATCGCCGGATCTGTGGGGTTAG	1	bc
GCGAAGACTT	GAAACACCGGTCTCGAGTGAGGTGTTCAGGGTGGGGTTAGAGCTAGAAAT	1	bc
ATTCTTAACG	GAAACACCGGTTTACGTTGCATCTAGAAATAGCAAGTTAACCTAAGGCTA	1	bc
AAGTATCGCG	GAAACACCGGTTATATTTGTAAGTGTGTGGGGTTAGAGCTAGAAATAGCA	1	bc
AAGGACTTGA	GAAACACCGGTCGGCGGCAATCGTGGGGTGGGGTTAGAGCTAGAAATAGC	1	bc
AGGCACTATC	GAAACACCGGTGTGGCTGAGAGTCCGGCAATGGTGTGGCTGTGGGGTTAG	1	bc
AGGCTGCATA	GAAACACCGGTCCGTAGGAGACCCGTGTGGCATGTACCTGTGGGGTTAGA	1	bc
GGACTCTGCC	GAAACACCGGTGCATTCGAAAGTCCGGTCTTAGTGTGGACGTGGGGATAG	1	bc
AGACGCGCGT	GAAACACCGGTGCATTCGAAAGTCCGGTCGTAGTGTGGACGTGGGGTTAG	1	bc
TAGAGGAGGG	GAAACACCGGTAACTATATTCATGCGATATCGCCGTATCAGTGGGGTTAG	1	bc
TGTATCCACC	GAAACACCGGTCGGGGCCACTCAGTGTGGTGGGGGTAGAGCTAGAAATAG	1	bc
AGCCTCTAGC	GAAACACCGGTGCATTCGAAAGTCCGGTCGTAGTGTGGACGTGGGGTTAG	1	bc
CAACACGCCT	GAAACACGGGTTAGAGCTAGAAATAGCAAGTTAACCTAAGGCTAGTCCGT	1	bc
AGAACATGAA	GAAACACCGGTAGCAAGTGCGAGACGTGTTAAATAGCAAGTTAACCTAAG	1	bc
TCAGATCTGG	GAAACACCGGTTACATTGAGGGTTAGAGCTAGAAATAGCAAGTTAACCTA	1	bc
GCGTAGCCTA	GAAACACCGGTTCCCGTCCAGTGGGGTTAGAGCTAGAAATAGCAATTTAA	1	bc
ACACCAATCC	GAAACACCGGTTTGAACTACCTAGTAGCAAGTTAACCTAAGGCTAGTCCG	1	bc
TTCCCGTACA	GAAACACCGGTAGATATGAGGGTGCCCCACTCAGCAAGCCGTGGGGTTAG	1	bc
CAACTCGCTC	GAAACACCGGTTTGAACTAGAAATAGCAAGTTAACCTAAGGCTAGTCCGT	1	bc
GAATAACCGA	GAAACACCGGTCGGTGGGGTTAGAGCTAGAAATAGCAAGTTAACCTAAGG	1	bc
AAACTCCCTA	GAAACACCGGTGCCCTTACTCTCACCTGATTACTTAATCCGTGGGGTTAG	1	bc
TTGGGAGTAA	GAAACACCGGTTAAGCCGAGGAGTTTCGTTAGAGCTAGAAATAGCAAGTT	1	bc
AGTAAAGGCA	GAAACACCGGTTTGCAGTAAATATAGAGAGTTATACTAAGGCTAGGCCGT	1	bc
TTTAGGTATG	GAAACACCGGTTACATTGAGATTAGAGCTAGAAAAGGCTAGTCCGTTATC	1	bc
CTACTAGGTG	GAAACACCGGTACCTTTGTTGATGCTGGGTGGGGTTAGAGCTAGAAATAG	1	bc
