CTCGTAAGTC	GAAACACCGGTCATGTCAATGCGGTGTGGGGTTAGAGCTAGAAATAGCAA	2	bc
GGCGACCGCA	GAAACACCGGTCCCGGTAGAACCAAAGGCTGTGGGGTTAGAGCTAGAAAT	2	bc
AGGCTGTGTC	GAAACACCGGTCCGTAGGAGACCCTTTTGGGATGTATCTGTGGGATTAGT	1	bc
TGCCTTATCC	GAAACACCGGTAACTATATTCATGCGGTATCGCCGTATCAGTGGGGTTAG	1	bc
AAACCCCTCC	GAAACACCGGTGCCCTTACTCTCACCTGATTACTTAATCCGTGGGGTTCG	1	bc
TAGGCCCGCC	GAAACACCGGTGGCCTTACCCTCATATGGTTACTTAATCCGTGGGGATAT	1	bc
ATGCCTCGCC	GAAACACCGGTTTGCGTGGCATCGGTGTGGGGTTAGAGCTAGAAATAGCA	1	bc
GCGTCGCGGA	GAAACACCGGTAGAACATGGTCGACACATGGTGGGGTTAGAGCTAGAAAT	1	bc
ACCGCGCTAA	GAAACACCGGTGGCGCTTATCTAAATGTGGGGTTTGAGCTCGAAGTAGAG	1	bc
AACGTACCAC	GAAACACCGGTTCCCTTACTCTCACCTGTTTACGTAATCCGTGGGGTTAG	1	bc
ATGCGCTGCT	GAAACACCGGTTTACGATGCATCGGAGTGGGGGTAGAGCTAGAAATAGAA	1	bc
TAAATCCTAC	GAAACACCGGTAACTAATTTCATGCCGTATCGCCGTATCAGGGGGGTTAA	1	bc
GGAGCGCCTC	GAAACACCGGTTCCTGCGAAGTTCGGTTCGAGCTGGGGATGGCGGGTTAG	1	bc
CACCTATCGC	GAAACACCGGTTTGAACTACATAGAAGGGGTTAGAGCTAGAAATAGAAAG	1	bc
CGGGGGTTCC	GAAACACCGGTCTTGGTTCTAGGGTAGTGGGGTTAGAGCAGAAATAGCAA	1	bc
ATTCTTTACT	GAAACACCGGTTTACGTTGCACCGGTGTGGGGTTAGAGCTAGAAATAGCA	1	bc
TCGAAGGAGG	GAAACACCGGTTCTATTCGTAAGTGTGTGGAGCTAGAGATAGCAATATAA	1	bc
GGCGACCGCG	GAAACACCGGTCCCGGTAGAACCAAAGGCTGTGGGGTTAGAGCTAGAAAT	1	bc
AATCCCCCTC	GAAACACCGGTGCCCTTACTCTCACCTGATTACTTAATCCGTGGGGTTAG	1	bc
ACCTCTACCG	GAAACACCGGTCGGGGCCACTCAGTGGTGGGGTTAGAGCTAGAAATAGCA	1	bc
GGCCCCCCGC	GAAACACCGGTGCACTCGAAAGCCCCGTCGCAGTGTGGTCGTGGGGTTAG	1	bc
CAAGAATCGC	GAAACACCGGTTGGCTGCAATCAAGCTAGAAATAGCAAGTTAACATAAGG	1	bc
GGGAAACGCC	GAAACACCGGTTTACGTTGCATCGGTGTGGGGTTAGAGCTAGAAATAGCA	1	bc
TAGCCACGCC	GAAACACCGGTCGTTGGAGCTCGCTGTCGTGGGGGTTTAGCTCTAGATAT	1	bc
AGGTGTTCGA	GAAACACCGGTAATAATTCCTGCCGGGTGGGGTTAGAGCTAGAAATAGCA	1	bc
GGGGATGCGC	GAAACACCGGTTCCCGTGGAGAGGGGTTAGAGTTAGAAATAGAAAGATAA	1	bc
GTGACCTACA	GAAACACCGGTATATTTGAATATGCGGCCTGCAGGAGGACAGGTGGATAT	1	bc
GACCCTTCCT	GAAACACCGGTCGGCCAGAGGTAATCACATGTGGGGTTAGAGCTAGAAAT	1	bc
TGTCTGACAC	GAAACACCGGTCCGTAGGAGACCCGTGTGGCATTAAGAATTCGAAAGTTA	1	bc
CCTCACCCCA	GAAACACCGGTCCGTAGGAGACCCGTGTGGCATGTACCTGTGGGGTTAGA	1	bc
ATGGTCAGAT	GAAACACCGGTGTACGTACTATCGGCTGATGACTTGAGCTGGAGAGATAG	1	bc
GAACTTAGCC	GAAACACCGGTTTACGGTAATTGGGGGTGGGGTTAGAGCTAGAAATAGCA	1	bc
CGCGTGGTGT	GAAACACCGGTGACATTGGGTTAGAGAGAGAAATAGCAAGTTAACATAAG	1	bc
TCATCAGGCC	GAAGCACCGGTGAGAAACCTTTCTAAGTGGGGTTAGAGCTAGAAATAGCA	1	bc
ACGTCGCGGA	GAAACACCGGTAGAGCATGGTCGACATATAGTGGGGTTAGAGCTAGAAAT	1	bc
TCCGCCCTCC	GAAACACCGGTGCCCTTACTCTCTCCTTATTACTTAATCCGTGGGGTTAG	1	bc
ACGCGCAGCT	GAAACACCGGTTTACGTTCAATCATAGCAAGCTAACCTAAGGCTAGTCCG	1	bc
CGAGTCCTGC	GAAACACCGGTCGGCGGGGCTAGAGCTAGAAGTAACAAGTTGACATAGGG	1	bc
TAACGCATAA	GAAACACCGGTTAAGCCGTGGATTTAGAGCTAGAGATAGCAAGTTGACCT	1	bc
GCCAACGAGC	GAAACACCGGTAATCGGAGGTGAACGTAAGGTGGGGTTAGAGCTAGAAAT	1	bc
CACGCCCTCT	GAAACACCGGTACACTCATCTCAATTTGTTATTTAGTTAGAGCGAGTAGT	1	bc
TACACCCCAC	GAAACACCGGTTCGCGCGGAATCTTTGTGGGGTTAGAGCTAGAAATAGCA	1	bc
ACATCAGGGT	GAAACACCGGTAGATTCATATCGATAAATTTAGGTATCAGAAGGGATACT	1	bc
CACTTCCTTC	GAAACACCGGTGTGGGGTTAGGGGAGCAATAGCAAGTTAGCCTAAGACTA	1	bc
TTTCCTGCAG	GAAACACCGGTCTCGAGTGAGGTGTTCAGGGTGGGGTTAGAGCTAGAAAT	1	bc
CACGCCATGC	GAAACACCGGTGCCCTTACTCTCACCTGATTACTTAATCCGTGGGGTTAG	1	bc
TCTTATAACC	GAAACACCGGTAACCAGCGCATGCTCCAAAGTGGGGTTAGAGCTAGAAAT	1	bc
GAAACCTTTT	GAAACACCGGTCTCGAGTGAGGTGTTCAGGGTGGGGTTAGAGCTAGAAAT	1	bc
TGCAGCATCA	GAAACACCGGTTAAGCCGAGAGGGGGTAAAGCTAGAAATAGCAAGTTAAC	1	bc
CGTGGTTTCA	GAAACACCGGTGACATATAAATAGCAAGTTAACCTAAGGCTAGTCCGTTA	1	bc
CTCTATTGAG	GAAACACCGGTTATATTTGTAAGTGTTGTGGGGTTAGAGCTAGAAATAGC	1	bc
CACAAATCCT	GAAACAAAGGTTTGAAGTAGAAATCGCAAGTTAACCTCATGCTAGTCTGT	1	bc
CGCATTGTCC	GAAACACCGGTGACATTGCACGGGGTTAGAGCTAGAAATAGCAAGTTAAC	1	bc
GCTCACGATT	GAAACACCGGTTATAGTAGAAAGTGTGTGGGGTTAGAGCTAGAAATAGCA	1	bc
TGACACGGAC	GAAACACCGGTAGCGAGTGCGAGACGTGTTTGTGGGGTTAGAGCTAGAAA	1	bc
AAGCCGCGCC	GAAACACCGGTTTAAGTTGACTCGGCCTGTGGGTATAGATATAAAAATAG	1	bc
CACCGCCCTC	GAAACACCGGTGGACGTATGGACGGAACGAGGGTGGGCAAGGGGGGAGAG	1	bc
GTAACTCCCT	GAAACACCGGTTACATTTACCGGCTAGAGCTAGTAGTAGTAAGTTAACCA	1	bc
ACGTCTAGCT	GAAACACCGGTTTACGTTGTGTCTAGAGCTAGATATAGCAAGTTAACCTA	1	bc
AGGAGTATAA	GAAACACCGGTTAAGCCGAGAGGGGTTAAAGCTAGGAATAGCAAGGTAAC	1	bc
CCATCAGCCC	GAAACACCGGTTTGAACTACCTAGAAATAGCAAGATAACCTAAGGCTAGT	1	bc
TTTAGCCTAC	GAAACACCGGTTAAGCCGAGGGGTTAGAGCTAGAAATAGCAAGTTAACCT	1	bc
AGCGACCGCC	GAAACACCGGTCCCGGTAGAACCAAAGGCGGAGGGGTTAGAGGTGGTAAT	1	bc
TAATTTATGT	GAAACACCGGTGACTATATTTATGCGATATCGCTGTAGCAGGGAGGATAG	1	bc
TGGTGATGGT	GAAACACCGGTCAAACCTGGATAGAAGTGGGGTTAGAGCTAGAAATAGCA	1	bc
