AGGTACCCTC	GAAACACCGGGGTGGCTGAGAGTCCGGCAATGGTGTGGCTGTGGGGTTAG	1	bc
TAAGCTAAAT	GAAACACCGGTTACATTGAGGGTTAGAGCTAGAAATAGCAAGTTAACCTA	1	bc
ACGTTCTGGA	GAAACACCGGTCGATTCATATCAACACCTTCCCGTGACAGAGGGGTTAGA	1	bc
GTAGCTCTGC	GAAACACCGGTTACATTCAGTCGTAGAGCTAGATATAGCTAGATATCCTA	1	bc
TCTAGCTCGG	GAAACACCGGTTATATTTGTAAGTGGGGTTAGAGCTAGAAATAGCAAGTT	1	bc
TCATCGTCCT	GAAACACCGGTGTACGTATGGACTGAACCAGGGTGTGCAAGTGGGGTTAG	1	bc
CTTCTACGGC	GAAACACCGGTAGGGGCCACTAAGCTGGGGGGATGGAGCTGGGAGGATCG	1	bc
AAGGCGGATC	GAAACACCGGTACCACTCCCGTCGAGAGTAGTGGGGTTAGAGCTAGAAAT	1	bc
GAAGTTTAGC	GAAACACCGGTTTACGTTGCATCGGTGTGGGGTTAGAGCTAGAAATAGCA	1	bc
TTCTCCTACA	GAAACACCGGTAAATTGCAGGCTGCGCTATGCACCTAATCGTGGGGTTAG	1	bc
CAATCCGACT	GAAACACCGGTACAACCGTCTCACTTGGTCGTGGGGTTAGAGCTAGAAAT	1	bc
TACACCTGCA	GAAACACCGGTAAATTTGAGGCTCCGGCATGCAGGAGGCCGTGGGGTTAG	1	bc
GCGTCGCCCT	GAGACACCGGTGTCCGCTGCCAGCTCCATTGTGGGGTTAGAGCTAGAAAT	1	bc
CATTCACGTC	GAAACACCGGTGAAAGAATTTACTAAACCGGGTTAGGCCAGGGGGTTTAA	1	bc
TAGCTCTAAC	GAAACACCGGTTAGAGCTAGAATTCGGGCCCATTGGTATGGCAGATCGGA	1	bc
TAACAACGCC	GCTAGAAATAGCCCGGTATCCTAAGGCTAGTCCGTTATCAACTTGAAGAA	1	bc
ATGACCCACC	GAAACACCGGTATATAAAAATACGAGTACAGTGGGGTTAGAGCTAGAAAT	1	bc
TAGGTATGTC	GAAACACCGGTTACATTGAGGGGTTAGAGCTAGAAATAGCAAGTTAACCT	1	bc
TTAGCTTCGA	GAAACGGGGGTTAGAGCTAGAAATAGCAAGTTAACCTAAGGCTAGTCCGT	1	bc
CGCATTGTCC	TTCCAAGGAGGAAAGACCTGTTCATAAAAAACTTACTTAGACCTAGGCCC	1	bc
ATGTCATCGA	GAAACACCGGTAGACCCTGTTGCTTCGTGGGGTTAGAGCTAGAAATAGCA	1	bc
GTGGAGGGAC	GAAACACCGGTCGTCGCTATATCATTATGGGGTTAGACTAGAAATAGCAA	1	bc
TATCCATGCA	GAAACTCCGGTCCGTAGGAGAACCGTGTGGCATGTACCTTGTGGGGATAG	1	bc
CCACCATCCG	GAAACACCGGTCTCGTATCCATGTATGTGGGGTTAGAGCTAGAAATAGCA	1	bc
