TAACTGCTCT	GAAACACCGGTTAGCAGCCAATTGCGTGGCTCCTAGAGGTGTGGGGTTAG	3	bc
AGCATACCCA	GAAACACCGGTCCTGTCGCCACGGGTGTGGGGTTAGAGCTAGAAATAGCA	1	bc
TCACCAATGT	GAAACACCGGTTTGATTGTGGGGATAGAGCTAGAAGTAGCAAGTTAACCT	1	bc
TCTGAAGAGC	GAAACACCGGTCAAGCGCCCTCGCGGTATGACGTAGAGTGAGAGGTAGAG	1	bc
GACGGCGTAC	GAAACACCGATGCCCTTACTCTCACCTGATTACTTAATCCGTGGGGTTAG	1	bc
TCCTCGTAGT	GAAACACCGGTGTACGTATGGACTGAACCAGGGTGTGCAAGTGGGGTTAG	1	bc
GAGGCGCCAC	GAAACACCGGTTGCCGTCCAGTGGGTTTAGATCGATGAATAGCAAGTTAG	1	bc
AGACGCAGAG	GAAACACCGGTAGCCAGTGCGAGACGTGTTTGTGGGGTTAGAGCTAGAAA	1	bc
TTTTTTTATC	GAAACACCGGTTTACGTTGCATCGGTGTGGGGTTAGAGCTAGAAATAGCA	1	bc
CTCGTAAGTC	GAAACACCGGTCATGTCAATGCGGTGTGGGGTTAGAGCTAGAAATAGCAA	1	bc
TCTTCTCCGC	GAAACACCGGTACCTTTGTTGATGCTGGGTGGGGTTAGAGCTAGAAATAG	1	bc
TCAACTCTGT	GAAACACCGGTTACCAGCCAAGTTAGAGCTTGATATAGGTGGGGGGCCTA	1	bc
CCCAACCTTT	GAAACACCGGTCTCGAGTGAGGTGTTCAGGTGGGGTTAGAGCTAGAAATA	1	bc
GATACCCCCT	GAAACACCGGTCGAATAAGATGGAACGTTTGGTTAGAGATAGAGATAACA	1	bc
GAAGTTGCCT	GGCTAGAGCTAGGAATAGTAAGTTAACCTAAGGCTATTCCGCTATCAACT	1	bc
TTGATCATCC	GAAACACCGGTTAAGCCGTGGGGTTAGAGCTGGAAATAGCAAGTTAACCT	1	bc
ATGATCGGCT	GAAACACCGGTTTACGTTGCATCGTGGGGTTAGAGCTAGCAATAGATAGT	1	bc
AAGTCTGTCG	GAAACACCGGTCCGTAGGAGACCCGTGTGGCATGTACCTGTGGGGTTAGA	1	bc
AAACCAGACA	GAAACACCGGTGGCAAGGGCGAGCCGGGCTTTTGTGGGGCTAGAGCTTAG	1	bc
TAACAGCCCA	GAAACACCGGTCTGGGGCAATCGGAGGAATGGGTAAGAGCGAGAGATAGC	1	bc
ATGAATTCTC	GAAACACCGGTTCCTGACATGTGGGTTTAGAGCGAGGAGTAGGAAGTTAA	1	bc
CGCCTCTCTA	GAAACACCGGTAAATGTGTGGATCCTGCTTGCAGGAGTACAGGTGGTAAT	1	bc
CCCTCACTGC	GAAACACCGGTCGGGGTCACTCAGCGGCGGGGTTGGAGCTAGAAATAGCA	1	bc
TAAGACCTCG	GAAACACCGATGCATTCAAAAGTCCGGTCGTAGTGTGGACGTGGGGTTAG	1	bc
ACCTTAGATA	GAAACACCGGTAGCAACTGATCGACACGTTAGACGTGGGGTTAGAGTAAG	1	bc
CATACCCCAC	GAAACACCGGTCTCGTATCCATGTATGTGGGGTTAGAGCTAGAAATAGCA	1	bc
AGGCGTTCAA	GAAACACCGGTTATAGTTGCTTCCGGTGTGGGGTAAGACTTAGAAATACC	1	bc
GAAACTACGT	GAAACACCGGTCCAAAATGTCGCCACGTGGGGGTAGAGCTAGAAATAGCA	1	bc
GCTACAGCGA	GAAACACCGGTCGGGGCCACTCAGTGGTGGGGTTAGAGCTAGAAATAGCA	1	bc
GACCCTTCCT	GAAACACCGGTCGGCCAGAGGTAATCACATGTGGGGTTAGAGCTAGAAAT	1	bc
TCATCAGGCC	GAAACACCGGTGAGAAACCTTTCTAAGTGGGGTTAGAGCTAGAAATAGCA	1	bc
AACCTGCATC	GAAACACCGGTCCGTAGGCGCCCAGTTTGGCATGTACCTGGGGGGTTTGA	1	bc
AGAGCCGTGT	GAAACACCGGTGCCCTTACTCTCACCTGATTACTTAATGACTTAGGTGGG	1	bc
CGACTAGATT	GAAACACCGGTCTCGAGTGAGGGGTTCAGGGCGGGGTTAGAGCTGGAAAT	1	bc
AATGCTCGAC	GAAACACCGGTGCACGTACGCTCAGCTGATTACTTAGTCCGTGGGGTTAG	1	bc
CACATCGGGC	GAAACACCGGTTTGAACTAGAAATAGCAAGTTAACCTAAGGCTAGTCCGT	1	bc
AACTCTCCAC	GAAACACCGGTGCTCTTGCTCTCACCTTATTATTTAATTCGTGGGGGTAG	1	bc
TCCACCGACG	GAAACACCGGTTTTATTTGTAAGTGGGCATAGATCTAGAAATAGCAAGTT	1	bc
GAGGCGCTCC	GAAACACCGGTGCGGCTGAGGTTGCGGCAATGGTGGGTATGGCTGGTTAT	1	bc
TCTGCTTAGC	GAAACACCGGTTATATTTGCATTAGGGGAGTTAGAGCCAGGAGTAGCAAG	1	bc
CTGCTGGGCG	GAAACACCGGTACCTTAGAGCTAGAAATGGCAAGTTAACCTAAGGCTGGA	1	bc
GATATGCCTC	GAAACACCGGTCCGTAGTAGACCCGTGTGGCATGTACCTTTGGGGTTGGA	1	bc
CTATCCGCCT	GAGACACCGGTACCTTTGTTGATGCTGGGTGGGGTTATAGCTCGAGATAG	1	bc
GTGCTTCCTC	GAAACACCGGTCCGCAGGAGACCCGTGTGGCGTGTACCTTTGGGGTTACA	1	bc
TACACCGAGG	GAAACACCGGTTATAGTTGTAAGTTTGTGGGGTTAGAGCTAGAAATAGCA	1	bc
AATATCGACA	GAAACACCGGTAGTGCGCTTTTAGAACTAGCTATAGGAAGTTAACCTTAG	1	bc
ATATGCGTTT	GAAACACCGGTCGATTCATATCGAAACCTTCCCGTGACAGTGGGGTTAGA	1	bc
ATTTTTAACT	GAAACACCGGTTTACGTCGCATCCGTGTGGGGTTAGAGCTAGAAATAGCA	1	bc
AGCACTGGTC	GAAACACCGGTTCACGTATGACATGAATAGGCGAGGGCACGTGGGGTTAG	1	bc
AAAAGCCCCC	GAAACACCGGTGCCCTTACTCTCACCTGATTACTTAATCCGTGGGGTTAG	1	bc
TTTCCTGCAG	GAAACACCGGTCTCGAGTGAGGTGTTCAGGGTGGGGTTAGAGCTAGAAAT	1	bc
ACGTCGCGGA	GAAACACCGGTAGAACATGGTCGACATATAGTGGGGTTAGAGCTAGAAAT	1	bc
GAGACCGCCC	GAAACACCGGTTTGGCTGAGAGTCGGGTAGTGGTTTGAGTGTGGGGTTAG	1	bc
CATCGCCCAC	GAAACACCGGTATACGCATGAGCCGAACCAGGGGGTGTAAGGGGAGTTAT	1	bc
AATTCTTCAT	GAAACACCGGTCTCGAGTGAGGTGTTCAGGGTGGGGTTAGAGCTAGAAAT	1	bc
GACCGTGACA	GAAACACCGGTAGCCATTGCGACAGGAGCTGGAGACGCGTTAGGGACAAG	1	bc
ATGATCTTTT	GAAACACCGGTCTAGAGTGAGGTGTTCGGGGTGGGGTTAGAGCTAGAAAT	1	bc
GCTGGCTCGC	GAAACACCGGTTGACGGCGCATGTGGGTGGGGTTAGAGCTAGAAATAGCA	1	bc
CCAATACATT	GAAACACCGGTTTTCTGGGTTAGGTTCTGTGGGGGGAGAGATCGAGATAG	1	bc
GGAACCTCCC	GAAACACCGGTGTGGCTGAGAGTCGGGCAATGGGGTGGGTGTGGGGATAG	1	bc
AGTGCTCAGC	GAAACACCGGTTTACGTTGCATCGGTTGTGGGGTTAGAGCTTGAAATAGC	1	bc
CGTGTTACAC	GAAACACCGGTGACATAGCAAGTTAACCTAAGGCTAGTCCGTTATCAACT	1	bc
ACCCCCGCCC	GAAACACCGCTTTGAATAGCAAGTTAACCTAAGGCTAGTCCGTTATCAAC	1	bc
TTATCCGTGT	GAAACACCGGTTACATTGAGGGTTAGAGCTCGAAATAGCAAGTTAACCTA	1	bc
GAGGAATCGC	GAAACACCGGTCGGCGGAACTCGGGAGTTAGAGCTAGGCATGACATATTA	1	bc
ATGTCATCTA	GAAACACCGGTTAAGCCGAGGTTAGAGCTAGAAATAGCAAGTTAACCTAA	1	bc
GTCACCATAA	GAAACACCGGTTAGGCCGAGGAGTTAGAGATAGAAATAGTGAGTTGACAT	1	bc
