TCCCCCCCAC	GAAACACCGGTGCCCTTACTCTCACCTGATTACTTAATCCGTGGGGTTAG	1	bc
TTAGTGATGG	GAAACACCGGTTACATTCAGGGCTATAAATAGAATTAGCAAGTTAACTTA	1	bc
AGTGGAGTCT	GAAACACCGGTTCCCGTCCAGTGGGGTTAGAGCTAGAAATAGCAAGTTAA	1	bc
AACGTCCTTT	GAAACACCGGTGTCCTTACTCTCACTTGATTACTTAATCCGTGGGGTTAG	1	bc
AATGCTCAGC	GAAACACCGGTTTACGTTGCATCGGGGTTAGAGCTAGAAATAGCAAGTTA	1	bc
TTAGGCATAT	GAAACACCGGTTACGCCGAGAGGTGTTAGAGCTAGAAATAGCAAGTTAAC	1	bc
TCCGCTACGT	GAAACACCGGTTGCGAGCGCGGCGCTCATGAGGTTGTTAGGGCAAAGATT	1	bc
CCCCCCCGCA	GAAACACCGGTGTGGCTGAGAGTCCGGCAATGGTGTGGCTGTGGGGTTAG	1	bc
CTGATCCTCC	GAGACGCCGGTTTGGCTAAGAGTACGGCAATGGTGGGGCTGGGGGGATAG	1	bc
TCCCATCCTT	GAAACACCGGTCTCGAGTGAGGTGTTCAGGGTGGGGTTAGAGCTAGAAAT	1	bc
GCAACGCCCC	GGAACACCGGTTTGAACTAGAAATAGCAAGTTAACCTAAGGCTAGTCCGT	1	bc
CATTGAGCAT	GAAACACCGGTTAAGCCGAGGAGTTTCGTTAGAGCTAGAAATAGCAAGTT	1	bc
TTCTTATAAC	GAAACACCGGTAACCAGCGCATGCTCCAAAGTGGGGTTAGAGCTAGAAAT	1	bc
TATGCTTAAC	GAAACACCGGTTTACGTTGCATCGGTGTGGGGTTAGAGCTAGAAATAGCA	1	bc
GACCCTTCCT	GAAACACCGGTCGGCCAGAGGTAATCACATGTGGGGTTAGAGCTAGAAAT	1	bc
CTAGAGCCTG	GAAACACCGGTTCCCCACAAGCGGGGGTGGAGCTAGAGCTAGCAAGATCA	1	bc
TCTTTTCTGT	GAAACACCGGTTGCGGTCACTCAGTGGTGGGGTTAGAGCTAGAAATAGCA	1	bc
CGAGACGCTC	GAAACACCGGTGCATTCGAAAGTCCGGTCGTAGTGTGGACGTGGGGTTAG	1	bc
AATCGGGGTC	GAAACACCGGTGTACGTATGGACTGAACCCGGGGGTGCAAGTGGGGATAG	1	bc
GCACTCCGCC	GAAACACCGGTGTGGATGAGAGTCCGGCAATGGTGGGGCTGTGGGGGTAG	1	bc
ATAGAACCCC	GAAACACCGGTGCATTCGAAAGTCCGGTCGTAGTGTGGACGTGGGGTTTG	1	bc
GCGGGGCTTC	GAAACACCGGTTACCGTCCGGTGGGGGTGGGGCTAGAAATAGCAAGTTAA	1	bc
AAAGCCTTGC	GAAACACCGGTGCACTTGCTCGCACCTGATTACTTAGGCCGTGGGGTTAG	1	bc
CCTACAACAG	GAAACACCGGTGCAGCGAACAAGTACGTCTTCACGAGCAAGTGGGGTTAG	1	bc
TTCGCTTATT	GAAACACCGGTTACATTGGGGTTAGAGCTAGAAATAGCAAGTTAACCTAA	1	bc
CAACGCCCCC	GCTAGAAATAGCAAGTTAACCTAAGGCTAGTCCGTTATCAACTTGAAAAA	1	bc
GGAATACCTT	GAAACACCGGTCTCGAGTGGGGTGTTCCGGGGGGGGGTAGAGCTAGCAAT	1	bc
TCGCCCTGCA	GAAACACCGGTGCATTCGAAAGTCCGGTCGTAGTGTGGACGTGGGGTTAG	1	bc
AGCCCATACC	GAAACACCGGTAAATTTGAGGCTCCGTCATGCAGGAGGCTGTGGGGTTAG	1	bc
CAGCAGCGTC	GAAACACCGGTGTACGTATGGACTGAACCAGGGTGTGCAAGTGGGGTTAA	1	bc
TTTTGGATAA	GAAACACCGGTTAAGCCGTGGGGTTAGAGCTAGAAATAGCAAGTTAACCT	1	bc
AACGATCTAA	GAAACACGGGTGCCCTTACTCTCATTGGATTACTTAATCTGTGGGGAAAG	1	bc
AATGCATGTT	GAAACACCGGTGTGCGAATTCTTAGTCGTGGAGTTGATAGGGCTGGTAAT	1	bc
TAGCTTCCTC	GAAACACCGGTTCCTGTCTTCATGCGTTAGAGCTATAAAGATCAAGCTAA	1	bc
CCCACCATAC	GAAACACCGGTGCCCTTACTCTCACCTGATTACTAAATCCAGGAGTATAG	1	bc
CACTTAATTC	GAAACACCGGTGTGGGGTTAGAGTAGAAATAGCAAGTTAACCTAAGGCTA	1	bc
CATTGGAGGT	GAAACACCGGTACCTTTGTTGATGCTGGGGGGATGGAATTGGGAGTATCG	1	bc
TTTTGCCTAA	GAAACACCGGTTAAGCCGAGTGGGGTTAGAGCTAGAAATAGCAAGTTAAC	1	bc
ACCAACGGCC	GAAACACCGGTTTGAACTCGAAATAGCAAGTTAACCTAAGGCTAGTCCGT	1	bc
GCGGTCGCTC	GAAACACCGGTTGACGCATAGCGGGGCTTTAGCGAGACATAGCAAGTTAA	1	bc
CTTTATGATA	GAAACACCGGTTAAGCCGAGGAGTTAGAGCTAGGAATAGCAAGTTAACCT	1	bc
GTAGATACGC	GAAACACCGGTCGGCGGGAAACGTGGGTGGGGTTAGAGCTAGAAATAGCA	1	bc
TAGCCATGCA	GAAACACCGGTTTACGTTGCATCGGAGTGGGGTTAGAGATAGCAATAGAT	1	bc
ATAATTGTAC	GAAACACCGGTGTGGCTGAGAGTCCGGCAATGGTGTGGCTGTGGGGTTAG	1	bc
CGGGGCCCCC	GAAACACCGGTGTGGCTGAGAGTCCGGCAATGGTGTGGCTGTGGGGTTAG	1	bc
TGGTGATGGT	GAAACACCGGTCAAACCTGGATAGAAGTGGGGTTAGAGCTAGAAATAGCA	1	bc
ATGACCATAC	GAAACACCGGTTAAGACGCGTGGGGTTAGAGCTAGAAATAGCAAGTTAAC	1	bc
TTTGCTAGGC	GAAACACCGGTTACATTGAGGGGTTAGAGCGAGAAAGAGCAAGTTAACCT	1	bc
ATGCCATCTA	GAAACACCGGTACATCCTGAAGTCCGTGCGGAGTAGAGAGAGGAAGATAG	1	bc
