GACGGTTCCA	GAAACACCGGTTTCCACGGCGCACATGCGGGTATTAAGGCGTGGGGTTAG	2	bc
ACTATCGATC	GAAACACCGGTTCTATTTGTAAGCGTTTGGGGGGTTAGAGCTAGAAAACG	1	bc
CTCTATCGCG	GAAACACCGGTTATATTTGTAAGTGTTTGTGGGGTTAGAGCTAGAAATAG	1	bc
AATAGATGTA	GAAACACCGGTTTTATTTGTAATTGGGGTTAGAGCTAGAAATATCAAGTT	1	bc
TCAGCTATCC	GAAACACCGGTTACATTGAGGGGTTAGAGCTAGAAATAGCAAGTTAACCT	1	bc
GACGGTTCCA	GAAACACCGGTTTCCACGGCGCACATGCGGGTATCAAGGCGTGGGGTTAG	1	bc
TGGCACAGAC	GAAACACCGGTAGCAAGTGCGAAATAGCAAGTTAACCTAAGGCTAGTCCG	1	bc
ATTTTTGCTC	GAAACACCGGTGGGGTTAGAGCTAGAAATAGCAAGTTAACCTAAGGCTAG	1	bc
TTTGAGAATA	GAAACACCGGTTAAGCCGAGTGGGGTTAGAGCTAGAAATAGCAAGTTAAC	1	bc
GAGGATACTC	GAAACACCGGTTCCTATACAGAGGCGATAGAGCTGGAACAAGCAGGTTAA	1	bc
TGGATCGAGT	GAAACACCGGTTAAATTTGTGGGTAGAGCGAGATATAGCTAGTTAACCCA	1	bc
GACGGTTCCA	GAAACACCGGTTTCCACGGCGCACACGCGGGTATTAAGGCGTGGGGTTAG	1	bc
AGACTTATAT	GAAACACCGGTAACATTGGGCATAGGGTGGGGTTTGAGCTAGGAATAGAC	1	bc
GAACCTCGGC	GAAACACCGGTGCATTCGAAAGTCCGGTCGTAGTGTGGACGTGGGGTTAG	1	bc
TCTATCGCTT	GAAACACCGGTTATATTTGTAAGTGTTGTGGGGTTGGAGCTAGAAATAGC	1	bc
CGAGTTCACC	GAAACACCGGTTTCCTGGTTGGGTTAGGTTTAGAATTAGCATGTTAACCT	1	bc
CAACGCCCCC	GAAACACCGGTTTGAACTACCTAGAGCTAGAAATAGCAAGTTAACCTAAG	1	bc
TACCCCCTAA	GGAACACCGGTGCGCTTCCTCTCACCTGATTACTTAATCCGTGGGGTTAG	1	bc
CTGCTATGCT	GAAACACCGGTTTACGTTGCATCGGTGTGGGGTTAGAGCTAGAAATAGCA	1	bc
GGGACGCGCC	GAAACACCGGTGTAACTGAGAGCCCGGCAATGGTGGGGCTGGGGGGTTAG	1	bc
GTAGCCTCGC	GAAACACCGGTGCCTTCGAAAGTCCGGTCGTAGTGGGGCCGTGAAGATAG	1	bc
TCACAAAGCC	GAAACACCGGTTTGAACTACCTAGTTCAAACCGGTGGGGTTAGAGCTAGA	1	bc
ATCCTTAACA	GAAACACCGGTTTACGTTGCATCCGAGTAGGGTTAGAGCTAGAAATAGCA	1	bc
CCTTTCTCTT	GAAACACCGGTCTCGAGTGAGGTGTTCAGGGTGGGGTTAGAGCTAGAAAT	1	bc
ACTTCGCCTT	GAAACACCGGTCCGTACGAGACCCGTGATTCTTGTACTTGTGGGGGTAGA	1	bc
CCCATAACTC	GAAACACCGGTTTGCGGTATGAGTAGGAAGAGTAAGTTATACTAATACCA	1	bc
GGAAACCCCC	GAAACACCGGTCGGCGGCAATGTGGGGTTAGAGCTAGAAATAGCAAGTTA	1	bc
AACGTTATTC	GAAACACCGGTGCCCTTACTCTCACCTGATTGCTTAATCCGTGGGGTTAG	1	bc
CGTATCTACA	GAAACACCGGTAACTTTGAGACGTCGGTATGCATAGAGCTGGAAATATCG	1	bc
GGGTGACACG	GAAACACCGGTGCTCTCGGATCATCAGTGGGGTTAGAGCTAGAAATAGCA	1	bc
CATAGAACAC	GAAACACCGGTTTACGGGTGGACTTAACCAGGTTAGGCAAAGAAATAGCA	1	bc
CTTCGCCGCC	GAAACACCGGTACCCGTATGGACTGAACGAGGGAGGGCAAGTGGGGTAAG	1	bc
ACAACACCCC	GAAACACCGGTTTGAACTAGAAATAGCAAGTTAACCTAAGGCTAGTCCGT	1	bc
AAGTCGGCCT	GAAACACCGGTCGGGGCCACTCAGAGCTAGGAATAGCAAGTTAAACTAAG	1	bc
ATGCCAACCT	GAAACACCGGTTTACGCTGCATCGGTTGTGGGGTTGGGGCTGGAAATGGC	1	bc
AAGTCTGCTT	GAAACACCGGTCCGTAGGAGACCTGTGTGGCATGTACCTGTGGGGTTAGA	1	bc
GACCCAGCCC	GAAACACCGGTAGCAAGTGCGAGACGTGTTGGTGGGGTTAGAGCTAGAAA	1	bc
GAGAACCTTG	GAAACACCGGTGTGGCTGAGTGTACGGCAATGGTATGGCTAGGGGGATCG	1	bc
TCTATAGCGC	GAAACACCGGTTATCTTTGTTAGTGGGGGTAGTGCTAGTAATAGCAAGAT	1	bc
GTGGGACCCC	GAAACACTGGTTCCCGTCCAGTGGGGTTAGAGCTAGAAATAGCAAGTTAA	1	bc
CAAGCTAGGT	GAAACACCGGTGACAGTGAGTGGGTAGAGCTATAAATAGCAGAAAAAGCT	1	bc
AACGCCCCCT	GAAACACCGGTTTGAACTACCTAGTTCAAACCGGTGGGGTTAGAGCTAGA	1	bc
ACGTGTTGAA	GAAACACCGGTGACATTGGGTACAGAGCTAGAATTAGCCTAGTAACCTCA	1	bc
GGCAACATTC	GAAACACCGGTGTGGCTGAGAATACGGCGGTGGTGTGGCTGTGGGGTTAG	1	bc
CCTATAGCGG	GAAACACCGGTCGGGGCCACTCAGTGGTGGGGTTAGAGCTAGAAATAGCA	1	bc
CTCATCTCCC	GAAACACCGGTTTGAACAACCTAGTTCAAACCGGAGGGGTTAGAGCTAGA	1	bc
GATCAGCCTC	GAAACACCGGTTCGCGTGCAGTGGGCTTGGAGCTAGAAGTAGCGATTTAA	1	bc
CGACTGGGTC	GAAACACCGGTACCTTTGATGATGCTGTGGGGTGGGAATGTGGGGTTAGA	1	bc
CACTTTTACC	GAAACACCGGTAACTATATTCATGCGATATCGCCGTATCAGTGGGGTTAG	1	bc
AGGCTTATAC	GAAACACCGGTAACTATTTTCATCCGATATCGCCATATCTAGAAAGATAG	1	bc
AGGCGTATAA	GAAACACCGGTAACAATATTCGTCCGGTGGCGCTATAGCTATGAATATCA	1	bc
TTGACCCTCA	GAAACACCGGTTACGACGCGTTGTAAGTGGGGTTAGAGCTAGAAATAGCA	1	bc
GCCAGATACC	GAAACACCGGTAGCAAGTGCGAGACGTGTTTGTTAGGGTAGAGATAGGAA	1	bc
GACTTAGGTT	GAAACACCAGTCGCTTCATCTCGACACCTTCCCGTGATAGTGGGGGTAAA	1	bc
AGGCGCTACA	GAAACACCGGTAATTATGCGGCTCCGGCATGCAGAGAGCTAGGAGGTTAG	1	bc
AGCCCCCCCC	GAAACACCGGTGCATTCGAAAGTCCGGTCGTAGTGTGGACGTGGGGTTAG	1	bc
