CGTGTGCTGT	GAAACACCGGTGACATTGGGTACAGCACACGGAATTCGGGCCCATTGGTA	4	bc
TACATTAGGT	GAAACACCGGTCGATTCATATCGAAACCTTCCCGTGACAGTGGGGTTAGA	1	bc
AGGCTCCGCT	GAAACACCGGTTTACGTAGAATCGGTGTGTGGTTGGTTCTAGCTATAACA	1	bc
CGGACACAGA	GAAACACCGGTAGCAAGTGTGTGGGGTTAGAGCTAGAAATAGCAAGTTAA	1	bc
GCGAACGCGC	GAAACACCGGTCCGCGGGAGGGCTAGGGGTCGTGATAGCGAGTTAATCTA	1	bc
CATCCCCCGC	GAAACACCGGTGTATTCGTGAGCTGAACCGGGGTGTGCAAGTGGGGTTAG	1	bc
TATGGTACAA	GAAACACCGGTAACTATATTCATGCGATATCGCCGTATCAAGTGGGGTTA	1	bc
CTTTGGTATT	GAAACACCGGTTACATTGAGGGTTAGAGCTAGAAATAGCAAGTTAACCTA	1	bc
AGAGCTATGC	GAAACACCGGTTACATTGAATGTTAGAGCTAGAAATAGCAAGTTAACCTA	1	bc
CTACCCGCGC	GAAACACCGGTGCATTCGAAAGTCCTGTCGGGGTGTGGTTGTGGGGTTAG	1	bc
ACCCCGCCCC	GAAACACCGGTCCGTAGGAGACCCGTGTGGCATGTACCTGTGGGGTTAGA	1	bc
TACACCTGCA	GAAACACCGGTAAATTTGAGGCTCCGGCATGCAGGAGGCCGTGGGGTTAG	1	bc
AGATTCGGAA	GAAACACCGGGAGTAGGCTGTTATCAATTTGTATTAGGGGCTCCGGGTAG	1	bc
CGAGTTGCCC	GAAACACCGGTGACATTGGGTACAGGGTGGGGTTAGAGCTAGAAATAGCA	1	bc
TTGGGGCCCC	GAAACACCGGTTCCCGTCCAGTGGGGTTAGAGCTAGAAATAGCAAGTTAA	1	bc
CTTTAGCATA	GAAACACCGGTTAAGCCGAGGTTAGAGCTAGAAATAGCAAGTTAACCTAA	1	bc
AATGGAGCCT	GAAACACCGGTTCCCGTCCAGTGGGGTTAGAGCTAGAACTAGCAAGTTAA	1	bc
CCCCTCACTT	GAAACACCGGTGGAAGGTTGTATGTTGCTAGTGGGGTTAGAGCTAGAAAT	1	bc
ACTCAACGCC	GAAACACCGGTTTGAACTACCTAGAGCTAGAAATAGCAAGTTGACCTAAG	1	bc
CCCATCACCC	GAAACACCGGTCGTCTGCACTACGCAGTGGGGTTAGAGCTAGAAATAGCA	1	bc
ATCCTCCTCC	GAAACACCGGTGTACGTATGGACTGAACCAGGGTGTGCAAGTGGGGTTAG	1	bc
ATCCCAAATC	GAAACACCGGTTACCTCGCGAGGTTATAGCTAACTTGTTCATGTTGATCT	1	bc
GACCGCCTCC	GAAACACAGGTCCGTAGGAGACCCGTGTGGCATGTACCTGTGGGGTTAGA	1	bc
CCAATCCCCA	GAAACACCGGTCTCGAGTGAGGTGTTCAGGGTGGGGTTAGAGCTAGAAAT	1	bc
AACGGCATAA	GAAACACCGGTGCCCTTACTCTCACCTGATTACTTAATCGTGGGGTTAGA	1	bc
GGTAGGCTCC	GAACACCGGTGTGGCTGAGAGTCCGGAAATGGTATGGCTGTGGGGTTAGA	1	bc
ACGTGGTGTC	GAAACACCGGTGACATTGGGGACAGGGTGGGGTTTGAGCTAGAAATAGCA	1	bc
TAAAGCCCCA	GAAACACCGGTGCCCTTACTCTCACCTGATTACTTAATCCGTGGGGTTAG	1	bc
AGGACCTCCC	GAAACACCGGTGCATTCGAAAGTCCGGTCGTAGTGTGGACGTGGGATTAG	1	bc
ATGTATCCTC	GAAACACCGGTTCACGTCCAGTGGGGTTAGAGCTAGAAATAGCAAGTTAA	1	bc
GGGTGACACG	GAAACACCGGTTTGAACTACAACTAGAAAGTTAACCTAAGGCTAGTCCGT	1	bc
GACACCAATA	GAAACACCGGGTTAGACTTTGTAATAGTAGGTTAACCTAAGGCAATACCA	1	bc
TTATGCATAC	GAAACACCGGTTATATTTGTCAGTGTTGAGGGGTTAGAGCTTGATATAGC	1	bc
GAAACCTTTT	GAAACACCGGTCTCGAGTGAGGTGTTCAGGGTGGGGTTAGAGCTAGAAAT	1	bc
CGCATTGCAT	GAAACACCGGGTGGGGTTAGAGCTAGAAATAGCAAGTTAACCGAAGGCTA	1	bc
AAGACTTCAT	GAAACACCGGTTGGTGACATCGTCGTTTAGCTCGTTGAGAGTGGGGTTAG	1	bc
CATCCTCGAG	GAAACACCGGTGTACTTGGAGCATCAGCGGGGGTGTGGCTGGGAGGATAG	1	bc
ATTATTACCT	GAAACACCGGTTTAAGATGCCTCGACGTGGGGTTAGAGCTAGAAATAGCA	1	bc
AAGCCGCGCG	GGAACACCGGTGTAACTTAACACTGAGTGGGGTTAGAGCTAGAAATAGCA	1	bc
CCCCTCACTT	GAAACACCGGTGGAAGGTTGTATGTTGCTAGTGGGGTTAGAGCTAGAACT	1	bc
AGTACTGTAC	GAAACACCGGTTCATGAAAAACATACTTAGACGACGGTCCGTGGGGTTAG	1	bc
CCCTACCGCC	GAAACACCGGTCGGGGCCACTCAGTGGTGGGGTTAGAGCTAGAAATAGCA	1	bc
CAGGTTCGCG	GAAACACCGGTGAAACTAAACATAGCAAGTTAACCTAGGTCTAAACCGTT	1	bc
TTCTTAGCTC	GAAACACCGGTTTACGTTGCATCGGTGTGGGGTTAGAGCTAGAAATAGCA	1	bc
CCCAAAGCAC	GAAACACCGGTTTGAACTAGAAATACCAATTTACCCTCAGGCTAGTCCGT	1	bc
TACACCTGCA	GAAACACCGTTAGAGCTAGAAATAGCAAGTTAACCTAAGGCTAGTCCGCT	1	bc
CTTTTCCGCC	GAAACACCGGTCGGGGCCACTCAGTGGTGGGGTTAGAGCTAGAAATAGCA	1	bc
GAAATTCTCC	GAAACACCGGTAACTATATTCATGCGATATCGCCGTATCAGTGGGGTTAG	1	bc
TAGCCATGCA	GAAACACCGGTGTACGTATGAACTGAACCAGGGTGTGCAGGTGGGGTTAG	1	bc
AGAGTCGTGC	GAAACACCGGTGACATTGGGTGCAAAAAAAAAAAAGGGGGGTTGGGGCTG	1	bc
