GATACCCCCA	GAAACACCGGTCCAAAATGTCGCCACGTGGGGTTAGAGCTAGAAATAGCA	8	bc
CTCCCCTGCA	GAAACACCGGTGTGGCTGAGAGTCCGGCAATGGTGTGGCTGTGGGGTTAG	4	bc
AGCGGAGCCT	GAAACACCGGTTCCCGTCCAGTGGGGTTAGAGCTAGAAATAGCAAGTTAA	3	bc
TCGCCCTGCA	GAAACACCGGTGCATTCGAAAGTCCGGTCGTAGTGTGGACGTGGGGTTAG	3	bc
ACACAACGCA	GAAACACCGGTTTGAACTAGAAATAGCAAGTTAACCTAAGGCTAGTCCGT	3	bc
ACACAACGCA	GAAACACCGGTTTGAACTACCTAGAGCTAGAAATAGCAAGTTAACCTAAG	2	bc
AAGGCAATAC	GAAACACCGGTGCCCTTACTCTCACCTGATTACTTAATCCGTGGGGTTAG	2	bc
AAACGACCTA	GAAACACCGGTGCCCTTACTCTCACCTGATTACTTAATCCGTGGGGTTAG	2	bc
ACGAATACTT	GAAACACCGGTCTCGAGTGAGGTGTTCAGGGTGGGGTTAGAGCTAGAAAT	2	bc
TCATAGTCGT	GAAACACCGGTGTACGTATGGACTGAACCAGGGTGTGCAAGTGGGGTTAG	2	bc
AATGATTAGC	GAAACACCGGTTTACGTTGCATCGGTTGTGGGGTTAGAGCTAGAAATAGC	2	bc
ATCGATCGAG	GAAACACCGGTTATATTTGTAAGTGTGTGGGGTTAGAGCTAGAAATAGCA	2	bc
AGTGGAGCGT	GAAACACCGGTTCCCGTCCAGTGGGGTTAGAGCTAGAAATAGCAAGTTAA	2	bc
AATGATTAGC	GAAACACCGGTTTACGTTGCATCGGTGTGGGGTTAGAGCTAGAAATAGCA	2	bc
GAGGAGACTA	GAAACACCGGTTCCCGTCCAGTGGGGTTAGAGCTAGAAATAGCAAGTTAA	2	bc
AAGAACCTCG	GAAACACCGGTGCATTCGAAAGTCCGGTCGTAGTGTGGACGTGGGGTTAG	2	bc
AACAGTCGGT	GAAACACCGGTCGATTCATATCGAAACCTTCCCGTGAGTGGGGTTAGAGC	1	bc
ACATAACGCA	GAAACACCGGTTTGAACTAGAAATAGCAAGTTAACCTAAGGCTAGTCCGT	1	bc
GCGAAGCGTT	GAAACACCGGTTACCATCCAGTGGGGTTACAGCTAGAGATAGCAAGTTAA	1	bc
AGCAGCATCC	GAAACACCGGTGTGGCTGAGAGTCCGGCAATGGTGTGGCTGTGGGGGTAG	1	bc
AACGTGTTGT	GAAACACCGGTGACATTGGGTGGGGTTAGAGCTAGAAATAGCAAGTTAAC	1	bc
ACGAGTGTTC	GAAACACCGGTGACATTGGGTAGAGCTAGAAATAGCAAGTTAACCTAAGG	1	bc
TTGTGCCTAC	GAAACACCGGTTAAGCCGAGTGGGGTTAGAGCTATAAATAGCAAGTTAAC	1	bc
AACACAGCCC	GAAACGCAGGTTAACCTACGGCTAGTCCGTTATCAACTTGAAAAAGAGGC	1	bc
TGAGGATCCA	GAAACACCGGTTCCTGTCCAGTGGGGTTAGTGCTAGAACTAGCAAGTTAG	1	bc
GAAGCTTAGC	GAAACACCGGTTTACGTTGCATCGGTGTGGGGTTAGAGCTAGAAATAGCA	1	bc
GACTACACGC	GAAACACCGGTCGGCGGCAATCGTGGGTGGGGTTAGAGCTAGAAATAGCA	1	bc
CTGATTGGCT	GAAACACCGGTTTACGTTACCTCGGTTGTGGGGTTAGAGCTAGAAATAGC	1	bc
GACACTGAAC	GAAACACCGGTAGCAAGTGCGAGACGTGTTAAATAGCAAGTTAACCTAAG	1	bc
ATTGAGCGTA	GAAACACCGGTTAAGCCGAGGAGTTAGAGCTAGAAATAGCAAGTTAACCT	1	bc
CGAGTCGGCT	GAAACACCGGTGACATTGGGCGGGGTTAGAGCTAGCAATAGCAAGTTAAC	1	bc
TCGAATGTTC	GAAACACCGGTCTCGAGTGAGGTGTTCAGGGTGGGGTTAGAGCTAGAAAT	1	bc
AGAGTACGCT	GAAACACCGGTAACATGTAGTTCTGAAAGCTAGAATTCTGAATTTGACCC	1	bc
CAAGATGCCC	GAAACACCGGTTTGAACTAGAAATAGCAAGTTAACCTAAGGCTAGTCCGT	1	bc
AATCGTTGTA	GAAACACCGGTGAACGTATGGACTGAACCAGGTTGTGCAGGTTAGAGCTA	1	bc
AAGACCCTTG	GAAACACCGGTGCATTCGAAAGTCCGGTCGTAGTGTGGGCGTGGGGATAG	1	bc
AAGTCTGACT	GAAACACCGGTCCGTAGGAGACCCGTGTGGCGAGCTAGAAATAGCAAGTT	1	bc
AACAACGATC	GAAACACCGGTTTGAACTAGAAATAGCAAGTTAACCTAAGGCTAGTCCGT	1	bc
GATGCCTCGC	GAAACACCGGTCGGCGGCAATCGTGGGTGGGGTTAGAGCTAGAAATAGCA	1	bc
CTCATCGTTT	GAAACACCGGTCTCGAGTGAGGTGTTCAGGGTGGGGTTAGAGCTAGAAAT	1	bc
TTAGATCTGC	GAAACACCGGTTACATTGAGGGTTAGAGCTAGAAATAGCAAGTTAACCTA	1	bc
AACATTCAGT	GAAACACCGGTCGATTCATATCGAAACCTTCCCGTGACAGTGGGGTTAGA	1	bc
AAGACAAGAC	GAAACACCGGTAAATTTGAGGCTCCGGCATGCAGGAGGCCGTGGGGTTAG	1	bc
AAGTCTGTCT	GAAACACCGGTCCGTAGGAGACCCGTGTGGCATGTACCTGTGGGGTTAGA	1	bc
ATTAGCTACG	GAAACACCGGTTACATTGAGGGGTTAGAGCTAGAAATAGCAAGTTGACCT	1	bc
CACGCCAACC	GAAACACCGGTAAACTTGAGGCCCCGGCATGCATTAGGCCGTGGGGTTAG	1	bc
ACATAACGCT	GAAACGCAAGTTAACCTAAGGCTAGTCCGTTATCAACTTGAAAAAGTGGC	1	bc
TAGCTACTTT	GAAACACCGGTCTCGAGTGAGGTGTACAGGGTGGGGTTAGAGCTAGAAAT	1	bc
GGCGTTGTCC	GAAACACCGGTGTGGCTGAGAGTCCGGCAATGGTGTGGCTGTGAGAGTAA	1	bc
GTAACGATGA	GAAACACCGGTTACATTGAGGGGTTAGAGCTAGAAATAGCAAGTTAACCT	1	bc
GCGAATCGTT	GAAACACTAAGGCTAGTCCGTTATCAACTTGAAAAAGTGGCACCGAGTCG	1	bc
AACAAATCGC	GAAACACCGGTGCATTCGAAAGTCCGGTCGTAGTGTGGACGTGGGGTTAG	1	bc
TTTAGCTACG	GAAACACCGGTTACATTGAGGGTTAGGGCTAGAAATAGCAAGTTAACCTA	1	bc
AAAAATGTGC	GAAACACCGGTCGACGGCAATCGTGGTTGGGGGTAGAGCTAGAAATATCA	1	bc
ATAAGCTATG	GAAACACCGGTTTGAGGGTTAGAGCTAGAAATAGCAAGTTAACCTAAGGC	1	bc
CATTGACTGC	GAAACACCGGTCGGGGCCACTCAGTGGTGGGGTTAGAGCTAGAAATAGCA	1	bc
ATCGCGCTAG	GAAACACCGGTGCCCTTACTCTCACCTGATTACTTAATCCGTGGGGTTAG	1	bc
TTGCGCATGG	GAAACACCGGTTAAAACGATGTGCTTTTTTCCTGCAGGTTATGCTCAAGA	1	bc
TAAAGTATCT	GAGCAAGTTAACCTAAGGCTAGTCCGTTATCAACTTGAAAAAGTGGCACC	1	bc
ACGCTCGCTC	GAAACACCGGTAGCTATATTCCGGCGATTTCGCCGTATCAGTGGGGTTAG	1	bc
ATCGAGCATA	GAAACACCGGTTAAGCCGAGGTTAGAGCTAGAAATAGCAAGGTAACCTAA	1	bc
AAGCGTCGGC	GAAACACCGGTGTACGTATGGACTGAACCAGGGTGTGCAAGTGGGGTTAG	1	bc
TCGTTAACGC	GAAACACCGGTTATATTTGTAAGTGTGTGGGGTTAGAGCTAGAAATAGCA	1	bc
GTAGATAGGT	GAAACACCGGTTACGATGAGGGTTAGAGCTAGAAATAGCAAGTTAACCTA	1	bc
GGAATCGTCG	GAAACACCGGTGTCGGTGCTTTTTTTCCTGCAGGGACGACGATGGAATTC	1	bc
GCATCGTGGT	GAAACACCGGTGTACGTATGGACTGAACCAGGGTGTGCAAGTGGGGTTAG	1	bc
TTATGACGCC	GAAAAACCGGTTTGAACTAGAAATAGCAAGTTAACCTAAGGCTAGTCCGT	1	bc
AGCGGAGCCT	GAAACACCGGTTCCCGTCCAGCGGGGTTAGAGCTAGAAATAGCAAGTTAA	1	bc
AATGGCACTG	GAAACACCGGTGCCCTTACTCTCACCTGATTACTTAATCCGTGGGGTTAG	1	bc
GAAGCCGTGC	GAAACACCGGTGCCCTTACTCTCACCTGATTACTTAATCCGTGGGGTTAG	1	bc
ATGGTGCGTT	GAAACACCGGTTTACGTTGCATCGGGATCCGGTGCTTTTTTTCATGCAGG	1	bc
ACATTACCGT	GAAACACCGGTCGGGGCCACTCAGTGGTTGGGGTAGAGCTAGAAATAGCA	1	bc
GACCCCGACC	GAAACACCGGTAGCAAGTGCGAAATAGCAAGTTAACCTAAGGCTAGTCCG	1	bc
ATTAGTTATG	GAAACACCGGTTACATTGGGGTTAGAGCTAGAAATAGCAAGTTAACCTAA	1	bc
TAAGCAGACC	GAAACACCGGTAGCAAGTGCGAAATAGCAAGTTAACCTAAGGCTAGTCCG	1	bc
AGCGTTGTTT	GGAACACCGGTGACATTGGGGTGGGGTTAGAGCTAGAAATAGCAAGTTAA	1	bc
AAATCGGCGT	GAAACACCGGTCCGTAGGAGACCCGTGTGGCATGTACCTGTGGGGTTAGA	1	bc
AAGATTAGAT	GAAACACCGGTTTACGTTGCATCGGTGTGGGGTTAGAGCTAGAAATAGCA	1	bc
GACGCACTCC	GAAACACCGGTGCCCTTACTCTCACCTGATTACTTAATCCGTGGGGATAG	1	bc
AAGCCAGGCG	GAAACACCGGTCCGTAGGAGACCCGTGTGGCATGTACGGGGTTAGAGCTA	1	bc
TAGATCGGGA	GAAACACCGGTTATATTTGTATTAGAGCTAGAAATAGCAAGCTAACCTAA	1	bc
GGGTACCAGC	GAAACACCGGTGTGGCTGAGAGTCCGGCAATGGTGTGGCTGTGGGGTTAG	1	bc
AGACACAGGT	GAAACACCGGTAGCAAGTGCGAAGTAGCAAGTTAACCTAAGGCTAGTCCG	1	bc
CGGATCATTA	GAAACACCGGTTAAGCCGAGGGGGTAGAGGTAGAATTAGCGATAGAACTA	1	bc
GACAGAGAAC	GAAACACCGGTAGCAAGTGCGAGACGTTTTTGTGGGGTTAGAGCTAGAAA	1	bc
CACTTCGGAT	GAAACACCGGTCGATTCATATCGAAACCTTCCCGTGACAGTGGGGTTAGA	1	bc
TAAATCACAC	GAAACACCGGTAAATATTGTCGTGCCATATCGTTAGAGCTAGAAGTGGCT	1	bc
GAAGGCAGGC	GAAACCTCAGGCTAGTCCGTTATCAACTTGAAAAAGTGGCACCGAGACGG	1	bc
GTACACAATA	GAAACACCGGTTAAACCGAAGTGTTAGAGCTGTTAGTGCTAGGTTTACCT	1	bc
CCATGCGGTC	GAAACACCGGTCGATTCATATCGAAACCTTCCCGTGACAGTGGGGTTAGA	1	bc
TAGCGTTGTC	GAAACACCGGTGACACTGGGTAGAGCTAGAAATAGCAAGTTAACCTAAGG	1	bc
AGGCTGATTC	GAAACACCGGTCCGTAGGAGACCCGTGTGGCATGTACCTGTGGGGTTAGA	1	bc
ACCGGTAGTC	GAAACACCGGTGACACCGGGTACTTGACAAAGTGGCACAGAGTCGGTGCT	1	bc
AGCTATCGAG	GAAACACCGGTTATATTTGTAAGTGTGTGGGGTTAGAGCTAGAAATAGCA	1	bc
AAGTTGGCCT	GAAACACCGGTCCGTAGGAGACCCGTGTGGCATGTACCTGTGGGGTTAGA	1	bc
CTTGTTATGT	GAAACACCGGTTACATTGAGGGGCTACAGCTAGAGATAGCAAGTTAACCT	1	bc
GCAAAACCGC	GAAACACCGGTCGGCGGAAATCGCAAGTTAACCTAAGGCTAGTTCGTTAT	1	bc
CGCCTCTCGC	GAAACACCGGTGCATTCGAAAGTCCGGTCGTAGTGTGGACGTGGGGTTAG	1	bc
ACTACACGGC	GAAACACCGGTACCTTTGTTGATGCTGGGTGGAAGGAATTCTAGAAATAG	1	bc
CGTTGAGCAT	GAAACACCGGTTAAGCCGGTGGGGTTAGAGCTAGAAATAGCAAGTTAACC	1	bc
TACCCTAGGT	GAAACACCGGTGCACGTATGGACTGAACCAGGGTGTGCAAGGGGAGCTAG	1	bc
ACACAGCGCA	GAAACACCGGTTTGAACTAGAAATAGCAAGTTAACCTAAGGCTAGTCCGT	1	bc
TAGTCAGCCT	GAAACACCGGTCCGTAGGAGACCCGTGTGGCATGTACCTGTGGGGTTAGA	1	bc
GTGGATAAAC	GAAACACCGGTTCCCGTCCAGTGGGGTTAGAGCTAGAAATAGCAAGCTAA	1	bc
CGACATTCGC	GAAACACCGGTGCATTCGAAAGTCCGGTCGTAGTGTGGACGTGGGGTTAG	1	bc
CTCCGCTCGA	GAAACACCGGTAAATTTGCGGCCACGGCATGCAGAGAGCCGTGGGGTTCG	1	bc
TGAGGAGCCT	GAAACACCGGTTCCCGTCCAGTGGGGTTAGAGCTAGAAATAGCAAGTTAA	1	bc
CGTGGCGGTT	GCTAGTCCGTTATCAACTTGAAAAAGTGGCACCGAGTCGGTGCTTTTTTT	1	bc
GGACGCCCTA	GAAACACCGGTGCCCTTACTCTCACCTGATTACTTAATCCGTGGGGTTAG	1	bc
GAGGACTTGC	GAAACACCGGTCGGCGGCAATCGTGGGTGGGGTTAGAGCTAGAAATAGCA	1	bc
CGAGATCCTC	GAAACACCGGTGCATTCGAAAGTCCGGTCGTAGTGTGGACGTGGGGTTAG	1	bc
TATGCTTAGA	GAAACACCGGTTTACGTTGCATCGGTTGTGGGGTTAGAGCTAGAAATAGC	1	bc
GACTCATATA	GAAACACCGGTAGCAAGTTAACCTAAGGCTAGTCCGTTATCAACTTGAAA	1	bc
AGAGTGTGCC	GAAACACCGGTCCGTAGGAGACCCGTGTGGCATGTACCTGTGGGGTTAGA	1	bc
GCTAACGAGT	GAAACACCGGTTATATTTGTAAGTGTGTGGGGTTAGAGCTAGAAATAGCA	1	bc
GAACAAAGCC	GAAACACCGGTTTGAACCGGTGGGGTTAGAGCTAGAAATAGCAAGTTAAC	1	bc
TAGGGACTAC	GAAACACCGGTTAAGTCGCTGAGTTATAGTTAGTTATAGCAAGTTAACAT	1	bc
TATCTTGTTC	GAAACACCGGTACCTATATTCATGCGATATCGCCGTATCAAGTGGGGTTA	1	bc
TGGTTTCTCT	GAAACACCGGTGACTGTGTGGGGTTAGAGCTAGAAATAGCAAGTTAACCT	1	bc
AAACGCACTA	GAAACACCGGTGCCCTTACTCTCACCTGATTACTTAATCCGTGGGGTTAG	1	bc
CGAGCTGCCG	GAAACACCGGTGACATTGGGAACAGAGCTAGAAATAGCAAGTTAACCTAA	1	bc
ACGGATCCTT	GAAACACCGGTCTCGAGTGAGGTGGGGTTAGAGCTAGAAATAGCAAGTTA	1	bc
ATACCTTATA	GAAACACCGGTAACTATATTCATGCGATATCGCCGTATCAGTGGGGTTAG	1	bc
CGAGCGGTCA	GAAACACCGGTGACATTGGGTCATGCCTATTGACCTAGTAGTAGCGCTAT	1	bc
GAGACGCGCG	GAAACACCGGTGCATTCGAAAGTCCGGTCGTAGTGTGGACGTGGGGTTAG	1	bc
GTGATGACTC	GAAACACCGGTTCCCGTCCAGTGGGGTTAGAGCTAGTAATAGCAAGTTAA	1	bc
TAGATGGGTG	GAAACACCGGTTATATTTGTAAGTGTGTGGGGTTAGAGCTAGAAGTAGCA	1	bc
AAACCCTGAC	GAAACACCGGTAAATTTGAGGCTCCGGCATGCAGGAGGCCGTGGGGTTAG	1	bc
ACGTGTTGTA	GAAACACCGGTGACATTGGGTACAGTTAGAGCTAGAAATAGCAAGTTAAC	1	bc
GTGTTACCGC	GAAACACCGGTCGGGGGTTAGAGCTAGAAATAGCAAGTTAACCTAAGGAT	1	bc
AGCGCCAAAC	GAAACACCGGTGCCCTTACTCTCACCTGATTACTTAATCCGTGGGGTTAG	1	bc
AGATTTGTTT	GAAACACCGGTGAAATTGGGTGGGGATAGAGCTAGAAATAGCAAGTTAAC	1	bc
GTAACTGATT	GAAACACCGGTAACTACATTCATGCGATATCGCCGTATCAGTGGGGTTAA	1	bc
CCTGCCCCAC	GAAACACCGGTCGGGGCAATTCCACGTGATTGCTAAAGCTGGGAGTAGAG	1	bc
GCGGTGTCTC	GAAACACCGGTTCCCGTCCAGTGGGGCTAGAGCTAGAAATAGCAAGTTAA	1	bc
AAGTCTGGCT	GAAACACCGGTCCGTAGGAGACCCGTGTGGCATGTACCTGTGGGGTTAGA	1	bc
ATTAGATATG	GTGTGGAAAGGGTTAGAGCTAGAAATAGCAAGTTAACCTAAGGCTAGTCC	1	bc
AGGAGGATAC	GAAACACTGGTCCGTAGGAGACCCGTGTGGCATGTACCTGTGGGGTTAGA	1	bc
GAGACTGCCT	GAAACACCGGTCCGTAGGAGACCCGTGTGGCATGTACCTGTGGGGTTAGA	1	bc
TTGTGCAGCA	GAAACACCGGTTAAGCCGGGAGGGAAGACTGCTGGGATAGAGATGGTAAT	1	bc
ATGGCTAGTC	GAAACACCGGTTTACGTTGCATCGGTGTGGAGTTAGAGCTAGAAAGATCA	1	bc
CCCATACCTC	GAAACACCGGTTGGCTGGATGGGTACATCTAGAAATAGCAAGTTAACCTA	1	bc
AAATAGCGAG	GAAAACACCGGTTATATTTGTAAGTGTGTGGGGTTAGAGCTAGAAATAGC	1	bc
GACATGCACT	GAAACACCGGTCTCGAGTGAGGGGTTCAGGGGGGGGTTAGAGCTAGAAAT	1	bc
GCGATTGAGT	GAAACACCGGTTATATTTGTAAGTGGGGTTAGAGCTAGCAATAGCAAGCT	1	bc
GCGTCTGCCT	GAAACACCGGTCCGTAGGAGACCCGTGTGGCATATACCTGTGGGGTTAGA	1	bc
TTAGGCATGA	GAAACACCGGTTACGCCGAGGAGTTAGAGCTAGAAATAGCAAGTTAACCT	1	bc
ATGACTTACA	GAAACACCGGTAAATTTGAGGCTCCGGCATGCAGGTGGCCGTGGGGTTAG	1	bc
TCCTCGTCGT	GAAACACCGGTGTACGTATGGACTGAACCAGGGTGTGCAAGTGGGGTTAG	1	bc
AGTCTGGTTA	GAAACACCGGTCCGTAGGAGACCCGTTTGGCATGTACCTGTGGGGGTAGA	1	bc
GGGAATACTT	GAAACACCGGTCTCGAGTGAGGTGTTCAGGGTGGGGTTAGAGCTAGAAAT	1	bc
GTGTCGCACC	GAAACACCGGTTCCCGTCCAGTGGGGTTAGAGCTAGAAATAGCAAGTTAA	1	bc
GACCCAGAAC	GAAACACCGGTAGCAAGTGCGAGACGTGTTTGTGGGGTTAGAGCTAGAAA	1	bc
TTTCGTAGCC	GAAACACCGGTGTATGTATGGACTGAACCAGGGTGTGCAAGTGGGGTTAG	1	bc
ACGTCGTCGT	GAAACACCGGGGTACGTATGGACTGAACCAGGGTGTGCAAGTGGGGTTAG	1	bc
CGGGCCCCTA	GAAACACCGGTAAATTTGAGGCTCCGGCATGCAGGAGGCCGTGGGGTTAG	1	bc
ATTTGCTATG	GAAACACCGGTTACTAGAGCTAGAAATAGCAAGTTAACCTAAGGCTAGTC	1	bc
GTCGAGCAAC	GAAACACCGGTTCCCGTCCTGTGGGGTTAGAGCTAGAAATAGCAAGTTAA	1	bc
AACGAACCAC	GAAACACCGGTTCCCTTACTCTCACCTGATTACTTAATCCGTGAGGTTAG	1	bc
AGAGGAGACT	GAAACACCGGTTCCCGTCCAGTGGGGTTAGAGCTAGAAATAGCAAGTTAA	1	bc
CACATGGCGC	GAAACACCGGTTTGAACTAGAAATAGCAAGTTAACCTAAGGCTAGTCCGT	1	bc
AAGAAGACCC	GAAACACCGGCCGGCGGCAATCGTGGGTGGGGTTAGAGCTAGAAATAGCA	1	bc
GGGGACCGTA	GAAACACCGGTTCCGGTACAGCGGGGGTATAGCGAGATATAGCTAGTTAT	1	bc
AGACACAGAT	GAAACACCGGTAGCAAGTGGGGTTAGAGCTAGAAATAGCAAGTTAACCTA	1	bc
AGAAGAAGCG	GAAACACCGGTCGGCGGTGGGGTTAGAGCTAGAAATAGCAAGTTAACCTA	1	bc
GGGGAGAATC	GAAACACCGGTTCCCGTCCAGTGGGGTTAGAGCTAGAAATAGCAAGTTAA	1	bc
TAATTAGGTT	GAAACACCGGTTCCGTTATCAACTTGAAAAGGTGGCACCGAGTCGGTGCT	1	bc
GGGGTACCTA	GAAACACCGGTTCCCGTCCAGTGGGGTTAGAGCTAGAAATAGCAAGTTAA	1	bc
GAAACCCTCG	GAAACACCGGTGCATTCGAAAGTCCGGTCGTAGTGTGGACGTGGGGTTAG	1	bc
TAATGCCATA	GAAACACCGGTGCCCTTACTCTCACCTGATTACTTAATCCGTGGGGTTAG	1	bc
GGACACTACC	GAAACACCGGTAAATTTGAGGCTCCGGCATGCAGGAGGCCGTGGGGTTAG	1	bc
ACCTTTAGCG	GAAACACCGGTCGGGGCCACTCAGTGGTGGGGTTAGAGCTAGAAATAGCA	1	bc
AGGCACCTAC	GAAACACCGGTAAATTTGAGGCCCCGGCATGCAGGAGGCCGTGGGGTTAG	1	bc
AGGCACCCTT	GAAACACCGGTGTGGCTGAGAGTCCGGCAATGGTGTGGCTGTGGGGTTAG	1	bc
AATAACCTAC	GAAACACCGGTGCCCTTACTCTCACCTGATTACTTAATCCGTGGGGTTAG	1	bc
AATGCCTAGC	GAAACACCGGTTTACGTTGCATCGGGATCCGGTGCTTTTTTTCCTGCAGG	1	bc
AGTAAGCATA	GAAACACCGGTTAAGCCGAGGAGTTAGAGCTAGAAATAGCAAGTTAACCT	1	bc
GGCAGCCTTT	GAAACACCGGTGTGGCGGAGAGTGTAGCAATGGGGTGTCGAGCTAGGTAT	1	bc
TCCACAGACC	GAAACACCGGTAGCAAGTGCGAGAGTTAGAGCTAGAAATAGCAAGTTAAC	1	bc
CTTGACGTCT	GAAACACCGGTGACATTGGGTTCAGGGGTGGGGTTAGAGCTAGAAATAGC	1	bc
GGCTCTCACG	GAAACACCGGTGTGGCTGAGAGTCCGGCAATGGTGTGGCTGTGGGGTTAG	1	bc
ATACTGCGAC	GAAACACCGGTTATATTTGTAAGAGTTTGTGGGGTTAGAGCTAGAACTAC	1	bc
GAGACCCTAA	CAACACCGGGGCCCTTACTCTCACCTGATGGGTTTAGCGCTAGAAAAAGC	1	bc
AAGTCTGACT	GAAACACCGGTCCGTAGGAGACCCGTGTGGCATGTACCTGTGGGGTTAGA	1	bc
TGGCCCATCA	GAAACACCGGTAAATTTGAGGCTCCGGCATGCAGGAGGCCGTGGGGTTAG	1	bc
CCTTTAGTGT	GAAACACCGGTGACATTGGTGGGGTTAGAGCTAGAAATCGCAAGTTAACC	1	bc
GAGGAGCGTA	GAAACACCGGTTCCCGTCCAGTGGGGTTAGAGCTAGAAATAGCAAGTTAA	1	bc
CGGGTCGGAC	GAAACACCGGATTGGGGTTAGAGCTAGAAATAGCAAGTTAACCTAAGGCT	1	bc
CATAATGCTC	GAAACACCGGTTTGAACGAGAAATAGCAGGTTTACCTAAGGCTAGTCCGT	1	bc
ACGTGTTGTA	GAAACACCGGTGACATTGGGTACAGGGTGGGGTTAGAGCTAGAAATAGCA	1	bc
GAAGCTTCGC	GAAACACCGGTCGGCGGCAATGTGGGGTTAGAGCTAGAAATAGCAAGTTA	1	bc
ATGGGCTGTC	GAAACACCGGTGACATTTGTGGGTTTAGAGCTAGAAATATCAAGTTAACC	1	bc
AGGGAAGCCT	GAAACACCGGTTCCCGTCCAGTGGGGTTAGAGCTAGAAATAGCAAGTTAA	1	bc
GCCCCAGACT	GAAACACCCGTAGCAAGTGCGAGACGTGTTTGTGGGGTTAGAGCTAGAAA	1	bc
GTCCCCTCCC	GAAACACCGGTAAATTTGAGGCTCCGGCATGCAGGAGGCCGTGGGGTTAG	1	bc
AACGCACTCA	GAAACACCGGTGCCCTTACTCTCACCTGATTACTTAATCCGTGGGGTTAG	1	bc
AGAAACAGAC	GAAACACCGGTAGCAAGTGCGACATCGCACGTTACCGTACGTCTCGTCCG	1	bc
GGAGGATCAT	GAAACACCGGTTCCCGTCCAGTGGGGTTAGAGCTAGAAATAGCAAGCTAA	1	bc
TGAAGCCCCG	GAAACACCGGTCGGCGGCAATCGTGGGGTGGGGTTAGAGCTAGAAATAGC	1	bc
GTGAATCCTT	GAAACACCGGTCTCGAGTGAGGTGTTCAGGGTGGGGTTAGAGCTAGAAAT	1	bc
CTGCCGATCT	GAAACACCGGTTTACGCATCCTCGGCTTGTGCAGGTAGAGGTGGGGATAG	1	bc
GGCACGTTGA	GAAACACCGGTGTGGCTGAGAGTCCGGCAATGGTGTGGCTGTGGGGTTAG	1	bc
ATTGAGCATT	GAAACACCGGTTAAGCCGAGTGGGGTTAGAGCTAGAAATAGCAAGTTAAC	1	bc
ACGACTCTCG	GAAACACCGGTGCATTCGAAAGTCCGGTCGTAGTGTGGACGTGGGGTTAG	1	bc
AACGATGCGC	GAAACACCGGTTTGAACTAGAAATAGCAAGTTAGCCTAAGGCTAGTCCGT	1	bc
ACAGCGCCGT	GAAACACCGGTGTACGTATGGACTGAACCAGGGTGTGCAAGTGGGGTTAG	1	bc
TTGTGCGTCA	GAAACACCGGTTAAGCCGAGTGGGGTTAGAGCTAGAAATAGCAAGTTAAC	1	bc
AGCACGTCTC	GAAACACCGGTAAATTTGAGGCTCCGGCATGCAGGAGGCCGTGGGATTAG	1	bc
AATCGAGGCC	GAAACACCGGTGTACGTATGGACTGAACCAGGGTGTGCAAGTGGGGTTAG	1	bc
CGAATAGTTC	GAAACACCGGTTTCGAGTGAGGTGTTCAGGGTGGGGTTAGAGCTAGAAAT	1	bc
CGGGTGGTCC	GAAACACCGGTGACATTGGGTTAGAGCTAGAAATAGCAAGTTAACCTAAG	1	bc
AGGCACCTAC	GAAACACCGGTAAATTTGAGGCTCCGGCATGCAGGAGGCCGTGGGGTTAG	1	bc
CATTAGCCGC	GAAACACCGGTCGGCGGCAATCGGGGGTGGGGTTAGAGCTAGAAATAGCA	1	bc
AACGTTGTAT	GAAACACCGGTGACATTGGGTACAGGGTGGGGTTAGAGCTAGAAATAGCA	1	bc
AACGCTATAG	GAAACACCGGTGCCCTTACTCTCACCTGATTACTTAATCCGTGGGGTTAG	1	bc
AGATACACCC	GAAACACCGGTCCAAAATGTCGCCACGTGGGGTTAGAGCTAGCAATAGCA	1	bc
CTGCGGGCTC	GAAACACCGGTTCCCGTCCAGTGGGGTTAGAGCTAGAAATAGCAAGTTAA	1	bc
CGCCTTATGC	GAAACACCGGTAAGTATATTCATGCGATATCGCTGTATCAGTGGGGTTAG	1	bc
ATGCATTCCC	GAAACACCGGTGCATTCGAAAGTCCGGTCGTAGTGTGGACGTGGGGTTAG	1	bc
GGGTTACTTT	GAAACACCGGTCTCGAGTGAGGCGATCAGGGTGGGGCTCGAGCTAGAAAT	1	bc
AACAAAACGC	GAAACACCGGTTTGAACTACCTAGTTCAAACCGGTGGGGTTAGAGCTAGA	1	bc
GAAGCCATGC	GAAACACCGGTCGGCGGCAATCGTGCTTTTTTTCCTGCAGGGCGGGTCTT	1	bc
GATGGGACGC	GAAACACCGGTCGGCGGCAATCGTGGGTGGGGTTAGAGCTAGAAATAGCA	1	bc
GGGCCCGGCA	GAAACACCGGTAGTTTTGACGCCCCTTCAGGCAGGGGGACGTGGGGTAAT	1	bc
TGCCTCCCTG	GAAACACCGGTCCGTAGGAGACCCGTGTGGCATGTACCTGTGGGGTTAGA	1	bc
GAGGCAACCA	GAAACACCGGAGTGGCTGAGAGTCCGGCAATGGTGTGGCTGTGGGGTTAG	1	bc
TAGCGCATAC	GAAACACCGGTTAAGCCGATGTGCTTTTTTCCTGCAGGTTATGCTCAAGA	1	bc
GGCCACCCCA	GAAACACCGGTGTGGCTGAGAGTCCGGCAATGGTGTGGCTGTGGGGTTAG	1	bc
GGCCTCAAAA	GAAACACCGGTAAATTTGAGGCTCCGGCATGCAGGAGGCCGTGGGGTTAG	1	bc
TCGTGTCGTC	GAAACACCGGAGTGGGGTTAGAGCTAGAAATAGCAAGTTAACCTAAGGCT	1	bc
GCGTGGTGTC	GAAACACCGGTGACATTGGGTACGTGGGGTTAGAGCTAGAAATAGCAAGT	1	bc
AGGCTCCTAC	GAAACACCGGTAAATTTGAGGCTCCGGCATGCAGGAGGCCGTGGGGTTAG	1	bc
AACTTGAGCG	GAAACACCGGTCGGGGCCACTCAGTGGTGGGGTTAGAGCTAGAAATAGCA	1	bc
GAGAAGATCC	GAAACACCGGTCGGCGGCAATCGTGGTATGAGCCACGTGGGGTTAGATCG	1	bc
CAGATCGCGC	GAAACACCGGTTTGAACTAGAAATAGCAAGTTAACCTAAGGCTAGTCCGT	1	bc
ATGCTTTCGT	GAAACACCGGTTTACGTTGCATCGGTGTGGGGTTAGAGCTAGAAATAGCA	1	bc
AGGTTCGAAT	GAAACACCGGTCAATTCGAATCTCCACCTTCCCGGGGGCCGAGGGCTAGA	1	bc
AATGAGCATA	GAAACACCGGTTAAGCCGAGGTTAGAGCTAGAAATAGCAAGTTAACCTAA	1	bc
CACGACATAC	GAAACACCGGTGCCCTTACTCTCACCTGATTACTTAATCCGTGGGGTTAG	1	bc
CATACCGCAC	GAAACACCGGTTTGAACTACCTAGCAAGTTAACCTAAGGCTAGTCCGTTA	1	bc
ACCAACATAC	GAAACACCGGTGCCCTTACTCTCACCTGATTACTTAATCCGTGGGGTTAG	1	bc
AGTTTGGCTT	GAAACACCGGTCCGTAGGAGACCCGTGTGGCATGTACCTGTGGGGTTAGA	1	bc
ACGCATCTTA	GAAACACCGGTGCATTCGAAAGTCCGGTCGGAGTGAGGACGTGAGTTTAG	1	bc
CACCACGTAC	GAAACACCGGTTTGAACTAGAAATAGCAAGTTAACCTAAGGCTAGTCCGT	1	bc
GTGAAAGCTC	GAAACACCGGTTCCCGTCCAGTGGGGTTAGAGCTAGAAATAGCAAGTTAA	1	bc
AAAGGCACAA	CAAAACACCGGTACCCTTACTCTCCACCGATCACGTGATCCGTTGGCTTA	1	bc
ATTGAGCATC	GAAACACCGGTTAAGCCGAGTGGGGTTAGAGCTAGAAATAGCAAGTTAAC	1	bc
AGAATTCCTT	GAAACACCGGTCTCGAGTGAGGTGTTCAGGGTGGGGTTAGAGCTAGAAAT	1	bc
ACGAATCCTC	GAAACACCGGTCTCGAGTGAGGTGTTCAGGGTGGGGTTAGAGCTAGAAAT	1	bc
AGTGGGGCCT	GAAACACCGGTTCCCGTCCAGTGGGGTTAGAGCTAGAAATAGCAAGTTAA	1	bc
GGGACACTCA	GAAACACCGGTGTGGCTGAGAGTCCGGCAATGGTGTGGCTGTGGGGTTAG	1	bc
TAGTCTACAT	GAAACACCGGTCCGTAGGAGACCCGTGTGGCATGTACCTGTGGGGTTAGA	1	bc
AACGCCTGCC	GAAACACCGGTACCCTTACTCTCACCTATTGACTTAATACGTGGAGATAG	1	bc
ACTACTTGGC	GAAACACCGGTACCTTTGTTGATGCTGGGTGGAAGGTGTGGGGTTAGAGC	1	bc
CGCAGCCCCC	GAAACACCGGTTTGAACCGGTGGGGTTAGAGCTAGAAATAGCAAGTTAAC	1	bc
CTCCCCTGCA	GAAACACCGGTGTGGCTGAGAGTCCGGCAATGGTGTGGCTGGGGGGTTAG	1	bc
GAACGATGTC	GAAACACCGGTGCCCTTACTCTCACCTGATTACTTAATCCGTGGGGTTAG	1	bc
AAAATTCGGG	GAAACACCGGTCGATTCATATCGAAACCTTCCCGTGACAGTGGGGTTAGA	1	bc
GGTGATGTCC	GAAACACCGGTGGGGTTAGAGCTAGAAATAGCAAGTTAACCTAAGGCTAG	1	bc
CTGATCCTGT	GAAACACCGGTCTCGAGTGAGGTGTTCAGGGTGTGGTTAGAGCTAGAAAC	1	bc
ATTCGCTATG	GAAACACCGGTTACATTGAGGGTTAGAGCTAGAAATAGCAAGTTAACCTA	1	bc
TGGGTTGACC	GAAACACCGGTGACATTGGGTACAGGTAGGGGTTAGAGCTAGAGATAGAG	1	bc
GAGCAGCACA	GAAACACCGGTTCCCGTCCAGTGGGGTTAGAGCTAGAACTAGCAAGTTAA	1	bc
ACAGCGTCGT	GAAACACCGGTGTACGTATGGACTGAACCAGGGTATGCAAGTGGGGTTAG	1	bc
GCATAGTGCC	GAAACACCGGTCCAAAATGTCGCCACGCGGGGTTAGAGCTAGAAATAGCA	1	bc
CATAGTAGTG	GAAACACCGGTGTACGTATGGACTGAACCAGGGTGTGCAAGTGGGGTTAG	1	bc
AAGTGATGTC	GAAACACCGGTGACATTGGGTGGGGTTAGAGCTAGAAATAGCAAGTTAAC	1	bc
GACATTGGGT	GAAACACCGGTCGATTCATATCGAAACCTTCCCGTGACAAGTGGGGTTAG	1	bc
GTGCGCATTA	GAAACACCGGTTAAGCCGAGGAGTTAGAGCTAGAAATAGCAAGTTAACCT	1	bc
AAGGCACCCT	GAAACACCGGTGTGGCTGAGAGTCCGGCAATGGTGTGGCTGTGGGGTTAG	1	bc
AACTCTTTGC	GAAACACCGGTCTCGAGCGTGTTGGTCAGGGAGGCGTTAGAGCTAGAAAT	1	bc
ACATAGTCGT	GAAACACCGGTGTACGTATGGACTGAACCAGGGTGTGCAAGTGGGGTTAG	1	bc
AAAGGAGTAC	GAAACACCGGTGCCCTTACTCTCACCTGATTACTTAATCCGTGGGGTTAG	1	bc
CTAAATACGC	GAAACACCGGTTACATTGAGGGGTTAGAGCTAGAAATAGCGAGTTAGCCT	1	bc
ACACCTCGGC	GAAACACCGGTACCTTTGTTGATGCTGGGTGGAAGGAATGTGGGGTTAGA	1	bc
GACACAATAC	GAAACACCGGTGTGGCTGAGAGTCCGGCAATGGTGTGGCTGTGGGGTTAG	1	bc
ATAAATTATA	GAAACACCGGTAACTATATTCATGCGATGTCGTAGAGCTAGAAATAGCAA	1	bc
TACGCACTAG	GAAACACCGGTTATATTTGTAAGTGTGTGGGGTTAGAGCTAGAAATAGCA	1	bc
AACATGCGGT	GAAACACCGGTCGATTCATATCGAAACCTTCCCGTGACAGTGGGGTTAGA	1	bc
AGTGAGCATA	GAAACACCGGTTAGAGCTAGAAATAGCAAGTTAACCTAAGGCTAGTCCGT	1	bc
ACGATAGAGG	GAAACACCGGTTATATTTGTAAGTGTGTGGGGTTAGAGCTAGAAATAGCA	1	bc
AATAGTTGTC	GAAACACCGGTGTACGTATGGACTGAACCAGGGTGTGCAAGTGGGGTTAG	1	bc
GAGGACCAGA	GAAACACCGGTCGGCGGCAACGCGTGGGGTTAGAGCTAGAGATAGCAAGT	1	bc
AGCATACACA	GAAACACCGGTAGCCTGTGATTCTGCAGGGGCGTATCCTGAATTCTAGCA	1	bc
TGTGTTATGT	GAAACACCGGTTACATTTGAGGGTTAGAGCTAGAAATAGCAAGTTAACCT	1	bc
AAACAACGCC	GAAACACCGGTTTGAACTAGAAATAGCAAGTTAACCTAAGGCTAGTCCGT	1	bc
CACCTCGTCC	GAAACACCGGTACCTTTGTTGTTGCTGGGTGGATGGAGGTGTTAGAGCTA	1	bc
ACCTTTACAG	GAAACACCGGTCGGGGCCACTCAGTGGTGGGGTTAGAGCTAGAAATAGCA	1	bc
CGACACTCAC	GAAACACCGGTGCATTCGAACGCCAGGTCGTCGTGTGGCCGTGGGGTTAG	1	bc
GGCACTTAGT	GAAACACCGGTAAATTTGAGGCTCCGGCATGCAGGAGGCCGTGGGGTTAG	1	bc
TAGAGCGCAC	GAAACACCGGTTTGAACTAGAAATAGCAAGTTAACCTAAGGCTAGTCTGT	1	bc
AAACTAGGCC	GAAACACCGGTACCTTTGTTGATGCTGGGTGGAAGGAATTTTGTGGGGTT	1	bc
AGCAGACCCG	GAAACACCGGTCGGCGGCAATGTGGGGTTAGAGCTAGAAATAGCAAGTTA	1	bc
ACCTTTAACG	GAAACACCGGTCGGGGCCACTCAGTGGTGGGGTTAGAGCTAGAAATAGCA	1	bc
TTACGTGTCT	GAAACACCGGTACCTTTGTTGATGCTGGGTTGAAGGTTGGAGCTAGAAAT	1	bc
GGCCATCACC	GAAACACCGGTAAATATGAGGCTCCGGCATGCAGGAGGCCGTGGGGTTAG	1	bc
ACCTATCGAA	GAAACACCGGTTATATTTGTAAGTGTGTGGGGTTAGAGCTAGAAATAGCA	1	bc
ACGAATCGTT	GAAACACCGGTCTCGAGTGAGGTGTTCAGGGTGGGGTTAGAGCTAGAAAT	1	bc
ATTCGGCGTC	GAAACACCGGTGTACGTATGGACTGAACCAGGGTGTGCAAGTGGGGTTAG	1	bc
CACCTTATCC	GAAACACCGGTAACTATATTCATGCGATATCGCCGTAGCAGTGGGTGAGG	1	bc
GAACGCACTA	GAAACACCGGTGCCCTTACTCTCACCTGATTACTTAATCCGTGGGGTTAG	1	bc
GTGATGCGCC	GAAACACCGGTTCCCGTCCAGTGGGGGTAGAGCTAGAAATAGCAAGTTAA	1	bc
ATTAGCTGTG	GAAACACCGGTTACATTGAGGGGTTAGAGCTAGAAATAGCAAGTTAACCT	1	bc
TATAGCAGGT	GAAACACCGGTTATATATGCAGGTGTGTGGGGCTAGAGCTAGAAATAGCA	1	bc
AGACCATCTA	GAAACACCGGTGCATTCGAAAGTCCGGTCGTAGTGTGGACGTGGGGTTAG	1	bc
AACATCGTCG	GAAACACCGGTGTACGTATGGACTGAACCAGGGTGTGCAAGTGGGGTTAG	1	bc
AACGCAATTC	GAAACACCGGTCCCGTTACTCCCACCTGATTATTTAATTAGAGGGATTAG	1	bc
CAGCTTATGC	GAAACACCGGTAACTATATTCATGCGATATCGCCGTATCAGTGGGGTTAG	1	bc
GAGGAGACGC	GAAACACCGGTTCCCGTCCAGTGGGGTTAGAGCTAGAAATAGCAAGTTAA	1	bc
AGGACTCTCG	GAAACACCGGTGCATTCGAAAGTCCGGTCGTAGTGTGGACGTGGGGTTAG	1	bc
GCTACTTGGC	GAAACACCGGTACCTTTGTTGATGCTGGGTGGAAGGAATGTGGGGTTAGA	1	bc
ATGAGCATCG	GAAACACCGGTTAAGCCGATGTGCTTTTTTCCTGCAGGTTAGGCTCAAGA	1	bc
ATCTAACGCG	GAAACACCGGTTATATTTGTAAGTGTGTGGGGTTAGAGCTAGAAATAGCA	1	bc
GAGTGTTGTT	GAAACACCAGTAACCTAAGGCTAGTCCGTTATCAACTTGAAAAAGTGGCA	1	bc
ACGTCAAGCT	GAAACACCGGTTTACGATCCTTCTAAGTGGGGTTAGAGCTAGAAATAGCA	1	bc
AAGTCTTCGT	GAAACACCGGTCCGTAGGAGACCCGTGTGGCATGTACCTGTGGGGTTAGA	1	bc
AAAAACGCCA	GAAACACCGGTTTGAACTACCTAGCTCAAACCGGTGGGGTTAGAGCTAGA	1	bc
GGTGGTTTCA	GAAACACCGGTAAATTTGAGGCTCCGGCATGCATGAGGCCGTGGGGTTAG	1	bc
AGCTCCTCTC	GAAACACCGGTGCATTCGAAAGTCCGGTCGTAGTGTGGACGTGGGGTTAG	1	bc
CTTAGCGGCC	GAAACACCGGTATCCTTGTTGATGCTGGGTGGAGGGAATTTTTGTGGGGT	1	bc
GCAGGCCAGC	GAAACACCGGTCGGCGGCAATCGTGCTTTTTTTCCTGCAGGGCGGGTCTT	1	bc
CGAAGACGTG	GAAACACCGGTCTCGAGTGAGGTGTTCAGGGGGGGGTTAGAGCGAGAAAT	1	bc
GAAACTATCA	GAAACACCGGTAGCAAGAGCGAAATAACAACGTCGCCTAAGTCTGGTCAG	1	bc
TCACAGCTTC	GAAACACCGGTTCCTGTCCAGATGGGTTATAGCTAGAAATAGCAAGTTAA	1	bc
CAGCAGACCC	GAAACACCGGTCGGCGGCAATCGTGGGTGGGGTTAGGGCTAGAAATAGCA	1	bc
GCAGAGAAGT	GAAACACCGGTGTACGTATGGACTGAACCAGGGTGTGCAAGTGGGGTTAG	1	bc
AGTATTGTAT	GAAACACCGGTGACATTGGGGTTAGAGCTAGAAATAGCAAGTTAACCTAA	1	bc
GGGCCATCCA	GAAACACCGGTAAATTTGAGGCTCCGGCATGCAGGAGGCCGTGGGGTTAG	1	bc
ACCATTACCG	GAAACACCGGTCGGGGCCACTCAGTGGGGTTAGAGCTAGAAATAGCAAGT	1	bc
AGAAGACGCG	GTGGGGTTAGAGCTAGAAATAGCAAGTTAACCTAAGGCTAGTCCGTTATC	1	bc
AAGCTGAGAT	GAAACACCGGTTTACGTTGCATCGGTTTGTGGGGTTAGAGCTAGAAATAG	1	bc
ATAGCTCCTA	GAAACACCGGTCGGCGGCAATCGTGGGCGGGGGTAGAGCTAGAAATAGAA	1	bc
AAGCTCTCTA	GAAACACCGGTGCCCTTACTCTCACCTGATTACTTAATCCGTGGGGTTAG	1	bc
ACACAAAGCC	GAAACACCGGTTTGAACCGGTGGGGTTAGAGCTAGAAATAGCAAGTTAAC	1	bc
AGGCCCTTAC	GAAACACCGGTAAATTTGAGGCTCCGGCATGCAGGAGGCCGTGGGGTTAG	1	bc
TACGATATGT	GAAACAGGGGTTAGAGCTAGAAATAGCATGTTAACTTAAGGCTAGTCCGT	1	bc
ACTGAGCATA	GAAACACCGGTTAAGCCGAGGTTAGAGCTAGAAATAGCAAGTTAACCTAA	1	bc
GAGGAGCCCA	GAAACACCGGTTCCTGTCCAGTGGGGTTAGAGCTAGAAATAGCAAGTTAA	1	bc
ATGGGAGCCT	GAAACACCGGTTCCCGTCCGGTGGGGTTAGAGCTAGAAATAGCAAGTTAA	1	bc
GTGAGGATAC	GAAACACCGGTTAAGCCGAGTGGGGTTAGAGCTAGAAATAGCAAGTTAAC	1	bc
ACTGCGTAGC	GAAACACCGGTTTACGTTGCATCGGTGTGGGGTTAGAGCTAGAAATAGCA	1	bc
GGAAAACCCG	GAAACACCGGTCGGCGGCAATCGTGGGTGGGGTTAGAGCTAGAAATAGCA	1	bc
AAGAATCATT	GAAACACCGGTCTCGAGTGAGGTGTTCAGGGCGGTGTTAGAGCTAGTAAT	1	bc
CCTCACCCCA	GAAACACCGGTTTGAACTAGAAATAGCAAGTTAACCTAAGGCTAGTCCGG	1	bc
GGCAAACTAC	GAAACACCGGTGTGGCTGAGAGTCCGGCAATGGTGTGGCTGTGGGGTTAG	1	bc
CAGCACGGCC	GAAACACCGGTTTGAACTACCTAGTTCAAACCGGTGGGGTTAGAGCTAGA	1	bc
AAATCCCTCC	GAAACACCGGTGCCCTTACTCTCACCTGATTACTTAATCCGTGGGGTTAG	1	bc
GACCACGTTC	GAAACACCGGTTTGAACTACCGGGGTTAGAGCTAGAAATAGCAAGTTAAC	1	bc
GGAACCTATA	GAAACACCGGTAAATTTGAGGCTCCGGCATGCAGGAGGCCGTGGGGTTAG	1	bc
CAGATAGCCC	GAAACACCGGTTTGAACTAGAAATAGCAAGTTAACCTAAGGCTAGTCCGT	1	bc
ATGCCTAATT	GAAACACCGGTTTACGTGCCAGCGGTGCGGGGTTTGAGTTAGAAAGATCG	1	bc
ATTCGCATAC	GAACCACCGGTTAAGCCGAGGTTAGAGCTAGAAATAGCAAGTTAACCTAA	1	bc
ATACTCGGAG	GAAACACCGGTACCTTTGTTGATGCTGGGTGGAAGGAATTGTGTGGGGTT	1	bc
GGCACTGTAC	GAAACACCGGTGTGGCTGAGACACAGGCAATGGAGTGGCTGTGGGGTTAG	1	bc
GAAAAAGGCC	GAAACACCGGTTTGAACTAGAAATAGCAAGTTAACCTAAGGCTAGTCCGT	1	bc
AGACGAGGGC	GAAACACCGGTGCATTCGAAAGTCCGGTCGTAGTGTGGACGTGGGGTTAG	1	bc
TCGCCCGGCA	GAAACACCGGTGCATTCGAAAGTCCGGTCGTAGTGTGGACGTGGGGTTAG	1	bc
GAGAAAGAGA	GAAACACCGGTAGCAAGTTAACCTAAGGCTAGTCCGTTATCAACTTGAAA	1	bc
GGAGCAGACA	GAAACACCGGTAGCAAGTTAACCTAAGTCTAGTCCGTTATCAACTTGAAA	1	bc
TCGAATACTT	GAAACACCGGTCTCGAGTGAGGTGTTCAGGGTGGGGTTGGAGCTAGAAAT	1	bc
CATAGTAGCA	GAAACACCGGTGTACGCATGGGCTGAACCGGGGTGAGCAGGTGGGTATCG	1	bc
CTGCTAGGTC	GAAACACCGGTACCTTTGTTGATGCTGGGGGGAAGGTGTGGGGTTAGAGC	1	bc
CTGCACGCCC	GAAACACCGGTTTGAACTACCTAGTTCAAACCGGTGGGGTTAGAGCTAGA	1	bc
AGTCACGGAC	GAAACACCGGTAGCAAGTGCGAGACGTGTTAAATAGCAAGTTAACCTAAG	1	bc
GAGGAGACTA	GAAACACCGGTTCCCGTCCAGTGGGGTTAGAGCTAGGAATAGCAAGTTAA	1	bc
ACACAACGCT	GAAACACCGGTTTGAACTAGGAATAGCAAGTTAACCTAAGGCTAGTCCGT	1	bc
GAGTAACCGC	GAAACACCGGTCGGCGGCAATCGTGGTTAGAGCTAGAAATAGCAAGTTAA	1	bc
TTGTGTTTAA	GAAACACCGGTTAAGCCGAGTGTTAGAGCTAGATATAGCAAGTTAACCTA	1	bc
GTGGCGCTTT	GAAACACCGGTTATACGGAGGGCTAGAGCTAGCAATAGCTAGATAACCTA	1	bc
CGGGAGTTAT	GAAACACCGGTTCCCGTCCAGTGGGGTTAGAGCTAGAAATAGCAAGTTAA	1	bc
GGGCACTAAA	GAAACACCGGTAAATTTGAGGCTCCGGCATGCAGGAGGCCGTGGGGTTAG	1	bc
ACCAGCGTCC	GAAACACCGGTTTGAACTAGAAATAGCAAGTTAACCTAAGGCTAGTCCGT	1	bc
AGAATATTTT	GAAACACCGGTCTCGAGTGAGGTGTTCAGGGTGGGGTTAGAGCTAGAAAT	1	bc
GACGCGATAC	GAAACACCGGTCCCCTTGCATACAGCTGTTGTGTGGTTAGAGCTAGATAT	1	bc
AGCCGCTCCA	GAAACACCGGTAATTTTTAGGCCCCGGCATGCAGGAGGCCGTGGGTTTAG	1	bc
AGATTTGTTT	GAAACACCGGTCGATTCATATCGAAATCTTCCCGGGTCAGTGGTGTTAGT	1	bc
CACATTGCCT	GAAACACCGGTTTGAACTAGAAATAGCAAGTTAACCTAAGGCTAGTCCGT	1	bc
ATGGACCCCC	GAAACACCGGTTACCGTCCAGCGCGGTTAGAGCTAGAAATAGCAAGTTAG	1	bc
GTGTAGAATC	GAAACACCGGTTCCCGTCCAGTGGGGTTAGAGCTAGAAATAGCAAGTTAA	1	bc
ACACTGATAT	GAAACACCGGTCTCTCGGGAGGCGGTCGTGGTGGGGTTAGAGCTAGAAAT	1	bc
AAAATCCGGG	GAAACACCGGTTCCGTTATCAACTTGAAAAAGTGGCACCGAGTCGGTGCT	1	bc
CGATCCCCTT	GAAACACCGGTCTCGAGTGAGGCGTTCAGGGGTGGGGTTAGAGCTAGAAA	1	bc
TTAGATAGGA	GAAACACCGGTTACATTGAGGGTTAGAGCTAGAAATAGCAAGTTAACCTA	1	bc
GATACCACCA	GAAACACCGGTCCAAAATGTCGCCACGTGGGGTTAGAGCTAGAAATAGCA	1	bc
GAGCCACTAC	GAAACACCGGTAAATTTGAGGCTCCGGCATGCAGGAGGCCGTGGGGTTAG	1	bc
ACTGTAGCGC	GAAACACCGGTCAGAGCCACTAAGGGGTGGGGTTAGAGCTAGAAATAGCA	1	bc
ATACCTAATC	GAAACACCGGTAACTATATTCATGCGATATCGCCGTATCAGTGGGGTTAG	1	bc
CTGCATTTTC	GAAACACCGGTTCCCGTCCAGTGGGGTTAGAGCTAGAAATAGCAAGTTAA	1	bc
ACACACCAAC	GAAACACCGGTTTGAACTAGAAATAGCAAGTTAACCTAAGGCTAGTCCGT	1	bc
ATCAATCGGG	GAAACACCGGTTATATTTGTAAGTGTGTGGGGTTAGAGCTAGAAATAGCA	1	bc
GTGAGGTGTG	GAAACACCGGTTACATTGAGATCTAGCTAGAAATAGCAAGTTAACCTAAG	1	bc
AGCCAACGAC	GAAACACCGGTAGCAAGTGCGAGACGTGTTTGTGGGGTTAGAGCTAGAAA	1	bc
GGGCCAAACA	GAAACACCGGTAAATTTGAGGCTACGGCATGCAGAAGGCCGTGGGGATAG	1	bc
CACATAGACT	GAAACACCGGTTTGAACTAGAAATAGCAAGTTAACCTAAGGCTAGTCCGT	1	bc
ACTTGTAGTA	GGAACACCGGTGACATCGGGTGGGGTTAGAGCTAGAAATAGCAAGTTACC	1	bc
AACAGTCGTC	GAAACACCGGTGAAAGTATGGACTGAACCAGGATGTGCAAGTGGGGCTAG	1	bc
AGTGGCGCCT	GAAACACCGGTTCCCGTCCAGTGGGGTTAGAGCTAGAAATAGCAAGTTAA	1	bc
GTACACAATT	GAAACACCGGTTTACGTAACATCGGAGTGGGGTTAGAGCTAGAAATAGCA	1	bc
ATTGCTCTGT	GAAACACCGGTTACATTGAGGGTTAGAGCTAGAAATAGCAAGTTAACCTA	1	bc
AAGGCGCGTC	GAAACACCGGTTCCAGTTAAGAGGGGTTAGAGCTAGAAATAGAAAGTTAA	1	bc
TCTATCGTTT	GAAACACCGGTTATATTTGTAAGGGTGTGGGGTTAGAGCTAGCAATAGCT	1	bc
TCAACAGATT	GAAACACCGGTCGATTCATATCGAAACCTTCCCGTGACAGTGGGGTTAGA	1	bc
CAACTACAAT	GAAACACCGGTCGGGGCCAATCAGTGGTGGGGTTAGAGCTAGAAATAGCA	1	bc
TAGGTGAGCT	GAAACACCGGTGTACGTATGGACTGAACCAGGGTGTGCAAGTGGGGTTAG	1	bc
CTAGCTCTGC	GAAACACCGGTTACATTGTGTGGGGTTAGAGCTAGAAATGGCAGGTTAAC	1	bc
CGAGATGTCC	GAAACACCGGTGACATTGAGCTAGACATTAGAGCTAGAAATAGCAAGTTA	1	bc
AAATTCATTA	GAAACACCGGTTACATTTTGGAGTTAGAGCTAGAAATAACGAGTTAACCT	1	bc
AAATCGTTGT	GAAACACCGGTGTACGTATGGACTGAACCAGGGTGTGCAAGTGGGGTTAG	1	bc
ACGCCAATTT	GAAACACCGGTTAAGCCGAGGGTTAGAGCTAGAAATAGCAAGTTAACCTA	1	bc
ATGAGCATCC	GAAACACCGGTTAAGCCGAGGGTTAGAGCTAGAAATAGCAAGTTAACCTA	1	bc
CGCATCGACT	GAAACACCGGTGACATTGGGAACAGAGCTAGACATAGGGAGTTAACCTAA	1	bc
AACATTTGGC	GAAACACCGGTCGATTCATATCGAAACCTTCCCGTGACAGTGGGGTTAGA	1	bc
AACGCCACAA	GAAACACCGGTGCCCTTACTCTCACCTAATTACTTAATCCGTGGGGTTAG	1	bc
CATTGCAGTC	GAAACACCGGTGTACGTATGGACTGAACCAGGGTGTGCAAGTGGGGTTAG	1	bc
AAACAACGCC	GAAACACCGGTTTGAACCGGTGGGGTTAGAGCTAGAAATAGCAAGTTAAC	1	bc
GCGGAACAGC	GAAACACCGGTCGGCGGCAATCGTGGGTGGGGTTAGAGCTAGAAATAGCA	1	bc
CGCGCTACGC	GAAACACCGGTTACATTGAGGGGTTAGAGCTAGAAATAGCAAGTTAACAT	1	bc
GGTGGAGGCT	GAAACACCGGTTCCCGTCCAGTGGGGTTAGAGCTAGAAATAGCAAGTTAA	1	bc
CGTGACGGCT	GAAACACCGGTGACATTGGGTGGGGTTAGAGCTAGAAATAGCAAGTTAAC	1	bc
AAACGGCGTA	GAAACACCGGTGCCCTTACTCTCACCTGATTACTTAATCCGTGGGGTTAG	1	bc
ACTTTCACGC	GAAACACCGGTCAGGGGTTAGAGCTAGAAATAGCAAGTTAACCTAAGGCT	1	bc
TTTAACGCAC	GAAACACCGGTTTGAACTAGAAATAGCAAGTTAACCTAAGGCTAGTCCGT	1	bc
CACAGTCGCT	GAAACACCGGTGTACGTATGGACTGAACCAGGGTGTGCAAGTGGGGTTAG	1	bc
GGCAATTACA	GAAACACCGGTAAATTTGAGGCTCCGGCATGCAGGAGGCCGAAGGCTAGT	1	bc
ACAATCGCGG	GAAACACCGGTTATATTTGTAAGTGTGTGGGGTTAGAGCTAGAAATAGCA	1	bc
TTATCAACGT	GAAACACCGGTTACATTGAGGGTTAGGGCTAGAAATAGCAAGTTAACCTA	1	bc
AATCGTGGAC	GAAACACCGGTGTACGTATGGACTGAACCAGGGTGTGCAAGTGGGGTTAG	1	bc
ATGCCTAGGC	GAAACACCGGTTTACGCTGCATCGGTGTCGGGTTAGAGCTAGAAATAGCA	1	bc
TTGTGCCTAC	GAAACACCGGTTAAGCCGAGGTTAGAGCTAGAAATAGCAAGTTAACCTAA	1	bc
AAGGTGAGTC	GAAACACCGGTTACTATATTCATGCGATATCGCCGTATCAAGTGGGGTTA	1	bc
GGTTTACTGA	GAAACACCGGTCGGGGCCAGAGCTAGAAATAGCAAGTTAACCTAAGGCTA	1	bc
TAAGGTATCT	GAAACACCGGTTACATTGAGGGTTAGAGCTAGATATGGCAAGTTAAACTA	1	bc
GACTTCGCAC	GAAACACCGGCCGGCGGCTAGAAATAGCAAGTTAACCTAAGGCTAGTCCG	1	bc
CACGCCCATC	GAAACACCGGTGCCCTTACTCTCACCTGATTACTTAATCCGTGGGGTTAG	1	bc
ACTATATCGC	GAAACACCGGTGCATTCGAAAGTCCGGTCGTAGTGTGGACGTGGGGTTAG	1	bc
AATCGGAGTC	GAAACACCGGTGTACGTATGGACTGAACCAGGGTGTGCAAGTGGGGTTAG	1	bc
GTGATCAGCA	GAAACACCGGTTAAGCCGAGTGGGGTTAGAGCTAGAAATAGCAAGTTAAC	1	bc
AACATACGGT	GAAACACCGGTCGATTCATATCGAAACCTTCCCGTGACAAGTGGGGTTAG	1	bc
ACGAATCATT	GAAACACCGGTCTCGAGTGAGGTGTTCAGGGTGGGGTTAGAGCTAGAAAT	1	bc
ACCAAGGCCC	GAAACACCGGTTTGACCTACCTAGTTCAAACCGTGGGTATAGAGCTAGAA	1	bc
AGACCCAGAC	GAAACACCGGTAGCAAGTGCGAGACGTGTTAAATAGCAAGTTAACCTAAG	1	bc
AAAGCGCTAT	GAAACACCGGTGCCCTTACTCTCACCTGATTACTTAATCCGTGGGGTTAG	1	bc
CTTATCGTGA	GAAACACCGGTCTCGAGTGAGGTGTTCAGGGTGGGGTTAGAGCTAGAAAT	1	bc
AGAAGACCGG	GAAACACCGGTCGGCGGCAAGAAATAGCAAGTTAACCTAAGGCTAGTCCG	1	bc
CGTGTTCTTC	GAAACACCGGTTCCCGAGTGGGGTTAGTACTAGAAGTAGTAAGTTAACAT	1	bc
ATTGAGAATA	GAAACACCGGTTAAGCCGAGGAGTTAGAGCTAGAAATAGCAAGTTAACCT	1	bc
TAAGAGCAGT	GAAACACCGGTCGGCGGCAATGTGTGTAGATGTAGAAGTAGCAAGTTAAC	1	bc
GCCGCTGACA	GAAACACCGGTAGCAAGTGCGTGGGGTTAGGGCTAGAGATAGCAAGCTAA	1	bc
AACATTCGGA	GAAACACCGGTCGATTCATATCGAAACCTTCCCGTGACAAGTGGGGTTAG	1	bc
AACAAACGCC	GAAACACCGGTTTTAGAAATAGCAAGTTAACCTACGGCTAGTCCGTTATC	1	bc
CCATTACTTC	GAAACACCGGTCTCGAGTGAGGTGTTCAGGGTGGGGTTAGAGCTAGAAAT	1	bc
CACGTTGTAT	GAAACACCGGTGACATTACTCTCACCTGGTTATTTAATGCGAGGCGTTAG	1	bc
AGACAAATCC	GAGACACCGGTAGCAAGTGCGAGACGTGTTGGTGGGGTTAGAGCTAGAAA	1	bc
TAATCTCTGT	GAAACACCGGTTACATTGAGATTGGGGTTAGAGCTAGAAATAGCGAGTTA	1	bc
GACGAAACGC	GAAACACCGGTCGGTGGGGTTAGAGCTAGAAATAGCAAGTTAACCTAAGG	1	bc
AAGTCTGACT	GAAACACCGGTCCGTAGGAGACCCGTGTGGCATGTACCTGTGGGGTTAGT	1	bc
TTGGATACGT	GAAACACCGGTTCCCGTCCAGTGGGGTTAGAGCTAGAAATAGCAAGTTAA	1	bc
ATGGCTATTC	GAAACACCGGTTACTTTGAGGGTTAGAGCTATAAGTATCGAGTTAACCTT	1	bc
GGGCAACCTC	GAAACACCGGTGTGGCTGAGAGTCCGGCAATGGTGTGGCTGTGGGGTTAG	1	bc
AGACGTGCGC	GAAACACCGGTGCATTCGAAAGCCCGGTCGTAGTGTGGACGTGGGGTTAG	1	bc
CGGTTCCATT	GAAACACCGGTCTCGAGTGAGGTGTTCAGGGTGGGGTTAGAGCTAGAAAT	1	bc
TTCACTATGC	GAAACAGGGTTAGAGCTAGAAATAGCAAGTTAACCTAAGGCTAGTCCGTT	1	bc
AGCAGACCCG	GAAACACCGGTCGGCGGCAATCGTGCTTTTTTTCCTGCAGGGCGGGTCTT	1	bc
AGTATCGATG	GAAACACCGGTTATATTTGTAAGTGTTTGTGGGGTTAGAGCTAGAAATAG	1	bc
CACAAAGTCA	GAAACACCGGTTTGAACTAGAAATAGCAAGTTAACCTAAGGCTAGTCCGT	1	bc
GCGACAGAAA	GAAACACCGGTAGCAAGTGCGAGACGTGTTTGTGGGGTTAGAGCTAGAAA	1	bc
AGACGTTCTC	GAAACACCGGTGCATTCGAAAGTCCGATCGTCGTGTGGACGTGGGGTTAG	1	bc
AAATTCAGAT	GAAACACCGGTCGATTCATATCGAAACCTTCCCGCGACAGTGGGGTTAGA	1	bc
ACGTGCTGTC	GAAACACCGGTGACATTGGGTGGGGTTAGAGCTAGAAATAGCAAGTTAAC	1	bc
TAACGCAGAA	GAAACACCGGTGCCCTTACTCTCACCTGATTACTTAATCCGTGGGGTTAG	1	bc
ATTAGCTCTG	GAAACACCGGATACATTGAGGGTTAGAGCTAGAAATAGCAAGTTAACCTA	1	bc
TCTTCGTGGT	GAAACACCGGTGTACGTATGGACTGAACCAGGGTGTGCAATGGGGTTAGA	1	bc
ACGAATGCTT	GAAACACCGGTCTCGAGTGAGGTGTTCAGGGTGGGGTTAGAGCTAGAAAT	1	bc
GAGGAGACCA	GAAACACCGGTTCCCGTCCAGTGGGGTTAGAGCTAGAAATAGCAAGTTAA	1	bc
CACGCCCCGC	GAAACACCGGTTTCAACTACTTAGAAAGTTAACCTAAGGCAAGTCCGTTA	1	bc
AACACCGCCA	GAAACACCGGTTTGAACTACCTAGGGGGTAGTTCAAACCGGGGTTAGAGC	1	bc
CCGCGTCTTC	GAAACACCGGTGTACGTATGGACTGAACCAGGGTGTGCAAGTGGGGTTAG	1	bc
GAGGACCAAC	GAAACACCGGTCGGCGGAGAAATAAGAAGTTAACCTAGCGCTGGGCCGTT	1	bc
AGTGGAGGCT	GAAACACCGGTTCCCGTCCAGTGGGGTTAGAGCTAGAAATAGCAAGTTAA	1	bc
ACAAGCCTTT	GAAACACCGGTCTCGAGTGAGGCGTTCAGGTGGGGTTAGAGCTAGAAATA	1	bc
GTTGAGCACA	GAAACACCGGTTAAGCCGAGTGGGGTTAGAGCTAGAAATAGCAAGATAAC	1	bc
CTGAAGGCTC	GAAACACCGGTTTGAACTACCTAGAGCTAGAAATAGCAAGTTAACCTAAG	1	bc
AACATGCGGA	GAAACACCGGTTGAGTCATATCGAGACAGTCCCGGCACAGTGGGGTTAGA	1	bc
GAGGAGCACC	GAAACACCGGTTCCCGTCCAGTGGGGTTAGAGCTAGAAATAGCAAGTTGA	1	bc
ATGCTAGGCC	GAAACACCGGTACCGGGTTAGAGCTAGAAATAGCAAGTTAACCTAAGGCT	1	bc
ATGCGCATTA	GAAACACCGGTTAAGCGGTTGTGCTTTTTTCCTGCGGGATCTTCTCAATA	1	bc
CGCAACTCCA	GAAACACCGGTTTATTTGACCCTGCTGCATGCAGGAAGCCGTGAGGATAG	1	bc
GAGAACCCTT	GAAACACCGGTCTCGAGTGAGGCGTTCAGGGTGGGGTTAGAGCTAGAAAT	1	bc
CCTTTAGAGG	GAAACACCGGTCGTATTTACTCAGGGTTGGGGTTAGAGCTAGAAATAGCA	1	bc
ATTGAGAATA	GAAACACCGGTTAAGCCGAGGTTAGAGCTAGAAATAGCATGTTAACCTAA	1	bc
TAATTTCGAC	GAGAAAGTTAACCTAAGGCTACTCCGTTGTCGACTTGGCAAAAAGGATCC	1	bc
TAGAGCGTCC	GAAACACCGGTTAAGACTAGGATAGAGCTAGTAATATCAAGTTAACCTGT	1	bc
AGGCCCAGGC	GAAACACCGGTTTACGTTGCATCGGTTGTGGGGTTAGAGCTAGAAATAGC	1	bc
AGACACCGCC	GAAACACCGGTAGCAAGTGCGAGACGTGTTAAATAGCAAGTTAACCTAAG	1	bc
GAAGCGCAGC	GAAACCCCGGTCGGCGGCACTCGTGCTTTTTTTCCTGCAGGGCGGGGCTT	1	bc
AGAGCCGTGC	GAAACACCGGTGCCTTCAATATCACCTGCGTAGTTTGTCCGTGGGGTTAG	1	bc
AGAACAGCGC	GAAACACCGGTGCATTCGAAAGTCCGGTCGTAGTGTGGACGTGGGGTTAG	1	bc
ATCGCTGCAC	GAAACACCGGTGCCCTTACTCTCACCTGATTACTTAATCCGGGGGGTTAG	1	bc
CAAAACGTCA	GAAACACCGGTGTGGCTGAGAGTCCGGCAATGGTGTGGCTGTGGGGTTAG	1	bc
CTCAACGGTC	GAAACACCGGTTTGAACCGTTCGGGTTAGAGCTAGAAATAGCAAGTTCAC	1	bc
TGAGCTACGA	GAAACACCGGTTACATTGAGGGGTTAGAGCTAGAAATAGCAAGTTAACCT	1	bc
AGCAGCCTTT	GAAACACCGGTCTCGAGTGAGGTGTTCAGGGTGGGGTTAGAGCTAGAAAT	1	bc
AACTACCTTT	GAAACACCGGTGCCCTTACTCTCACCTGATTACTTAATCCGTGGGGTTAG	1	bc
CAGAACGACA	GAAACACCGGTTTGAACCGGTGGGGTTAGTGCTAGAAATAGCAAGTTAAC	1	bc
TAGAGTCCTT	GAACCACCGGTCTCGAGTGAGGTGTTCAGGGGTGGGGTTAGAGCTAGAAA	1	bc
TCGTGGTCGT	GAAACACCGGTGTACGTATGGACTGAACCAGGGTGTGCAAGTGGGGTTAG	1	bc
CATTTATAGC	GAAACACCGGTCGGGGCCACTCAGTGGTGGGGTTAGAGCTAGAAATAGCA	1	bc
AACTATGCCC	GAAACACCGGTTTGAACTAGATGAAGCAAGGTAACCTAAGGCTAGTCCGG	1	bc
ATCGAGCATA	GAAACACCGGTTAAGCCGAGGTTAGAGCTAGAAATAGCAAGTTAACCTAA	1	bc
GGCAGCATAA	GAAACACCGGTGTGGCTGAGAGTCCGGCAATGGTGTGGCTGTGGGGTTAG	1	bc
ACGAATCCTG	GAAACACCGGTCTCGAGTGAGGTGGGGTTAGAGCTAGAAATAGCAAGTTA	1	bc
ACCTCCTGTT	GAAACACCGGTCGATTCATATCGAAACCTTCCCGTGACAAGTGGGGTTAG	1	bc
CTGATTAAAA	GAAACACCGGTTTACGTTGCATCGGTGTGGGGTTAGAGCTAGAAATAGCA	1	bc
AACATTTGGT	GAAACACCGGTCGATTCATATCGAAACCTTCCCGTGACAGTGGGGTTAGA	1	bc
CGCCCCCCGC	GAAACACCGGTGCATTCGAAAGTCCGGTCGTAGTGTGGACGTGGGGTTAG	1	bc
CTACACGGAA	GAAACACCGGTACCTTTGTTGATGCTGGGTGGAAGGATGCTGGGAGGGGT	1	bc
ACCGCGCTAT	GAAACACCGGTGCCCTTACTCTCACCTGATTACTTAATCCGTGAGGTTAG	1	bc
AGTGAGCATA	GAAACACCGGTTAAGCCGAGTGGGGTTAGAGCTAGAAATAGCAAGTTAAC	1	bc
AAGTGAGCCT	GAAACACCGGTCCGTAGGAGACCCGTGTGGCATGTACCTGTGGGGTTAGA	1	bc
TACTTTACCG	GAAACACCGGTCGGGGCCACTCAGTGGTGGGGTTAGAGCTAGAAATAGCA	1	bc
GGCAAATACA	GAAACACCGGTAAATTTGAGGCTCCGGCATGCAGGAGGCCGTGGGGTTAG	1	bc
TCATTGCCTC	GAAACACCGGTCCGTAGGCTACCCGTGTGGCATTTACCTGTGAGGTAAGA	1	bc
AGTGGTGTCA	TAGCCTTAGTCCGTTATCAACTTGAAAAAGTGGCACCGAGTCGATGCTTT	1	bc
TAGAACGCGC	GAAACAACGGCTTGAACTACCTAGTTAAAACCGGTGGGGTTAGAGCTAGA	1	bc
GCGGACACGC	GAAACACCGGTCGGCGGCAATGTGGGGTTAGAGCTAGAAATAGCAAGTTA	1	bc
ATGAGTCATT	GAAACACCGGTCTCGAGTGAGGGCAAGTTAACCTAAGGCTAGTCCGTTAT	1	bc
ACAAAAAGCC	GAAACACCGGTGTGGGCGACACAGTGGCGGGGGTAGAGCTGGGAATAGCA	1	bc
AACTTTAACG	GAAACACCGGTCGGGGCCACTCAGTGGTGGGGTTAGAGCTAGAAATAGCA	1	bc
CTCCCCTGCA	GAAACACCGGTGTGGCTGAGAGTCCTGCACTGTTGTTTCTTTTGGGTTAG	1	bc
AAGACCATCG	GAAACACCGGTGCATTCGAAAGTCCGGTCGTAGTGTGGACGTGGGGTTAG	1	bc
AAGTATGCAT	GAAACACCGGTCCGTAGGAGACCCGTGTGGCATGTACCTGTGGGGTTAGA	1	bc
GGCACTGAAA	GAAACACCGGTAGCAAGTAAGAGACCGGAGGCGGCGCTTTTTTTCCTGCA	1	bc
GCATAGTAGT	GAAACACCGGTGTACGTATGGACTGAACCAGGGTGTGCAAAGTGGGGTTA	1	bc
GTCTCCTCCA	GAAACACCGGTAAATTTGAGGCTCCGGCATGCAGGAGGCCGTGGGGTTAG	1	bc
ACACACCGCC	GAAACACCGGTTTGAACTAGAAATAGCAAGTTAACCTAAGGCTAGTCCGT	1	bc
ATGCTTCCTT	GAAACACCGCTAGAAATAGCAAGTTAACCTAAGGCTCGTCCGGTATCAAC	1	bc
AGGCCACTAC	GAAACACCGGTAAATTTGAGGCTCCGGCATGCAGGAGGCCGTGGGGTTAG	1	bc
GACTTTACCG	GAAACACCGGTCGGGGCCACTCAGTGGTGGGGTTAGAGCTAGAAATAGCA	1	bc
TCCTCGTCGT	GAAACACCGGTGTACGTATGGACTGAACCAGGGTGTGCAAGTGGGGTTGG	1	bc
AAGGCGGCCT	GAAACACCGGTCCGTAGGCGACCCGTGTGGCATGTACCTGTGGGGTTAGA	1	bc
AAGTCCGGTT	GAAACACCGGTCGATTCATATCGAAACCTCCCCGTGACAGTGGGGTTAGA	1	bc
CACAAAGCGA	GAAACACCGGTTTGAACTACCTAGTAGCAAGTTAACCTAAGGCTAGTCCG	1	bc
AATTCCATAC	GAAACACCGGTGCCCTTACTCTCACCTGATTACTTAATCCCGTGGGGTTA	1	bc
AGAGTAGGTT	GAAACACCGGTCGATTCAGATCGAAATCTTCCCGTGACAGTGGGGTTAGA	1	bc
TCAATAATTT	GAAACACTAGGGCAAGTCCGTTATCAACTTGGAAAAGGGGCACAGAGGCG	1	bc
TTATCGCGAC	GAAACACCGGTTACATGGAGGGTCAGAGCTAGAAATAGCAAGTTAACATA	1	bc
AAAGAACGCC	GAAACACCGGTTTGAACTAGAAATAGCAAGTTAACCTAAGGCTAGTCCGT	1	bc
GCCGTAGCCC	GAAACACCGGTCGTGGCCACTCAGTGGTGGGGTTAGAGCTAGAAATAGCA	1	bc
CTGCTTCTCC	GAAACACCGGTTTACGTTGCATCGGTTGTGGGGTTAGAGCTAGAAATAGC	1	bc
TTTAGAGAGG	GAAACACCGGTTATATTTGTAAGTGTGTGGGGTTAGAGCTAGAAATAGCA	1	bc
GACGCGCCTC	GAAACACCGGTTCCCGTCCAGTGGGGTTAGAGCTAGAGATAGAAAGTTAA	1	bc
ACAGCCCTAT	GAAACACCGGTGCCCTTACTCTCACCTGATTACTTAATCCGTGGGGTTAG	1	bc
GCTACCCCCA	GAAACACCGGTCCAAAAATGTCGCCACGTGGGGTTAGAGCTAGAAATAGC	1	bc
GTAGCCCTGC	GAAACACCGGTTACATTGAGGGTTAGAGCTAGAAATAGCAAGTTAACCTA	1	bc
GGACCCTATT	GAAACACCGGTAAATTTGAGGCTCCGGCATGCAGGAGGCCGTGGGGTTAG	1	bc
GGCGCCATAC	GAAACACCGGTGTGGCTGAGAGTCCGGCAATGGTGTGGCTGTGGGGTTAG	1	bc
AGACACGTGC	GAAACACCGGTGCATTCGAAAGTCCGGTCGTAGTGTGGACGTGGGGTTAG	1	bc
CGCATCTACA	GAAACACCGGTAAATTTGAGGCTCCGGCATGCAGGAGGCCGTGGGGTTAG	1	bc
AGTGGTGCCT	GAAACACCGGTTCCCGTCCAGTGGGGTTAGAGCTAGAAATAGCAAGTTAA	1	bc
AAACGCTCTG	GAAACACCGGTGCCCTTACTCTCACCTGATTACTTAATCCGTGGGGTTAG	1	bc
ATGGAGAGTC	GAAACACCGGTTCCCGTCCAGTGGGGTTAGAGCTAGAAATAGCAAGTTAA	1	bc
CGCAACCATT	GAAACACCGGTCTCGAGTGAAGTGTTCAGGGTGGGGTTAGAGCTAGAAAT	1	bc
GCCATACGGT	GAAACAACGGTCGATTCATATCGAAACCTTCCCGTGACAGTGGGGTTAGA	1	bc
ACACAAAGCC	GAAACACCGGTCTGAACTAGAAATAGCAAGTTAACCTAAGGCTAGTCCGT	1	bc
CATAAAGCAC	GAAACACCGGTTTGAACTAGAAATAGCAAGTTAACCTAAGGCTAGTCCGT	1	bc
CAATGTCGAC	GAAACACCGGTGTACGTATGGACTGAACCAGGGTGTGCAAGTGGGGTTAG	1	bc
ATTGCGCATA	GAAACACCGGTTAAGCCGAGGAGTTAGAGCTAGAAATAGCAAGTTAACCT	1	bc
GGAACCGACA	GAAACACCGGTAGCAAGTGCGGGGTTAGAGCTAGAAATAGCAAGTTAACC	1	bc
ATGAGCACAC	GAAACACCGGTTAAGCCGAGGTTAGAGCTAGAAATAGCAAGTTAACCTAA	1	bc
TGGGCTATCT	GAAACACCGGTTACATTGAGGGTTAGAGCTAGAAATAGCAAGTTAACCTA	1	bc
GCCAACGCTT	GAAACACCGGTTTGAACCTGTCGGGATAGACCCAGAAATAGCAAGTTAAC	1	bc
AGAGACAGAC	GAAACACCGGTAGCAAGTGGGGTTAGAGCTAGAAATAGCAAGTTAACCTA	1	bc
TACCTGTCTT	GAAACACCGGTCGTCGCTATATCATTGTGGGGTTAGACTAGAAATAGCAA	1	bc
CGCTTGAGGT	GAAACACCGGTCGGTTCCTATCGAAACCTTCCCGTGACAGTGGGGTTAGA	1	bc
AAGGGGTGTA	GAAACGCAAGTTAACCTAAGGCTAGTCCGTTATCAACTTGAAAAAGTGGC	1	bc
CATAGTGGTA	GAAACACCGGTGTACGTATGGACTGAACCAGGGTGTGCAAAGTGGGGTTA	1	bc
AAGGCTGCCT	GAAACACCGGTCCGTAGGAGACCCGTGTGGCATGTACCTGTGGGGTTAGA	1	bc
TACCTTAACC	GAAACACCGGTAACTATATTCATGCGATATCGCCGTATCAGTGGGGTTAG	1	bc
AATGCTTAGA	GAAACACCGGTTTACGTTGCATCGGTGTGGGGTTAGAGCTAGAAATAGCA	1	bc
CCAATCGTGG	GAAACACCGGTTAAATTTCTAAGTGTTTTGGGGTTAGAGTTAGAAATAGC	1	bc
AAACCACGCC	GAAACACCGGTTTGAACTAGAAATAGCAAGTTAACCTAAGGCTAGTCCGT	1	bc
GTAGCGTCGC	GAAACACCGGTCGGCGGCAATCGTGCCTAGTGTTAGAGCTAGGAATAGCA	1	bc
GCATTTACCG	GAAACACCGGTCGGGGCCACTCAGTGGTGGGGTTAGAGCTAGAAATAGCA	1	bc
ACAAAACGCC	GAAACACCGGTTTGAACTAGAAATAGCAAGTTAACCTAAGGCTAGTCCGT	1	bc
ACCTTGGGTC	GAAACACCGGTCGATTCATATCGAAACCTTCCCGTGACAGGGGGGGTAGA	1	bc
CGAATATTTC	GAAACACCGGTCTCGAGTGAGGTGCTAGAAATAGCAAGTTAACCTAAGGC	1	bc
ACAAACGAGG	GAAACACCGGTTATATTTGTAAGTGTGTGGGGTTAGAGCTAGAAATAGCA	1	bc
TTCACTATGC	GAAACACCGGTTACATTGAGGGTTAGAGCTAGAAATAGCAAGTTAACCTG	1	bc
GGCCACTTAA	GAAACACCGGTAAATTTGAGGCTCCGGCATGCAGGAGGCCGTGGGGTTAG	1	bc
CTAAGCGACC	GAAACACCGGTACCTTTGTTGATGCTGGGTGGAAGGTGTGGGGTTAGAGC	1	bc
AGTTTACCGA	GAAACACCGGTCGGGGCCACTCAGTGGTGGGGTTAGAGCTAGAAATAGCA	1	bc
GACAGAGATC	GAAACACCGGTAGCAAGTGCGAGACGTGTTAAATAGCAAGTTAACCTAAG	1	bc
ATATATCGAG	GAAACACCGGTTATATTTGTAAGTGTGTGGGGTTAGAGCTAGAAATAGCA	1	bc
GCGACTCCTT	GAAACACCGGTCTCGAGTGAGGTTAGAGCTAGAAATAGCAGGTTAACCTA	1	bc
GCTGTGCCGC	GAAACACCGGTCGGCGCCAAGCAGGGGTAGGGTTAGAGCTAGAAATAGCA	1	bc
GCCACGCTTC	GAAACACCGGTGTGGCTGAGGGTCCGGCAATGGTGTGGCTGTGGGGTTAG	1	bc
TTGAGGCGAA	GAAACACCGGTTAAGCCGATGTGCTTTTTTCCTGCAGGTTATGCTCAAGA	1	bc
AAGACTCTCG	GAAACACCGGTGCATTCGAAAGTCCGGTCGTAGTGTGGACGTGGGGTTAG	1	bc
TAGAGAGACA	GAAACACCGGTAGCAAGTGGGGTTAGAGCTAGAAATAGCAAGTTAACCTA	1	bc
GTGGAGTATA	GAAACACCGGTTCCCGTCCAGAGTGGTTAGAGCTAGAAATAGCAAGATAA	1	bc
AGTGAGCATA	GAAACACCGGTTAAGCCGAGGAGTTGGAGCTAGAAATAGCAAGTTAACCT	1	bc
GAGGCGACTC	GAAACACCGGTTCCCGTCCAGTGGGGTTAGAGCTAGAGATAGCGAGAGAA	1	bc
CGTTCCTCGC	GAAACACCGGTCGGGGCCACTCAGTGGGGTTAGAGCTAGAAATAGCAAGT	1	bc
ACGTCACTAC	GAAACACCGGTGCCCTTACTCTCACCTGATTACTTAATCCGGGGGGTTAG	1	bc
CGTCTGTGTA	GAAACACCGGTCCGTAGGAGACCCGTGTGGCATGTACCTTGTGGGGTTAG	1	bc
AAACGCTCTA	GAAACACCGGTGCCCTTACTCTCACCTGATTACTTAATCCGTGGGGTTAG	1	bc
GGAGAGAAGC	GAAACACCGGTCGGCGGCAAGAAATAGCAAGTTAACCTAAGGCTAGTCCG	1	bc
AGAACATCGA	GAAACACCGGTGCATTCGAAAGTCCGGTCGTAGTGTGGACGTGGGGTTAG	1	bc
TCTCGCGCGG	GAAACACCGGTTATATTTGTAAGTGTGCGGGGTTAGAGCTAGAAATAGCA	1	bc
AAGTGTTGTC	GAAACACCGGTGACATTGAGTGGGGTTAGAGCTAGAAATAGCAAGTTAAC	1	bc
AACATTAGGT	GAAACACCGGTCGATTCATATCGAAACCTTCCCGTGACAGTGGGGTTAGA	1	bc
ACGAGTTGCT	GAAACACCGGTGACATTGGGTGGGGTTAGAGCTAGAAATAGCAAGTTAAC	1	bc
AGATACCACC	GAAACACCGGTCCAAAATGTCGCCACGTGGGGTTAGAGCTAGAAATAGCA	1	bc
GAAGACGGTT	GAAACACCGGTCGGCGGCAATCGTGGGTGGGGTTAGAGCTAGAAATAGCA	1	bc
ACAGCGTAGT	GAAACACCGGTGTACGTATGGACTGAACCAGGGTGTGCAAGTGGGGTTAG	1	bc
CCCCTCACTT	GAAACACCGGTGGAAGGTTGTATGTTGCTAGTGGGGTTAGAGCTAGAAAT	1	bc
CTCATCGGTC	GAAACACCGGTACCTTTGTTGATGCTGGGAGGAAGGAATGTGGGGTTAGA	1	bc
AGACGGCCTG	GAAACACCGGTGGGGTTAGAGCTAGAAATAGCGAGTTAACCTAAGGCTAG	1	bc
GGGGAACGTC	GAAACACCGGTTCCCGTCCAGTGGGGTTAGAGCTAGAAATAGCAAGTTAA	1	bc
AAGATTCGGT	GAAACACCGGTCGATTCATATCGAAACCCTCCCGTGACAGTGGGGTTAGA	1	bc
TCTTAAGCGC	GAAACACCGGTCGGGACCACTCAGTGGCGGGGGGATAGTAAAAAAAACCA	1	bc
GCGTGTTGGC	GAAACACCGGTGACATTGGGTACAGGGTGGGGTTAGAGCTAGAAATAGCA	1	bc
TAAGAGGCGT	GAAACACCGGTCGGCGGCAATCGTGGGTGGGGTTAGAGCTAGAAATAGCA	1	bc
ATGAGAATAC	GAAACACCGGTTAAGCCGAGGGTTAGCGCTAGAAATAGCAAGTTAACCTA	1	bc
AAGAACGCTC	GAAACACCGGTTTGAACCGGTGGGGTTAGAGCTAGAAATAGCAAGTTAAC	1	bc
GAAGATCTCC	GAAACACCGGTCGGCGGCAATCGTGGGTGGGGTTAGAGCTAGAAATAGCA	1	bc
AACGACGTCT	GAAACACCGGTCGGCGGCAATCGTGGGTGGGGTTAGAGCTAGAAATAGCA	1	bc
CTCCACAGAC	GAAACACCGGAACCTTTGTTGATGCTGGGTGGAAGGTGGGTGGGGGTTAG	1	bc
AGAACCTGCA	GAAACACCGGTAAATTTGAGGCTCCGGCATGCAGGAGGCCGTGGGGTTAG	1	bc
ACGATTCCTT	GAAACACCGGTCTCGAGTGAGGTGTTCAGGGTGGGGTTAGAGCTAGAAAT	1	bc
GGGGACGTTC	GAAACACCGGTTCCCGTGCGGTGGGGTTAAAGCTGGAAATAGCAAGTTAA	1	bc
TTAAATAAGT	GAAACACCGGTTACATTGAGGGTTAGAGCTAGAAATAGCAAGTTAACCTA	1	bc
CGTAGCGTCT	GAAACACCGGTTACAGGGGGGGGTAGAGCTAGAAATAGTAAGTTAACCTA	1	bc
TAAGACAGCC	GAAACACCGGTGCCCTTACTCTCACCTGATTACTTAATCCGTGGGGTTAG	1	bc
ACGTGTTGTA	GAAACACCGGTGACATTGGGGTTAGAGCTAGAAATAGCAAGTTAACCTAA	1	bc
ACTTTAGCGT	GAAACACCGGTCGGGGCCACTCAGTGGTGGGGTTAGAGCTAGAAATAGCA	1	bc
AAGATCCTCG	GAAACACCGGTGCATTCGAAAGTCCGGTCGTAGTGTGGACGTGGGGTTAG	1	bc
ATGATTAGAG	GAAACACCGGTTTACGTTGCATCGGTTAGAGCTAGAAATAGCAAGTTAAC	1	bc
AGAAGCTAGG	GAAACACCGGTTATATTTGTAAGTGTGTGGGGTTAGAGCTAGAAATAGCC	1	bc
TGTGCTGCCT	TAGCCTTAGTCCGTTATCAACTTGAAAAAGTGGCACCGAGTCGGTGCTTT	1	bc
ATTAGATATG	GAAACACCGGTTACATTGAGGGGTTAGAGCTAGAAATAGCAAGTTAACCT	1	bc
TTGGCGCCTA	GAAACACCGGTTCCCGTCCAGTGGGGTTAGAGCTAGAAATAGCAAGTTAA	1	bc
TTGGTGGCTC	GAAACACCGGTTCCCGTCCAGTGGGGTTAGAGCTAGAAATAGCAAGATAA	1	bc
AAACAACGCC	GAAACACCGGTTAGAGCTAGAAATAGCAAGTTAACCTAAGGCTAGTCCGT	1	bc
AGTGGAGCAT	GAAACACCGGTTCCCGTCCAGTGGGGTTAGAGCTAGAAATAGCAAGTTAA	1	bc
GCACTTAGAC	GAAACACCGGTAACTATATTCATGCGATATCGCCGTATCAGTGGGGTTAG	1	bc
GGCACATAAA	GAAACACCGGTAAATTTGAGGCTCCGGCATGCAGGAGGCCGTGGGGTTAG	1	bc
AAAAAAGAAT	GAAACACCGGTTAGAGCTAGAAATAGCAAGTTAACCTAAGGCTAGTCCGT	1	bc
TCTAGCGCGA	GAAACACCGGTTATATTTGTAAGTGTGTGGGGTTAGAGCTAGAAATAGCA	1	bc
GTTGTACCGC	GAAACACCGGTTCCCGTCCAGTGGGGGTAGGGCTAGAAATAGCAAGTTAA	1	bc
TTGTGCATCC	GAAACACTGGTTAAGCCGAGTGGGGTTAGAGCTAGAATTAGCAAGTTAAC	1	bc
AGAAACCGAC	GAAACACCGGTAGCAAGTGCGAGCTAGAAATAGCAAGTTAACCTAAGGAT	1	bc
CACCCCGACA	GAAACACCGGTAGCAAGTGGGGTTAGAGCTAGAAATAGCAAGTTAACCTA	1	bc
GAGTAGCTAT	GAAACACCGGTTACATTGAGGGTTAGAGCTAGAAATAGCAAGTTAACCTA	1	bc
AGGTGTTGTC	GAAACACCGGTGGGGATAGAGCTAGAAATAGCAAGTTAACCTAAGGCTAG	1	bc
GGTAATCCTT	GAAACACCGGTCTCGAGTGAGGTGTTCAGGGTGGGGGTAGAGCTAGAAAT	1	bc
AACACATAAA	GAAACACCGGTAGCAATTGCGAAATAGCAAGTTAACCTAAGGCTATTCCG	1	bc
AGAAGGCTCG	GAAACACCGGTCGGCGGCAATCGTGCTTTTTTTGGTTTAGGGCGGGTATT	1	bc
ACGCATGAGG	GAAACACCGGTTATATTTGTAAGGGGTTAGAGCTAGAAATAGCAAGTTAA	1	bc
GCCCAACGCC	GAAACACCGGTTTGAACTAGAAATAGCAAGTTAACCTAAGGCTAGTCCGT	1	bc
GCTACCCTCA	GAAACACCGGTGTGGCTGAGAGTCCGGCAATGGTGTGGCTGTGGGGTTAG	1	bc
AGGAGCCAAG	GAAACACCGGTAAATTTGAGGCTCCGGCATGCAGGAGGCCGTGGGGTTAG	1	bc
AAACAACGCA	GAAACACCGGTTTGAACTAGAAATAGCAAGTTAACCTAAGGCTAGTCCGT	1	bc
AAATGCTTAT	GAAACACCGGTTTACGTTGCATCGGTGTGGGGTTAGAGCTAGAAATAGCA	1	bc
TCGATCGGCT	GAAACACCGGTTATATTTGTAAGGGTGTGGGGTTAGAGCTAGAAATAGCA	1	bc
AGTCAGACTA	GAAACACCGGTCCGTAGGAGACCCGTGTGGCGAGCTAGAAATAGCAAGTT	1	bc
AGAAACAGAC	GAAACACCGGTAGCAAGTGGGGTTAGAGCTAGAAATAACAAGTTAACCTA	1	bc
AAGCCCTGGG	GAAACACCGGTGCATTCGAAAGTCCGGTCGTAATGTGGACGTGGGGTTAG	1	bc
AGATTGAGTC	GAAACACCGGTCCGTTCATTTCGAAACCTTCCCGTGACAAGTGGGGTTAG	1	bc
ACAACTCGGC	GAAACACCGGTACCTTTGTTGATGCTGGGTGGAAGGAATTTGGAGCTAGA	1	bc
GTGAGCATGC	GAAACACCGGTTAAGCCGAGGGTTAGAGTTAGAAATAGCAAGTTAACCTA	1	bc
TACTCTCTAC	GAAACACCGGTAACTTTGTTCCAGCGATATCGCCGTATCAGTGGAGTTAG	1	bc
CATCTCCGTT	GAAACACCGGTGTACGTATGGACTGAACCAGGGTGTGCAAGTGGGGTTAG	1	bc
AAATGGTCGT	GAAACACCGGTGTACGTATGGACTGAACCAGGGTGTGCAAGTGGGGTTAG	1	bc
GTCATTTACT	GAAACACCGGTGACTTTCGGAACAGGGGCGGGGGGAGAACTGGAAGTAGT	1	bc
AAGATAATAC	GAAACACCGGTTAAGCCGAGTGGGGTTAGAGCTAGAAATAGCAAGTTAAC	1	bc
CAGACACGTC	GAAACACCGGTGTACGCATGGACTGAACCGGGGTGTGCCTAGGGAGATAG	1	bc
GAGTCGCGCG	GAAACACCGGTGCATTCGAAAGTCCGGTCGTAGTGTGGACGTGGGGTTAG	1	bc
TATGCTTGGG	GAAACACCGGTTTTATTTGCAAGGGTGTGGGGTTAGAGCTAGAAATAGCA	1	bc
AAGTATGCCT	GAAACACCGGTCCGTAGGAGACCCGTGTGGCATGTACCTGTGGGGTTAGA	1	bc
ACGCATCCTT	GAAACACCGGTCTCGAGTGAGGTGTTCAGGTGGGGTTAGAGCTAGAAATA	1	bc
AAGAATGACC	GAAACACGGGTTAGAGCTAGAAATAGCAAGTTAACCTAATGCTAGTCCGT	1	bc
GGTAGGCCTC	GAAACACCGGTCCGTAGGAGACCCGTGTGGCATGTACCTGTGGGGTTAGA	1	bc
AACGTATTGC	GAAACACCGGTTCCCTTACTCTCACCTGATTACTTAATCCGGGGGGATAG	1	bc
CTGGACATAA	GAAACACCGGTTAAGCCGAGTGGGGTTAGAGCTAGAAATAGCAAGTTAAC	1	bc
AGGGCGGCTT	GAAACACCGGTGTCATTGGGTAAGTTAGAGCTAGAAATAGCAAGTTAAAT	1	bc
AGAGAGAGAC	GAAACACCGGTAGCAAGTTAACCTAAGGCTAGTCCGTTATCAACTTGAAA	1	bc
AAAACACTCT	GAAACACCGGTTTGAACTACCGGGGTTAGAGCTAGAAATAGCAAGTTAAC	1	bc
AGACACTGAC	GAAACACCGGTTGCAAGAGCGCAACGTGTTTGTGGGGTTAGAGCTAGTAA	1	bc
TCAGCTAAGG	GAAACACCGGCTACATTGAGGGTTGGAGCTAGAAATAGCAAGTTAACCTA	1	bc
TCGATCGCGT	GAAACACCGGTTATATTTGTAAGTGTGCTAGAAATAGCAAGTTAACCTAA	1	bc
GAAAAAGCTT	GAAACACCGGTAGCAAGTGCGAGACGTGTTTGTGGGGTTAGAGCTAGAAA	1	bc
CAAACAGCCT	GAAACACCGGTTTGAACTACCGGGGTTAGAGCTAGAAATAGCAAGCTAAC	1	bc
AATTAACATC	GAAACACCGGTCGGGGCCACGGGCTACAGCTAGAGATTGCAAGTTGAAAT	1	bc
TCGCCCTACA	GAAACACCGGTAAATTTGAGGCTCCGGCATGCAGGAGGCCGTGGGGTTAG	1	bc
AGGACACAGA	GAAACACCGGTAGCGAGTGGGGTTAGAGCTAGAAATAGCAAGTTAACCTA	1	bc
GAGTCGGCCA	GAAACACCGGTCCGTAGGAGACCCGTGTGGCATGTACCTGTGGGGTTAGA	1	bc
AATGGTCGAC	GAAACACCGGTGTACGTATGGACTGAACCAGGGTGTGCAAGTGGGGTTAG	1	bc
ATGGCTAGGT	GAAACACCGGTTACTAGTGCTAGGAATAGCAAGTTGACCTAGAGCTAGTC	1	bc
GAGACCCACG	GAAACACCGGTGCATTCGAAAGTCCGGTCGTAGTGTGGACGTGGGTTAGA	1	bc
GCGGATCCGC	GAAACACCGGTCGGCGGCAATCGTGGGTGGGGTTAGAGCTAGAAATAGCA	1	bc
AGTGGACACT	GAAACACCGGTTCCCGTCCAGTGGGGGTAAAGCTAGAAATAGCAGGATAA	1	bc
AATCTTGCAC	GAAACACCGGTTATATTTGTCAGTGTGTGGGGTTAGAGCTAGAAATAGCA	1	bc
TCAAGCGTGG	GAAACACCGGTTATATTTGTAAGTGTGTGGGGTTAGAGCTAGAAATAGCA	1	bc
AAAGAACGGC	GAAACACCGGTCGGCGGCAATCGTGGAGGGGGTTAGCGCTAGAAATAGCA	1	bc
AGACCAGAGC	GAAACACCGGTGCATTCGAAAGTCCGGTCGTAGTGTGGACGTGGGGTTAG	1	bc
GGAGTCCTCC	GAAACACCGGTGTGGCTGAGAGTCCGGCAATGGTGTGGCTGTGGGGTTAG	1	bc
ATCCACAATT	GAAACACCGGTTACCGTACTTTGAGCGGATTACTAAATCCGGAGATATAG	1	bc
GAGGAGTCGA	GAAACACCGGTTCCCGTCCAGTGGGGTTAGAGCTAGAAATAGCAAGTTAA	1	bc
AAGTGCGACG	GAAACACCGGTACAACCGTCTCACTTGGTCGTGGGGTTAGAGCTAGAAAT	1	bc
TAACGCTCTA	GAAACACCGGTGCCCTTACTCTCACCTGATTACTTAATCCGTGGGGTTAG	1	bc
ACAAAACGCG	AAAGTGGGGTTAGAGCTAGAAATAGCAAGTTAACCTAAGGCTAGTCCGTT	1	bc
CGACGTCGTT	GAAACACCGGTGTACGTATGGACTGAACCAGGGTGTGCAAGTGGGGTTAG	1	bc
AAAAGCCCTA	GAAACACCGGTGCCCTTACTCTCACCTGATTACTTAATCCGTGGGGTTAG	1	bc
ACGGATCATT	GAAACACCGGTCTCGAGTGAGGTGTTCAAGGTGGGGTTAGAGCTAGAAAT	1	bc
TCTATGGCTG	GAAACACCGGTTCTATTTGTACGAGAGCTAGAAATAGCAAGTTAACCTAA	1	bc
GTCACAGGCC	GAAACACCGGTAGCAAGTGCGAAATAGCAAGTTAACCTAAGGCTAGTCCG	1	bc
TGGAGATACA	GAAACACCGGTGAATTTGAGGCTCCGGCATGCAGGAGGCCGTGGGGTTAG	1	bc
AGCCTCGCGC	GAAACACCGGTGCATTCGAAAGTCCGGTCGTAGTGTGGACGTGGGGTTAG	1	bc
ACGTGTTGTA	GAAACACCGGTGACATTGGGTTAGAAATAGCAAGTTAACCTAAGGCTAGT	1	bc
GAGAACGAGT	GAAACACCGGTCGGCGGAGAAATAGCAAGTTAACCTAAGGCTAGGCCGAT	1	bc
ACATACAGTA	GAAACACCGGTCGAATCATATTGAAACCTTCCCGTGACAGTGGGATTAGA	1	bc
ATCTACCGAG	GAAACACCGGTGGGGTTAGAGCTAGAAATAGCAAGTTAACCTAAGGCTAG	1	bc
CAAACCGCCA	GAAACACCGGTTTGAGCTACCTAGTTCAAACCGGTGGGGTTAGAGCTAGA	1	bc
ACACGCGGCT	GAAACACCGGTCGATTCATATCGACACCTTCCCGTGACCGTGGGGTTAGA	1	bc
AACGGTGTAC	GAAACACCGGTGTGGCTGAGAGTCCGGCAATGGTGTGGTTGTGGGGTTAG	1	bc
TATGACGAGG	GAAACACCGGTTATATTTGTAAGTGTGTGGGGTTAGAGCTAGAAATAGCA	1	bc
CCTTTAGGGA	GAAACACCGGTCGGGAGCTAGAAATAGCAAGTTAACCTAAGGCTAGTCCG	1	bc
GAATGGCGTA	GAAACACCGGTGCCCTTACTCTCACCTGATTACTTAATCCGTGGGGTTAG	1	bc
AACGAACTAA	GAAACACCGGTGCCCTTACTCTCACCTGATTACTTAATCCGTGGGGTTAG	1	bc
CTCTAGACTC	GAAACACCGGTCCGTAGGAGACCCGTGTGGGATGTAAGTGTGAGGTTACA	1	bc
TAGAACCTCG	GAAACACCGGTGCATTCGAAAGTCCGGTCGTAGTGTGGACGTGGGGTTAG	1	bc
ATTGGCTATG	GAAACACCGGTTACATTGAGGGTTAGAGCTAGAAATAGCAAGTTAACCTA	1	bc
CTCACTTGCA	GAAACACCGGTGTGGCTGAGAGTCCGGCAATGGTGTGGCTGTGGGGTTAG	1	bc
GACATACGGT	GAAACACCGGTCGATTCATATCGAAACCTTCCCGTGACAGTGGGGTTAGA	1	bc
AGGATCGGGC	GAAACACCGGTAACACTTGTTAGTGCGTGGGCGTATAGCTAGTAATAGCA	1	bc
GATACAAGGC	GAAACACCGGTACCTTTGTTGATGCTGGGTGGAAGGAATTTGTGGGGTTA	1	bc
AGTTTTAGCT	GAAACACCGGTTTACGTTGCATAGGTGTGGGGGTAGGGCTAGGAATAGAA	1	bc
AATCAATCGA	GAAACACCGGTGGGGTTAGAGCTAGAAATAGCAAGTTAACCTAAGGCTAG	1	bc
ATATGCGGTA	GAAACACCGGTCAATTCGTATCGTAACCTTGCCGAGACAGAGAGGTTACA	1	bc
AGTTTGCATG	GAATCACCGGTCCGTAGGAGTCCCGAGTGGCATTAACCTGAGGGGCTACA	1	bc
TTCCGCAGAA	GAAACACCGGTTAAGCCGAGTTTAGAGCTAGAAATAGCAAGTTAACCTAA	1	bc
ATGGAGCATA	GAAACACCGGTTAAGCCGAGTGGGGTTAGAGCTAGAAATAGCAAGTTAAC	1	bc
AATGCTTCGC	GAAACACCGGTTTACGTTGCATCGGTGTGGGGTTAGAGCTAGAAATAGCA	1	bc
AACAACGGTC	GAAACACCGGTTTAGAGATAGAAATAACCAGTTAACCTAAGGCTAGTCAG	1	bc
AGTGTAGCCT	GAAACACCGGTTCCCGTCCAGTGGGGTTAGAGCTAGAAATAGCAAGTTAA	1	bc
CAACATGGCC	GAAACACCGGTACCTTTGTTGATGCTGGTGGGGCTAGAGCTAGAAATAGC	1	bc
GCATCACCGC	GAAACACCGGTCGGCGGAGAAATAGCACGTTAACCTAAGGCTCGTCCGTT	1	bc
CAGGTTCTCC	GAAACACCGGTCAGAGACAGTCGTTAGAGCTAGAAATAGCAAGTTAACCT	1	bc
AAGTCTGCAT	GAAACACCGGTCCGTAGGAGACCCGTGTGGCATGTACCTGTGGGGTTAGA	1	bc
AGACTCTTTT	GAAACACCGGTGCATTCGAAAGTCCGGTCGTAGTGTGGACGTGGGGTTAG	1	bc
AGAGGTGTCT	GAAACACCGGTGACAGGTGGGGTTAGAGCTAGAAATAGCAAGTTAACCTA	1	bc
ATCTATAGAG	GAAACACCGGTTATATTTGTAAGTGTGTGGGGTTAGAGCTAGAAATAGCA	1	bc
AACTCCTAAA	GAAACACCGGTGCCCTTACTCTCACCTGATTACTTAATCCGTGGGGTTAG	1	bc
GCAGCTATGC	GAAACACCGGTTACATTGAGGGTTAGAGCTAGAAATAGCAAGTTAACCTA	1	bc
ACGTGGTGTC	GAAACACCGGTGACATTGGGTAGAGCTAGAAATAGCAAGTTAACCTAAGG	1	bc
GTCCCTATGT	GAAACACCGGTTACCTTGAGTGGGGTTAGAGCTAGAAATAGCCAGTTAAC	1	bc
GCCTCCTTGA	GAAACACCGGTTCTCGCACATGTGGGGTTAGAGCTAGAAATAGAATGTTA	1	bc
GGAAAGCCCG	GAAACACCGGTCAGCGGCCATCGTGGGTGGGGTTAGAGCTAGAAATAGCA	1	bc
AAAGCCTTGC	GAAACACCGGTGCCCTTACTCTCACCTGATTACTTAATCCGTGGGGTTAG	1	bc
ACGGGTTGTC	GAAACACCGGTGACATTGGGTAGTGGGGTTAGAGCTAGAAATAGCAAGTT	1	bc
GCACGCCGTA	GAAACACCGGTGCCCTTACTCTCACCTGATTACTTAATCCGTGGGGTTAG	1	bc
ATGGAGCATA	GAAACACCGGTTAAGCCGAGGAGTTAGAGCTAGAAATAGCAAGTTAACCT	1	bc
AGTATCGTGG	GAAACACCGGTTATATTTGTAAGTGTGTGGGGTTAGAGCTAGAAATAGCA	1	bc
ACTGTCTGAC	GAAACAGCGGTGCCCTTACTCTCACCTGATTACTTAATCCGTGGGGTTAG	1	bc
TCAATTGTGC	GAAACACCGGTAATCAGAGGTGAACGTAAGGCGGGGTTAGAGCTAGAAAT	1	bc
ACTCTTGAGT	GAAACACCGGTTATATTTGTAAGTGTGTGGGGTTAGAGCTAGAAATAGCA	1	bc
AGCGCCGTCC	GAAACACCGGTGCCCTTACTCTCACCTGATTACTTAATCCGTGGGGTTAG	1	bc
ACACACTGTA	GAAACACCGGTGTACGTATGGACTGAATCAGGGAGTGCAAGTGGGGTTAG	1	bc
GGCCTCCATA	GAAACACCGGTCCATTTGAGACTCCTGCACCCTGTACGCCGTGGGGTTAG	1	bc
AAGTTTACCG	GAAACACCGGTCGGGGCCACTCAGTGGTGGGGTTAGAGCTAGAAATAGCA	1	bc
AGTGGATCCT	GAAACACCGGTTCCCGTCCAGTGGGGTTAGAGCTAGAAATAGCAAGTTAA	1	bc
GGACAGAGAC	GAAACACCGGTAGCAAGTGCGAGCTAGAAATAGCAAGTTAACCTAAGGCT	1	bc
AATGCTTGGT	GAAACACCGGTTTACGTTGCATCGGTTGTGGGGTTAGAGCTAGAAATAGC	1	bc
CACGACGTAC	GAAACACCGGTGCCCTTACTCTCACCTGATTACTTAATCCGTGGGGTTAG	1	bc
CACACCCACC	GAAACACCGGTAGCAAGTGGGGTTAGAGCTAGAAATAGCAAGTTAACCTA	1	bc
ACAACTTATA	GAAACACCGGTAACTATATTCATGCGATATCGCCGTATCAGTGGGGTTAG	1	bc
AAGAATCCTT	GAAACACCGGTCTCGAGTGAGGTGTTCGGGGTGGGGTTAGAGCTAGAAAT	1	bc
AATGCTAAGC	GAAACACCGGTTTACGTTGCATCGGTGTGGGGTTAGAGCTAGAAATAGCA	1	bc
ACCGCACTAA	GAAACACCGGTGCCCTTACTCTCACCTGATTACTTAATCCGTGGGGTTAG	1	bc
CGTATACCTT	GAAGCACCGGTCTCGAGTGAGGTGTTCAGGGGTGGGGTTAGAGCTAGAAA	1	bc
TAGAACGACC	GAAACACCGGTTTGAACTACCGGGGTTAGAGCTAGAAATAGCAAGTTAAC	1	bc
TAATTTAGGC	GAAACACCGGTAACTATATTCATGCGATATCGCCGTATCAGTGGGGTTAG	1	bc
GAATTTCTTT	GAAACACCGGTCTCGAGTAAGTTGTTCAGGGGGGGTTAGAGCTAGGATTG	1	bc
ATACACCGGC	GAAACACCGGTAAATTTGAGGCTCCGGCATGCAGGAGGCCGTGGGGTTAG	1	bc
AGGCAACCGG	GAAACACCGGTGTGGCTGAGAGTCCGGCAATGGGGTGGCTGTGGGGGTAG	1	bc
GTTTAGCGTC	GAAACACCGGTTCCCGTCCAGTGGGGTTAGAGCTAGGAATAGCAAGTTAA	1	bc
GAGGAACTTC	GAAACACCGGTTCCCGTCCAGTGGGGTTAGAGCTAGAAATAGCAAGTTAA	1	bc
GCCCTCACGC	GAAACACCGGTGGAAGGTTGTATGTTGCTAGTGGGGATAGAGCTAGAAAT	1	bc
ATCGATCTAC	GAAACACCGGTGCCCTTACTCTCACCTGATTACTTAATCCGTGGGGTTAG	1	bc
ATATATAGAG	GAAACACCGGTTATATTTGTAAGTGTGTGGGGTTAGAGCTAGAAATAGCA	1	bc
GACGGTTTCT	GAAACACCGGTGGGTAGAGCGAAATATAGCATGTGAATAGAGGTAGAGAC	1	bc
ACTATGCTGG	GAAACACCGGTCCGTAGATAACTCGGGTCTCGTGTGCGTGTGTGGTGAGA	1	bc
AAAATTCGGT	GAAACACCGGTCGATTCATATCGAAACCTTCCCGTGACAGTGGGGTTAGA	1	bc
TGGTCGGAGT	GAAACACCGGTGTACGTATGGACTGAACCAGGGTGTGCAAGTGGGGTTAG	1	bc
TCTTTTACGC	GAAACACCGGTCGGGGCCACTCAGTGGTGGGGTTAGAGCTAGAAATAGCA	1	bc
GTGATCATCT	GAAACACCGGTTTACGTTGCATCGGTGTGGGGTTAGAGCTAGAAATAGCC	1	bc
AAGAGACTCG	GAAACACCGGTGCATTCGAAAGTCCGGTCGTAGTGTGGACGTGGGGTTAG	1	bc
GGTAAACTCC	GAAACACCGGTGTGGCTGAGAGTCCAGCAATGGTGTGGCTGTGGGGTTAG	1	bc
GTAGCCCAGC	GAAACACCGGTCGGCGGCAATCGTGGGTGGGGTTAGAGCTAGAAATAGCA	1	bc
TATGATTAGC	GAAACACCGGTTTACGTTGCATCGGTTGTGGGGTTAGAGCTAGAAATAGC	1	bc
ATAACTTCTA	GAAACACCGGTAACTATATTCATGCGATATCGCCGTATCAGTGGGGTTAG	1	bc
ATTAGCTCTG	GAAACACCGGTTACATTGAGGGGTTAGAGCTAGAAATAGCAAGTTAACCT	1	bc
TAGAAAGCAT	GAAACACCGGTTTGAACTACCTAGTTCAAACCGGTGGGGTTAGAGCTAGA	1	bc
GGCAAGCCTC	GAAACACCGGTCCGTAGGAGACCCGTGTGGCATGTAACTGTGGGGGTTGA	1	bc
TGAAGGCCCT	GAAACACCGGTCGGCGGCAATCGTGGGTGGGGTTAGAGCTAGAAATAGCA	1	bc
ACTTGTGGTC	GAAACACCGGTTTACGTTGCATCGGTTGTGGGGTTAGAGCTAGAAATAGC	1	bc
TAAATTGATA	GAAACACCGGTAACTAGATTCTAGCGATATCGCCGGATCGGTAGGGTAAG	1	bc
AATTAGCTAT	GAAACACCGGTTACATTGAGGGTTAGAGCTAGAAATAGCAAGTTAACCTA	1	bc
AACATTAGAT	GAAACACCGGTCGATTCATATCGAAACCTTCCCGTGACAGTGGGGTTAGA	1	bc
CATCTAACGC	GAAACACCGGTCGGGGCCACTCAGTGGTGGGGTTAGAGCTAGAAATAGCA	1	bc
AAGAATCCTT	GAAACACCGGTCTCGAGTGAGGCGTTCAGGGTGGGGTTAGAGCTAGAAAT	1	bc
TTTAGGATCA	GAAACACCGGTTAAGCGGTGGTTAGAGCTATAAATAGATAGTTAACCTAG	1	bc
CTGCGGATAA	GAAACACCGGTTAAGCCGATGTGCTTTTTTCCTGCAGGTTATGCTCATGA	1	bc
AGCGGTGTCT	GAAACACCGGTGAACAGGGGTTAGAGCTAGAAATAGCAAGTTAACCTAAG	1	bc
ACAAGAGGTT	GAAACACCGGTCGATTCATATCGAAGCCTTCCCGTGACAGTGGGGTTAGA	1	bc
TTGGGCCCTG	GAAACACAGGTTAAGCCGAGGAGTTAGAGCTAGAAATAGCACGTTAACCT	1	bc
ACTGTCGAAG	GAAACACCGGTGATCTTTGTAAGAGCGGGGGACTAGAGCTGTAGGGATCA	1	bc
GCCTCCGACT	GAAACACCGGTACAACCGTCTCACTTGGTCGTGGGGTTAGAGCTAGAAAT	1	bc
GCACTCGACT	GAAACACCGGTCAATTTGAGGCTCCGGCATGCAGGAGGCCGTGGGGATAG	1	bc
AATACTCGGC	GTGGCACCGAGTCGGTGCTTTTTTCCCTGCAGGGGCCGAGTAGGAATTCG	1	bc
ACTACTCGGT	GAAACACCGGTACCTTTGTTGATGCTGGGTGGAAGGGATTTTGTGGGGTT	1	bc
ACTCTTGGAC	GAAACACCGGTACCTTTGTTGATGCTGGGTAGAAGGAATTTTGTGGGGTT	1	bc
CGGACCTTTT	GAAACACCGGTCTCGAGTGAGGTGTTCAGGGTGGGGTTAGAGTTAGAAAT	1	bc
AACGACGAAC	GAAACACCGGTAACTATATTCATTCGATATCGCCGTAGCTAGAGGGGTTA	1	bc
AACAAAGCAC	GAAACACCGGTTTGAACTAGAAATAGCAAGTTAACCTAAGGCTAGTCCGT	1	bc
GGCTCACTCA	GAAACACCGGTGTGGCTGAGAGTCCGGCTATGGGGTGGCTGGCGGGTTAG	1	bc
AGAAGACACG	GAAACACCGGTCGGCGGCAATGTGGGGTTAGAGCTAGAAATAGCAAGTTA	1	bc
AGGAACTCGC	GAAACACCGGTGCATTCGAAAGTCCGGTCGTAGTGTGGACGTGGGGTTAG	1	bc
ACCACCGCCC	GAAACACCGGTTTGAAAATAGCAAGTTAACCTAAGGCTAGTCCGTTATCA	1	bc
CCTTACAGCC	GAAACACCGGTCGGGGCCACTCAGTGGTGGGGTTAGAGCTAGAAATAGCA	1	bc
AAACTCCTAC	GAAACACCGGTACCCTTACTCTCACCTGATTACTTAATCCGTGGGGTTAG	1	bc
CGTAGTGCCT	GAAACGCAAGTTAACCTAAGGCTAGTCCGTTATCAACTTGAAAAGGTGGC	1	bc
ACACTCGCGC	GAAACACCGGTGCATTCGATAGCCCGGTGGTAGTGTGGCCGTGGGGTTAA	1	bc
TATATCACCA	GAAACACCGGTTCTATTTGTCGCCGCGTGGGGGGATAGCGAGAGATAGCG	1	bc
GCGACTCGGC	GAAACACCGGTACCTTTGTTGATGCTGGGTGGAAGGAATTTGGTGGGGTT	1	bc
GAGGCGCGTC	GAAACACCGGTTCCCGTCCAGTGGGGTTAGAGCTAGAAATAGCAAGTTAA	1	bc
AGTGGAGACT	GAAACACCGGTTCCCGTCCAGTGGGGTTAGAGCTAGAAATAGCAAGTTAA	1	bc
AGGCCCGGGA	GAAACACCGGTGCATTCGAAAGTCCGGTCGTGGTGTGGACGTGGGGTTAG	1	bc
CACCTCGGCT	GAAACACCGGTACCCTTGTTGATGCTGGGGGGATGGAAGGTGGGGTTAGA	1	bc
AAGGGTTGTC	TAGCCTTAGTCCGTTATCAACTTGAAAAAGTGGCACCGAGTCGGTGCTTT	1	bc
GAGCATCCCC	GAAACACCGGTCGGCGGCAATCGGTCGCCGACCGTCGGTGAGGTTAGAGC	1	bc
ATCAGTTCCG	GAAACACCGTCGAGGCCACTCATTGGGGTTAGAGCTAGAAATTGCACTTT	1	bc
CGGCACGCCC	GAAACACCGGTTTGAACTAGAAATAGCAAGTTAACCTAAGGCTAGTCCGT	1	bc
ACTACTCAGC	GAAACACCGGTACCTTTGTCGATGCTGGGTGGAAGGAATGGGGTTAGAGC	1	bc
ACTACTCAGC	GAAACACCGGTACCTTTGTTGATGCTGGGTGGAAGGAATGGGGTTAGAGC	1	bc
CAACTAGACC	GAAACACCGGTAGCAAGTGTGAGACGTGTTCAATAGCAAGTTAACCTAAG	1	bc
ACCAACGCCA	GAAACACGGGTTAGAGCTAGAAATAGCAAGTTAACCTAAGGCTAGTCCGT	1	bc
GAGGCGACTA	GAAACACCGGTTCCCGTCCAGTGGGGTTAGAGCTAGAAATAGCAAGTTAA	1	bc
AAATAGGGTT	GAAACACCGGTCGATTCATATCGAAACCTTCCCGTGACAGTGGGGATAGA	1	bc
TGTGTTGGCC	GAAACACCGGTGACATTGGGTGGGGTTAGAGCTAGAAATAGCAAGTTAAC	1	bc
CGTAGTCTTT	GAAACACCGGTCTCGAGAGAGGTTTTCAGGGTGGGGTTAGAGCTAGAAAT	1	bc
AATACTCGGC	GAAACACCGGTACCTCTGTTGATGCTGGGTGGGGTTAGAGCTAGAAATAG	1	bc
AACTTAGGTT	GAAACACCGGTTCCGTTATCAACTTGAAAAAGTGGCACCGAGTCGGTGCT	1	bc
GATATCGCGG	GAAACACCGGTTATATTTGTAAGTGTGTGGGGTTAGAGCTAGAAATAGCA	1	bc
GGGCACACTC	GAAACACCGGTGTGGCTGAGAGTCCGGCAATGGTGTGGCTGTGGGGTTAG	1	bc
AAACTCCCTA	GAAACACCGGTGCCCTTACTCTCACCTGATTACTTAATCCGTGGGGTTAG	1	bc
CGCATCGTTC	GAAACACCGGTCTCGAGTGAGGAGCTCAGGGTGGGGTTAGAGCTAGAAAT	1	bc
CAGCTGACAC	GAAACACCGGTCGGCGGCAATGGGGTTAGAGCTAGAAATAGCAAGTTAAC	1	bc
GGGACTGCCA	GAAACACCGGTAACAAGGGGGGTTAGAGCTGGAAATAGCAAGTTAACCTA	1	bc
