CGAACACCTC	GAAACACCGGTCTCGAGTGAGGTGTTCAGAATTCAGAGTGAGGTGTTCGG	4	bc
AAACAGACAC	GAAACACCGGTAGCAAGTGCGAGACGGGGTGAGAGTGGGGCTAGAGCTAG	1	bc
GATCGTGGGC	GAAACACCGGTGTACGTATGGACTGAACCAGGGTGTGCAAGTGGGGTTAG	1	bc
GTGACGCCTA	GAAACACCGGTTCCCGTCCAGAGGGGTTATAGCTAGAAATAGCAAGTTAA	1	bc
CACACATCCA	GAAACACCGGTAGCATGTGCGGGGTTGGGGCTGGAAATAGCAAGTTAACC	1	bc
GGCTGCCTGC	GAAACACCGGTGAGACTGGGTGTCCGGCGGTGGTGGGGCTAGGAAGATAA	1	bc
CGAGCTGTCC	GAAACACCGGTGACATTCGTTACAAAGAGCTAGTAGTAGCAAGTTAACCT	1	bc
CGAACACCTC	GAAACACCGGTATCGCGTGAGGTGTTCAGAATTCAGAGTGAGGTGTTCGG	1	bc
CTTCTCCTCC	GAAACACCGGTGTACGTATGGACTGAACCAGGGTGTGCAAGTGGGGTTAG	1	bc
CGTGCTTCCT	GAAACACCGGTGGCAAAATTGGGGGTAGAGCTAGAAATAGCAAGTGAAAC	1	bc
CACCGCCGAC	GAAACACCGGTGTACGTATGGACTGCTTCGACGTGTGCACGTGGGGTTAG	1	bc
CTAAGTGGTA	GAAACACCGGTACCTTAGAGCTAGAAATAGCAAGTTAACCTAATGCTAGT	1	bc
GGGGATGCTC	GAAACACCGGTTCCCGTCCAGTGGGGTTATAGATAGAGATAGCACGTTAA	1	bc
GTGTTTTTTC	GAAACACCGGTGACATTGGGTACAGGGTGGGGTTAGAGCTAGAAATAGCA	1	bc
TGAAGACTCG	GAAACACCGGTCGGCGGTGGGGTTAGAGCTAGAAATAGCAAGTTAACCTA	1	bc
CACCAAGTTC	GAAACACCGGTTTGAACTACGAATAGCATAATACCATAAGGCTAGTACAT	1	bc
CCCCTCACTT	GAAACACCGGTGGAAGGTTGTATGTTGCTAGTGGGGTTAGAGCTAGAAAT	1	bc
GCACGGCCTA	GAAACACCGGTGCCCTTACTCTCACCTGATTACTTAATCCGTGGGGTTAG	1	bc
ATGCTAGCCC	GAAACACCGGTTTACGTTGCGGGGTTAGAGCTAGAAATAGCAAGTTAACC	1	bc
AGGTGCCTAA	GAAACACCGGTAACTATATTCATGCGATATCGTCGTATCAGTGGGGTTAG	1	bc
GTGTATTGAG	GAAACACCGGTTATATTTGTAAGTGTGTGGGGTTAGAGCTAGAAATAGCA	1	bc
ATCTTCGTCC	GAAACACCGGTGTACGTATGGACTGAACCAGGGTGTGCAAGTGGGGTTAG	1	bc
CGCCACGCTC	GAAACACCGGTTTGCACTACCGTGGTGGTAGAGCTTGATATAGCAAGTAA	1	bc
ACTCCATGTT	GAAACACCGGTATGAGAATCGGTAGTCATGGTGGGGTTAGAGCTAGAAAT	1	bc
ATGGCGCCTA	GAAACACCGGTGTCTCGTTGGTACGTTCTGGTGGGGTTAGAGCTAGAAAT	1	bc
CGCGCTGCCT	GAAACACCGGTTACATTGCTAGAAATAGCAAGTTGACCTAAGGCTAGTCC	1	bc
GTCACTAACC	GAAACACCGGTAACTTTCAGAGGTAGAGCTAGGAATAGAAAGCTAACATT	1	bc
AACGTCGTCC	GAAACACCGGTGTACGTATGGACTGAACCAGGGTGTGCAAGTGGGGTTAG	1	bc
ATGGCGCCTA	GAAACACCGGTGTCTCGTTGGTACGTCCTGGTGGGGTTAGAGCTAGAAAT	1	bc
TAACTGCTCT	GAAACACCGGTTAATGGGACCGCAGGTACTTGACTGGGATGTGGGGCTAG	1	bc
CGTCTGCATG	GAAACACCGGTCCGTAGGAGACACGAGTGGCATGTACCTGTGGGGTTAGA	1	bc
GGCGCCCGAC	GAAACACCGGTTCCCTTACTCTCACCTGATTACTTGATCCGTGGGGTTAG	1	bc
TAACTGCTCT	GAAACACCGGTGTGGCTGAGAGTCCGGCAATGGTGTGGCTGTGGGGTTAG	1	bc
CACTTTGACT	GAAACACCGGTGACAGGGGAGGTTAAGTCTAGAAATAGCAAGTTAACCTA	1	bc
CTGGGGCCCC	GAAACACCGGTTCCCGTCCAGTGGGGTTAGAGCTAGAAATAGCAAGTTAA	1	bc
GAACCCAAGT	GAAACACCGGTTAATTCGAAAGTCCGGTCGTAGTAGAGCTAGGGAGATCG	1	bc
AACGCTCGCT	GAAACACCGGTTTACGTTGCATCGGTGTGGTGTTAGAGCTAGAAATAGCA	1	bc
AATGCCATTC	GAAACACCGGTGACATTACCCTCACCTGATTACTTAATCCGGGGGGAGAG	1	bc
CAGAGTCTTA	GAAACACCGGTGGACGGATGGACTGAACCAGGGTAGGCAAGGGAGGATCG	1	bc
CCAAACCCCC	GAAACACCGGTTTGAACTAGAAATAGCAAGTTAACCTAAGGCTAGTCCGT	1	bc
CTGCTAAGGT	GAAACACCGGTTTACGTTGCATCGAGCTAGGAATAGCAAGATAACCTGAG	1	bc
CTTCGTGGAC	GAAACACCGGTGTACGCATGGACTGAACCAGGGTGTGCAAGTGGGGTTAG	1	bc
TAAAACCATC	GAAACACCGGTCGTCAGGAATCGTGGGTGGGGCTCCAGCCGGCGACACCG	1	bc
AACTATCGGC	GAAACACCGGTAAAGGGCATATGAGGGAGGGAATCGATGCGTGGGGTTAG	1	bc
