CAATCCGACT	GAAACACCGGTACAACCGTCTCACTTGGTCGTGGGGTTAGAGCTAGAAAT	2	bc
CACTCTCAAG	GAAACACCGGTGCTCTCGGATCATCAGTGGGGTTAGAGCTAGAAATAGCA	2	bc
GACCCAGCCC	GAAACACCGGTAGCAAGTTAACCTAAGGCTAGTCCGTTATCAACTTGAAA	1	bc
AATAGTCGTA	GAAACACCGGTGTACGTATGGACTGAACCAGGGTGTGCAAGTGGGGATAG	1	bc
GGACTCCGGC	GAAACACCGGTGCATTCGAAAGTCCGGTCTTAGTGGGTACGGGTGGTTAT	1	bc
GGTTTCCTGC	GAAACACCGGTCGGGGCCAGTCAGCGGTAGTGGTGGAGCTGGAAATATAA	1	bc
TATATCGGGC	GAAACACCGGTTATCTTTGTAAGTGTGTGGGGTTAGAGCTAGAAATATCA	1	bc
TTCACCCTGC	GAAACACCGGTTTGGCTGAGAGTCCGGCAATGGTGTGGCTGTGGGTATAG	1	bc
TCCGTCGAAC	GAAACACCGGTTATATTTGTATGAGCGGGGGGCTTGGGCTGGGGGTAGCA	1	bc
TAAAAACCCC	GAAACACCGGTGTACGTATGGACTGAACCAGGGTGGGGTTAGAGCTAGAA	1	bc
GGTGTTCTCG	GAAACACCGGTTACCATGGGGGTAGAATTCATAATGGCAAGTTAACCTAG	1	bc
TCACCACGCC	GAAGCACCGGTTTGAACTACCTAGTTCAAACCGGTGGGGTTAGAGCTAGA	1	bc
GAAACAAACC	GAAACACCGGTAGCAAGTGGGGTTAGAGCTAGAAATAGCAAGTTAACCTA	1	bc
GCCAGCCGCT	GAAACACCGGTTAGCAGCCAATTGCGTGGCTCCTAGAGGTGTGGGGTTAG	1	bc
CCATTCCGGT	GAAACACCGGTCGATTCATATCGAAACCTTCCCGTGACAGTGGGGTTAGA	1	bc
GCGGGTCCTC	GAAACACCGGTTACCGTCCAGTGGGGGTAGGGCTAGAGCTAGCAAGATCA	1	bc
CGAGCGATGT	GAAACACCGGTTACATTGAGACTCGGGTTTTAGCTAGCAATAGGAAGTTA	1	bc
CGTCGTCGCA	GAAACACCGGTGTACGTATGGACTGAGCCAGGGTGTGCAAGTGGGGTTAG	1	bc
CAATTTATAT	GAAACACCGGTAACTATATTCATGCGATATCGCTGTATCAAGGGGTTTAG	1	bc
AGGCGTAGGT	GAAACACCGGTTTACGTTGCATCGGTGTGGGGTTAGAGCTAGAAATAGCA	1	bc
AGAGCTACTC	GAAACACCGGTTACATTGAGGGGCTAGAGCTAGAAATAGCAGGGTAACCT	1	bc
CTATTCGACG	GAAACACCGGTACCTTTGTTGCTGCTGGGTGGAAGGAGATAGAGCTAGAA	1	bc
GACGACTCGA	GAAACACCGGTCAGCGGGAATCGTGGGGTGGGGTTAGAGCGAGAAATAGC	1	bc
TTAACCGTGT	GAAACACCGGTTTGATTTACGTAGTAGAGCTGGAAATAGCAAGATAACCT	1	bc
CGGGGGCTCC	GAAACACCGGCCTTGGTTCTAGGGTAGAGGGGTTAGAGCAGAAATAGCAA	1	bc
GACCAACACA	GAAACACCGGTGCATTCGAAAGTCCGGTCGTAGTGGGGACGTGGGGATAG	1	bc
CGCGGTCACT	GAAACACCGGTGAGATTGTTCATAGAGTTAGACATAGCAAGTTAAGCTAA	1	bc
GAAGATTCGT	GAAACACCGGTCGGCGGCAACCTGGTTCTAGCTCTAACCTGGGGATAGAG	1	bc
CTGCTATCGA	GAAACACCGGTCCTGTCGCCACGGGTGTGGGGTTAGAGCTAGAAATAGCA	1	bc
TCATCGTCAT	GAAACACCGGTGTACGTATGGACTGAACCAGGGTGTGCAAGTGGGGTTAG	1	bc
CTTCTATCTC	GAAACACCGGTCCGGAGACGACCCGAGTGGCATGAGCCTTAGAAATTAGA	1	bc
TCCATAGTGG	GAAACACCGGTTATATTTGTAAGTGTGAGGAGCTAGAGATAGAAAGAGCA	1	bc
GACGGATCCC	GAAACACCGGTTTCCACGGCGCACATGCGGGTATTAAGGCGTGGGGTTAG	1	bc
TCTAGCGCAG	GAAACACCGGTTATATTTGTAAGTGTGTGGGGTTAGAGCTAGAAATAGCA	1	bc
GAGAAAGACG	GAAACACCGGTAGCAAGTGCGAAATAGCAAGTTAACCTCTGGCTAGTCCG	1	bc
ATAGCCCGCA	GAAACACCGGTACCTTTGTTGATCGTGGGTGGAAGGTTTTTGCTAGGGAT	1	bc
CTAATCATTA	GAAACACCGGTCAAGCCTGGGGGGTTCGGGGGGGGGATAGAGATAGAACT	1	bc
CAGATATCGC	GAAACACGGGTTAGAGCTAGAAATAGCAAGTTAACCTGAGACTAGTCCGT	1	bc
TATCTTCTAA	GAAACACCGGTAACTATATTCATGCGTTATGGCAGAATCAGTGGGGTTAG	1	bc
CTGGGGTCTC	GAAACACCGGTTCCCGTCCAGTGGGGTTAGAGCTAGAAATAGCAAGTTAA	1	bc
AGCACTGTAC	GAAACACCGGTTCATGAAAAACATACTTAGACGACGGTCCGTGGGGTTAG	1	bc
CAATCACGCC	GAAACACCGGTGCACGTATTTACTGAACCGGGGTGTACAACTAGGTATAG	1	bc
GTAATGCTTA	GAAACACCGGTCCCGGGTGAGTTATCCTGGGTTTGGATATAGATAGAGCT	1	bc
CTACCAGGCA	GAAACACCGGTACCTTTGTTGATGTTGGGTGGAAGGAAATGGGGTTAGAG	1	bc
AGTCCGCTAC	GAAACACCGGTGAGGACTTGCGCAGTGCGAGTGGGGTTAGAGCTAGGAAT	1	bc
ACCTTCAGAA	GAAACACCGGTCAATTCATATCGAAACCTTCCCGAGCTAGAGCTAGAAAT	1	bc
GATACCCCCA	GAAACACCGGTCCAAAATGTCGCCACGTGGGGTTAGAGCTAGAAATAGCA	1	bc
ACAACCCCCC	GAAACACCGGTTTGAACTAGAAATAGCAAGTTAACCTAAGGCTAGTCCGT	1	bc
AACACACGCG	GAAACACCGGTATCAAGTGAGACATAGCGAGGTAATCTAAGGCTAGACCG	1	bc
CCTTTTGTTT	GAAACACCGGTGACATTGGGTACAGGGGTGGGGTTAGAGCTAGAAATAGC	1	bc
GGGACCATAC	GAAACACCGGTTTAGCTGAGAGTTTGGCACTAGAAAGGCTGAGGTGATCT	1	bc
TTGGGCGTCA	GAAACACCGGTTAAGCCGAGTGGGGTTGGCGCTAGAAATCGCAAGTTAAT	1	bc
TCCTCCCAAG	GAAACACCGGTTCTCTCGGTACGTGAGTGGGGCTAGAGCTAGCAATATAA	1	bc
TCATAACGCC	GAAACACCGGTATCAACTACCTACGGGTTAGAGCTAGTAATAGCAAGTTA	1	bc
AAATTCGCAC	GAAACACCGGTATGCTCAACCAGAGCGTTTCACCGCGAAATAGTAAGTTA	1	bc
GTGAACCCAC	GAAACACCGGTTCCCGTCCAGTGGGGTTAGAGCTAGAAATAGCAAGTTAA	1	bc
CAAATCGGCA	GAAACACAGGTACCTTTGTTGATGCTCGGTGGACGGGATTGAGACGTTAG	1	bc
TTAGATAAGA	GAAACACCGGTTACATTGAGGGTTAGAGCTAGAAATAGCAGGTTAACCTA	1	bc
CATGCTTAAA	GAAACACCGGTTTACGTTGCATCGGTGTGGGGTTAGAGCTAGAAATAGCA	1	bc
TAAATCGCCC	GAAACACCGGTACCTGTGGTAATTCTTGTGGGGTTAAGAGCTAGAAATAG	1	bc
TCGCTCTGCA	GAAACACCGGTGCATTCGAAAGTCCGGTCGTAGTGTGGACGTGGGGTTAG	1	bc
TTTTTGCATA	GAAACACCGGTTAAGCCGAGGAGTTAGAGCTAGAAATAGCAAGTTAACCT	1	bc
ACGCATAGCA	GAAGAAATAGCAAGTTAACCTAAGGCTAGTCCGTTATCAACTTGAAAAAG	1	bc
CCCTTCCCCC	GAAACACCGGTCGGGGCCACTCAGTGGTGGGGTTAGAGCTAGAAATAGCA	1	bc
CCCAACGCTT	GAAACACCGGTTTAGAGCTAGAAATAGCAAGTTAACCTAAGGCTAGTCCG	1	bc
TAAGACGCCA	GAAACACCGGTTCGTAAGAGACCCGTGTGGCATGTTCCTAGGGGGGTAAA	1	bc
AACATTAGGT	GAAACACCGGTCGATTCATATCGAAACCTTCCCGTGACAGTGGGGTTAGA	1	bc
AGGCCGTCTC	GAAACACCGGTCCGTAGGTGACCCGTTTTGCATGTACCTGTGGGGGAAAT	1	bc
CAATCCGACT	GAAACACCGGTACAACCGTCTCACTTGGTCGGGGGGTTAGAGCTAGAAAT	1	bc
AGGCTACTAC	GAAACACCGGTAAATTTGAGGCTCCGGCATGCAGGAGGCCATGGGGTTAG	1	bc
ACTACACCGC	GAAACACCGGTACCTTTGTTGATGCTGGGGGGAAGGAAAGTTAACCTAAA	1	bc
CATCGTCCCT	GAAACACCGGTGTACGTATGGACTGAACCAGGGTGTGCAAGTGGGGTTAG	1	bc
GCCACAACAC	GAAACACCGGTATAAAGGGTGGTTTCGTCTAGTTATAGCTAGTTATCGTA	1	bc
TTCGATGTGT	GAAACACCGGTTACATTGAGGGTTAGAGCTGGAAATAGCAAGTTAACCTA	1	bc
AGGATGCCTA	GAAACACCGGTACGTAAGAGACCCGTGTGGCATGTACCTGAGAGGTTAGA	1	bc
TATACTTAGC	GAAACACCGGTTTACGTTGCATCGGGGTTAGAGCTAGAAATAGCAAGTTA	1	bc
CAGAACCACC	GAAACACCGGTTTGAAATAACTAGTTCAAACCGGTGGGGTTAGAGCTAGA	1	bc
ATACTTATGT	GAAACACCGGTTACATTGAGGGTTAGAGCTAGAAATAGCAAGTTAACCTA	1	bc
GGCCTCGACC	GAAACACCGGTAAATTTGAGGCTCCGGCCTCCACGAGGCCGTGGGGTGCG	1	bc
AGGGCTGTCT	GAAACACCGGTGACTTTGGGGAGAGCTATAGATAGCATGGTACTCGAAGG	1	bc
TCTCTAGATC	GAAACACCGGTTGAGCTCCCGTGCCCTATAACGCAAAATGTGGGGTAGAG	1	bc
TTTGGCACAC	GAAACACCGGTAGCAGCGGCAGGCGTGATGGTGGGGTTAGAGCTAGAAAT	1	bc
TTATTTCTGT	GAAACACCGGTTACATTGAGGCTGAGAGCTAGAAATAGCAAGTTAACCTA	1	bc
GCGAAGGCCC	GAAACACCGGTTTCACCTAACTACATCATTCGTTGGGGGAGAGCTAGAAA	1	bc
TGGAGACCCG	TCGTGAGCTAGAAATAGCAAGTTAACCTAAGGCTAGTCCGTTATCAACTT	1	bc
TTACATAAGT	GAAACACCGGTTACATTGAGATTAGAGCTAGAAAAGGCTAGTCCGTTATC	1	bc
TAAGACATGC	GAAACACCGGTGGGGTTAGAGCTAGAAATAGCAAGTTACCCTAAGGCTAG	1	bc
CTAGTGGGAC	GAAACACCGGCACCTTTGTTGATGCTGGGTGGGGTTAGAGCTAGAAATAG	1	bc
TACAAGGCGC	GAAACACCGGTTTGAACTACCTAGTTCAAAGCGGTGGGGTTAGAGCTAGA	1	bc
CTACCCGTAC	GAAACACCGGTGCCCTTACTCTCACTTGATTACTTAATCCGTGGGGTTAG	1	bc
CTACTCGTTT	GAAACACCGGTACCTTTGTTGATGCTGTGTGGAAGGAATTTGTGGGGTTA	1	bc
TCTACTGAGT	GAAACAGCTAGAAATATCAAGTTAACCTAAGGCTAGTCCGTTATCAACCT	1	bc
GCTTTCCAGA	GAAACACCGGTCGGGGCCACTCTGCGTGGGGTTAGAGCTCGTAATAGCAA	1	bc
AACCCCCGCG	GAAACACCGGTGTGGCTGAAAGCCCGGCAATGGTGTGGCTGTGAGGTTAA	1	bc
TCTCTAGATC	GAAACACCGGTTAAGCTCCCGTGCCCTATAACGCAAAATGTGGGGTAGAG	1	bc
TTTCTGCCTT	GAAACACCGATTCGTATGAGACCCTCGTGGCGTGTACCTTAGGGGTTAGA	1	bc
GCCTCGTCGT	GAAACACCGGTGTACGTATGGACTGAACCAGGGTGTGCAAGTGGGGTTAG	1	bc
ACAGTCGTAT	GAAACACCGGTCGCTTCATATCGAAACCTTCCCGTGACAGGGGGGGTAAG	1	bc
AACCTCGCTC	GAAACACCGGTCTGTAGGAGACCCGTGTGGCATGTACCTGTGGGGTTAGA	1	bc
GCGGTCCCTC	GAAACACCGGTTCCCGTCCAGTGGGGTTAGAGCTAGACATAGCAAGTTAA	1	bc
ATGATTCTAC	GAAACACCGGTAACTATATTTATGCGTTCTCGGGGGATAAGGCTAGATAG	1	bc
ATCACACCTA	GAAACACCGGTTCCCTTGCAGCGGGGGTAGGGCTAGAGCTAGAAAGTTAA	1	bc
GAGCATCGCT	GAAACACCGGTTTACGTCGCATCGGTGTGGGGTTAGAGCTAGAAATAGCA	1	bc
GTGACATCCA	GGAAGAGCGAAACAACGATGACCTTAATCTAACCTGATTCCTTTATCAGT	1	bc
