GCGTCGCCCT	GAAACACCGGTGTCCGCTGCCAGCTCCATTGTGGGGTTAGAGCTAGAAAT	8	bc
CTCCCCTGCA	GAAACACCGGTGTGGCTGAGAGTCCGGCAATGGTGTGGCTGTGGGGTTAG	4	bc
ACATCGTAGT	GAAACACCGGTGTACGTATGGACTGAACCAGGGTGTGCAAGTGGGGTTAG	3	bc
AGCGGAGCCT	GAAACACCGGTTCCCGTCCAGTGGGGTTAGAGCTAGAAATAGCAAGTTAA	2	bc
ACGAATCCTC	GAAACACCGGTCTCGAGTGAGGTGTTCAGGGTGGGGTTAGAGCTAGAAAT	2	bc
AAATCGTCGT	GAAACACCGGTGTACGTATGGACTGAACCAGGGTGTGCAAGTGGGGTTAG	2	bc
ACCTCGTCGT	GAAACACCGGTGTACGTATGGACTGAACCAGGGTGTGCAAGTGGGGTTAG	2	bc
AGTGGAGACT	GAAACACCGGTTCCCGTCCAGTGGGGTTAGAGCTAGAAATAGCAAGTTAA	2	bc
AACGCCAGAT	GAAACACCGGTGCCCTTACTCTCACCTGATTACCTAATCCGTGGGGTTAG	1	bc
ATATCACTCT	GAAACACCGGTCCGTAGGAGACCCGTGTGGCACGTACCTGTGGGGTCAGA	1	bc
GCACGCACCA	GAAACACCGGTGCCCTTACTCTCACCTGATTACTTAATCCGTGGGGTTAG	1	bc
CATAAAGCGC	GAAACACCGGTTTGAACTAGAAATAGCAAGTTAACCTAAGGCTAGTCCGT	1	bc
CGTGTTGCGC	GAAACACCGGTCGGGGCCACTCAGTGGCGGGGTTAGAGCTAGAAATAGCA	1	bc
GCTAGCGAGA	GAAACACCGGTTATATTTGTAAGTGTGTGGGGTTAGAGCTAGAAATAGCA	1	bc
ATTGATCATA	GAAACACCGGTTAAGCCGAGGAGTTAGAGCTAGAAATAGCAAGTTAACCT	1	bc
TAACTGTCGC	GAAACACCGGTGTACGTATGGACTGAACCAGGGTGTGCAGTGGGGTTAGA	1	bc
AGACCATACC	GAAACACCGGTGCATTCGACAGGCCGGTCGGAGTGTGGACGTGGAGTTAG	1	bc
AAGTGACGAC	GAAACACCGGTCCACCCTGGCTAGAAGTGGGGTTAGAGCTAGAAATAGCA	1	bc
CGTGTCGCTT	GAAACACCGGTGACATTAGGTACAGGGGTGGGGTTAGAGCTAGAAATAGC	1	bc
CACGCCGCAC	GGAACACCGGTTTGAACTACCTAGTAGCATGTTATCCTAAGGCGAGTCCG	1	bc
AAGTCTGTCT	GAAACACCGGTCCGTAGGAGACCCGTGTGGCATGTACCTGTGGGGTTAGA	1	bc
AGCATCATTT	GAAACACCGGTCTCGAGTGAGGTGTTCAGGGTGGGGTTAGAGCTAGAAAT	1	bc
TTGGTTACGT	GAAACACCGGTTACATTGAGGGTTAGAGCTAGAAATAGCAAGTTAACCTA	1	bc
AGGAACCCTC	GAAACACCGGTGTGGCTGAGAGTCCGGCAATGGTGTGGCTGTGGGGTTAG	1	bc
AAGTATGACT	GAAAAACCGGTCCGTAGGAGACACGTGTGGCATGTACCTGTGGGGTTAGA	1	bc
CACACAACGC	GAAACACCGGTTTGAACTAGAAATAGCAAGTTAACCTAAGGCTAGTCCGT	1	bc
AAGACACTCG	GAAACACCGGTGCATTCGAAAGTCCGGTCGTAGTGTGGACGTGGGGTTAG	1	bc
GCTTCACAGA	GAAACACCGGTCGGGGCCACTCAGTGGTGGGGTTAGAGCTAGCAATAGCA	1	bc
ACGCTTGGAC	GAAACACCGGTTTACGTTTCACCACTGCGACGCTCGACTTAGAAATAGCA	1	bc
GGCATCTAGA	GAAACACCGGTGCATTCGAAAGTCCGGTCGTAGTGTGGACGTGGAGTTAG	1	bc
CTGAGCGTCC	GAAACACCGGTTTGAACTAGAAATATCAAGTTAACCTAAGGCTAGTCCGT	1	bc
ATATATAGCG	GAAACACCGGTTATATTTGTAAGTGTTGTGGGGTTAGAGCTAGAAATAGC	1	bc
AAAAGACGTA	GAAACACCGGTGCCCTTACTCTCACCTGATTACTTTATCCGTGGGGTTAG	1	bc
ATCCCTTACC	GAAACACCGGTCGGGGCCACTCAGCGGTGGGGTTAGAGCTAGAAATAGCA	1	bc
ACGAGTCCTT	GAAACACCGGTCTCGAGTGAGGTGTTCAGGTGGGGTTAGAGCTAGAAATA	1	bc
GACTTAGTTA	GAAACACCGGTAGCAAGTGTGAGACGTTTTTGTGGGGTTAGAGTTAGAAA	1	bc
AAGCGGAGCT	GAAACACCGGTTTACGTTGCATCGGTGTGGGGTTAGAGCTAGAAATAGCA	1	bc
ATGATTAGTC	GAAACACCGGTTTACGTTGCATCGGTGTGGGGTTAGAGCTAGAAATAGCA	1	bc
GGTATAGAGG	GAAACACCGGTTATATTTGTAAGTGTGTGGGGTTAGAGCTAGAAATAGCA	1	bc
AAGTCAGCCT	GAAACACCGGTCCGTAGGAGACCCGTGTGGCATGTACCTGTGGGGTTAGA	1	bc
CGAGATATGT	GAAACACCGGTTACATTGAGGGGTTAGAGCTAGAAATAGCAAGTTAACCT	1	bc
CTGATCATAC	GAAACACCGGTTAAGCCGAGTGGGGGTAGAGCTAGAAATAGCAAGTTAAC	1	bc
TTTTATCGCG	GAAACACCGGTTATATTTGTAAGTGTATGGGGTTAGAGCTAGAAATAGCA	1	bc
CATCGACAAC	GAAACACCGGTGTACGTATGGACTGAACCAGGGTGTGCAAGTGGGGTTAG	1	bc
GGTCGATACA	GAAACACCGGTAAATTTGAGGCTCCGGCATGCAGGAGGCCGTGGGGTTAG	1	bc
GCTGCGCGTC	GAAACACCGGTTTGAAAACAGTGGGGTTAGAGCTAGAAATAGCAAGTTAA	1	bc
CGAATAATCT	GAAACACCGGTCTCGAGTGAGGTGTTCAGGGTGGGGTTAGAGCTAGAAAT	1	bc
ACCAATGGCC	GAAACACCGGTTTGAACTAGAAATAGCAAGTTAACCTAAGGCTAGTCCGT	1	bc
ACTACGCGGC	GAAACACCGGTACCTTTGTTGATGCTGGGTGGGGTTAGAGCTAGAAATAG	1	bc
AGGCTGATTC	GAAACACCGGTCCGTAGGAGACCCGTGTGGCATGTACCTGTGGGGTTAGA	1	bc
TAGAACTAGG	GAAACACCGGTTCGGTCGCTATTCCGGTCGGAGTGTGGATGTAGGTAGCA	1	bc
ACATTGTCGT	GAAACACCGGTGTACGTATGGACTGAACCAGGGTGTGCAAGTGGGGTTAG	1	bc
TTTACTGTGT	GAAACACCGGTTATATTTGTAGTTGTGGCTGGTAAGAGCTAGATAAACTA	1	bc
GGACCCTTGA	GAAACACCGGTGCATTCGAAAGTCCGGTCGTAGTGTGGACGTGGGGTTAG	1	bc
TTCTTTCGAG	GAAACACCGGTTATATTTGTAAGTGTTGTGGGGTTAGAGCTGGAAATAGC	1	bc
GCAGAGACAC	GAAACACCGGTCGGCGCGTCTACGGGGGTAGAGCGAGTAATGGTAGGTAT	1	bc
AAAGCAATAC	GAAACACCGGTGCCCTTACTCTCACCTGATTACTTAATCCGTGGGGTTAG	1	bc
ACATTTACTG	GAAACACCGGTCGGGGCCACTTAGTGGTGGGGTTAGAGCTAGAAATAGCA	1	bc
TAGCTGCTCC	GAAACACCGGTAACTATATTCATGCGATATCGCCGTATCAGTGGGGTTAG	1	bc
GGACCATCCA	GAAACACCGGTAAATTTGAGGCTCCAGCATGCAGGAGGCCGCGGGGTTAG	1	bc
AACTATCGAG	GAAACACCGGTTATATTTGTAAGTGAGTTAACCTAAGGCTAGTCCGTTAT	1	bc
ACATTGTCGT	GAAACACCGGTGTACGTATGGACTGAACGTGGGGTTAGAGCTAGAAATAG	1	bc
ATTGAGCGTA	GAAACACCGGTTAAGCCGAGTGGGGTTAGAGCTAGAAATAGCAAGTTAAC	1	bc
AACAACGCTA	GAAACACGGGTTAGAGCTAGAAATAGCAAGTTAACCTAAGGCTAGTCCGT	1	bc
ACTAATCGGC	GAAACACCGGTACCTTTGTTGATGCTGGGTGGAAGGAATTTTGTGGGGTT	1	bc
ACGGAGTCTA	GAAACACCGGTTCCCGTCCAGTGGGGTTAGAGCTAGAAATAGCAAGTTAA	1	bc
AACACCGCTC	GAAACACCGGTTTGAACTACCTAGTTCAAACCGGTGGGGTTAGAGCTAGA	1	bc
GTGGTGGCTT	GAAACACCGGTTCACGTTCAGTTAAGCTAAAGCTAGACCTAGAACGATAT	1	bc
TGCAGCATAT	GAAACACCGGTTAAGCCGAGGAGTTTCGTTAGAGCTAGAAATAGCAAGTT	1	bc
GGAAGCTACA	GAAACACCGGTAAATTTGAGGCTCCGGCATGCAGGAGGCCGTGGGGTTAG	1	bc
AAAAACGCCT	GAAACACGGGTTAGTGCTAGACATAACAAGTTCACCTCAGGCTAGTCCGA	1	bc
ATGCGAATAA	GAAACACCGGTTAAGCCGAGGAGTTAGAGCTAGTAATAGCAAGTTAACCT	1	bc
ACTTCAGCGG	GAAACACCGGTAAACTTTGTTACTTTGGTGGGTTTAGGCTAGGAATTGCC	1	bc
AGAAGAACCG	GAAACACCGGTCGGCGGTGGGGTTAGAGCTAGAAATAGCAAGTTAACCTA	1	bc
TCTTTATGGC	GAAACACCGGTCGGGGCCACTAAGTGGTGGGGGTAGAGCTAGAAATAGCA	1	bc
ACATAGTCGT	GAAACACCGGTGTACGTACGGACTGAACCAGGGTGTGCAAGTGGGGTTAG	1	bc
CATAAAGCTC	GAAACACCGGTTTGAACTTGAAATAGCATGGTAACCTAAGGCTAGTCCGT	1	bc
TGTATAATAA	GAAACACCGGTTAAGCCGAGGAGTTAGAGCTAGAAATAGCAAGTTAACCT	1	bc
GAGGGATCGG	GAAACACCGGTCTCGAGTGAGGTGTTCAGGGTGGGGTTAGAGCTAGAAAT	1	bc
AACCACGCTC	GAAACACCGGTTTGAACTACCTAGTTCAAACCGGTGGGGTTAGAGCTAGA	1	bc
GCCCAACGCA	GAAACACCGGTTTGAACTAGAAATAGCAAGTTAACCTAAGGCTAGTCCGT	1	bc
GCGAATCATT	GAAACACCGGTCTCGAGTGAGGCGTTCAGGGTGGGGTTAGAGCTAGAAAT	1	bc
AAAGCCATGC	GAAACACCGGTGCCCTTACTCTCACCTGATTACTTAATCCGTGGGGTTAG	1	bc
GGTAGTCGTC	GAAACACCGGTGTGGGTGAGAGCTCGGCAATGGTGTGGCTGTGGGGTTAG	1	bc
CGAGTCCCGT	GAAACACCGGTCTGCAGCCAGTTAGTGCGAGGAATATCAAGCTAAAATTA	1	bc
TTAGCCACGC	GAAACACCGGTTGCTGACGATCTAGAGCTAGGAATAGCAAGTTAACCTAA	1	bc
CGGGGTATCC	GAAACACCGGTTACGTTGAGGTGGTATTACTGCTAAAAATAGCAAGTCAA	1	bc
ACACAGCGCC	GAAACACCGGTTTGAACTACCTAGTTCAAACCGGGTGGGGTTAGAGCTAG	1	bc
CAAGTTATCC	GAAACACCGGTAACTATATTCATGCGATATCGCCGTATCAGTGGGGTTAG	1	bc
GGATACTCGC	GAAACACCGGTCGGCGGCAATCGTGGGTGGGGTTAGAGCTAGAAATAGCA	1	bc
GAGCTTGTAC	GAAACACCGGTAACTATATTCATGCGATATCGCCGTATCAGTGGGGTTAG	1	bc
ACAGTGTCGT	GAAACACCGGTGTACGTATGGACTGAACCAGGGTGTGCAAGTGGGGTTAG	1	bc
TAACTTCACC	GAAACACCGGTAACTATATTCATGCGATATCGCCGTATCAGTGGGGTTAG	1	bc
ATAAATTATA	GAAACATCGGTAACTATATTCATGCGATATCGCCGTATCAGTGGGGTTAG	1	bc
ACACAACGCA	GAAACACGGGTTAGAGCTAGAAATAGCAAGTTAACCTAAGGCTAGTCCGT	1	bc
GCCTTTACAG	GAAACACCGGTCGGGGCCACTCAGTGGTGGGGTTAGAGCTAGAAATAGCA	1	bc
TTTGGAGACT	GAAACACCGGTTCCCGTCCAGTGGGGTTAGAGCTAGAAATAGCAAGTTAA	1	bc
GTGCTTTACA	GAAACACCGGTAAATGTGAGACTCCGGCATGCATAAAGCTGTGAGTATAG	1	bc
GCAACCACGC	GAAACGCCGGTCGGTTGGTGGATCCGGAAAGAAGGAGGCAGTCGGGTTAG	1	bc
AGAAGACTTT	GAAACACCGGTCTCGAGTGAGGTGTTCAGGGGGGGGTTAGAGCTAGAAAT	1	bc
TAGACAGAAA	GAAACACCGGTAGCAAGTGCGAGACGTGTTTTGTGGGGTTAGAGCTAGAA	1	bc
TGACATAGCC	GAAACACCGGTGGGGTTAGAGCTAGAAATAGCAAGTTAACCTAAGGCTAG	1	bc
CTACGGGGAC	GAAACACCGGTACGTTTGTTGATACTGCGTGGGAGGTATTTGTGGGGTTA	1	bc
GCTTTACAGA	GAAACACCGGTCGGGGCCACTCAGTGGGGTTAGAGCTAGAAATAGCAAGC	1	bc
TTGAGCCGAC	GAAACACCGGTTAAGCCGAGTGGGGTTAGAGCTAGAAATAGCAAGTTAAC	1	bc
ACTGCTCATA	GAAACACCGGTTAAGCCGAGGTGGGGTAAGAGCTAGAAATAGCAAGTTAA	1	bc
GTGGCGCCGA	GAAACACCGGTTCCCGTCCAGCGGGATTAGAGCTGGAAATAGCAAGTTAA	1	bc
AGGCACCCTT	GAAACACCGGTGTGGCTGAGAGTCCGGCAATGGTGTGGCTGTGGGGTTAG	1	bc
GATAGCTATG	GAAACACCGGTTACATTGAGGGTTAGAGCTAGAAATAGCAAGTTAACCTA	1	bc
GGGCTCCCTC	GAAACACCGGTGTGGCGGAGAGTCCGGCAAGGGTGAGGCTGTGGGGGTAG	1	bc
GTTAGATATG	GAAACACCGGTTACATTGGGGTTAGAGCTAGAAATAGCAAGTTAACCTAA	1	bc
CACGATGCCG	GCTAGAAATAGCAAGTTAACCTAAGGCTAGTCCGTTATCAACTTGAAAAA	1	bc
AAACAAAGAC	GCTAGAAATAGCAAGTTAACCTAAGGCTAGTCCGTTATCAACTTGAAAAA	1	bc
CATGGCAGTC	GAAACACCGGTGTACGTATGGACTGAACCAGGGGAAATAGCAAGTTAACC	1	bc
GGCAAGATCC	GAAACACCGGTGTGGCTGAGAGTCCGGCAATGGTGTGGCTGTGGGGTTAG	1	bc
GAGCCAGATA	GAAACACCGGTAGCAAGTGCAGTTAACCTAAGGCTAGTCCGTTATCAACT	1	bc
GCGTCTGCCT	GAAACACCGGTCCGTAGGAGACCCGTGTGGCATGTACCTGTGGGGTTAGA	1	bc
GGCAGATACA	GAAACACCGGTAGCAAGTGCGAGGTTAGAGCTAGAAATATTAAGTTAACC	1	bc
ACTTTACTGA	GAAACACCGGTCGGGGCCACTCAGTGGTGGCGTTAGAGCTAGAAATAGCA	1	bc
AAACGACCTA	GAAACACCGGTGCCCTTACTCTCACCTGATTACTTAATCCGTGGGGTTAG	1	bc
CTGGACGGCC	GAAACACCGGTACCTTTGTTGATGCTGGGTGGAAATAGCAAGTTAACCTA	1	bc
TGGGGACCTT	GAAACACCGGTTAAAGTCGGATAGGGGTAGAGCTAGAGATAGCAAGATAA	1	bc
GAAGTCCGTA	GAAACACCGGTCTCGAGAGCGGTGTTCAGGGGGGGGTTAGAGCAAGAAAT	1	bc
GGGATACTCC	GAAACACCGGTGTAGCCTGGATAGCGGCAGTGGTGTGGCTGGGGGGATAG	1	bc
ATAAGTGATA	GAAACACCGGTAACTATATTCATGCGATATCGCCGTATCAGTGGGGTTAG	1	bc
TTCCTTAGCC	GAAACACCGGTACCTTTGTTGATGCTGGGTGGAAGGAATGTGGGGGTAGA	1	bc
GATAAAGATA	GAAACACCGGTAGCAAGCGCGAGACGTGTTAAATAGCAAGTTAACGTAAG	1	bc
ATCTATCGAT	GAAACACCGGTTATATTTGTAAGTGGGGTTAGAGCTAGAAATAGCAAGTT	1	bc
CGTTTTGCGC	GAAACACCGGTCGGGGGAGAGATATAGCAAGTTAGCCTAAGGAAAGCCCG	1	bc
GTGCTGCCGC	GAAACACCGGTTCCCGTCCAGTGGGGTTAGAGCTAGAAATAGCAAGTTAA	1	bc
GGAGACCTTC	GAAACACCGGTCTCGAGCGATGGGTTCAGGTGGTGTTAGAGCTAGAAATA	1	bc
TAGCAAGGCC	GAAACACCGGTTTGTATTACAACTTGCAGGTTAAGCTAAGGGTAATACGT	1	bc
CACCTTTGCC	GAAACACCGGTCGGGGCCACTCAGGGGGGGGATAGAGCTAGAAATAGCAA	1	bc
TTACCTTTGC	GAAACACCGGTGCATTCGAAGGACCGGTCGTAGTGTGGACGTGGGGTTAG	1	bc
TATCTCGAGA	GAAACACCGGTTATATTTGTAAGTGTGTGGGGTTAGAGCTAGAAATAGCA	1	bc
AATACTCGGC	GAAACACCGGTACCTTTGTTGATGCCGGGTGGAAGGATTTTTGTGGGGTT	1	bc
GCATAGTCGT	GAAACACCGGTGTACGTATGGACTGAACCAGGGTGTGCAAGTGGGGTTAG	1	bc
AACAGCGCGC	GAAACACCGGTTTGAACTAGAAATAGCAAGTTAACCTAAGGCTAGTCCGT	1	bc
GACGAAGCTC	GAAACACCGGTGGGGTTAGAGCTAGAAATAGCAAGTTAACCTAAGGCTAG	1	bc
AGTATGTATC	GAAACACCGGTCCGTAGGAGACCCGTGTGGCATGTACCTGTGGGGTTAGA	1	bc
AAGACACAGA	GAAACACCGGTAGCAAGTGCGAGACGTGTTAAATAGCAAGTTAACCTAAG	1	bc
GCTCTACGCC	GAAACACCGGTTTGAACTACCTAGTTCAAACCGGGTGGGGTTAGAGCTAG	1	bc
GTGACCCCCC	GAAACACCGGTTCAAGATGTCGGCACGTAGGGCTAGAGATAGAAATATCA	1	bc
ACCGCCCACC	GAAACACCGGTGCCCTTACTCTCACCTGATTACTTAATCCGTGGGGTTAG	1	bc
GATACCTCGG	GAAACACCGGTCATACTTGTAAGTGCGTGGGGTGAGTTCGAGCAAGAGCT	1	bc
ATTAGCTCTG	GAAACACCGGTTACATTGGGGAGTAGAGCTAGTAGTAGCAAGATAAACTA	1	bc
TACGCAATGG	GAAACACCGGTTACATTGAGGGCTATTGCTAACTTTAGCAAGGTAACCTA	1	bc
GAGGCGTCTC	GAAACACCGGTTCCCGTCCAGTGGGGTTAGAGCTAGAAATAGCAAGTTAA	1	bc
AAGTCGGCCT	GAAACGCCGGTCCGTAGGAGACCCGTGTGGCATGTACCTGTGGGGTTAGA	1	bc
CTAACCGGCA	GAAACACCGGTACCTTTGTTGATGCTGGGTGGAAGGGGTTAGAGCTAGAA	1	bc
ATACCGGGCC	GAAACACCGGTACCTTTGTTGATGCTGGGTGGAAGGTGGGGTTAGAGCTA	1	bc
TGACAGTCGC	GAAACACCGGTGCATTCGAAAGTCCGGTCGTAGTGTGGACGTGGGGTTAG	1	bc
TCAATCGGTC	GAAACACCGGTCGATTCATATCGAAACCTTCCCGTGACAGTGGGGTTAGA	1	bc
ACACAACGCA	GAAACACCGGTTTGAACTAGAAATAGCAAGTTAGCCTAAGGCTAGTCCGT	1	bc
AATAGACGTC	GAAACACCGGTGTACGTATGGACTGAACCAGGGTGTGCAAGTGGGGTTAG	1	bc
ACATAGTCGT	GAAACACCGGTGTACGTATGGACTGAACCAGGGTGTGCAAGTGGGGTTAG	1	bc
GGAACCCTAT	GAAACACCGGTGTGGCTGAGAGTCCGGCAATGGTGTGGCTGTGGGGTTAG	1	bc
CCGTGACAGC	GGAACACCGGTCGGGGCCACTCAGTGGTGGGGTTAGAGCTAGAAATAGCA	1	bc
AGACTATCCC	GAAACACCGGTGCATTCGAAAGTCCGGTCGTAGTGTGGACGTGGGGTTAG	1	bc
AATGTTGACA	GAAACACCGGTGACATTGGGTACAGGGGTGGGGTTAGAGCTAGAAATAGC	1	bc
ACCTTTACAG	GAAACACCGGTCGGGGCCACTCAGTGGTGGGGTTAGAGCTAGAAATAGCA	1	bc
AATTGAGCAT	GAAACACCGGTTAAGCCGAGGAGTTAGAGCTAGAAATAGCAAGTTAACCT	1	bc
GCGCGACGCA	GAAACACCGGTGCACGTATGGACTGAACCAGGGTGGGCAAGGGTGGTTAT	1	bc
GAAGGGCTGC	GAAACACCGGTCGTGGGTATTCGGTAAAGCGGTTAGATGGGAATAGGCCT	1	bc
GATCTACGCC	GAAACATTAGAGCTAATGAGGTCAAGTTAACCTAAGTTTAAGCTAGTATT	1	bc
ACCTTTAACG	GAAACACCGGTCGGGGCCACTCAGTGGTGGGGTTAGAGCTAGAAATAGCA	1	bc
GAACGCACTA	GAAACACCGGTGCCCTTACTCTCACCTGATTACTTAATCCGTGGGGTTAG	1	bc
ACTACTAGGC	GAAACACCGGTACCTTTTAGAGCTAGAAATAGCAAGTTAACCTAAGGCTA	1	bc
GTATATCGAG	GAAACACCGGTTATATTCGTAAGTGTGTGGGGTTAGAGCTAGAAATAGCA	1	bc
GAGACGGCGT	GAAACACCGGTCCGTAGGAGACCCGTGTGGCATGTACCTTGTGGGGTTAG	1	bc
ACTGCCCTAA	GAAACACCGGTGCCCTTCCTCTCACCTGATTACTTACACCGTGGGGTTAG	1	bc
CTGCGACTTC	GAAACACCGGTGTACGTATGGACTGAACCAGGGTGTGCAAGTGGGGTTAG	1	bc
ACATTTACCG	GAAACACCGGTCGGGGCCACTCAGTGGTGGGGTTAGAGCTAGAAATAGCA	1	bc
CATCGTATAC	GAAACACCGGTGTACGTATGGACTGAACCAGGGTGTGCAAGTGGGGTTAG	1	bc
AGAGGTGCCT	GAAACACCGGTTCCCGTCCAGTGGGGTTAGAGCTAGAAATAGCAAGTTAA	1	bc
GGAAGAACCG	GAAACACCGGTCGGCGGTAGCAAGTTAACCTAAGGCTAGTCCGTTATCAA	1	bc
AGAGCTTATA	GAAAGACCGGTAACTATATTCATGCGATATCGCCGTATCAGTGGGGTTAG	1	bc
ATATTCGTCC	GAAACACCGGTACCTTTGTTGATGCTGGGTAGAAGGAATGTGGGGTTAGA	1	bc
TTATCTAATT	GAAACACCGGTTACATTGAGGGTTAGAGCTAGAAATAGCAAGTTAACCTA	1	bc
GGCACCAAGA	GAAGCACCGGTAAATTTGAGGCTCCGGCATGCAGGAGGCCGTGGGGTTAG	1	bc
GTGGCTACTT	GAAACACCGGTTCCCGTCCAGTGTAGTTCTAGATAGAGCAAGCTAGTTTA	1	bc
GAAGCAGCGC	GAAACACCGGTCGGCGGCAACGTGGGGTTAGAGCTAGAAATAGCAAGTTA	1	bc
GAAAATTTCT	GAAACACCGGTGGGGCTGAGAGTACGGCAAGGGGGTGGCGGGGGAGAAAG	1	bc
TGGTTTATAC	GAAACACCGGTAACTATATTCATGCGATATCGCCCTATCTGTAGGGATAG	1	bc
ACACAACGCA	GAAACATTAGAGCTAGAAATAGCAAGTTAACCTAAGGCTAGTCCGTTATC	1	bc
AAGGATGCCT	GAAACACCGGTCCGTAGGAGACCCGTGTGGCATGTACCTTGTGGGGTTAG	1	bc
TCAGCTCCGC	GAAACACCGGTCGGCGGCAATCGTCGGTGGGGTTAGATCTAGAAATCGCA	1	bc
GCCATAGCCA	GAAACACCGGTAGCAAGTGCGAGACGTTTTTGTGGGGTTAGAGAAAGAAA	1	bc
GAGGACCCTT	GAAACACCGGTTCCCGTCCAGTGGGGTTAGAGCTAGAAATAGCAAGTTAA	1	bc
TGACACCGAC	GAAACACCGGTAGCAAGTGCGGGGTTAGAGCTAGAAATAGCAAGTTAACC	1	bc
GCCACCGAAA	GAAACACCGGTAGCAAGTGCGAGACGTGTTTGTGGGGTTAGAGCTAGAAA	1	bc
GGCATGTACA	GAAACACCGGTAAATTTGAGGCTCCGGCATGCAGGAGGCCGTGGGGTTAG	1	bc
ACGAATACTT	GAAACACCGGTCTCGAGTGAGGTGTTCAGGGTGGGGTTAGAGCTAGAAAT	1	bc
GGAAACCTCA	GAAACACCGGTGTGGCTGAGAGTCCGGCAATGGTGTGGCTATGGGGTTAG	1	bc
ACCCTTACCG	GAAACACCGGTCGGGGAGAGCTAGAAATAGCAAGTTAGCCTAAGGCTAGT	1	bc
AGGGCGTCGA	GAAACACCGGTGCATTCGAAAGTCCGGTCGTAGTGGGGAAGAGGGGGTAG	1	bc
GCCGACGCGT	GAAACACCGGTCGGCGGCAACGTGGGGTTAGAGCTAGAAATAGCAAGATA	1	bc
AAAGCTTAGC	GAAACACCGGTTTACGTTGCATCGGTGTGGGGTTAGAGCTAGAAATAGCA	1	bc
CTGCGCATTA	GAAACACCGGTTAAGCCGACGTCTTAGAGCTAGTAATAGCAAGTTTACCT	1	bc
GAAACAGGCT	GAAACACCGGTAGCAAGTGCGAGACGTGTTTGTGGGGTTAGAGCTAGAAA	1	bc
GAGAACACGC	GAAACACCGGTCGGCGGCAATCGCGGTTGGGGTTATGGCTGGGGGTAGCA	1	bc
ATCAATCGAG	GAAACACCGGTTATATTTGTAAGTGGGGTTAGAGCTAGAAATAGCAAGTT	1	bc
GACAGCGGCT	GAAACACCGGTTTGCAGTAGAAATAGCAGGTTAACCTAGGGCTAGGCTAG	1	bc
TCATAGTCGT	GAAACACCGGTGTACGTATGGACTGAACCAGGGTGTGCAAGTGGGGTTAG	1	bc
AGAACTGCGC	GCAACACCGGTGCATTCCCAAGTCCGGTCGCCGTGTGGACGTGGGGTTAG	1	bc
GATGGCCCGA	GAAACACCGGTCGGCGGGGTTAGAGATAGAAATAGCATGTTAACCTAAGG	1	bc
TCGCCCTGCA	GAAACACCGGTGCATTCGAAAGTCCGGTCGTAGGGTGGACGTGGGGTTAG	1	bc
TGACGCTACA	GAAACACCGGTAAATTTGAGGCTCCGGCATGCAGGAGGCCGTGGGGTTAG	1	bc
TTGCCTAGGT	GAAACACCGGTTACATTGAGGGTTAGAGCTAGAAATAGCAAGTTAACCTA	1	bc
AGAGGACGCG	GAAACACCGGTCGGCGGCAATCGTGGGTGGGGTTAGAGCTAGAAATAGCA	1	bc
ACGAATCGTT	GAAACACCGGTCTCGAGTGAGGTGTTCAGGATGGGGTTAGAGCTAGAAAT	1	bc
TCGAATCCTC	GCATATATATCCTGCAGGAGAGGATTCGAAATTCGAGCCCATTGGAATGG	1	bc
GACACATAAC	GAAACACCGGTAGCAACTGTGGGGTTAGAGCTAGAAATAGCAAGTTAACC	1	bc
AAGGAACGCC	GAAACACCGGTAGGCGGCGGTTAGGCCGGGACATATCCTGATTACCTACC	1	bc
ATCCACCTCC	GAAACACCGGTGTGGCTGAGAGTCCGGCAATGGTGTGGCTGTGGGGTTAG	1	bc
GCGTCGCCCT	GAAACACCGGTGTCCGCTGCCAGCTCCATTGTGGGGTTAGAGCTAGGAAT	1	bc
GCAGGCCAGC	GAAACACCGGTCGGCGGCAATCGTGGTTAGAGCTAGAAATAGCAAGTTAA	1	bc
TGACACAGAG	GAAACACCGGTAGCAAGTGCGAGACGTGTTTGTGGGGTTAGAGCTAGAAA	1	bc
GACGTTTACA	GAAACACCGGTCGGGGCCACTCAGTGGAGGGGTTAGAGCTAGAAATAGCA	1	bc
AGTGGCGCCT	GAAACACCGGTTCCCGTCCAGTGGGGTTAGAGCTAGAAATAGCAAGTTAA	1	bc
ACTAGTCGGC	GAAACACCGGTACCTTTGTTGATGCTGGGTGGAAGGAATTTTTGTGGGGT	1	bc
AGGACCACGC	GAAACACCGGTGCATTCGAAAGTCCGGTCGTAGTGTGGACGTGGGGTTAG	1	bc
TATGCATAGC	GAAACACCGGTTTACGTTGCATCGGTGTGGGGTTAGAGCTAGAAATAGCA	1	bc
CACGATGACC	GAACCACCGGTTTGAACTACCTAGTTCAAACCGGTGGGGTTAGAGCTAGA	1	bc
GTCTCCCCCC	GAAACACCGGTGTGGCTGAGAGTCCGGCACTGGTGGGGCTGTGGGGTTAG	1	bc
TCTATCGCTC	GAAACACCGGTTATATTTGTAAGTGTGTGGGGTTAGAGCTAGAAATAGCA	1	bc
TAGCTGTGTC	GAAACACCGGTTACATTGAGATTGGGGTTAGAGCTAGAAATAGCAAGTTA	1	bc
TTATTGCCTC	GAAACACCGGTTACATTGAGATTCGTGTTACATCTAGATATAGCAAGTTA	1	bc
CCTCTGCGTC	GAAACACCGGTGTACGTATGGACTGAACCAGGGTGTGCAAGTGGGGTTAG	1	bc
GAGACACAGA	GAAACACCGGTAGCAAGTGCGAGCAAAAAAAGTGGGGTTAGAGCTGGAAA	1	bc
AGAATACCAT	GAAACACCGGTCTCGAGTGAGGTGTTCAGGGTGGGGTTAGAGCTAGAAAT	1	bc
CATAGTAGAC	GAAACACCGGTGTACGTATGGACTGAACCGGGGTGTGCAAATAGGGATAG	1	bc
ATAAAATGAC	GAAACACCGGTAGCAAGTGCGGGGTTAGAGCTAGAAATAGCAAGTTAACC	1	bc
ATGATTTGAT	GAAACACCGGTTTACGTTGCATCGGTGTGGGGTTAGAGCTAGAAATAGCA	1	bc
GGCCACATGC	GAAACACCGGTGTGGCTGAGAGTCCGGCAATGGTGTGGCTGTGGGGTTAG	1	bc
CAACAAGTCC	GAAACACCGGTACCTTTGTTGATGCTTGGTGGGAGGTGGGGTTAGGGCTA	1	bc
GTAGATCAGT	GAAACACCGGTTACATTGAGGGATAGAGCTAGAAATAGCAAGTTAACCCA	1	bc
ACATCGCTGT	GAAACACCGGTCGATTCATATCGAAACCTTCCCGTGACAGTGGGGTTAGA	1	bc
TCACGGCGTC	GAAACACCGGTGTACGTATGGACTGAACCAGGGTGTGCAAGTGGGGTTAG	1	bc
ACGAATCCGT	GAAACACCGGTCTCGAGTGAGGTGTTCAGGGTGGGGTTAGAGCTAGAAAT	1	bc
ATGTATCGGT	GAAACACCGATTTACGGTACATCCGTGTGGGACTAGCGCTAGAAATAGCA	1	bc
GAGTCGGCAG	GAAACACCGGTCCGTAGGAGACCCAAGTTAACCTAAGGCTAGTCCGTTAT	1	bc
ATTGAGAATA	GAAACACCGGTTAAGCCGAGGAGTTAGAGCTAGAAATAGCAAGTTAACCT	1	bc
GAGTCCCCTC	GAAACACCGGTTCCCGTCCAGTGGGGTTAGTGCTAGACATAGCAAGTTAA	1	bc
CGTCTGCGTA	GAAACACCGGTCCGTAGGAGACCCGTGTGGCATGTACCTGTGGGGTTAGA	1	bc
AGGAGGCCCG	GAAACACCGGTCGGCGGCAACGTGGGGTTAGAGCTAGAAATAGCAAGTTA	1	bc
AAATACTCGC	GGCTAGTCCGTTATCAACTTGAAAAAGTGGCACCGAGTCGGTGCTTTTTT	1	bc
AACATTCGGG	GAAACACCGGTCGATTCATATCGAAACCTTCCCGTGACAGTGGGGTTGGA	1	bc
CGAGACGCGC	GAAACACCGGTGCGTTCGAAAGTCCGGTCGTAGTGTGGACGTGGGGTTAG	1	bc
CGTGTGGCTC	GAAACACCGGTTCCCGTCCAGAGAGGGTAGAGGTTAGAGTTACAAATTGC	1	bc
AGTGGAGGCT	GAAACACCGGTTCCCGTCCAGTGGGGTTAGAGCTAGAAATAGCAAGTTAA	1	bc
ACCCAACGAA	GAAACACCGGTTTGAACTACCTAGTTCAAACGGTTAGAGCTAGAAATGGC	1	bc
TCAGCCCTCA	GAAACACCGGTGCCCTTACTTTCACCTGATTACTTAATCCGTGGGGTTAG	1	bc
AAGTATGACT	GAATCACCGGTCCGTAGGAGACCCGTGTGGCATGTACCTGTGGGGTTAGA	1	bc
ACGCTGCGCG	GAAACACCGGTCGATTCAAATAGAGACCTTCCCTTGACCGAGAGATAAGA	1	bc
ACCTTGACCG	GAAACACCGGTCGGGGCCACTCAGTGGTGGGGTTAGAGCTAGAAATAGCA	1	bc
GCCACAGAGG	GAAACACCGGTTACATTTGCGAGAGGTGTTGGTTAGAGTAGAGCAAAACA	1	bc
AGGGGCATAC	GAAACACCGGTAAATTTGAGGCTCCGGCATGCAGGAGGCCGTGGGGCTAG	1	bc
TGGCGCCTAA	GAAACACCGGTTAAAAGGAGGAGTTACAGTTAGAACTAGCAAGTTGACCT	1	bc
AGGAACCATA	GAAACACCGGTGTGGCTGAGAGTCCGGCAATGGTGTGGCTGTGGGGTTAG	1	bc
AGGCACGCTC	GAAACCCCGGTGTGGCTGAGAGTCCGGCAATGGTGTGGCTGTGGGGTTAG	1	bc
ATAGTTCACT	GAAATACCGGTTTACGTTGCATCGGTGTGGGGTTAGAGCTAGAAATAGCA	1	bc
TCTCTCGATT	GAAACACCGGTTATATTTGTAAGTGTTGTGGGGTTAGAGCTAGAAATAGC	1	bc
TTATCTAGGC	GAAACACCGGTTACATTGATGGTTAGAGCTAGAAATAGCAAGTTAACCTA	1	bc
ACATCGTCGA	GAAACACCGGTGTACGTATGGACTGAATCAGGGTGTGCAAGTGGGGTTAG	1	bc
AACGACATGC	GAAACACCGGTGCCCGTACTCTCACCTGATTACTTAATCCGTGGGGTTAG	1	bc
CAGACACAGA	GAAACACCGGTAGCAAGTGCGAGACGTGTTTCGTCCTTTCGTGGGGTTAG	1	bc
AGTGGGGCCG	GAAACACCGGTCCCCGCCCCGCGGGGTTAGAGCTAGAACTAGCAAGATAA	1	bc
ACTTGACAGC	GAAACACCGGTCGGGGCCACTCAGTGGTGGGGTTAGAGCTAGAAATAGCA	1	bc
ACCGAACTCT	GAAACACCGGTTTGAACTAGAAATAGCAAGTTAACCTAAGGCTAGTCCGT	1	bc
CCAAACTCGC	GAAACACCGGTGCGTTCGAAAGTCGGCTCGTAGTGTGGACGTGTAGTTAT	1	bc
GGGGAACTTC	GAAACACCGGTTCGCGTCTAGTGGGGTTAGAGCTAGATAAAGTAAGGTAA	1	bc
ACAGCGACTT	GAAACACCGGTGTACGTATGGACTGAACCAGGGTGTGCAAGTGGGGTTAG	1	bc
GACGTAGAAC	GAAACACCGGTAGCAAGTGCGAGACGTGTTTGTGGGGTTAGAGCTAGAAA	1	bc
TTTGTTCTGT	GAAACACCGGTTACATTGAGGGTTAGAGCTAGAAATAGCAAGTTAACCTA	1	bc
ACATTTACCG	GAAACACCGGTCGGGGCCACTCAGTGGGTGGGGTTAGAGCTAGAAATAGC	1	bc
GCGGAGTATA	GAAACACCGGTTAAGCCGAGTGGGGTTAGAGCCAGAAATAGCAAGTTAAC	1	bc
TGAACCCAGC	GAAACACCGGTGCATTCGAAAGTACGGTCGGAGTGTGGCCGGGGGGTTCG	1	bc
TGGAGCATCT	GAAACACCGGTTTAGCCGAGGAGGTAGAGCTAGAAATAGCAAGTTAACCT	1	bc
AGGGATGCTC	GAAACACCGGTCCCCGTCCAGTGGGGGTAGAGCTAGAAATAGCAAGATAA	1	bc
ACCGCACGAC	GAAACACCGGTGCGCTTACTGTCACCTGATTACTTAATCCGTGTGTTAGA	1	bc
AGACACTGAC	GAAACACCGGTAGCAAGTGCGAGACGTGTTTGTGGGGTTAGAGCTAGAAA	1	bc
AATAGATATG	GAAACACCGGTTACATTGAGGGTTAGAGCTAGAAATAGCAAGTTAACCTA	1	bc
GAGAACCTCG	GAAACACCGGTGCATTCGAAAGTCCGGTCGTAGTGTGGACGTGGGGTTAG	1	bc
GGCCCCATCT	GAAACACCGGTGTGGCTGAGAGTCCGGCAATGGTGTGGCTGTGGGGTTAG	1	bc
GTGCGGACTC	GAAACACCGGTTCCCGTCCCGTGGGGTTAGAGCTAGAGCTAGCAAGTTAA	1	bc
GCTTCACCCA	GAAACACCGGTCGGGGCTACTCAGTGGTGGGGTTAGAGCTAGAAATAGCA	1	bc
CCGTGTCAGC	GAAACACCGGTCGGGGCCACTCAAGTGGGGTTAGAGCTAGAAATAGCAAG	1	bc
AGACGCCGGC	GAAACACCGGTGCATTCGAAAGTCCGGTCGTAGTGTGGACGTGGGGTTAG	1	bc
AGGAGACCCG	GAAACACCGGTCGGCGGCAATCGTGGGTGGGGTTAGAGCTAGAAATAGCA	1	bc
GAGGACAAGC	GAAACACCGGTCGGCGGTGGGGTTAGAGCTAGAAATAGCAAGTTAACCTA	1	bc
CGGCTCTCGC	GAAACACCGGTGCATTCGAAAGTCCGGTCGTAGTGTGGACGTGGGGTTAG	1	bc
AAACACACGC	GAAACACCGGTGCATTCGAAAGTCCGGTCGTAGTGTGGACGTGGGGTTAG	1	bc
AGATACCGTG	GAAACACCGGTCGATTCATATCGAAACCTTCCCGTGACAGTGGGGTTAGA	1	bc
AAAGCCTTGC	GAAACACCGGTGCCTTCGCTAGCACGTTCGTAGTTAGGCCGTGGGGTTAG	1	bc
TAGGGCCTAA	GAAACACCGGTGCCCTTACTCTCACCTGATTAATTATTCCGCGGGGTTAG	1	bc
CTATTCGGAG	GAAACACCGGTACCTTTGTTGATGCTGGGTGGAGGGAATGTGGGGTTAGA	1	bc
TGTGGAGACT	GAAACACCGGTTCCCGTCCAGTGGGGTTAGAGCTAGAAATAGCAAGTTAA	1	bc
TTGGATCTGT	GAAACACCGGTTCCATTGCGTGGGGTTAGAGCTAGAAATAGGAAGTTACC	1	bc
AACTTCGGGT	GAAACACCGGTCGATTCATATCGAAACCTTCCCGTGACAGTGGTGTTAGA	1	bc
TTGACTCCTT	GAAACACCGGTCTCGAGTGAGGTGTTCAGGGGTGGGGTTAGAGCTAGAAA	1	bc
CCTATCACGG	GAAACACCGGTTATATTTGTAAGTGGGGTTAGGGCTAGAAATAGCAAGTT	1	bc
CTTTAACGGC	GAAACACCGGTCGGGGCCACTCAGTGGTGGGGTTAGAGCTAGAAATAGCA	1	bc
GCGACGCCTC	GAAACACCGGTTCCCGTCCAGTGGGGTTAGAGCTAGAAATAGCAAGTTAA	1	bc
GCGGCGGCTC	GAAACACCGGTTCCCGTCCAGTGGGGTTAGAGCTAGAAATAGCAAGTTAA	1	bc
CGTACCTTCC	GAAACACCGGTGTGGCTGAGAGTCCGGCAATGGTGTGGCTGGGGGGGTAG	1	bc
GTGCTATCGA	GAAACACCGGTTGGGCTGACAGCACTGCGATGGTAGGGCTGGGAGTATCA	1	bc
CATCTGATTC	GAAACACCGGTCCGTATGAGACCCGTGTGGCATGTACCTGTGAAGTTAGA	1	bc
AGGGTTGCCT	GAAACACCGGTGACATTGGGGTTAGAGCTAGAATTAGGATGTTAACCTAA	1	bc
GCGGTCCCCC	GAAACACCGGTTCCCGTCCAGTGGGGTTAGAGCTAGAAATAGCAAGTTAA	1	bc
TATCTTCTTC	GAAACACCGGTAACTATATTCATGCGATATCGCCGTATCAGTGGGGTTAG	1	bc
AAACTTAGGC	GAAACACCGGTAACTATATTCATGCGATATCGCCGTATGGGGTTAGAGCT	1	bc
TCAATCTTTT	GAAACACCGGTCTTGTTTGTGGGGGTGTGGGGTTGGAGCTAGCAATAGAT	1	bc
TGAAGGACGG	GAAACACCGGTCGGCGGCAATCGTGGGTGGGGTTAGAGCTAGAAATAGCA	1	bc
GTATTCGGAC	GAAACACCGGTACCTTTGTTGATGCTGGGTGGAAGGTACACCGGTACCTT	1	bc
GAAGAGATGC	GAAACACCGGTCGGCGGCAATCGTGGGTGGGGTTAGAGCTAGAAATAGCA	1	bc
AGATGGTCGT	GAAACACCGGTGCCTTCGACAGTGCGGTCGGAGTGTGGACGTGGGTTTAG	1	bc
ACGTTATCGA	GAAACACCGGTAGGGGCCACTCAGTGGTGGGGTTAGAGCTAGAAATAGCA	1	bc
GAGTTTGGCT	GAAACACCGGTCCGTAGGAGACCCGTGTGGCATGTACCTGTGGGGTTAGA	1	bc
GACCCCGCCA	GAAACACCGGTAGCAAGTGCGGGGTTAGAGCTAGAAATAGCAAGTTAACC	1	bc
GTCAAAGAAA	GAAACACCGGTAGCAAGTGCGAGCAAGTGTGGGGTTAGAGCTAGAAATAG	1	bc
TCTCGTCGCC	CAAAACACCGGTGTACGTATGGACTGAACCAGGGTGTGCAAGTGGGGTTA	1	bc
CTAATCGGAA	GAAACACCGGTAACTTTGTTGATGCAGGGGTGGGGTTAGCACTAGAACTA	1	bc
ACAAGCCGCA	GAAACACCGGTGTACGTATGGACTGAACCAGGGTGTGCAAGTGGGGTTAG	1	bc
GTGTTGACTA	GATATCAACACGGGTGGACGATACACCCGTTAAGCCGAGGAATAGGAAAG	1	bc
ATACCCCTGC	GAAACACCGGTAAATTTGAGGCTCCGGCATGCAGGAGGCTTGGGGTTAGA	1	bc
AAATGGCTTA	GAAACACCGGTGCCCTTACTCTCACCCGATTACTTAATCCGTGGGGTTAG	1	bc
AGACACCTAC	GAAACACCGGTAAATTTGAGGCTCCGGCATGGGGTTAGAGCTAGAAATAG	1	bc
ATAATCGCAA	GAAACACCGGTACCCTTGTTGATGCTGGGTGGATGGAATTTGTGGGGTTA	1	bc
CAACCTACAC	CAAAACACCGGTAACTATATTCATGCGATATCGCCGTATCAGTGGGGATA	1	bc
GCTTTTCTGC	GAAACACCGGTCGGGGCCACTCAGTGGTGGGGTTAGAGCTAGAAATAGCA	1	bc
TCGAATTCTT	GAAACACCGGTCTCGAGTGAGTGGGGTTAGAGCTAGAAATAGCAAGTTAA	1	bc
TAAGATCTAC	GAAACACCGGTCGGCGGCCGGTTAGAGCTAGAAGTAGCAAGTTAACCTAA	1	bc
ATGCAGCCTT	GAAACACCGGTTCCCGTCCAGTGGGGTTAGAGCTAGAAATAGCAAGTTAA	1	bc
AGCTACGCGG	GAAACACCGGTACCTTTGTTGATGCTGGGTGGAAGGAATTTTGTGGGGTT	1	bc
TCTCTCGATC	GAAACACCGGTTTAAGTTGTCAGTGAACAAGGGTGGAGATGTGGGGTAAG	1	bc
ACGTCGTCGT	GAAACACCGGTGTACGTATGGACTGAACCAGGGGGTGCAAGTGGGGTTAG	1	bc
TATGCTGAGC	GAAACACCGGTCTACGTTGCATCGGTGTGGGGTTAGAGCTAGAAATAGCA	1	bc
AGACTATAGC	GAAACACCGGTGCATTCGAAAGTCCGGTCGTAGTGTGGACGTGGGGTTAG	1	bc
ATACTGAGTT	GAAACACCGGTTTACGTTGCATCGGTGTGGGGTTAGAGCTAGAAATAGCA	1	bc
TAGAGTGTTC	GAAACACCGGTTTACGCATGGACTGAACCAGGGTGTGCAAGCAGGTTTAG	1	bc
GGGGTTCCTC	GAAACACCGGTTCCCGTCCAGTGGGGTTAGAGCTAGAAATAGCAAGTTAA	1	bc
CGGCGCCCTC	GAAACACCGGTGTGGCTGAGAGTCCGGCAATGGTGTGGCTGTGGGGTTAG	1	bc
ACGATTCCTT	GAAACACCGGTCTCGAGTGAGGTGTTCAGGGTGGGGTTAGAGCTAGAAAT	1	bc
GGTGCTGTCC	GAAACACCGGTGACATTGAGTACAGGGCGGTGGTAGAGCTAGAAATAGCA	1	bc
CTGCTTGGAT	GAAACAACGGTTTACGTTGCATCGTACGTTTTACGTTGAAAAAGTGGCAC	1	bc
CTACCTGTCC	GAAACACCGGTACCTTTGTTGATGCTGGGTGGAAGGAATTTGTGGGGTTA	1	bc
ATAAAGTATA	GAAACACCGGTAACTATATTCATGCGATATCGCCGTATCAGTGGGGTTAG	1	bc
ACGCTTTGCC	GGAACACCGGTTTACGTTGCATTAGAGCTAGAAATAGCAAGTTAACCTAA	1	bc
CCGTTGGGTA	GAAACACCGGTCGATTCATATCGAAACCTTCCCGTGACAGTGGGGTTAGA	1	bc
GGCACACTTA	GAAACACCGGTGTGGCTGAGAGTCCGGCAATGGTGTGGCTGTGGGGTTAG	1	bc
ATTGAGCCTA	GAAACACCGGTTAAGCCGGTGGGGTTAGAGCTAGAAATAGCAAGTTAACC	1	bc
GCGTCGCCCT	GAAACACCGGTGTCCGCTACCAGCTCCATTGTGGGGTTAGAGCTAGAAAT	1	bc
AGAAGAAGCG	GAAACACCGGTCGGCGGCAATCGTGGGTGGGGTTAGAGCTAGAAATAGCA	1	bc
ATGCAGCGCT	GAAACACCGGTTTACGTTGCATCGGTGTGGGGTTAGAGCTAGAAATAGCA	1	bc
CGACCCTAGA	GAAACACCGGTGCATTCGAAAGTCCGGTCGTAGTGTGGACGTGGGGTCAG	1	bc
AAAGCGTAGT	GAAACACCGGTGTACGTATGGACTGAACCAGGGTGTGCAAGTGGGGTTAG	1	bc
ACGCATCCTT	GAAACACCGGTCTCGAGTGAGGTGTTCAGGGTGGGGTTAGAGCTAGAAAT	1	bc
AGCACTGGTC	GAAACACCGGTATGAGAATCGGTCGGCATAGGGGGGGTAGAGCTAGTTAT	1	bc
AAAGACGTAC	GAAACACCGGTGCCCTTACTCTCACCTGATTACTTAATCCGTGGGGTTAG	1	bc
CTAGTCCGCA	GAAACACCGGTACCTTTGTTGATGCTGGTGTGGGGTTAGAGCTAGAAATA	1	bc
AGACACGAGC	GAAACACCGGTGCATTCGAAAGTCCGGTCGTAGTGTGGACGTGGGGTTAG	1	bc
AGGCACCATC	GAAACACCGGTGTGGCTGAGAGTCCGGCAATGGTGTGGCTGTGGGGTTAG	1	bc
GGCAACTACC	GAAACACCGGTAAATTTGAGGCTCCGGCATGCAGGAGGCCGTGGGGTTAG	1	bc
TTGATCCTCT	GAAACACCGGTTAAGCCGAGGGTTTAGAGCTAGAAATAGCAAGTTAACCT	1	bc
AAATGGTCGT	GAAACACCGGTGTACGTATGGACTGAACCAGGGTGTGCAAGTGGGGTTAG	1	bc
AAGGCTGTAC	GAAACACCGGTCCACTGACTCTCACCGTAGTACTTGATCCGGGGGGATAG	1	bc
AGCTTTACCG	GAAACACCGGTCGGGGCCACTCAGTGGTGGGGTTAGAGCTAGAAATAGCA	1	bc
CCCATCGGTT	GAAACACCGGTCGATTCATATCGAAACCTTCCCGTGACAGTGGGGTTGGA	1	bc
GAACTTATCT	GAAACACCGGTAAGTATATTCATGCCATATCTCGGTATCAGTGTGGTTAT	1	bc
AGAGGACCCG	GAAACACCGGTCAGTGGGGTTAGAGCTAGAAATAGCAAGTTAACCTAAGG	1	bc
GTTTAGCTGC	GAAACACCGGTTCGCGCCCCGCAGGGTTGGAGCTAGAAATAGCAATATCA	1	bc
CTGCTTATAT	GAAACACCGGTTTACGTTGCATCGGTGTGGGGTTAGAGCTAGAAATAGCA	1	bc
TAATCTATAA	GAAACACCGGTTACATTGATGCTTAGAGCTAGAAATAGCAAGTTAGCCTA	1	bc
GGAAGACTCG	GAAACACCGGTCGGCGGCAATCGTGGGTGGGGTTAGAGCTAGAAATAGCA	1	bc
GGGGAGACTA	GAAACACCGGTTCCCGTCCAGTGGGGTTAGAGCTAGAAATAGCAAGTTAA	1	bc
GTCACAGTAA	GAAACACCGGTAGCAAGTGCGAGACGTGTTTGTGGGGTTAGAGCTAGAAA	1	bc
ATGCTTGCCC	GAAACACCGGTTTACGTTGCATAGGTGTGGGGTTAGAGCTAGAAATAGCA	1	bc
AATGATTAGC	GAAACACCGGTTTACGTTGCATCGGTGTGGGGTTAGAGCTAGAAATAGCA	1	bc
ATGCGTATGT	GAAACACCGGTTTACGTTGCATCGGGGTTAGAGCTAGAAATAGCAAGCTA	1	bc
AGAAGGGGAC	GAAACACCGGTACCTTAGTTGATGCTGGGGGGATGGAATTTGTGTGGGGT	1	bc
TACCTTACTT	GAAACACCGGTAACTATATCCATGCTGTATCGCCGGATCAATGGGGATAG	1	bc
GCATCGCCGT	GAAACACCGGTGTACGTGTGGACTGAACCAGGGGGTGCAAGTGGGGTTAG	1	bc
GTGGAGGATA	GAAACACCGGTTCCCGTCCAGTGGGGTTAGAGCTAGAAATAGCAAGTTAA	1	bc
TCGCCCTGCA	GAAACACCGGTGCATTCGAAAGTCCGGTCGTAGTGTGGACGTGGGGTTAG	1	bc
GAGGATCCTA	GAAACACCGGTTTCCGTCCAGTGGGGTTAGATCTAGAAATAGCAAGTTAG	1	bc
ATAATATCGC	GAAACACCGGTGCATTCGAAAGTCCGGTTGTAGTGTGGACGTGGGGTTAG	1	bc
AGTATGCATA	GAAACACCGGTCCGTAGGAGACCCGTGTGGCATGTACCTGTGGGGTTAGA	1	bc
TCTTTAAGGA	GAAGCACCGGTTAAGCCGAGGGGGTAGAGCTAGTAATACCAAGTTTACCT	1	bc
ATATTGGTGC	GAAACACCGGTACCTTTGATGATGCTGGGTGGAATGAGGGGTTAGAGTTA	1	bc
TTTGGCTAGG	GGAACACCGGTTACATTGAGGGTTAGAGCTAGAAATAGCAAGTTAACCTA	1	bc
GAGCCAGGCA	GAAACACCGGTCGCAGGAGCGAGATGTGTGTGGGGGGTAGAGCTAGAAAT	1	bc
ACATTTGTGT	GAAACACCGGTCGATTCATATCGAAACCTTCCCGTGACAGTGGGGTTAGA	1	bc
TGAAGACCAG	GAAACACCGGTCGGGGTTAGAGCTAGAAATAGCAAGTTAACCTAAGGCTA	1	bc
CTAATAGTCC	GAAACACCGGTACCTTTGTTGATGATGTGTGGTTGGAATTTGAGGTGTTA	1	bc
AGACACGGAC	GAAACACCGGTAGCAAGTGCGGGGTTAGAGCTAGAAATAGCAAGTTAACC	1	bc
ATACCGATGC	GAAACACCGGTTGCATTGGGGCTAGAGCTAGAAATAGCAAGTTAACTTAA	1	bc
AATGACTAGC	GAAACACCGGTTTACGTTGCATCGGTGTGGGGTTAGAGCTAGAAATAGCA	1	bc
AATGATCATA	GAAACACCGGTTAAGCCGAGGAGTTATAGCTAGAAATAGCAAGTTAACCT	1	bc
CATAGCGCGC	GAAACACCGGTTTGAACTAGAAATAGCAAGTTAACCTAAGGCTAGTCCGT	1	bc
ACATCGACGT	GAAACACCGGTGTACGTATGGACTGAACCAGGGTGTGCAAGTGGGGTTAG	1	bc
AGATAGCCGC	GAAACACCGGTGCATCCTAAAGGCCGTTCGGAGTGGGTACGGGTGGTTAT	1	bc
GGTACATATA	GAAACACCGGTAAATTTGAGGCTCCGGCATGCAGGAGGCCGTGGGGTTAG	1	bc
GAACAACGAC	GAAACACCGGTTTGAACTACCTAGTTCAAACCGCGGTGGGGTTAGAGCTA	1	bc
ACTTTCCCTG	GAAACACCGGTCGGGGCCACTCAAAGTGGGGTTAGAGCTAGAAATAGCAA	1	bc
AATCGGCGAC	GAAACACCGGTGTAAGTATGGAATGAACCAGGGTGTGCAAGTGGGGTTAG	1	bc
AATCCCCTGC	GAAACACCGGTGTGGCTGAGAGTGCGGCAATGGTGTGGCTGGGGAGAGAG	1	bc
ACGTGTTGTA	GAAACACCGGTGACATTGCTAGAAATAGCAAGTTAACCTAAGGCTAGTCC	1	bc
AATTACGAGG	GAAACACCGGTTATATTTGTAAGTGTGTGGGGTTAGATCTAGAAATAGCA	1	bc
GCGTGGTGTC	GAAACGCCGGTGTACGGTGGGGTTAGAGCTAGAAATAGCAAGTTAACCTA	1	bc
ATGGTTCGTT	GAAACACCGGTTTACGTTGCATGTTAGAGCTAGAAATAGCAAATTAACCT	1	bc
ATCTCCTAGG	GAAACACCGGTTACAGCAAGAAATAAAAAGGTAAGCGAAGGCTAGGCTGG	1	bc
CGGACAAAGA	GAAACACCGGTAGCAAGTGCGGGGTTAGAGCTAGAAATAGCAAGTTAACC	1	bc
GCCGTCCCGC	GAAACACCGGTCGGCGGCAATCGTTAATCGGTTAATCGTGGGGTTAGAGC	1	bc
ACATCCCGCT	GAAACACCGGTGCATTCGAAAGTCCGGTCGTAGTGTGGACGTGGGGTTAG	1	bc
CGTCTGCACC	GAAACACCGGTCCGTAGGAGACCCGTGTGGCATGTACCTGTGGGGTTAGA	1	bc
CTACTCTCCA	GAAACACCGGTACCTTTGTTGATGCTGGGTGGTAGGAATTTTTGGGGGGT	1	bc
AGCACATCGC	GAAACACCGGTGCATTCGAAAGTCCGGTCGTAGTGTGGACGTGGGGTTAG	1	bc
ATCTATAGAG	GAAACACCGGTTATATTTGTAAGTGTGTGGGGTTAGAGCTAGAAATAGCA	1	bc
TCTTTAGGGC	GAAACACCGGTCGGGGCCATTTCTTAGTGGGGTTAGAGCTAGAAATAGCA	1	bc
ACCGCGATAC	GAAACACCGGTGCCCTTACTCTCACCTGAGTACTTAATCCGTGAGGTTAG	1	bc
GACGCCCACC	GAAACACCGGTGGCCATACCCTCACCTGATTACTTGATCAGTGGGGGAAG	1	bc
ACGAATGCCT	GAAACACCGGTCTCGAGTGAGGTGTGGTTAGAGTCTCGAGTGATAGCAAG	1	bc
AGCACGGCGC	GAAACACCGGTAGCAAGTGCGAGCAAGTTGGCTGGAGGTGTGAGAGCTAG	1	bc
GACGCCGAGC	GAAACACCGGTAGCAAGTGCGAGACGTTTTTGTGGGGTTAGAGCTAGAAA	1	bc
CACCTCTGCT	GAAACACCGGTACCTTTGTTGATGCTGGGTGGAAGGATTTTTGTGGGGTT	1	bc
ATAAATTATA	GGAACACCGGTAACTATATTCATGCGATATCGCCGTATCAGTGGGGTTAG	1	bc
GGCAACTACG	GAAACACCGGTAAATTTTAGGCTCCTGCATGCAGGAGGCCGCGGGGTTAG	1	bc
AGCCGCCTCG	GAAACACCGGTGTGGCTGAGAGTCCGGCAATGGTGTGGCTGTGGGGTTAG	1	bc
GTTATCGGCC	GAAACACCGGTACCTTTGTTGATGCTGGGTGGGGTTAGAGCTAGAAATAG	1	bc
ACGTTAGATT	GAAACACCGGTCGATTCATATCGAAACCTTCCCGTGACAGTGGGGTTAGA	1	bc
AGGATACGCC	GAAACACCGGTAGACCGGGATTCTGCATGGGCGTATGCTGAATTCGTGCG	1	bc
CATTTTCAGG	GAAACACCGGTGCGGTCGACTCAGCGGTGGGGTTAGAGCTAGAAATAGCA	1	bc
TCTCCCCTGC	GAAACACCGGTGTGGCTGAGAGTCCGGCAATGGTGTGGCTGTGGGGTTAG	1	bc
AAGAATACTT	GAAACACCGGTCTCGAGTGAGGTGTTCAGGGTGGGGTTAGAGCTAGAAAT	1	bc
ATGCTTGGAG	GAAACACCGGTTTACGTTGCATCGGTGTGGGGTTAGAGCTAGAAATAGAA	1	bc
CACCTGGCTC	GAAACACCGGTTTGAACTAGAAATAGCAAGTTAACCTAAGGCTAGTCAGT	1	bc
GATCTAATAC	GAAACACCGGTAACTATATTCATGCGATATCGCCGTATCAGAGGGGGTAG	1	bc
GACTCACAAC	GAAACACCGGTAGCAAGGGCGCGTCGGTTTTGTTAGGTTAGAGCTAGGCA	1	bc
ACTGCTCGCC	GAGACACCGGTACCTTTGTTGATGCTGGGTGGAAGGAGCTAGATGCTGGA	1	bc
CCGTACTTCA	GAAACACCGGTACTTTTGAGGCTCAAGCATGCTTAGAGCCGTAAATATAG	1	bc
TCGATAGCGG	GAAACACCGGTTATGTTTGCAAGTGAGTGGGGTTAGAGCTAGAAATAGCA	1	bc
GAACAACGCC	GAAACACGGGTTAGAGCTAGAAATAGCAAGTTAACCTAAGGCTAGTCCGT	1	bc
ATGAGCCTAC	GAAACACCGGTTAAGCCGAGGAGTTAGAGCTAGAAATAGCAAGTTAACCT	1	bc
TAAGATATGG	GAAACACCGGTTACTGAGGGGTTAGAGCTAGAAATAGCAAGTTAACCTAA	1	bc
TTGAGAAGAC	GAAACACCGGTTAAGCTGAGGGGGGGTAGTGTTGGGATAAAGATGGTAAT	1	bc
CGACACTCGA	GAAACACCGGTGCATTCGAAAGTCCGGTCGTAGTGTGGACGTGGGGTTAG	1	bc
AACGCCAGAT	GAAACACCGGTGCCCTTACTCTCACCTGATTACTTAATACGTGTGTTAGA	1	bc
ACTATACCTC	GAAACACCGGTCGGGGCCACTCAGTGGTGGGGTTAGAGCTAGAAATAGCA	1	bc
CGAGTCGTCC	GAAACACCGGTGACATTGGGTTGTCCGTTATCAACTTGAAAAAGTGGCAC	1	bc
CAAGACCTAC	GAAACACCGGTGCCCTTACTCTCACCTGATTACTTAATCCGTGGGGTTAG	1	bc
ATTGCTTGAC	GAAACACCGGTTTACGTTGCATCGGGGTGGGGGTAGAGCTAGAAATAGCA	1	bc
GAATCGTCGT	GAAACACCGGTGTACGTATGGACTGAACCAGGGTGTGCAAGTGGGGTTAG	1	bc
TAAAGCCCTA	GAAACACCGGTGCCCTTACTCTCACCTGATTACTTAATCCGTGGAGTTAG	1	bc
GGCACCGGCA	GAACCACCGGTAGCAAGTGCGAGACGTGTTTGTGGGGTTAGAGCTAGAAA	1	bc
GCGTGTTTTA	GAAACACCGGTGACATTGGGTACAGGGTGGGGTTAGAGCTAGAAATAGCA	1	bc
ACTATAGAGT	GAAACACCGGCTATATTTGTAAGTGGGTGGGGGTAGAGCTAGAAATAGCA	1	bc
AGTATGCAGC	GAAACACCGGTCCGTAGGAGACCCGTGTAGCATGTACCTTGTGGGGTTAG	1	bc
GCATAGTAGT	GAAACACCGGTGTACGTATGGACTGAACCAGGGTGTGCAAGTGGGGTTAG	1	bc
GACCGCCCTA	GAAACACCGGTGCCCTTACTCTCACCTGATTACTTAATCCGTGGGGTTAG	1	bc
AAGCTGAACG	GAAACACCGGTTTACGTTGCATCGGGGTTAGAGCTAGAAATAGCAAGTTA	1	bc
ATAACTTCTA	GAAACACCGGTAACTATATTCATGCGATATCGCCGTATCAGTGGGGTTAG	1	bc
CTGATCACAT	GAAACACCGGTTAAGCGGAGGAGTTTCGTTAGAGCTAGAAATAGCGAGTT	1	bc
AATTTAATGC	GAAACACCGGTCGGGGCCACTCAGTGGTGGGGTTAGATCTAGAAATAGCA	1	bc
ACGTGCGGCG	GAAACACCGGTCGATTCATATCGAAACCTTCCCGTGGGGATAGAGCTAGA	1	bc
GGAAACATCC	GAAACACCGGTGTGGCTGAGAGTCCGGCAATGGTGTGGCTGTGGGGTCAG	1	bc
TCATACAGCC	GAAACACCGGTTTGAACTAGAAATAGCAAGTTAACCTAAGGCTAGTCCGT	1	bc
AGTCTGTAGG	GAAACACCGGTTATATTTGTAAGTGTGTGGGGTTAGAGCTAGAAATAGCA	1	bc
GGGACCATAC	GAAACACCGGTGTGGCTGAGAGTCCGGCAATGGTGTGGCTGTGGGGTTAG	1	bc
AATAGAGACT	GAAACACCGGTTCCCGTCAGTGGGGTTAGAGCTAGAAATAGCAAGTTAAC	1	bc
GACTTGGACA	GAAACACCGGTAGCAAGCGCGAGTTAGTGTGGTTAGAGCTAGAAATAGCA	1	bc
GGACAACGCC	GCTAGAAATAGCAAGTTAACCTAAGGCTAGTCCGTTATCAACTTGAAAAA	1	bc
GGGATCAGCC	GAAACACCGGTGTGGGTTGGAGTCCGGCAATGGTGTGGCTGGGGGGATAA	1	bc
GTATACGGCC	GAAACACCGGTACCTTTGTTGATGCTGGGTGGAAGGAATTTTGTGGGGTT	1	bc
GGCCAATACC	GAAACACCGGTAAATTTGAGGCTCCGGCATGCAGGAGGCCGTGGGGTTAG	1	bc
AGAGTAGCTC	GAAACACCGGTGCATTCGAAAGTCTGGTCGTAGTGGGGACGTGGGGTTAG	1	bc
AAGGGTTATC	GAAACACCGGTGACATTGGGGGGGTTAGAGCTAGAAATAGCAAGTTAACC	1	bc
CTACCCTCGT	GAAACACCGGTGCATTCGAAAGTCCGGTCGTAGTGTGGACGTGGGGTTAG	1	bc
GAGACTACTT	GAAACACCGGTCTCGAGTGAGGTGTTCAGGGTGGGGTTAGAGCTAGAAAT	1	bc
GGGGCGCTTC	GAAACACCGGTGTGGGTCAAGGTCTCGTGATGGTGTGGCTAGGGGTAGAA	1	bc
TGGCCCCTGC	GAAACACCGGTAAATTTGAGGCTCCGGCATGCAGGAGGCCGTGGGGTTAG	1	bc
GCACCAAATT	GAAACACCGGTAACAATAGCGAGCGGTGTTAGATAGCACGATAACCTACG	1	bc
ATGAGCGTAT	GAAACACCGGTTAAGCCGAGTGGGGATAGAGCTAGAAATAGCAAGTTAAC	1	bc
GCGTCGCGCT	GAAACACCGGTGTCCGCTGCGAGCTCCATTGTGGGGTTAGAGCTAGAAAT	1	bc
GCATTTACTG	GAAACACCGGTCGGGGCCACTCAGTGGTGGGGTTAGAGCTAGAAATAGCA	1	bc
AAGATTAGAC	GAAACACCGGTTTACGTTGCATCGGGGTTGGAGCTAGTAATAGAAAGTTA	1	bc
GACGACAAGC	GAAACACTAGAAATAGCAAGTTAACCTAAGGCTAGTCCGTTATCAACTTG	1	bc
ATTAGCTTTG	GAAACACCGGTTACATTGAGGGGTTAGAGCTAGAAATAGCAAGTTAACCT	1	bc
AAATCGTCGT	GAAACACCGGTGTACGTATGGACTGAACCAGGGTGTGCAGTGGGGTTAGA	1	bc
