TACACCTGCA	GAAACACCGGTAAATTTGAGGCTCCGGCATGCAGGAGGCCGTGGGGTTAG	2	bc
TCTTATAACC	GAAACACCGGTAACCAGCGCATGCTCCAAAGTGGGGTTAGAGCTAGAAAT	2	bc
GACCCTTCCT	GAAACGCCGGTCGGCCAGAGGTAATCACATGTGGGGTTAGAGCTAGAAAT	1	bc
CAAATAATTC	GAAACACCGGTCCGTAGGAGACCCGTGTGGCATGTACCTGTGGGGTTAGA	1	bc
TGACCCCTCC	GAAACACCGGTGTGTCTGATCGTCCGGCAATGGTGTTGCTGTGGGGTTAG	1	bc
TACACCTGCA	GAAACACCGGTAAATTTGAGGCTCCAGCATGCAGGAGGCCGTGGGGTTAG	1	bc
TCTAATCCTT	GAAACACCGGTCTCGAGTGAGGGAAATAGCAAGTTAACCTAAGGCTAGTC	1	bc
ACACAACGAC	GAGCTAGAAATAGCAAGTTAACCTAAGGCTAGTCCGTTATCAACTTGAAA	1	bc
CTGAGTTTTA	GAAACACCGGTCAAGAGCTAACGCGTAGTGGTGGGGTTAGAGCTAGAAAT	1	bc
AGATACTCGA	GAAACACCGGTGCATTCGAAGCGCCGGGCGGATTGAGGACGGGGGGTGAA	1	bc
CCACCATCCG	GAAACACCGGTGGCAATAGGATGAGTGGAGTGGGGTTAGAGCTAGAAATA	1	bc
CCAAAACCTT	GAAACACCGGTCTCGAGTGAGGTGTTCAGGGTGGGGTTAGAGCTAGAAAT	1	bc
CACAGTATAA	GAAACACCGGTTAAGCCGAGGAGTTAACCTAGGTCTAGTCAGTTATCAAC	1	bc
TTATCGTTCA	GAAACACCGGTGGGTAGCTGGGTGCCCTACTGACCTAATTGTGGGGTTAG	1	bc
TACATTGTAC	GAAACACCGGTAAGTATTATCTAGCTATATCGCTGTATCTAGAGGTAGTA	1	bc
ACCCGCCTCC	GAAACACCGGTGAGGATGTGCGCACGGCGATGGGGTGTATGTGGAGTTAG	1	bc
GTCAGCATCA	GAAACACCGGTGAGGCCGAGGAGCTAACTATGGCTAGGCTTAGCAGGTTA	1	bc
AAGCCCCCCC	GAAACACCGGTGCATTCGAAAGTCCGGCCGTAGTGTGGACGTGGGGTTAG	1	bc
TGACGCTTAA	GAAACACCGGTTCATTCGAGAGCACAGCTATAGATAGGACGTTAAGCTAA	1	bc
GCGTCGCCCT	GAAACACCGGTGTCCGCTGCCAGCTCCATTGTGGGGTTAGAGCTAGAAAT	1	bc
GTAACCATGT	GAAACACCGGTTACAAATTAGGGTTAGAGCTAGAAATAGCAAGTTAACCT	1	bc
GACGCCTACC	GAAACACCGGTCAGCTTGAAATACCAGCTTGCCCTAAGCCTAGTCGTTTG	1	bc
TGGCCCCCCC	GAAACACCGGTAAATTTGAGGCTCCGGCATGCAGGAGGCCGTGGGGTTAG	1	bc
CGCAAAACCG	GAAACACCGGTCGGCGGCAATCGTGGTATGAGCCACGTGGGGTTAGATCG	1	bc
ATGGATCGCT	GAAACACCGGTTTGCGGTGGATCGAGAGTGCATGGTGGTAAAGCAAGAAA	1	bc
TCACAAAGCC	GCTAGAAATAGCAAGTTAACCTAAGGCTAGTCCGTTATCAACTTGAAAAA	1	bc
AAGTGTAGCT	GAAACACCGGTTTAAGATGCATCGGTGTGGGGTTAGAGCTAGAAATAGCA	1	bc
TACACCTGCA	GAAACACCGGTAAATTTGAGGCTCCGGCATGCAGGATGCCGTGGGGTTAG	1	bc
TCAGATCCGA	GAAACACCGGTCGGCGGGTATAAATAGCGAGTTAACCTGAGACTCTTCCG	1	bc
GGGGGCCCCC	GAAACACCGGTTCCCGTCCAGTGGGGTTAGAGCTAGAAATAGCAAGTTAA	1	bc
ATCAATGCAC	GAAACACCGGTGCCCTTATTCTCACAAGATTACTTAATTCGTGGGGTTAG	1	bc
CAAACCCCCG	GAAACACCGGTGCATTCGAAAGTCCAGTCGTAGTGTGGACGTGGGGTTAG	1	bc
AGGTGTTCAA	GAAACACCGGTAATAATTCCTGCCGGGTGGGGTTAGAGCTAGAAATAGCA	1	bc
AAGACCCCCC	GAAACACCGGTCGGCGGCAATCGTGCCTTTTTTCCTGCAGGGCGGGCCTT	1	bc
TACACCCCAC	GAAACACCGGTTCGCGCGGAATCTTTGTGGGGTTAGAGCTAGAAATAGCA	1	bc
CTCGGAAGTC	GAAACACCGGTCATGTCAATGCGGTGTGGGGTTAGAGCTAGAAATAGCAA	1	bc
CTTCTTGGCT	GAAACACCGGTTTACGGTGCATCGGAGTGGGGGTAGATAGAGAAAGAGCA	1	bc
TGCAGAGACA	GAAACACCGGTAGCAAGAGCGAGACGTTGAGGGGGTAGAGCTAGAACTAG	1	bc
AGGTGTCCAA	GAAACACCGGTAATAATTCCTGCCGGGTGGGGTTAGAGCTAGAAATAGCA	1	bc
TGGGGGGCCC	GAAACACCGGTTCCCGTCCAGTGGGGTTAGAGCTAGAAATAGCAAGTTAA	1	bc
AGCACCCGTT	GAAACACCGGTGGGGCTGTGAGGCCGCCAATGGGGTGGCGGTGGGGTTAG	1	bc
ATGCAAAGAC	GAAACACCGGTTTACGGGGCATGTGCGTGGGGTTAGAGCTAGAAATAGCA	1	bc
TATGGTTAGC	GAAACACCGGTTTACGTTGCATCGGTGTGGGGTTAGAGCTAGAAATAGCA	1	bc
TTAAAGGCCG	GAAACACCGGTCGGCGGCAATCGTGGGTGGGGTTAGAGCTAGAAATAGCA	1	bc
CTTACAGCCA	GAAACACCGGTAGCAAGTGCGAGACGTGTTGGTGGGGGTAGAGCTAGAAA	1	bc
AAAGAAACGC	GAAACACCGGTCGGCGGAACTGTGGGGTTAGAGCTAGACATAGAAAGTTA	1	bc
GGCAAACACC	GAAACACCGGTACCTCTGTTGATGCTGGGTGGGGTTAGAGCTAGAAATAG	1	bc
CTAATCCCTG	GAAACACCGGTCTCGAGTGAGGTGATCAGGGTGGGGTTAGAGAGAGAAAT	1	bc
GCCCACCGCC	GAAACACCGGTCGGGGCCACTCAGTGGTGGGGCTAGAGCTAGAAATAGCA	1	bc
GCCAACGAGC	GAACCACCGGTAATCAGAGGTGAACGTAAGGTGGGGTTAGAGCTAGAAAT	1	bc
CATATATTCC	GAAACACCGGTCTCGCATCCATGTATGTGGGGTTAGAGCTAGAAATAGCA	1	bc
