ACGTCGCGGA	GAAACACCGGTAGAACATGGTCGACATATAGTGGGGTTAGAGCTAGAAAT	2	bc
ATGACCCACC	GAAACACCGGTATATAAAAATACGAGTACAGTGGGGTTAGAGCTAGAAAT	2	bc
TTAACCCTAA	GAAACACCGGTTAAGCCGAGGAGTTACAGCTAGAAATAGCAAGTTAACCT	1	bc
TTGTGACTAA	GAAACACCGGTTAAGCCGAGGAGTTAGACATAGAACTAGCAAGTTAAACT	1	bc
GACAAGGCGC	GAAACACCGGTTTGAACTACCTAGTTCAAACCGGTGGGGTTAGAGCTAGA	1	bc
GCCCAGATAC	GAAACACCGGTCCCTCCGCATACAGCTGTCGTGGGGTTAGAGCTAGAAAT	1	bc
GCCTTACACC	GAAACACCGGTAGCAAGTACTCGACGTGTTTCTTATAGCACTTGATACGA	1	bc
AACACCCACC	GAAACACCGGTGCCCTTACTCTCACCTGATTACTTAATCCGTAGGGTTAG	1	bc
AAAACCTAGC	GAAACACCGGTGCATTCGAAAGACCGGTCGTAGTGTGGACGTGGGGTTAG	1	bc
CCCAAAACAC	GAAACACCGGTTTACTGGGGTTAGAGCTAGAAATAGCAAGTTAACCTAAG	1	bc
CTGTTAAGGT	GAAACACCGGTCTGCGTTACTCCGGGTGGGGGTTTAAGGCTAGAAATGGA	1	bc
CGGGGGTTCC	GAAACACCGGTCTTGGTTCTAGGGTAGTGGGGTTAGAGCAGAAATAGCAA	1	bc
AGATGCGGTC	GAAACACCGGTCGTTCCTTATCGAAACCTACCCGTGACAATGGGGCTAGA	1	bc
ACGGCCCCAC	GAAACACCGGTCCCCTTACTCTCACCTGATTACTTAATCCGTGGGGATAG	1	bc
TTACTCGGTT	GAAACACCGGTATGTCTGTTGATGGTGGGGGAAGGAATTAGCTAGAAATA	1	bc
GCTAGCTATG	GAAACACCGGTTACATTGAGGGGTTAGAGCTAGAAATAGCAAGTTAACCT	1	bc
TTCCTCATTT	GAAACACCGGTTAAGCCGAGGAGGGGTTTGAGCTAGAAATAGCAAGATAA	1	bc
GAGCATCCTC	GAAACACCGGTGCCCGTCCAGTGGGGTTAGGGCTAGAAATAGCAAGTTAA	1	bc
AGGCGGTCGC	GAAACACCGGTCCGTAGGAGACCCGTGTGGCCTGTACATGGGGGGTTAGA	1	bc
CGTGATGCCC	GAAACACCGGTGACATTGGAAGGTGGGGTTAGAGCTAGAAATAGCAAGTT	1	bc
GCCCTGATAC	GAAACACCGGTCCCTCCGCATACAGCTGTCGTGGGGTTAGAGCTAGAAAT	1	bc
AGACTGCCCT	GAAACACCGGTTCATAGGAGAGCCGGGAGGTGTATAGCTGGGGGGGTTAG	1	bc
AAAAACCCCC	GAAACACCGGTGCATTCGAAAGTCCGGTCGTAGTGTGGACGTGGGGTTAG	1	bc
GACCCGGCCC	GAAACACCGGTAGCAAGTGCGAGACGTTTTTGTGGGGTTAGAGCTAGAAA	1	bc
CTAGCTACGC	GAAACACCGGTTACATTGTGATTAGAGCTAGAAAAGGCTAGCTCGTTATC	1	bc
TCACAAAGCC	GAAACACCGGTTTGAACTACCTAGTAGCAAGTTAACCTAAGGCTAGTCCG	1	bc
AAGGCGGATC	GAAACACCGGTACCACTCCCGTCGGGAGTAGTGGGGTTAGAGCTAGAAAT	1	bc
ACTCGGCCGA	GAAACACCGGTCCGTAGGAGACACGGGTGGCATGTACCTGGGGGGATAAA	1	bc
AGGCCTACCT	GAAACACCGGTTTACGTGGCATCGGGTTAAGCTTGAAATAGCAAGCTAAC	1	bc
AAGATCCTTG	GAAACACCGGTCTAGAGTAAGACTGTCAGGGGGGAGAGATAGATAGAGAT	1	bc
AGCGACCGCA	GAAACACCGGTCCCGGTAGAACCAAAGGCTGTGGGGTTAGAGCTAGAAAT	1	bc
CTACTTATGT	GAAACACCGGTTACTTTGATTATGCTTAGTGCTAGAAATTGCGAGGTTAC	1	bc
GCTCTACGTC	GAAACACCGGTCCGTATGGGACTCGTGTGTGGGGTGACAGTGAGATAAAG	1	bc
ATGCCTTTGT	GAAACACCGGTTTACGTTGCTAGAAATAGCAAGTTAACCTAAGGCTAGTC	1	bc
TCTTGGGGGG	GAAACACCGGTTATATTTGCAAGTGTGTGGGGTTAGAGCTAGAAATAGCA	1	bc
TGGAGACCCG	GAAACACCGGTCGGCGGCAATCGTGGGTGGGGTTAGAGCTAGAAATAGCA	1	bc
CTTTAGGATA	GAAACACCGGTTAAGCCGAGTGGGGTTAGAGCTAGAAATAGCAAGTTAAC	1	bc
CGAGTTGCCC	GAAACACCGGTGACATTGGGTACAGGGGTGGGGTTAGAGCTAGAAATAGC	1	bc
TTGTGACATA	GAAACACCGGTCGTTATCAACTCATGGAACGTGGGGTTAGAGCTAGAAAT	1	bc
GGCGACCGCA	GAAACACCGGTCCCGGTAGAACCAAAGGCTGTGGGGTTAGAGCTAGAAAT	1	bc
TACACCCCAC	GAAACACCGGTTCGCGCGGAATCTTTGTGGGGTTAGAGCTAGAAATAGCA	1	bc
CATATATTCC	GAAACACCGGTCTCGTATCCATGTATGTGGGGTTAGAGCTAGAAATAGCA	1	bc
AAACTTATCT	GAAACACCGGTAACTATATACATGGTTAGAGTCAGAAATAGAAAGATAAC	1	bc
TCTTATAACC	GAAACACCGGTAACCAGCGCATGCTCCAAAGTGGGGTTAGAGCTAGAAAT	1	bc
GCTACACTCC	GAAACACCGGTGTGGCTGAGAGTCCGGCAATGGTGTGGCTGTGGGGATAG	1	bc
AACGACGTCC	GAAACACCGGTTTGAACAAGCAAAAGTGAGTTCATCTACGGCTGGGCTAT	1	bc
AGAAACAGAC	GAAACACCGGTAGCAAGTGCGAGGGTTAGAGCTAGAAATAGCAAGTTAAC	1	bc
GCCAACGAGC	GAAACACCGGTAATCAGAGGTGAACGGAATGTGGGGTTAGAGCTAGAAAT	1	bc
TCAGGCCCGC	GAAACACCGGTCGTAGGCAAAGCGGGGTTAGAGTAAGACTAAAAAAGGCA	1	bc
CCGTACTTCA	GAAACACCGGTACTCCGGAAGGCCAAGTGGGGTTAGAGCTAGAAATAGCA	1	bc
CATCACGCCA	GAAACACCGGTTTCAACTAGAAATAGCAAGTTAACCTAAGGCTAGTCCGG	1	bc
